Company number,Total number of officers,Number of active officers,Number of inactive officers,Number of non-persons officers,Total number of person with significant control,Number of active persons with significant control,Number of ceased persons with significant control,Number of non-persons with significant control,Good/Bad
00000118,22,9,13,0,1,1,0,1,1
00000133,33,4,29,0,1,1,0,1,1
00000587,17,0,17,0,0,0,0,0,1
00000899,18,0,18,0,0,0,0,0,1
00001122,18,3,15,0,1,1,0,1,1
00001125,36,3,33,0,0,0,0,0,1
00001955,8,7,1,0,2,2,0,0,0
00002065,103,16,87,0,1,1,0,1,1
00002119,13,4,9,0,0,0,0,0,1
00002694,26,3,23,0,1,1,0,1,1
00002729,29,4,25,0,1,1,0,1,1
00002854,23,0,23,0,1,1,0,2,1
00002877,30,3,27,0,1,1,0,1,1
00003002,58,6,52,0,1,1,0,1,1
00003543,37,1,36,0,1,1,0,1,1
00004273,21,3,18,0,1,1,0,1,1
00004302,177,27,150,0,0,0,0,0,1
00004466,109,9,100,0,0,0,0,0,1
00004474,3,0,3,0,0,0,0,0,1
00005017,124,22,102,0,0,0,0,0,1
00005034,105,19,86,0,0,0,0,0,1
00005193,47,8,39,0,0,0,0,0,0
00005263,3,1,2,0,1,1,0,0,0
00005506,39,7,32,0,0,0,0,0,0
00006252,18,3,15,0,1,1,0,1,1
00006400,71,12,59,0,1,1,0,0,1
00006662,33,2,31,0,0,0,0,0,1
00007663,79,22,57,0,0,0,0,0,1
00008848,378,8,370,0,0,0,0,0,1
00008894,107,17,90,0,0,0,0,0,1
00009330,150,17,133,0,0,0,0,0,1
00009592,15,6,9,0,1,1,0,0,1
00009635,147,11,136,0,0,0,0,0,1
00009806,120,19,101,0,3,1,2,0,1
00009844,139,4,135,0,0,0,0,0,1
00010340,112,14,98,0,0,0,0,0,1
00010416,8,5,3,0,2,2,0,0,0
00010553,33,8,25,0,0,0,0,0,0
00010631,50,14,36,0,0,0,0,0,1
00010747,23,5,18,0,8,8,0,0,0
00011136,39,0,39,0,0,0,0,0,1
00011701,53,8,45,0,0,0,0,0,1
00011717,28,9,19,0,0,0,0,0,0
00011771,23,10,13,0,0,0,0,0,1
00011785,9,3,6,0,0,0,0,0,1
00012383,130,43,87,0,0,0,0,0,1
00012851,31,14,17,0,0,0,0,0,0
00012886,22,4,18,0,1,1,0,0,0
00012934,8,4,4,0,2,2,0,0,1
00013067,26,8,18,0,0,0,0,0,1
00013101,25,0,25,0,0,0,0,0,1
00013103,33,6,27,0,1,1,0,0,1
00013393,135,11,124,0,1,1,0,0,1
00013882,84,14,70,0,0,0,0,0,0
00014172,47,7,40,0,1,1,0,1,1
00014183,126,4,122,0,0,0,0,0,1
00014259,79,9,70,0,2,1,1,2,1
00014283,5,0,5,0,0,0,0,0,0
00014504,39,0,39,0,0,0,0,0,1
00014667,35,3,32,0,1,1,0,1,1
00015228,11,3,8,0,0,0,0,0,1
00015454,67,10,57,0,2,1,1,2,1
00015543,20,6,14,0,0,0,0,0,1
00015993,75,14,61,0,0,0,0,0,1
00016432,44,9,35,0,1,1,0,1,1
00017002,108,17,91,0,0,0,0,0,1
00017302,28,9,19,0,2,0,2,0,1
00017877,111,4,107,0,1,1,0,0,0
00019366,91,16,75,0,0,0,0,0,1
00019457,44,9,35,0,0,0,0,0,1
00019605,112,24,88,0,0,0,0,0,1
00019647,20,2,18,0,1,1,0,1,1
00019654,21,9,12,0,1,1,0,0,0
00019739,43,4,39,0,1,1,0,1,1
00019741,22,0,22,0,0,0,0,0,1
00020535,30,7,23,0,1,1,0,1,1
00020537,27,7,20,0,0,0,0,0,1
00021054,9,4,5,0,2,2,0,0,0
00021401,136,0,136,0,0,0,0,0,1
00021680,33,8,25,0,0,0,0,0,0
00021695,27,3,24,0,1,1,0,1,1
00022096,63,5,58,0,2,2,0,2,1
00022215,47,12,35,0,0,0,0,0,1
00022217,0,0,0,0,0,0,0,0,1
00022285,18,3,15,0,1,1,0,0,1
00022306,10,0,10,0,0,0,0,0,1
00022357,21,3,18,0,0,0,0,0,1
00022473,18,7,11,0,0,0,0,0,1
00022672,11,4,7,0,0,0,0,0,0
00023059,16,4,12,0,0,0,0,0,0
00023072,64,13,51,0,0,0,0,0,1
00023088,30,9,21,0,0,0,0,0,0
00023273,3,2,1,0,1,1,0,0,0
00023307,60,10,50,0,0,0,0,0,1
00024001,33,6,27,0,7,6,1,0,0
00024084,103,20,83,0,0,0,0,0,1
00024397,15,8,7,0,1,1,0,0,0
00024477,44,11,33,0,0,0,0,0,1
00024499,23,2,21,0,1,1,0,1,1
00024511,43,9,34,0,0,0,0,0,1
00024681,7,5,2,0,4,4,0,0,0
00024722,36,5,31,0,1,1,0,1,1
00024795,36,6,30,0,2,1,1,2,1
00025088,72,7,65,0,1,1,0,1,1
00025090,44,2,42,0,1,1,0,1,1
00025579,18,5,13,0,1,1,0,1,1
00025755,27,3,24,0,1,1,0,1,1
00025816,178,14,164,0,0,0,0,0,1
00025850,13,2,11,0,1,1,0,1,1
00025928,26,0,26,0,0,0,0,0,1
00025932,130,12,118,0,1,1,0,1,1
00026018,69,4,65,0,1,1,0,1,1
00026077,37,7,30,0,1,1,0,1,1
00026091,13,4,9,0,1,1,0,1,1
00026135,25,1,24,0,0,0,0,0,1
00026306,63,6,57,0,2,2,0,2,1
00026351,18,5,13,0,0,0,0,0,1
00026466,19,2,17,0,1,1,0,1,1
00026588,38,4,34,0,0,0,0,0,0
00027204,44,4,40,0,1,1,0,1,1
00027272,80,19,61,0,0,0,0,0,1
00027630,43,0,43,0,0,0,0,0,1
00027657,56,4,52,0,1,1,0,1,1
00027767,21,5,16,0,1,1,0,1,1
00027991,30,3,27,0,0,0,0,0,1
00028264,26,6,20,0,0,0,0,0,1
00028512,20,5,15,0,0,0,0,0,1
00028766,15,6,9,0,1,1,0,1,0
00028807,60,8,52,0,1,1,0,0,1
00029022,52,3,49,0,1,1,0,1,1
00029131,32,3,29,0,1,1,0,1,1
00029325,16,2,14,0,1,1,0,0,1
00029356,28,11,17,0,0,0,0,0,0
00029423,36,5,31,0,1,1,0,1,1
00029533,22,0,22,0,1,1,0,1,1
00029846,51,6,45,0,1,1,0,1,1
00030129,41,0,41,0,0,0,0,0,1
00030470,42,9,33,0,0,0,0,0,1
00030546,31,10,21,0,0,0,0,0,1
00030705,15,3,12,0,1,1,0,1,1
00031014,36,1,35,0,1,1,0,1,1
00031031,72,14,58,0,2,1,1,0,1
00031114,22,9,13,0,0,0,0,0,1
00031407,15,5,10,0,1,1,0,0,0
00031438,24,9,15,0,8,8,0,0,0
00031461,37,8,29,0,0,0,0,0,1
00031641,9,4,5,0,1,0,1,0,0
00031746,36,4,32,0,1,1,0,1,1
00031799,24,7,17,0,0,0,0,0,0
00031801,40,9,31,0,1,1,0,1,1
00032872,24,4,20,0,1,1,0,1,1
00032965,38,6,32,0,0,0,0,0,1
00032983,92,21,71,0,6,5,1,0,1
00033727,16,6,10,0,1,1,0,1,0
00033774,49,11,38,0,0,0,0,0,1
00033840,19,0,19,0,0,0,0,0,0
00033881,11,5,6,0,1,1,0,0,0
00033886,28,5,23,0,1,1,0,1,1
00034121,23,8,15,0,3,3,0,0,1
00034165,130,23,107,0,0,0,0,0,1
00034273,33,3,30,0,1,1,0,1,1
00034292,28,2,26,0,2,1,1,1,0
00034479,50,14,36,0,0,0,0,0,1
00034603,41,8,33,0,1,1,0,0,1
00034916,15,3,12,0,3,3,0,1,0
00035025,20,5,15,0,1,1,0,1,1
00035161,26,5,21,0,2,1,1,2,1
00035341,7,5,2,0,1,1,0,1,1
00035448,10,2,8,0,0,0,0,0,1
00035475,5,5,0,0,2,2,0,0,0
00035668,42,8,34,0,1,1,0,1,1
00035838,32,9,23,0,0,0,0,0,1
00035990,58,4,54,0,1,1,0,1,1
00036006,35,9,26,0,0,0,0,0,1
00036137,23,3,20,0,0,0,0,0,0
00036148,77,5,72,0,0,0,0,0,1
00036443,20,5,15,0,1,1,0,1,1
00036451,20,0,20,0,0,0,0,0,1
00036695,59,8,51,0,1,1,0,1,1
00036721,49,9,40,0,1,1,0,1,1
00036822,14,7,7,0,1,1,0,1,1
00036882,229,17,212,0,0,0,0,0,1
00036913,22,3,19,0,2,1,1,2,1
00037101,118,4,114,0,0,0,0,0,1
00037822,54,15,39,0,0,0,0,0,1
00038252,106,8,98,0,1,1,0,0,0
00038357,15,6,9,0,2,1,1,0,0
00038597,0,0,0,0,0,0,0,0,0
00038769,136,12,124,0,0,0,0,0,1
00038839,10,3,7,0,1,1,0,0,0
00039100,22,4,18,0,3,3,0,0,0
00039345,13,2,11,0,1,1,0,1,1
00039494,25,5,20,0,1,1,0,1,1
00039625,94,10,84,0,0,0,0,0,1
00039811,17,7,10,0,0,0,0,0,1
00040004,80,15,65,0,0,0,0,0,1
00040056,103,27,76,0,0,0,0,0,1
00040088,29,5,24,0,0,0,0,0,1
00040149,27,3,24,0,1,1,0,1,1
00040209,25,4,21,0,1,1,0,1,1
00040561,78,14,64,0,0,0,0,0,1
00040583,19,2,17,0,1,1,0,1,1
00040594,105,0,105,0,0,0,0,0,1
00040901,43,2,41,0,1,1,0,1,1
00040932,35,11,24,0,0,0,0,0,1
00040987,20,6,14,0,0,0,0,0,0
00041424,69,14,55,0,0,0,0,0,1
00041482,39,10,29,0,0,0,0,0,1
00041495,50,9,41,0,1,1,0,1,1
00042000,43,3,40,0,1,1,0,1,1
00042297,35,5,30,0,5,3,2,0,0
00042342,50,5,45,0,1,1,0,1,1
00043026,25,1,24,0,1,1,0,1,1
00043649,8,4,4,0,1,1,0,1,0
00043885,9,5,4,0,0,0,0,0,0
00043893,40,12,28,0,0,0,0,0,1
00044452,15,3,12,0,0,0,0,0,1
00045690,39,3,36,0,1,1,0,1,1
00045867,164,29,135,0,0,0,0,0,1
00046014,170,14,156,0,0,0,0,0,1
00046723,11,5,6,0,2,2,0,1,1
00046833,91,8,83,0,0,0,0,0,0
00046913,45,2,43,0,1,1,0,0,1
00047382,16,5,11,0,1,1,0,0,0
00047463,0,0,0,0,0,0,0,0,1
00047802,78,9,69,0,0,0,0,0,1
00048245,47,12,35,0,1,1,0,1,0
00048676,28,5,23,0,0,0,0,0,1
00048760,30,5,25,0,2,1,1,2,1
00048839,89,12,77,0,0,0,0,0,1
00048896,66,9,57,0,0,0,0,0,1
00048949,35,0,35,0,0,0,0,0,1
00049116,37,6,31,0,1,1,0,1,0
00049371,11,2,9,0,1,1,0,0,0
00049714,13,4,9,0,1,1,0,1,0
00049907,41,2,39,0,1,1,0,1,1
06058014,6,1,5,0,5,3,2,2,1
06058030,4,1,3,0,1,1,0,0,1
06058058,4,1,3,0,1,1,0,0,1
06058164,6,2,4,0,1,1,0,1,1
06058205,4,0,4,0,0,0,0,0,1
06058217,5,1,4,0,2,2,0,0,1
06058259,4,0,4,0,0,0,0,0,1
06058362,6,2,4,0,1,1,0,0,0
06058431,9,0,9,0,2,1,1,0,1
06058499,4,0,4,0,0,0,0,0,1
06058722,4,2,2,0,1,1,0,0,1
06058728,8,2,6,0,0,0,0,0,1
06058751,10,1,9,0,1,1,0,0,1
06058761,3,2,1,0,1,1,0,0,1
06058793,6,2,4,0,1,1,0,0,0
06058841,4,1,3,0,1,1,0,0,1
06058902,4,1,3,0,1,1,0,0,1
06058931,7,5,2,0,4,4,0,0,1
06058985,5,0,5,0,1,1,0,0,1
06059203,10,3,7,0,1,0,1,0,0
06059272,6,0,6,0,0,0,0,0,1
06059392,4,2,2,0,1,1,0,0,1
06059413,4,2,2,0,1,1,0,0,1
06059717,14,4,10,0,0,0,0,0,1
06060026,25,5,20,0,1,1,0,1,1
06060103,2,1,1,0,1,1,0,0,0
06060260,11,2,9,0,0,0,0,0,1
06060432,5,1,4,0,0,0,0,0,1
06060795,5,0,5,0,0,0,0,0,1
06060852,12,0,12,0,0,0,0,0,1
06060931,5,3,2,0,1,1,0,0,1
06060951,3,1,2,0,4,3,1,0,0
06061140,6,4,2,0,2,2,0,0,1
06061188,8,0,8,0,0,0,0,0,1
06061537,10,3,7,0,4,3,1,1,0
06061759,11,0,11,0,0,0,0,0,1
06061947,14,7,7,0,0,0,0,0,1
06061984,21,8,13,0,0,0,0,0,1
06062010,9,0,9,0,0,0,0,0,1
06062118,4,2,2,0,1,1,0,0,1
06062137,9,5,4,0,1,1,0,0,0
06062171,5,0,5,0,0,0,0,0,1
06062192,4,0,4,0,0,0,0,0,1
06062201,5,3,2,0,2,2,0,0,1
06062308,7,1,6,0,3,1,2,2,1
06062472,9,4,5,0,1,1,0,0,1
06062615,10,1,9,1,2,2,0,1,1
06062760,5,3,2,0,2,2,0,0,1
06062855,5,1,4,0,2,1,1,0,1
06063052,6,0,6,0,0,0,0,0,1
06063380,4,2,2,0,1,1,0,0,1
06064113,4,1,3,0,1,1,0,0,1
06064129,5,2,3,0,0,0,0,0,1
06064138,7,2,5,1,1,1,0,0,1
06064158,7,5,2,0,1,1,0,0,1
06064375,23,4,19,0,2,2,0,2,1
06064666,6,2,4,0,1,1,0,0,1
06064830,4,0,4,0,1,1,0,0,1
06064905,6,4,2,0,3,3,0,0,1
06065000,7,0,7,0,0,0,0,0,1
06065064,6,0,6,0,0,0,0,0,1
06065089,5,0,5,0,0,0,0,0,1
06065109,4,2,2,0,1,1,0,0,1
06065280,5,3,2,0,0,0,0,0,1
06065326,4,0,4,0,1,1,0,0,1
06065376,4,2,2,0,1,1,0,0,1
06065393,5,3,2,0,1,1,0,0,1
06065930,12,1,11,0,1,1,0,0,1
06066288,6,1,5,0,1,1,0,0,1
06066418,7,3,4,0,1,1,0,0,1
06066720,4,2,2,0,2,2,0,0,1
06066725,4,2,2,0,1,1,0,0,1
06067288,4,1,3,0,1,1,0,0,1
06067357,15,0,15,0,0,0,0,0,1
06067375,15,0,15,0,0,0,0,0,1
06067421,5,0,5,0,0,0,0,0,1
06067422,10,4,6,0,1,1,0,0,1
06067437,15,4,11,0,1,1,0,1,1
06067511,6,3,3,0,2,2,0,0,0
06067579,7,3,4,0,1,1,0,0,1
06067661,5,2,3,0,2,1,1,0,0
06067787,17,4,13,0,0,0,0,0,1
06067905,10,4,6,0,1,1,0,1,1
06068171,8,1,7,0,1,1,0,0,1
06068460,10,0,10,0,0,0,0,0,1
06068620,8,1,7,0,1,1,0,0,1
06068895,4,2,2,0,1,1,0,0,1
06068907,4,1,3,0,1,1,0,0,0
06068931,6,2,4,0,1,1,0,0,1
06068952,2,1,1,0,0,0,0,0,1
06069174,4,2,2,0,2,2,0,0,1
06069869,26,0,26,0,1,1,0,1,1
06069882,4,2,2,0,1,1,0,0,1
06069892,4,0,4,0,1,1,0,0,1
06069919,14,3,11,0,2,1,1,2,1
06070000,23,5,18,0,2,2,0,2,1
06070054,5,4,1,0,2,2,0,0,1
06070096,4,3,1,0,1,1,0,1,1
06070133,6,2,4,0,1,1,0,1,1
06070437,4,1,3,0,3,3,0,0,1
06070478,6,2,4,0,1,1,0,0,1
06070488,5,3,2,0,2,2,0,0,1
06070500,4,1,3,0,1,1,0,0,1
06070514,8,3,5,0,1,1,0,1,1
06070625,5,2,3,0,0,0,0,0,1
06070652,3,3,0,0,1,1,0,0,1
06070838,7,4,3,0,1,1,0,0,0
06070846,4,1,3,0,2,2,0,0,1
06071144,9,3,6,0,1,1,0,0,1
06071147,11,3,8,0,0,0,0,0,1
06071227,4,0,4,0,0,0,0,0,1
06071682,8,3,5,0,1,1,0,1,1
06071685,8,4,4,0,0,0,0,0,1
06071981,4,2,2,0,1,1,0,0,1
06072022,4,2,2,0,1,1,0,0,1
06072025,11,5,6,0,1,1,0,0,1
06072068,6,0,6,0,0,0,0,0,1
06072070,5,3,2,0,0,0,0,0,1
06072228,5,1,4,0,1,1,0,0,1
06072298,4,2,2,0,1,1,0,0,1
06072317,5,3,2,0,2,2,0,0,1
06072488,3,1,2,0,1,1,0,0,1
06072839,5,2,3,0,1,1,0,1,1
06072918,9,1,8,0,1,1,0,1,1
06072929,5,0,5,0,0,0,0,0,1
06072971,5,0,5,0,0,0,0,0,1
06073134,6,0,6,0,3,3,0,0,1
06073523,10,0,10,0,0,0,0,0,1
06073648,31,11,20,0,0,0,0,0,1
06073690,29,4,25,0,2,2,0,2,1
06073803,6,0,6,0,0,0,0,0,1
06073955,5,2,3,0,1,1,0,0,1
06073962,26,5,21,0,0,0,0,0,1
06073971,6,1,5,0,1,1,0,0,1
06074004,4,2,2,0,2,2,0,0,1
06074479,8,5,3,0,0,0,0,0,1
06074667,4,1,3,0,2,2,0,0,1
06074684,3,1,2,0,1,1,0,0,0
06074686,7,0,7,0,0,0,0,0,1
06075060,6,3,3,0,2,2,0,0,1
06075780,6,2,4,0,1,1,0,0,1
06075843,2,2,0,0,1,1,0,0,1
06076014,4,2,2,0,2,2,0,0,1
06076177,7,3,4,0,2,2,0,0,1
06076187,5,0,5,0,0,0,0,0,1
06076188,5,3,2,0,2,2,0,0,1
06076220,7,2,5,0,1,1,0,1,1
06076697,4,2,2,0,1,1,0,0,1
06076701,5,3,2,0,1,1,0,0,1
06076899,7,5,2,0,4,4,0,0,1
06076995,12,3,9,0,0,0,0,0,1
06076999,9,3,6,0,1,1,0,0,1
06077003,12,3,9,0,1,1,0,1,1
06077024,6,2,4,0,2,2,0,0,1
06077217,4,2,2,0,1,1,0,0,1
06077223,18,4,14,0,1,1,0,1,1
06077377,4,1,3,0,1,1,0,0,1
06077574,6,2,4,0,1,1,0,0,0
06077747,4,4,0,0,4,3,1,0,0
06077784,4,2,2,0,3,3,0,0,1
06077852,8,4,4,0,3,3,0,0,0
06077922,24,12,12,0,1,1,0,0,1
06078132,7,5,2,0,1,1,0,0,1
06078143,6,1,5,0,1,1,0,0,1
06078196,2,0,2,0,0,0,0,0,1
06078242,4,0,4,0,1,1,0,0,0
06078286,5,3,2,0,1,1,0,1,1
06078379,4,0,4,0,0,0,0,0,1
06078444,6,3,3,0,2,2,0,0,1
06078449,5,3,2,0,1,1,0,0,1
06078455,5,3,2,0,1,1,0,0,1
06078477,7,3,4,0,1,1,0,1,1
06078502,6,0,6,0,0,0,0,0,1
06078558,6,0,6,0,3,3,0,0,1
06078774,3,1,2,0,1,1,0,0,1
06078832,6,2,4,0,1,1,0,0,1
06078933,15,0,15,0,0,0,0,0,1
06079021,4,2,2,0,2,2,0,0,1
06079040,18,0,18,0,0,0,0,0,1
06079071,3,1,2,0,1,1,0,0,0
06079459,6,2,4,0,2,2,0,0,1
06079523,4,1,3,0,2,1,1,0,1
06079709,5,3,2,0,2,2,0,0,0
06079749,16,7,9,0,3,3,0,1,1
06079837,5,0,5,0,2,2,0,0,1
06079867,4,0,4,0,0,0,0,0,1
06080056,5,3,2,0,2,2,0,0,1
06080199,8,5,3,0,1,1,0,1,1
06080277,12,2,10,0,0,0,0,0,1
06080283,6,3,3,0,2,2,0,0,1
06080353,5,3,2,0,2,2,0,0,1
06080431,4,0,4,0,0,0,0,0,1
06080432,6,0,6,0,0,0,0,0,1
06080497,18,6,12,0,1,0,1,1,1
06080856,4,2,2,0,1,1,0,0,1
06080904,5,3,2,0,1,1,0,0,1
06080910,6,0,6,0,0,0,0,0,1
06080921,5,3,2,0,2,2,0,0,1
06081010,4,2,2,0,1,1,0,0,1
06081055,10,5,5,0,2,2,0,0,1
06081107,12,4,8,0,5,3,2,0,1
06081150,4,3,1,0,1,1,0,1,1
06081301,10,3,7,0,3,3,0,0,0
06081854,2,0,2,0,0,0,0,0,1
06082363,2,2,0,0,1,1,0,0,0
06082865,16,3,13,0,3,3,0,0,1
06083330,5,1,4,0,2,2,0,0,1
06083408,20,10,10,0,1,1,0,0,0
06083471,23,0,23,0,1,1,0,1,1
06084249,4,1,3,0,1,1,0,0,0
06084965,15,5,10,0,0,0,0,0,1
06085861,5,3,2,0,2,2,0,0,0
06086056,2,2,0,0,1,1,0,0,0
06086559,16,3,13,0,1,0,1,1,1
06086668,4,2,2,0,1,1,0,0,1
06086902,57,23,34,0,1,0,1,0,1
06087344,20,9,11,0,2,2,0,0,1
06087472,5,3,2,0,2,2,0,0,1
06087745,9,2,7,0,1,1,0,1,1
06088573,14,6,8,0,1,1,0,1,1
06089744,6,2,4,0,0,0,0,0,1
06090105,4,1,3,0,1,1,0,0,0
06090338,23,4,19,0,1,1,0,1,1
06090404,2,2,0,0,1,1,0,0,0
06090608,7,6,1,0,0,0,0,0,0
06091273,17,4,13,0,0,0,0,0,1
06091849,6,3,3,0,1,1,0,0,1
06092692,20,7,13,0,1,1,0,1,1
06092706,5,2,3,0,1,1,0,1,1
06092971,12,5,7,0,0,0,0,0,0
06093157,4,1,3,0,1,1,0,0,1
06096228,3,3,0,0,1,1,0,0,0
06096705,3,2,1,0,1,1,0,0,1
06096759,8,3,5,0,3,2,1,2,1
06097440,9,0,9,0,0,0,0,0,1
06098580,3,1,2,0,3,2,1,0,0
06098925,25,6,19,0,1,1,0,1,1
06098995,5,1,4,0,1,1,0,0,0
06099589,4,1,3,0,1,1,0,0,1
06099690,3,0,3,0,0,0,0,0,0
06099726,2,0,2,0,1,1,0,0,0
06100113,5,3,2,0,1,1,0,1,1
06102678,11,6,5,0,3,2,1,3,1
06102989,4,2,2,0,0,0,0,0,1
06103087,8,6,2,0,2,2,0,0,0
06103195,5,2,3,0,1,1,0,0,1
06103230,5,2,3,0,1,1,0,1,1
06103481,6,3,3,0,1,1,0,0,1
06103483,5,0,5,0,0,0,0,0,1
06103484,5,0,5,0,0,0,0,0,1
06104125,4,2,2,0,2,2,0,0,1
06105016,5,2,3,0,1,1,0,0,0
06106457,5,3,2,0,2,2,0,0,0
06107675,4,2,2,0,1,1,0,0,0
06107682,23,3,20,0,1,1,0,1,1
06108174,5,3,2,0,2,2,0,0,0
06108332,23,3,20,0,1,1,0,1,1
06109435,8,4,4,0,1,1,0,0,0
06109452,3,1,2,0,1,1,0,0,0
06109673,2,2,0,0,1,1,0,1,1
06109740,9,3,6,0,2,1,1,2,1
06110470,3,0,3,0,0,0,0,0,1
06110905,7,0,7,0,0,0,0,0,1
06111133,3,2,1,0,1,1,0,0,0
06111803,31,5,26,0,0,0,0,0,1
06112413,8,5,3,0,0,0,0,0,1
06112902,10,5,5,0,0,0,0,0,0
06113220,6,0,6,0,0,0,0,0,1
06113479,51,10,41,0,0,0,0,0,1
06113547,13,6,7,0,0,0,0,0,0
06113548,5,2,3,0,1,1,0,0,1
06113654,12,2,10,0,0,0,0,0,0
06113676,16,7,9,0,0,0,0,0,1
06114273,5,3,2,0,2,2,0,0,0
06114448,18,5,13,0,0,0,0,0,1
06115619,2,0,2,0,0,0,0,0,1
06115620,2,0,2,0,0,0,0,0,1
06115624,2,0,2,0,0,0,0,0,1
06116102,14,5,9,0,0,0,0,0,1
06116121,15,4,11,0,2,1,1,1,1
06116357,21,3,18,0,2,2,0,2,1
06116625,4,1,3,0,1,1,0,0,1
06116768,13,4,9,0,2,2,0,2,1
06117418,7,3,4,0,4,1,3,1,0
06117755,3,2,1,0,1,1,0,0,0
06117997,6,3,3,0,1,1,0,0,0
06119036,48,10,38,0,1,1,0,1,1
06119328,5,3,2,0,2,2,0,0,0
06119662,8,3,5,0,2,2,0,0,1
06119880,7,0,7,0,0,0,0,0,1
03880267,8,0,8,0,0,0,0,0,1
03880306,29,0,29,0,0,0,0,0,1
03880363,4,2,2,0,1,1,0,0,1
03880908,5,3,2,0,1,1,0,1,0
03880963,25,7,18,1,0,0,0,0,1
03881165,22,0,22,0,1,1,0,1,1
03881286,4,2,2,0,2,2,0,0,0
03881333,9,0,9,0,0,0,0,0,1
03881356,10,0,10,0,0,0,0,0,1
03881406,10,3,7,0,1,1,0,1,1
03881708,18,0,18,0,0,0,0,0,1
03881829,26,7,19,0,0,0,0,0,0
03882013,28,5,23,0,1,1,0,1,1
03882115,9,3,6,0,3,3,0,0,1
03882134,11,2,9,0,1,1,0,1,1
03882513,19,2,17,0,2,1,1,2,1
03882652,5,0,5,0,0,0,0,0,1
03882663,5,3,2,0,2,2,0,0,1
03882679,9,1,8,0,1,1,0,0,1
03882852,16,3,13,0,0,0,0,0,1
03882927,7,2,5,0,1,1,0,0,0
03883492,5,3,2,0,2,2,0,0,1
03883607,8,5,3,0,1,1,0,0,0
03883677,15,5,10,0,2,2,0,0,0
03883776,7,5,2,0,1,1,0,0,1
03883907,3,3,0,0,3,1,2,0,1
03884383,36,3,33,0,1,1,0,0,1
03884659,36,10,26,0,0,0,0,0,0
03884685,79,13,66,0,0,0,0,0,1
03884737,5,3,2,0,1,1,0,0,0
03884759,5,2,3,0,0,0,0,0,1
03884779,10,1,9,0,0,0,0,0,1
03884933,8,4,4,0,1,1,0,0,1
03884981,26,2,24,0,1,1,0,1,1
03885013,31,5,26,0,1,1,0,0,1
03885293,3,1,2,0,2,2,0,0,0
03885397,7,0,7,0,0,0,0,0,1
03885516,5,1,4,0,1,1,0,0,1
03885555,13,2,11,0,0,0,0,0,1
03885593,37,10,27,0,0,0,0,0,1
03885621,5,2,3,0,1,1,0,0,0
03885838,20,4,16,0,0,0,0,0,0
03885898,20,7,13,0,1,1,0,1,0
03886084,12,3,9,0,1,1,0,1,1
03886106,7,4,3,0,0,0,0,0,0
03886194,17,0,17,0,0,0,0,0,1
03886236,40,14,26,0,0,0,0,0,0
03886253,29,5,24,0,1,1,0,1,1
03886321,8,4,4,0,1,1,0,0,1
03886503,32,15,17,0,0,0,0,0,1
03886505,8,1,7,0,0,0,0,0,1
03886811,6,0,6,0,2,2,0,0,0
03886841,18,4,14,0,0,0,0,0,1
03887180,12,4,8,0,2,2,0,0,1
03887515,7,2,5,0,1,1,0,0,0
03887805,6,3,3,0,0,0,0,0,0
03887870,27,3,24,0,1,1,0,1,1
03888006,10,2,8,0,1,1,0,0,1
03888013,16,3,13,0,1,1,0,1,1
03888219,8,0,8,0,0,0,0,0,1
03888392,19,4,15,0,1,1,0,1,1
03888415,3,1,2,0,1,1,0,0,1
03888636,24,4,20,0,0,0,0,0,1
03888770,8,0,8,0,0,0,0,0,1
03888789,20,4,16,0,2,1,1,2,1
03888799,10,3,7,0,4,3,1,0,0
03888948,20,4,16,0,1,1,0,1,1
03889328,11,0,11,0,0,0,0,0,1
03889425,10,0,10,0,0,0,0,0,1
03889552,38,7,31,0,1,1,0,1,1
03889765,23,0,23,0,0,0,0,0,1
03890249,25,0,25,0,0,0,0,0,1
03890301,7,0,7,0,0,0,0,0,1
03890341,39,14,25,0,0,0,0,0,1
03890474,9,1,8,0,1,1,0,0,1
03891021,18,4,14,0,1,1,0,1,1
03891123,29,5,24,0,0,0,0,0,0
03891149,27,3,24,0,1,1,0,1,1
03891168,9,2,7,0,1,1,0,1,0
03891217,12,0,12,0,0,0,0,0,1
03891334,10,2,8,0,1,1,0,1,0
03891455,10,2,8,0,1,1,0,1,1
03891689,4,2,2,0,0,0,0,0,0
03891934,15,0,15,0,0,0,0,0,1
03892047,5,2,3,0,1,1,0,1,1
03892112,4,3,1,0,1,1,0,0,0
03892352,5,3,2,0,1,1,0,0,0
03892866,9,0,9,0,0,0,0,0,1
03893078,4,1,3,0,2,2,0,0,1
03893084,28,9,19,0,0,0,0,0,1
03893356,36,10,26,0,0,0,0,0,1
03893656,4,0,4,0,0,0,0,0,0
03893836,21,2,19,0,1,1,0,1,1
03894136,5,0,5,0,1,1,0,0,0
03894362,15,0,15,0,0,0,0,0,1
03894470,21,2,19,0,1,1,0,1,1
03894827,11,3,8,0,1,1,0,0,1
03894828,11,3,8,0,1,1,0,0,1
03895053,115,22,93,0,0,0,0,0,1
03895063,24,3,21,0,1,1,0,1,1
03895152,3,2,1,0,1,1,0,0,0
03895253,12,2,10,0,1,1,0,1,1
03895293,12,2,10,0,4,2,2,0,1
03895297,7,1,6,0,1,1,0,1,1
03895376,4,0,4,0,0,0,0,0,1
03895529,29,3,26,0,1,1,0,1,1
03895628,21,6,15,0,1,1,0,1,1
03895691,3,3,0,0,1,1,0,0,0
03895701,4,2,2,0,1,1,0,0,1
03895814,61,0,61,0,0,0,0,0,1
03895994,14,0,14,0,0,0,0,0,1
03896007,5,1,4,0,2,2,0,0,1
03896124,25,2,23,0,0,0,0,0,1
03896214,17,4,13,0,2,2,0,0,0
03896321,43,6,37,0,0,0,0,0,1
03896469,7,0,7,0,1,1,0,0,1
03896584,34,0,34,0,0,0,0,0,1
03896734,16,8,8,0,0,0,0,0,1
03896907,17,0,17,0,1,1,0,0,1
03897231,6,4,2,0,0,0,0,0,0
03897745,20,3,17,1,1,1,0,1,1
03897800,20,0,20,0,0,0,0,0,1
03897810,12,2,10,0,0,0,0,0,1
03897915,10,0,10,0,2,2,0,2,1
03897919,122,16,106,0,0,0,0,0,1
03897926,34,0,34,0,0,0,0,0,1
03897969,34,6,28,0,0,0,0,0,0
03898015,7,0,7,0,0,0,0,0,1
03898093,24,4,20,0,0,0,0,0,0
03898128,20,6,14,0,0,0,0,0,0
03898170,40,11,29,0,0,0,0,0,0
03898246,7,3,4,0,2,2,0,0,1
03898306,37,7,30,0,0,0,0,0,1
03898338,18,3,15,0,3,1,2,1,1
03898492,6,0,6,0,1,1,0,0,1
03898509,4,2,2,0,3,3,0,0,1
03898593,19,8,11,0,0,0,0,0,0
03898618,9,3,6,0,1,1,0,1,1
03898843,7,4,3,0,0,0,0,0,0
03899303,20,2,18,0,0,0,0,0,1
03899421,11,1,10,0,1,1,0,1,0
03899738,37,4,33,0,1,1,0,1,1
03900040,8,6,2,0,3,1,2,1,1
03900200,16,0,16,0,0,0,0,0,1
03900219,26,0,26,0,0,0,0,0,1
03900232,114,16,98,0,1,1,0,0,0
03900281,22,0,22,0,0,0,0,0,1
03900397,7,3,4,0,3,2,1,0,0
03900606,29,4,25,0,3,1,2,0,1
03900804,48,9,39,0,1,1,0,1,1
03900836,29,0,29,0,1,1,0,1,1
03900841,15,3,12,0,1,1,0,1,1
03900915,27,4,23,0,1,1,0,1,1
03901013,8,4,4,0,2,2,0,0,0
03901044,16,0,16,0,0,0,0,0,1
03901212,19,1,18,0,1,1,0,0,1
03901341,6,0,6,0,0,0,0,0,1
03901376,15,6,9,0,7,4,3,0,1
03901665,34,13,21,0,0,0,0,0,1
03901706,5,0,5,0,0,0,0,0,1
03901744,5,2,3,0,1,1,0,0,0
03901858,10,4,6,0,0,0,0,0,0
03901939,19,5,14,0,0,0,0,0,0
03902224,5,2,3,0,1,1,0,0,0
03902325,7,2,5,0,1,1,0,0,0
03902425,10,5,5,0,1,1,0,0,1
03902499,34,3,31,0,1,1,0,1,1
03902880,23,6,17,0,1,1,0,1,1
03902912,6,2,4,0,0,0,0,0,1
03902965,20,0,20,0,0,0,0,0,1
03903233,43,11,32,0,1,1,0,1,1
03903999,2,2,0,0,2,2,0,0,0
03904023,8,0,8,0,0,0,0,0,1
03904138,28,4,24,0,1,1,0,1,1
03904153,13,0,13,0,0,0,0,0,1
03904186,27,0,27,0,0,0,0,0,1
03904207,15,3,12,0,1,1,0,1,1
03904296,4,3,1,0,2,2,0,0,1
03904813,17,3,14,0,1,1,0,0,1
03904843,3,3,0,0,2,2,0,0,1
03905049,6,2,4,0,2,2,0,0,0
03905153,18,6,12,0,1,1,0,1,1
03905178,18,4,14,0,1,1,0,1,1
03905525,8,0,8,0,1,1,0,0,1
03905626,20,4,16,0,0,0,0,0,1
03905752,13,5,8,0,1,1,0,1,1
03906226,6,0,6,0,0,0,0,0,1
03906241,28,2,26,0,1,1,0,1,1
03906291,16,5,11,0,2,1,1,2,1
03906344,39,14,25,0,0,0,0,0,1
03906603,25,3,22,0,5,2,3,0,1
03906715,5,0,5,0,2,2,0,0,0
03906837,51,3,48,0,1,1,0,1,1
03906860,32,0,32,0,0,0,0,0,1
03907036,11,6,5,0,1,1,0,1,1
03907048,7,2,5,0,1,1,0,0,1
03907182,5,1,4,0,1,1,0,0,1
03907266,31,0,31,0,0,0,0,0,1
03907429,16,4,12,0,1,1,0,0,0
03907975,4,3,1,0,2,2,0,0,1
03908042,21,1,20,0,0,0,0,0,1
03908160,46,13,33,0,0,0,0,0,1
03908220,17,5,12,0,0,0,0,0,1
03908268,4,0,4,0,0,0,0,0,0
03908435,22,9,13,0,0,0,0,0,1
03908457,6,3,3,0,2,2,0,0,1
03908511,6,3,3,0,2,2,0,0,1
03908675,29,7,22,0,0,0,0,0,1
03908823,14,4,10,0,1,1,0,1,1
03908899,7,3,4,0,2,2,0,0,0
03908922,7,2,5,0,1,1,0,1,1
03908975,50,10,40,0,0,0,0,0,1
03909177,7,5,2,0,2,2,0,0,1
03909257,31,2,29,0,0,0,0,0,1
03909395,46,10,36,0,2,2,0,2,1
03909522,13,4,9,0,2,2,0,0,1
03909629,20,3,17,0,2,2,0,0,1
03909720,25,3,22,0,1,1,0,1,1
03909772,14,0,14,0,0,0,0,0,1
08800236,3,1,2,0,2,1,1,0,0
08800259,3,1,2,0,2,1,1,0,0
08800341,3,0,3,0,2,2,0,0,0
08800358,2,0,2,0,0,0,0,0,1
08800474,3,2,1,0,1,1,0,1,1
08800522,11,5,6,0,2,1,1,1,1
08800537,6,0,6,0,0,0,0,0,1
08800576,2,0,2,0,0,0,0,0,0
08800612,2,2,0,0,1,1,0,0,0
08800898,2,0,2,0,0,0,0,0,1
08801406,1,1,0,0,2,2,0,0,0
08802537,15,2,13,0,1,1,0,1,1
08802542,22,4,18,0,1,1,0,1,1
08802551,11,3,8,0,1,1,0,1,1
08802680,32,14,18,0,0,0,0,0,0
08802752,3,2,1,0,1,1,0,1,1
08802756,1,1,0,0,0,0,0,0,1
08802864,1,1,0,0,1,1,0,0,0
08802965,3,1,2,0,2,1,1,0,0
08803684,6,3,3,0,4,2,2,0,0
08803782,8,3,5,0,1,1,0,1,1
08803796,2,2,0,0,1,1,0,0,0
08803907,6,3,3,0,1,1,0,1,1
08804155,8,0,8,0,0,0,0,0,1
08804242,1,1,0,0,1,1,0,0,0
08804506,1,1,0,0,2,1,1,1,0
08804708,15,10,5,0,0,0,0,0,1
08805073,4,2,2,0,2,1,1,0,0
08805381,12,4,8,0,1,1,0,1,1
08805432,23,9,14,0,2,0,2,0,1
08805615,1,0,1,0,0,0,0,0,0
08806009,16,4,12,0,0,0,0,0,1
08807336,7,5,2,0,0,0,0,0,0
08807692,37,15,22,0,2,2,0,0,1
08807887,2,0,2,0,0,0,0,0,0
08808039,4,4,0,0,2,2,0,0,1
08808094,4,2,2,0,0,0,0,0,1
08808394,3,2,1,0,3,1,2,3,0
08808518,9,4,5,0,1,1,0,1,1
08808550,13,4,9,0,1,1,0,1,1
08808802,2,2,0,0,2,2,0,0,0
08809000,1,0,1,0,0,0,0,0,1
08809190,2,1,1,0,0,0,0,0,0
08809238,2,1,1,0,1,1,0,0,0
08809411,3,2,1,0,1,1,0,0,1
08809428,7,0,7,0,0,0,0,0,1
08809742,10,4,6,0,1,1,0,1,1
08809913,1,0,1,0,0,0,0,0,0
08810036,3,0,3,0,0,0,0,0,1
08810322,6,5,1,0,1,1,0,0,0
08810971,14,6,8,0,0,0,0,0,1
08811042,2,2,0,0,2,2,0,0,0
08811158,2,0,2,0,0,0,0,0,0
08811218,2,1,1,0,2,2,0,0,0
08811234,17,7,10,0,0,0,0,0,1
08811248,9,6,3,0,0,0,0,0,1
08811294,9,5,4,0,0,0,0,0,0
08811526,4,0,4,0,1,1,0,0,1
08811656,15,6,9,0,2,0,2,2,1
08811808,10,8,2,0,0,0,0,0,0
08812271,3,0,3,0,1,1,0,0,0
08812630,6,6,0,0,1,1,0,0,1
08812632,3,3,0,0,2,2,0,0,0
08812638,1,0,1,0,0,0,0,0,0
08812654,2,0,2,0,0,0,0,0,0
08812739,1,1,0,0,1,1,0,0,0
08812766,2,0,2,0,1,1,0,0,0
08812791,3,3,0,0,3,3,0,0,0
08812879,1,0,1,0,0,0,0,0,1
08812881,2,0,2,0,0,0,0,0,0
08812954,5,2,3,0,1,1,0,0,1
08813421,1,1,0,0,1,1,0,0,0
08813519,12,3,9,0,2,1,1,1,1
08814472,3,3,0,0,1,1,0,0,0
08814637,3,3,0,0,1,1,0,0,0
08814847,2,2,0,0,2,2,0,0,0
08814925,4,4,0,0,0,0,0,0,1
08816306,2,2,0,0,2,2,0,0,0
08816423,4,2,2,0,2,2,0,0,1
08816625,2,1,1,0,1,1,0,0,0
08816690,5,3,2,0,1,1,0,1,0
08816786,13,4,9,0,1,1,0,1,1
08817057,2,2,0,0,2,2,0,0,0
08817130,4,4,0,0,0,0,0,0,0
08817383,16,10,6,0,1,1,0,1,1
08817587,6,3,3,0,1,1,0,1,1
08818022,2,2,0,0,2,2,0,0,0
08818135,1,1,0,0,1,1,0,0,0
08818599,3,0,3,0,1,1,0,1,0
08818676,7,3,4,0,1,1,0,1,1
08818762,12,8,4,0,0,0,0,0,1
08818931,8,5,3,0,4,2,2,0,1
08818959,5,0,5,0,0,0,0,0,1
08819148,5,3,2,0,0,0,0,0,0
08819259,1,1,0,0,1,1,0,0,0
08819564,5,3,2,0,1,1,0,1,1
08819632,2,0,2,0,1,1,0,0,0
08819748,15,6,9,0,0,0,0,0,0
08820018,14,8,6,0,1,1,0,1,1
08820037,3,3,0,0,3,3,0,0,0
08820194,1,0,1,0,0,0,0,0,1
08820746,2,0,2,0,0,0,0,0,1
08821258,2,0,2,0,0,0,0,0,1
08821357,4,3,1,0,6,6,0,5,1
08821395,1,1,0,0,1,1,0,0,0
08821526,8,6,2,0,3,1,2,1,1
08821596,2,0,2,0,0,0,0,0,0
08821604,8,2,6,0,0,0,0,0,1
08821629,22,7,15,0,0,0,0,0,1
08821700,1,1,0,0,1,1,0,0,1
08822199,3,3,0,0,1,1,0,1,0
08822543,1,0,1,0,0,0,0,0,1
08822614,11,4,7,0,1,1,0,1,1
08822747,2,2,0,0,1,1,0,0,1
08822777,9,3,6,0,1,1,0,1,1
08822920,2,2,0,0,2,2,0,0,1
08822992,2,2,0,0,1,1,0,0,0
08823593,40,21,19,0,0,0,0,0,1
08823893,3,2,1,0,2,2,0,0,0
08824415,8,5,3,0,0,0,0,0,0
08824446,4,4,0,0,3,3,0,2,1
08824509,9,7,2,0,0,0,0,0,0
08824761,9,8,1,0,0,0,0,0,0
08824836,2,2,0,0,1,1,0,0,1
08824941,2,1,1,0,0,0,0,0,0
08824978,1,1,0,0,1,1,0,0,0
08825871,5,0,5,0,0,0,0,0,1
08825966,7,2,5,0,6,1,5,1,1
08825986,3,0,3,0,0,0,0,0,0
08826226,3,3,0,0,1,1,0,0,0
08826490,7,1,6,0,2,1,1,0,0
08826868,1,1,0,0,1,1,0,0,0
08827513,4,1,3,0,1,1,0,0,1
08827516,7,0,7,0,0,0,0,0,1
08827523,1,1,0,0,2,2,0,0,0
08827529,10,4,6,1,1,1,0,1,0
08827638,3,2,1,0,2,2,0,0,1
08827951,1,1,0,0,1,1,0,0,0
08828425,2,2,0,0,2,2,0,0,0
08828467,4,4,0,0,1,1,0,0,0
08828704,4,3,1,0,3,3,0,0,1
08829530,1,0,1,0,0,0,0,0,1
08829933,11,4,7,0,2,2,0,2,1
08829980,2,0,2,0,0,0,0,0,1
08830108,7,3,4,0,1,1,0,1,1
08830346,2,1,1,0,2,1,1,0,0
08830523,1,1,0,0,1,1,0,0,1
08830696,4,0,4,0,0,0,0,0,1
08830779,1,1,0,0,1,1,0,0,0
08830833,3,0,3,0,0,0,0,0,0
08830928,9,5,4,0,1,1,0,1,1
08830988,1,1,0,0,1,1,0,0,1
08831094,2,2,0,0,1,1,0,0,1
08832382,6,6,0,0,2,2,0,0,1
08832386,2,0,2,0,1,1,0,0,0
08832714,2,2,0,0,0,0,0,0,0
08832956,9,6,3,0,2,2,0,2,1
08833012,2,0,2,0,0,0,0,0,0
08833557,10,2,8,0,1,1,0,1,1
08834469,7,4,3,0,0,0,0,0,1
08834538,1,0,1,0,0,0,0,0,1
08834686,2,2,0,0,2,2,0,0,0
08834724,1,1,0,0,1,1,0,0,1
08834790,33,15,18,0,0,0,0,0,0
08834944,2,2,0,0,2,2,0,0,1
08835858,1,1,0,0,1,1,0,0,0
08835913,1,1,0,0,1,1,0,0,0
08836054,1,1,0,0,1,1,0,0,1
08836495,2,0,2,0,0,0,0,0,0
08836887,26,9,17,0,0,0,0,0,1
08837062,3,2,1,0,1,1,0,1,1
08837119,1,1,0,0,1,1,0,0,0
08837295,10,0,10,0,0,0,0,0,0
08837337,1,1,0,0,2,1,1,0,0
08837387,2,1,1,0,1,1,0,0,0
08837501,2,2,0,0,2,2,0,0,0
08837699,3,3,0,0,1,1,0,0,0
08838394,2,2,0,0,1,1,0,0,0
08839155,1,1,0,0,1,1,0,0,0
08839321,2,2,0,0,2,2,0,0,1
08839834,1,1,0,0,1,1,0,0,0
08839858,3,3,0,0,3,3,0,0,0
08839877,1,1,0,0,1,1,0,0,0
08839944,4,1,3,0,1,1,0,0,1
08840047,9,2,7,2,1,1,0,1,0
08840086,8,5,3,0,0,0,0,0,1
08840313,1,1,0,0,1,1,0,0,0
08840773,1,1,0,0,1,1,0,0,0
08841445,2,2,0,0,1,1,0,0,1
08841631,1,1,0,0,1,1,0,0,0
08841660,1,0,1,0,1,1,0,0,0
08841720,2,0,2,0,0,0,0,0,0
08842594,6,5,1,0,3,3,0,0,0
08842709,1,1,0,0,1,1,0,0,0
08842724,2,2,0,0,2,2,0,0,0
08842961,2,2,0,0,2,2,0,2,0
08842980,10,0,10,0,0,0,0,0,0
08843441,12,4,8,0,0,0,0,0,1
08843493,3,2,1,0,2,2,0,0,0
08843775,4,2,2,0,1,1,0,1,0
08844112,1,1,0,0,1,1,0,0,0
08844243,4,3,1,0,3,3,0,0,1
08844578,7,4,3,0,1,1,0,0,1
08844769,4,3,1,0,1,1,0,0,0
08845266,2,1,1,0,2,2,0,0,1
08845715,1,1,0,0,1,1,0,0,0
08845791,9,6,3,0,0,0,0,0,0
08845846,2,0,2,0,1,1,0,0,0
08846138,2,2,0,0,1,1,0,0,1
08846148,2,2,0,0,2,2,0,0,0
08846389,7,3,4,0,2,1,1,1,1
08846557,2,0,2,0,0,0,0,0,0
08846603,4,2,2,0,2,2,0,0,0
08846624,2,0,2,0,0,0,0,0,1
08846684,2,1,1,0,1,1,0,0,0
08846815,2,0,2,0,0,0,0,0,1
08846818,11,5,6,0,1,1,0,1,1
08846831,10,3,7,0,2,2,0,1,0
08846838,16,4,12,0,1,1,0,1,1
08846878,9,5,4,0,2,2,0,2,1
08846925,2,2,0,0,0,0,0,0,1
08847562,8,4,4,0,0,0,0,0,0
08847846,16,8,8,0,1,1,0,1,0
08847971,3,2,1,0,1,1,0,1,1
08848446,1,0,1,0,0,0,0,0,0
08848455,2,2,0,0,2,2,0,0,1
08848738,8,5,3,0,0,0,0,0,0
08848753,1,1,0,0,1,1,0,0,0
08848772,2,1,1,0,1,1,0,0,0
08848797,12,6,6,0,4,4,0,3,1
08848816,2,2,0,0,1,1,0,0,1
08848899,14,7,7,0,3,3,0,2,1
08849493,5,2,3,0,2,2,0,0,1
08849583,1,0,1,0,0,0,0,0,0
08849598,1,1,0,0,1,1,0,0,0
08849817,2,1,1,0,1,1,0,0,1
08849998,4,2,2,0,1,1,0,1,1
08850006,1,0,1,0,1,1,0,0,0
08850123,3,2,1,0,1,1,0,0,0
08850133,2,2,0,0,2,2,0,0,1
08850163,22,8,14,0,0,0,0,0,1
08850380,9,5,4,0,0,0,0,0,1
08850428,7,5,2,0,1,1,0,1,1
08850673,2,2,0,0,1,1,0,1,0
08850869,2,2,0,0,1,1,0,0,0
08851217,2,2,0,0,2,2,0,0,0
08851564,1,1,0,0,1,1,0,0,0
08851590,3,3,0,0,1,1,0,0,0
08851741,1,1,0,0,2,2,0,0,0
08851921,1,1,0,0,3,3,0,0,1
08852020,1,1,0,0,1,1,0,0,0
08852418,3,2,1,0,1,1,0,1,0
08852650,1,0,1,0,1,1,0,0,1
08852747,3,0,3,0,0,0,0,0,1
08853044,1,1,0,0,1,1,0,0,0
08853063,1,1,0,0,1,1,0,0,0
08853224,3,1,2,0,2,1,1,0,0
08853346,5,2,3,0,4,1,3,1,1
08853684,2,2,0,0,1,1,0,0,0
08853943,3,2,1,0,0,0,0,0,0
08853948,3,3,0,0,1,1,0,1,1
08853972,2,2,0,0,2,2,0,0,0
08854646,1,0,1,0,0,0,0,0,0
08854656,3,3,0,0,2,2,0,0,1
08854814,2,1,1,0,1,1,0,0,0
08854932,2,2,0,0,1,1,0,1,0
08854972,6,3,3,0,3,3,0,1,1
08856547,1,1,0,0,1,1,0,0,1
08857241,2,1,1,0,1,1,0,0,0
08858074,1,1,0,0,2,2,0,0,0
08858705,6,3,3,0,1,1,0,1,0
08858831,8,3,5,0,2,2,0,1,0
08858935,8,5,3,0,0,0,0,0,0
08858994,1,0,1,0,0,0,0,0,1
08859151,1,0,1,0,0,0,0,0,0
08859286,3,2,1,0,0,0,0,0,0
08860080,1,1,0,0,1,1,0,0,0
08860697,1,1,0,0,1,1,0,0,0
08860726,20,13,7,0,0,0,0,0,1
08860961,10,5,5,0,2,2,0,2,1
08861250,12,4,8,0,1,1,0,1,1
08861341,1,1,0,0,2,2,0,0,0
08861875,1,1,0,0,1,1,0,0,0
08861931,4,3,1,0,5,5,0,1,0
08861965,1,1,0,0,1,1,0,0,0
08863890,3,2,1,0,2,2,0,0,0
08864337,3,1,2,0,1,1,0,0,0
08864703,1,1,0,0,1,1,0,0,0
08864781,2,2,0,0,2,2,0,0,0
08864987,2,2,0,0,2,2,0,0,0
08865014,1,1,0,0,1,1,0,0,0
08865149,6,0,6,0,0,0,0,0,0
08865450,2,2,0,0,2,1,1,0,1
08866300,4,4,0,0,1,1,0,0,1
08866337,6,4,2,0,2,1,1,0,1
08866406,1,1,0,0,1,1,0,0,0
08866418,11,4,7,0,2,1,1,0,0
08866592,2,1,1,0,2,1,1,1,1
08866734,2,1,1,0,2,1,1,1,1
08867311,3,0,3,0,1,1,0,0,1
08867359,4,0,4,0,0,0,0,0,1
08867428,5,0,5,0,1,1,0,0,1
08867452,3,3,0,0,2,2,0,0,0
08867460,4,3,1,0,2,2,0,0,0
08867494,5,0,5,0,0,0,0,0,1
08867521,5,0,5,0,0,0,0,0,1
08867556,1,1,0,0,1,1,0,0,0
08867732,3,1,2,0,1,1,0,0,0
08867769,2,2,0,0,2,2,0,0,0
08867883,2,2,0,0,1,1,0,1,0
08868033,1,0,1,0,0,0,0,0,0
08868466,5,4,1,0,1,1,0,0,0
08868662,4,2,2,0,2,2,0,0,1
08869110,5,1,4,0,1,1,0,1,1
08869409,6,4,2,0,5,3,2,0,1
08869506,25,11,14,0,0,0,0,0,1
05070639,11,4,7,0,1,1,0,0,1
05070714,12,0,12,0,0,0,0,0,1
05070874,18,4,14,0,0,0,0,0,1
05070912,28,0,28,0,0,0,0,0,1
05071073,64,14,50,0,0,0,0,0,1
05071126,31,4,27,0,1,1,0,1,1
05071232,36,3,33,0,1,1,0,1,1
05071288,10,0,10,0,0,0,0,0,1
05071322,15,4,11,0,1,1,0,0,1
05071468,5,3,2,0,2,2,0,0,1
05071794,16,0,16,0,0,0,0,0,1
05072221,14,3,11,0,1,1,0,1,1
05072542,6,2,4,0,1,1,0,0,0
05072577,5,3,2,0,2,2,0,0,0
05072592,6,2,4,0,2,2,0,0,0
05072624,30,6,24,0,1,1,0,1,1
05072626,32,6,26,0,1,1,0,1,1
05072627,29,6,23,0,1,1,0,1,1
05072647,34,6,28,0,1,1,0,1,1
05072649,29,6,23,0,1,1,0,1,1
05072651,29,6,23,0,1,1,0,1,1
05072653,29,6,23,0,1,1,0,1,1
05072659,30,6,24,0,1,1,0,1,1
05072661,30,6,24,0,1,1,0,1,1
05072662,30,6,24,0,1,1,0,1,1
05072720,8,1,7,0,1,1,0,1,1
05072796,13,0,13,0,0,0,0,0,1
05072809,13,0,13,0,0,0,0,0,1
05072851,36,5,31,0,1,1,0,1,1
05072868,36,5,31,0,1,1,0,1,1
05072879,36,5,31,0,1,1,0,1,1
05073058,29,6,23,1,1,1,0,1,1
05073061,35,7,28,0,2,1,1,2,0
05073070,37,7,30,0,1,1,0,1,0
05073172,42,6,36,0,6,5,1,0,1
05073227,16,2,14,0,1,1,0,1,1
05073590,4,2,2,0,1,1,0,0,1
05073674,4,0,4,0,3,3,0,0,0
05073733,9,4,5,0,1,1,0,1,1
05073766,20,2,18,0,0,0,0,0,0
05073811,4,1,3,0,1,1,0,0,0
05073911,4,0,4,0,0,0,0,0,1
05073933,9,0,9,0,0,0,0,0,1
05074305,9,0,9,0,0,0,0,0,1
05074544,28,11,17,0,0,0,0,0,1
05074950,13,0,13,0,0,0,0,0,1
05075081,4,3,1,0,1,1,0,0,0
05075088,26,3,23,0,3,3,0,0,1
05075130,6,2,4,0,2,2,0,0,0
05075209,2,2,0,0,1,1,0,0,0
05075236,7,3,4,0,2,2,0,0,1
05075251,6,3,3,0,2,2,0,0,0
05075508,10,1,9,0,1,1,0,0,1
05075543,4,0,4,0,0,0,0,0,0
05075831,12,0,12,0,0,0,0,0,1
05075836,4,3,1,0,1,1,0,0,0
05075990,59,6,53,0,1,1,0,1,0
05076256,79,12,67,0,1,1,0,1,1
05076702,3,1,2,0,1,1,0,0,1
05076800,4,0,4,0,1,1,0,0,0
05076818,14,2,12,0,1,1,0,1,1
05077202,10,1,9,0,1,1,0,0,1
05077263,35,12,23,0,0,0,0,0,1
05077475,19,2,17,0,1,1,0,1,1
05077727,12,0,12,0,0,0,0,0,1
05077778,12,0,12,0,0,0,0,0,1
05077826,12,0,12,0,0,0,0,0,1
05077844,5,2,3,0,2,2,0,0,0
05078319,2,2,0,0,1,1,0,0,0
05078479,20,6,14,0,0,0,0,0,1
05078498,54,18,36,0,0,0,0,0,1
05078690,26,0,26,0,1,1,0,1,1
05078782,17,3,14,0,1,1,0,1,1
05079063,8,2,6,0,1,1,0,0,1
05079241,7,2,5,0,1,1,0,0,0
05079275,4,2,2,0,1,1,0,0,0
05079338,24,3,21,0,1,1,0,1,1
05079538,8,0,8,0,0,0,0,0,1
05079574,9,2,7,0,2,1,1,1,0
05079583,17,7,10,0,2,2,0,0,1
05079594,11,2,9,0,1,1,0,1,1
05079621,6,4,2,0,1,1,0,0,0
05079631,6,0,6,0,0,0,0,0,1
05079802,16,5,11,0,1,1,0,1,1
05079921,4,3,1,0,2,2,0,0,0
05079984,14,0,14,0,0,0,0,0,1
05079986,17,5,12,0,0,0,0,0,1
05080555,48,6,42,0,1,0,1,0,1
05080861,7,0,7,0,0,0,0,0,1
05081019,26,4,22,0,1,1,0,1,1
05081097,38,11,27,0,0,0,0,0,1
05081168,20,11,9,0,2,0,2,0,1
05081658,27,6,21,0,1,1,0,1,1
05081805,11,0,11,0,0,0,0,0,1
05081860,22,2,20,0,3,1,2,3,1
05082237,5,3,2,0,2,2,0,0,1
05082298,22,5,17,0,2,1,1,2,1
05082340,7,2,5,0,2,1,1,1,1
05082415,9,1,8,0,1,1,0,0,0
05082461,7,3,4,0,2,2,0,0,1
05082575,4,1,3,0,1,1,0,0,0
05082648,10,3,7,0,0,0,0,0,1
05082866,5,3,2,0,2,2,0,0,0
05083002,39,0,39,0,0,0,0,0,1
05083005,15,5,10,0,0,0,0,0,1
05083390,27,8,19,0,0,0,0,0,1
05083487,8,2,6,0,3,1,2,1,1
05084094,23,6,17,0,0,0,0,0,0
05084125,48,11,37,0,3,3,0,1,1
05084301,46,14,32,0,1,1,0,1,1
05084313,9,0,9,0,0,0,0,0,1
05084879,29,11,18,0,0,0,0,0,1
05084888,3,2,1,0,1,1,0,1,0
05084991,5,3,2,0,2,2,0,0,0
05085028,60,11,49,0,0,0,0,0,1
05085202,6,5,1,0,3,1,2,0,0
05085239,4,0,4,0,0,0,0,0,1
05085699,11,1,10,0,1,1,0,0,1
05085918,6,3,3,0,2,1,1,1,1
05085919,6,3,3,0,2,1,1,1,1
05085925,12,3,9,0,1,1,0,1,1
05086039,5,0,5,0,0,0,0,0,0
05086060,8,2,6,0,1,1,0,0,1
05086142,26,0,26,0,0,0,0,0,1
05086191,3,0,3,0,0,0,0,0,1
05086207,7,5,2,0,2,2,0,0,0
05086393,5,3,2,0,1,1,0,1,0
05086400,9,3,6,0,2,1,1,2,1
05086416,5,3,2,0,1,1,0,1,0
05086634,24,4,20,0,1,1,0,1,1
05086763,4,2,2,0,1,1,0,0,1
05087228,5,3,2,0,1,1,0,0,1
05087636,6,3,3,0,1,1,0,0,0
05087741,9,4,5,0,4,4,0,1,1
05087774,18,5,13,0,0,0,0,0,1
05087883,5,3,2,0,2,2,0,0,1
05088289,33,3,30,0,1,1,0,1,1
05088409,90,28,62,0,0,0,0,0,1
05088411,31,4,27,0,1,1,0,1,1
05088415,8,6,2,0,0,0,0,0,0
05088520,7,0,7,0,2,2,0,1,1
05088553,75,25,50,0,0,0,0,0,1
05088625,15,5,10,0,0,0,0,0,1
05088708,15,1,14,0,2,1,1,2,1
05088770,23,2,21,0,1,1,0,1,1
05088791,5,2,3,0,1,1,0,1,1
05088946,15,0,15,0,0,0,0,0,1
05089019,4,0,4,0,0,0,0,0,1
05089293,22,4,18,0,1,1,0,1,1
05089361,22,3,19,0,1,1,0,1,0
05089372,9,2,7,0,2,2,0,2,1
05089521,19,9,10,0,0,0,0,0,0
05089530,8,4,4,0,1,1,0,1,1
05089538,4,3,1,0,1,1,0,0,0
05089566,18,4,14,0,0,0,0,0,1
05089636,10,0,10,0,1,1,0,0,0
05089859,25,0,25,0,1,1,0,1,1
05089874,22,4,18,0,1,1,0,1,1
05090210,27,6,21,0,2,2,0,2,1
05090241,11,5,6,0,0,0,0,0,0
05090266,33,7,26,0,1,1,0,1,1
05090412,22,4,18,0,2,1,1,2,1
05090428,5,2,3,0,1,1,0,0,0
05091128,13,3,10,0,1,1,0,1,1
05091223,2,1,1,0,2,2,0,0,0
05091538,25,5,20,0,1,1,0,1,0
05091663,13,3,10,0,1,1,0,1,1
05091692,10,3,7,0,1,1,0,1,1
05091695,18,3,15,0,1,1,0,1,1
05091707,19,4,15,0,1,1,0,1,1
05091757,5,2,3,0,4,2,2,0,1
05091839,21,0,21,0,0,0,0,0,1
05091841,7,3,4,0,2,2,0,0,0
05091944,24,5,19,0,1,1,0,1,1
05092548,4,0,4,0,0,0,0,0,1
05092576,19,0,19,0,0,0,0,0,1
05092578,10,0,10,0,0,0,0,0,1
05092720,25,2,23,0,0,0,0,0,1
05093159,7,3,4,0,3,1,2,1,1
05093179,17,8,9,0,0,0,0,0,1
05093332,57,11,46,0,0,0,0,0,1
05093595,17,3,14,0,1,1,0,1,0
05093734,5,3,2,0,1,1,0,0,0
05094132,14,0,14,0,0,0,0,0,1
05094212,5,2,3,0,1,1,0,0,1
05094345,13,3,10,0,1,1,0,0,1
05094413,28,5,23,0,2,2,0,2,1
05094691,20,5,15,0,2,1,1,1,1
05094867,2,0,2,0,1,1,0,0,1
05095413,5,0,5,0,0,0,0,0,1
05095538,27,5,22,0,1,1,0,1,1
05095737,4,2,2,0,1,1,0,0,0
05095816,8,3,5,0,1,1,0,0,0
05096095,9,4,5,0,2,2,0,0,0
05096442,3,0,3,0,0,0,0,0,1
05096469,20,3,17,0,1,1,0,0,1
05096530,21,9,12,0,0,0,0,0,1
05097119,3,2,1,0,1,1,0,0,0
05097490,8,0,8,0,1,1,0,0,0
05097517,6,2,4,0,3,1,2,0,0
05097589,12,4,8,0,1,1,0,1,1
05097618,5,2,3,0,1,1,0,0,0
05097628,8,3,5,0,1,1,0,0,1
05097950,31,3,28,0,2,2,0,2,1
05098504,15,9,6,0,1,0,1,0,1
05098580,6,0,6,0,0,0,0,0,1
05098773,18,2,16,0,0,0,0,0,1
05098827,3,0,3,0,0,0,0,0,1
05098863,16,4,12,0,1,1,0,1,1
05098911,8,0,8,0,0,0,0,0,1
05099066,8,0,8,0,0,0,0,0,1
05099180,8,0,8,0,0,0,0,0,0
05099381,14,2,12,0,1,1,0,1,1
05099394,10,2,8,0,0,0,0,0,1
05099403,8,3,5,0,1,1,0,1,1
05099435,5,0,5,0,0,0,0,0,1
05099543,22,2,20,0,1,1,0,1,1
05099635,12,5,7,0,1,1,0,1,1
05099815,4,3,1,0,2,2,0,0,1
05100560,11,5,6,0,1,1,0,0,0
05100794,22,0,22,0,0,0,0,0,1
05100810,17,4,13,0,1,1,0,1,0
05101064,9,3,6,0,1,1,0,1,1
05101737,6,0,6,0,0,0,0,0,1
05101887,3,3,0,0,2,2,0,0,0
05101939,16,6,10,0,1,1,0,1,1
05102060,4,3,1,0,1,1,0,0,0
05102503,23,8,15,0,0,0,0,0,1
05102843,8,3,5,0,2,2,0,0,1
05102899,8,0,8,0,0,0,0,0,1
05102934,36,16,20,0,1,1,0,0,1
05102960,11,2,9,0,3,3,0,3,0
05103076,3,2,1,0,1,1,0,0,0
05103250,10,5,5,0,0,0,0,0,0
05103846,10,0,10,0,0,0,0,0,1
05103872,10,0,10,0,0,0,0,0,1
05103889,10,0,10,0,0,0,0,0,1
05104224,3,2,1,0,1,1,0,0,0
05104429,44,4,40,0,0,0,0,0,1
05104452,4,1,3,0,1,1,0,0,0
05104527,2,2,0,0,1,1,0,0,0
05104818,8,1,7,0,0,0,0,0,1
05104825,8,1,7,0,0,0,0,0,1
05104828,8,0,8,0,0,0,0,0,1
05104884,20,0,20,0,0,0,0,0,0
05105012,32,11,21,0,0,0,0,0,0
05105160,5,3,2,0,1,1,0,0,1
05105677,4,1,3,0,1,1,0,0,1
05105764,12,0,12,0,0,0,0,0,1
05105798,38,6,32,0,2,1,1,2,1
05105859,12,3,9,0,1,1,0,1,1
05106422,37,13,24,0,0,0,0,0,1
05106691,15,7,8,0,2,2,0,0,1
05107007,6,2,4,0,0,0,0,0,1
05107197,16,3,13,0,1,1,0,1,1
05107204,8,3,5,0,0,0,0,0,1
05107257,15,0,15,0,0,0,0,0,1
05107464,8,0,8,0,2,2,0,0,1
05107479,15,0,15,0,0,0,0,0,1
05107546,11,7,4,0,2,2,0,0,1
05107677,3,1,2,0,1,1,0,0,1
05107779,15,5,10,0,0,0,0,0,1
05107795,3,1,2,0,2,2,0,0,1
05107944,58,8,50,0,2,2,0,2,0
05107951,9,2,7,0,1,1,0,0,0
05108029,9,0,9,0,0,0,0,0,1
05108051,2,2,0,0,1,1,0,0,0
05108109,6,2,4,0,2,1,1,0,1
05108137,5,0,5,0,0,0,0,0,0
05108247,12,2,10,0,2,1,1,2,1
05108266,5,2,3,0,1,1,0,0,0
05108329,5,0,5,0,0,0,0,0,1
05108459,58,8,50,0,1,1,0,1,0
05108655,3,2,1,0,2,2,0,0,1
05108688,4,3,1,0,2,2,0,0,1
05108751,3,2,1,0,1,1,0,0,0
05109033,9,0,9,0,0,0,0,0,1
05109386,6,3,3,0,1,1,0,0,0
05109435,7,0,7,0,2,2,0,1,1
05109482,4,0,4,0,2,2,0,0,0
05109543,7,1,6,0,0,0,0,0,1
05109583,4,2,2,0,1,1,0,0,0
05109637,22,5,17,0,1,1,0,1,1
05109768,20,6,14,0,0,0,0,0,1
05110081,7,2,5,0,1,1,0,0,0
05110110,9,2,7,0,0,0,0,0,0
05110848,9,5,4,0,0,0,0,0,0
05111013,17,5,12,0,1,1,0,1,1
05111167,5,2,3,0,3,3,0,0,1
05111357,4,2,2,0,0,0,0,0,1
05111442,7,0,7,0,0,0,0,0,1
05111446,8,0,8,0,0,0,0,0,1
05111475,8,0,8,0,0,0,0,0,1
05111485,25,5,20,0,1,1,0,1,0
05111994,7,0,7,0,0,0,0,0,1
05112090,25,11,14,0,1,1,0,1,1
05112484,14,3,11,0,0,0,0,0,1
05112710,27,0,27,0,1,1,0,1,1
05113073,10,3,7,0,1,1,0,0,1
05113190,10,0,10,0,0,0,0,0,1
05113506,43,7,36,0,1,1,0,1,1
05113517,28,3,25,0,1,1,0,1,1
05113671,23,8,15,0,0,0,0,0,1
05113719,25,6,19,0,1,1,0,0,1
05113789,5,3,2,0,1,1,0,0,1
05113965,8,4,4,0,2,2,0,0,0
05114201,15,8,7,0,2,2,0,0,1
05114372,8,3,5,0,1,1,0,0,1
05114471,5,3,2,0,2,2,0,0,1
05114575,35,10,25,0,0,0,0,0,1
05114661,29,14,15,0,0,0,0,0,0
05115093,18,7,11,0,0,0,0,0,1
05115147,4,0,4,0,0,0,0,0,1
05115389,5,3,2,0,2,2,0,0,0
05115495,7,1,6,0,1,1,0,0,1
05115584,9,7,2,0,3,1,2,1,0
05115594,33,0,33,0,0,0,0,0,1
05115624,6,0,6,0,0,0,0,0,1
05115635,9,7,2,0,3,1,2,1,0
05115684,8,0,8,0,0,0,0,0,1
05116596,6,0,6,0,0,0,0,0,1
05116780,25,5,20,0,0,0,0,0,1
05117075,4,4,0,0,1,1,0,0,1
05117078,24,15,9,0,1,1,0,1,1
05117116,16,5,11,0,0,0,0,0,1
05117218,12,5,7,0,0,0,0,0,0
05117256,20,6,14,0,1,1,0,0,1
05117309,2,2,0,0,1,1,0,0,0
05117575,5,3,2,0,1,1,0,0,0
05117876,6,2,4,0,2,2,0,0,1
05118218,5,3,2,0,2,2,0,0,0
05118716,4,0,4,0,0,0,0,0,1
05118726,11,3,8,0,2,2,0,0,1
05119310,54,9,45,0,4,3,1,4,1
05119381,5,3,2,0,1,1,0,1,1
05119436,13,3,10,0,1,1,0,1,0
05119455,5,3,2,0,2,2,0,0,0
05119523,8,2,6,0,0,0,0,0,1
05119530,5,2,3,0,1,1,0,1,1
05120160,23,3,20,0,1,1,0,1,1
05120202,4,3,1,0,2,2,0,0,1
05120360,5,2,3,0,0,0,0,0,1
05120452,5,3,2,0,0,0,0,0,0
05120679,8,0,8,0,3,3,0,0,1
05120721,23,3,20,0,0,0,0,0,1
05120810,4,4,0,0,0,0,0,0,1
05120951,55,13,42,0,0,0,0,0,1
05121092,2,0,2,0,0,0,0,0,1
05121155,6,0,6,0,0,0,0,0,1
05121391,15,4,11,0,1,1,0,1,1
05121502,29,8,21,0,1,1,0,1,0
05121529,5,3,2,0,2,2,0,0,0
05121533,4,2,2,0,2,2,0,0,0
05121839,17,3,14,0,1,1,0,1,1
05121859,10,0,10,0,0,0,0,0,1
05121869,13,3,10,0,2,1,1,2,1
05121891,5,0,5,0,0,0,0,0,1
05122186,4,0,4,0,0,0,0,0,1
05122231,12,5,7,0,1,1,0,1,1
05122234,11,5,6,0,1,1,0,1,1
05122287,12,0,12,0,2,0,2,0,0
05122535,26,4,22,0,0,0,0,0,1
05122555,10,1,9,0,3,1,2,0,0
05122793,7,3,4,0,1,1,0,0,1
05122834,4,1,3,0,1,1,0,0,1
05122864,6,2,4,0,1,1,0,0,1
05123060,20,6,14,0,1,1,0,0,1
05123265,7,2,5,0,1,1,0,1,0
05123753,7,0,7,0,0,0,0,0,1
05123966,13,0,13,0,0,0,0,0,1
05123989,5,3,2,0,1,1,0,0,1
05124078,13,3,10,0,1,1,0,0,1
05124385,10,0,10,0,0,0,0,0,1
05124400,8,5,3,0,3,3,0,1,1
05124483,16,6,10,0,0,0,0,0,1
05124551,4,0,4,0,0,0,0,0,0
05124583,5,1,4,0,0,0,0,0,1
05124787,57,6,51,0,1,1,0,1,0
05124856,12,5,7,0,1,1,0,1,1
05124926,14,4,10,0,1,1,0,1,1
05125002,18,3,15,0,1,1,0,1,1
05125066,19,0,19,0,0,0,0,0,1
05125210,4,0,4,0,0,0,0,0,0
05125382,9,2,7,0,0,0,0,0,1
05125445,5,4,1,0,3,3,0,0,1
05125685,5,4,1,0,3,3,0,0,1
05126120,29,7,22,0,0,0,0,0,1
05126247,4,0,4,0,0,0,0,0,0
02500057,28,3,25,0,1,1,0,1,1
02500199,93,12,81,0,1,1,0,1,1
02500438,2,0,2,0,0,0,0,0,1
02500627,48,10,38,0,0,0,0,0,0
02500681,7,0,7,0,0,0,0,0,0
02500921,25,4,21,0,0,0,0,0,1
02501469,41,6,35,0,0,0,0,0,1
02501732,13,3,10,0,1,1,0,1,1
02501784,12,0,12,0,0,0,0,0,1
02501793,18,5,13,0,1,1,0,1,1
02501804,19,5,14,0,1,1,0,1,1
02501885,109,6,103,0,1,1,0,1,1
02501949,39,0,39,0,1,1,0,1,1
02502335,5,2,3,0,1,1,0,0,0
02502359,28,8,20,0,0,0,0,0,1
02502427,31,8,23,0,0,0,0,0,1
02502472,13,3,10,0,1,1,0,0,1
02502511,95,12,83,0,0,0,0,0,1
02502837,14,3,11,0,0,0,0,0,1
02502960,33,3,30,0,1,1,0,1,1
02502976,45,9,36,0,0,0,0,0,1
02503054,80,3,77,0,1,1,0,1,1
02503062,15,4,11,0,2,1,1,2,1
02503139,14,4,10,0,3,3,0,0,0
02503153,10,0,10,0,0,0,0,0,1
02503394,4,3,1,0,1,1,0,0,0
02503744,29,9,20,0,1,1,0,1,1
02503801,38,8,30,0,0,0,0,0,0
02504043,22,4,18,0,4,4,0,0,1
02504054,25,3,22,0,1,1,0,1,1
02504173,43,5,38,0,2,1,1,2,1
02504488,21,3,18,0,1,1,0,0,1
02504868,37,3,34,0,1,1,0,1,1
02504998,15,5,10,0,0,0,0,0,1
02505591,24,2,22,0,1,1,0,0,0
02506366,8,3,5,0,1,1,0,1,1
02506374,53,4,49,0,1,1,0,1,1
02506473,8,3,5,0,2,2,0,0,1
02506545,6,4,2,0,2,2,0,0,0
02506684,24,0,24,0,0,0,0,0,1
02506922,41,4,37,0,1,1,0,1,1
02506972,15,4,11,0,0,0,0,0,1
02508104,45,0,45,0,0,0,0,0,1
02508303,18,6,12,0,0,0,0,0,1
02508309,77,0,77,0,0,0,0,0,1
02508326,35,0,35,0,0,0,0,0,1
02508344,58,6,52,0,0,0,0,0,1
02508490,19,0,19,0,0,0,0,0,1
02508613,3,3,0,0,1,1,0,0,0
02508682,5,3,2,0,1,1,0,0,1
02508698,17,2,15,0,1,1,0,1,1
02508699,13,3,10,0,1,1,0,0,0
02508764,12,4,8,0,0,0,0,0,1
02508807,9,3,6,0,3,1,2,2,1
02508811,10,3,7,0,1,1,0,1,0
02509020,0,0,0,0,0,0,0,0,1
02509316,21,0,21,0,0,0,0,0,1
02509407,16,2,14,0,0,0,0,0,0
02509658,16,3,13,0,2,2,0,0,0
02509711,49,4,45,0,2,1,1,2,1
02509755,31,10,21,0,1,1,0,1,1
02509924,67,3,64,0,1,1,0,1,1
02509937,30,6,24,0,1,1,0,1,1
02509986,16,2,14,0,1,1,0,1,1
02510318,72,0,72,0,0,0,0,0,1
02510580,8,4,4,0,2,2,0,1,1
02510791,32,9,23,0,0,0,0,0,1
02511340,22,0,22,0,0,0,0,0,1
02511501,69,18,51,0,0,0,0,0,1
02511824,7,3,4,0,2,2,0,0,0
02511873,48,3,45,0,1,1,0,1,1
02511921,19,0,19,0,0,0,0,0,1
02512075,51,4,47,0,1,1,0,1,1
02512535,20,5,15,0,0,0,0,0,0
02512589,32,2,30,0,2,1,1,2,1
02512605,19,2,17,0,0,0,0,0,1
02512713,74,11,63,0,1,1,0,1,1
02513162,29,6,23,0,0,0,0,0,1
02513362,18,0,18,0,0,0,0,0,1
02513618,120,13,107,0,11,0,11,0,1
02513874,65,3,62,0,5,4,1,0,1
02514287,33,4,29,0,2,1,1,2,1
02514325,25,3,22,0,2,2,0,2,0
02514415,19,5,14,0,1,1,0,0,1
02514416,14,4,10,0,1,1,0,1,1
02514554,13,3,10,0,0,0,0,0,0
02514744,4,4,0,0,3,2,1,0,0
02514987,3,3,0,0,2,2,0,0,1
02515034,209,17,192,0,0,0,0,0,1
02515397,8,3,5,0,2,2,0,0,1
02515430,33,6,27,0,0,0,0,0,1
02515504,20,4,16,0,0,0,0,0,0
02515511,20,7,13,0,0,0,0,0,1
02515753,7,2,5,0,1,1,0,0,1
02515810,8,3,5,0,1,1,0,0,0
02515820,45,10,35,0,0,0,0,0,1
02515917,40,10,30,0,0,0,0,0,1
02516014,30,10,20,0,1,1,0,1,1
02516305,11,4,7,0,3,2,1,1,0
02516362,28,2,26,0,1,1,0,1,1
02516405,32,0,32,0,0,0,0,0,1
02516633,21,6,15,0,0,0,0,0,1
02517018,174,24,150,0,0,0,0,0,1
02517317,26,5,21,0,1,1,0,1,1
02517508,4,4,0,0,2,2,0,0,1
02517690,84,14,70,0,0,0,0,0,1
02517995,11,3,8,0,12,1,11,1,1
02518242,5,4,1,0,1,1,0,1,0
02518717,23,3,20,0,1,1,0,1,1
02518720,31,5,26,0,1,1,0,1,1
02518749,11,0,11,0,0,0,0,0,1
02518805,39,3,36,0,1,1,0,1,1
02519166,1,1,0,0,0,0,0,0,1
02519552,67,1,66,0,1,1,0,1,1
02519659,70,19,51,0,1,1,0,0,1
02519701,12,5,7,0,1,1,0,1,0
02519780,35,2,33,0,2,2,0,2,1
02519916,8,3,5,0,1,1,0,1,1
02520413,68,11,57,0,1,1,0,0,1
02520415,7,4,3,0,1,1,0,0,0
02520522,64,6,58,0,0,0,0,0,1
02520752,27,3,24,0,1,1,0,1,1
02520804,22,0,22,0,2,2,0,0,1
02520898,37,3,34,0,1,1,0,1,1
02521042,8,1,7,0,1,1,0,0,1
02521664,44,3,41,0,1,1,0,1,1
02521785,24,0,24,0,0,0,0,0,1
02521829,52,3,49,0,0,0,0,0,1
02521890,17,5,12,0,0,0,0,0,1
02521971,15,0,15,0,0,0,0,0,1
02522250,10,0,10,0,1,1,0,0,1
02522308,12,0,12,0,2,2,0,2,1
02522450,11,2,9,0,1,1,0,1,1
02522593,10,3,7,0,0,0,0,0,0
02522833,33,3,30,0,0,0,0,0,1
02522939,18,4,14,0,1,1,0,1,1
02522967,8,2,6,0,0,0,0,0,0
02522993,25,0,25,0,0,0,0,0,1
02523346,26,3,23,0,1,1,0,1,1
02523354,38,9,29,0,1,1,0,1,1
02523530,37,4,33,0,1,1,0,1,1
02523545,3,3,0,0,2,2,0,0,0
02524157,28,0,28,0,0,0,0,0,1
02524320,91,10,81,0,0,0,0,0,1
02524573,21,2,19,0,1,1,0,1,1
02524904,8,5,3,0,2,2,0,0,0
02525001,15,1,14,0,1,1,0,1,1
02525163,22,0,22,0,0,0,0,0,1
02525240,13,5,8,0,1,1,0,0,1
02525368,26,4,22,0,1,1,0,1,0
02525580,63,23,40,0,0,0,0,0,1
02525627,15,3,12,0,0,0,0,0,0
02526132,23,0,23,0,0,0,0,0,1
02526194,13,2,11,0,0,0,0,0,0
02526402,25,2,23,0,3,3,0,2,0
02526751,25,0,25,0,0,0,0,0,1
02527067,103,14,89,0,0,0,0,0,1
02527428,9,1,8,0,1,1,0,0,1
02527710,6,3,3,0,3,2,1,0,1
02528291,63,7,56,0,0,0,0,0,1
02528475,55,5,50,0,2,2,0,2,1
02528538,32,5,27,0,1,1,0,1,1
02528822,12,3,9,0,2,1,1,0,1
02529347,16,2,14,0,0,0,0,0,1
02529667,33,1,32,0,1,1,0,1,1
02530185,20,3,17,0,1,1,0,1,1
02530437,8,5,3,0,3,3,0,0,1
02530476,4,4,0,0,2,2,0,0,0
02531054,32,4,28,0,1,1,0,1,1
02531268,30,4,26,0,0,0,0,0,0
02531355,7,4,3,0,0,0,0,0,1
02531653,8,2,6,0,1,1,0,0,1
02531879,7,6,1,0,3,1,2,1,0
02531951,39,10,29,0,0,0,0,0,1
02532236,22,1,21,0,2,2,0,0,1
02532550,14,3,11,0,2,2,0,0,1
02532789,24,0,24,0,0,0,0,0,1
02532854,39,5,34,0,1,1,0,1,1
02532887,115,31,84,0,0,0,0,0,1
02533282,12,3,9,0,1,1,0,1,1
02533561,33,0,33,0,1,1,0,1,1
02533749,23,4,19,0,0,0,0,0,0
02533905,11,0,11,0,0,0,0,0,1
02534012,40,5,35,0,3,1,2,0,1
02534049,6,5,1,0,0,0,0,0,0
02534146,13,3,10,0,1,1,0,1,1
02534147,26,4,22,0,1,1,0,1,1
02534149,17,2,15,0,1,1,0,1,1
02534172,4,3,1,0,1,1,0,0,1
02534273,22,0,22,0,0,0,0,0,1
02534309,6,4,2,0,1,1,0,1,1
02534817,37,5,32,0,1,1,0,1,1
02535093,27,5,22,0,1,1,0,1,1
02535199,67,12,55,0,0,0,0,0,1
02535246,15,2,13,0,1,1,0,0,1
02535315,16,3,13,0,0,0,0,0,1
02535405,38,9,29,0,1,1,0,1,1
02535892,25,5,20,0,1,1,0,1,1
02535994,36,24,12,0,3,2,1,0,1
02536018,3,3,0,0,1,1,0,1,0
02536085,13,1,12,0,1,1,0,1,1
02536345,35,3,32,0,1,1,0,1,1
02536498,33,0,33,0,0,0,0,0,1
02537089,29,5,24,0,1,1,0,1,1
02537092,50,6,44,0,1,1,0,1,1
02537419,25,0,25,0,0,0,0,0,1
02537830,6,0,6,0,1,1,0,0,1
02538220,14,3,11,0,1,1,0,1,1
02538254,53,0,53,0,0,0,0,0,1
02538382,19,3,16,0,1,1,0,1,1
02538510,48,5,43,0,1,1,0,1,1
02538615,30,3,27,0,1,1,0,1,1
02538734,56,7,49,0,0,0,0,0,1
02538900,47,9,38,0,0,0,0,0,1
02538908,122,13,109,0,0,0,0,0,1
02538910,31,7,24,0,0,0,0,0,1
02538982,40,4,36,0,2,1,1,2,1
02539078,4,3,1,0,1,1,0,1,0
02539335,15,3,12,0,1,1,0,1,1
02539369,11,0,11,0,1,1,0,1,1
02539543,34,13,21,0,1,1,0,0,0
02539817,7,3,4,0,1,1,0,0,0
03400112,19,4,15,0,2,2,0,1,1
03400152,50,14,36,0,0,0,0,0,1
03400161,37,6,31,0,0,0,0,0,1
03400238,19,3,16,0,1,1,0,1,1
03400296,9,3,6,0,1,1,0,1,0
03400684,20,4,16,0,2,1,1,2,1
03400776,24,4,20,0,0,0,0,0,0
03400943,4,2,2,0,1,1,0,0,1
03401010,70,14,56,0,6,4,2,0,1
03401440,132,17,115,0,0,0,0,0,1
03401602,9,3,6,0,1,1,0,0,0
03401745,16,3,13,0,1,1,0,1,1
03402204,31,3,28,0,1,1,0,1,1
03402292,5,2,3,0,1,1,0,0,1
03402421,29,5,24,0,3,3,0,0,1
03402439,10,2,8,0,1,1,0,1,1
03402530,23,0,23,0,0,0,0,0,1
03402928,22,5,17,0,0,0,0,0,0
03403037,14,9,5,0,0,0,0,0,1
03403160,6,3,3,0,1,1,0,1,1
03403297,7,2,5,0,1,1,0,0,0
03403305,24,4,20,0,1,1,0,1,1
03403334,25,2,23,0,1,1,0,1,1
03403434,8,1,7,0,1,1,0,0,1
03403474,13,0,13,0,0,0,0,0,1
03403522,66,12,54,0,0,0,0,0,1
03403530,27,3,24,0,0,0,0,0,1
03403550,26,0,26,0,0,0,0,0,1
03403681,13,3,10,0,0,0,0,0,1
03403977,85,14,71,0,0,0,0,0,1
03404062,34,9,25,0,0,0,0,0,1
03404192,34,3,31,0,1,1,0,1,1
03404304,4,2,2,0,1,1,0,0,1
03404450,56,14,42,0,26,0,26,0,1
03404827,12,5,7,0,2,2,0,0,1
03405116,39,8,31,0,1,1,0,1,1
03405150,18,4,14,0,1,1,0,1,1
03405168,24,3,21,0,1,1,0,1,1
03405217,29,4,25,0,1,1,0,1,1
03405708,9,3,6,0,3,2,1,0,0
03405948,16,0,16,0,0,0,0,0,1
03406150,21,8,13,0,0,0,0,0,1
03406335,27,2,25,0,1,1,0,1,1
03406513,22,0,22,0,0,0,0,0,1
03406761,29,6,23,0,1,1,0,1,1
03407203,12,6,6,0,0,0,0,0,1
03407323,28,0,28,0,0,0,0,0,1
03407383,7,2,5,0,1,1,0,1,1
03407430,34,6,28,0,1,1,0,1,1
03407918,42,0,42,0,0,0,0,0,1
03407991,33,6,27,0,0,0,0,0,1
03407998,11,4,7,0,0,0,0,0,1
03408002,26,0,26,0,0,0,0,0,1
03408672,4,3,1,0,2,2,0,0,0
03408701,18,2,16,0,1,1,0,0,0
03408981,6,2,4,0,1,1,0,0,1
03409935,46,11,35,0,2,2,0,0,1
03410456,17,2,15,0,1,1,0,1,1
03410459,17,2,15,0,1,1,0,1,1
03410784,24,4,20,0,1,1,0,1,1
03410932,76,11,65,0,0,0,0,0,1
03410938,34,0,34,0,1,1,0,1,1
03410958,20,2,18,0,2,1,1,2,1
03410977,17,3,14,0,1,1,0,1,1
03411198,5,2,3,0,1,1,0,0,0
03411383,46,0,46,0,0,0,0,0,1
03411472,58,10,48,0,0,0,0,0,1
03411498,19,3,16,0,0,0,0,0,1
03411518,36,11,25,0,1,1,0,1,1
03411698,16,0,16,0,0,0,0,0,1
03412290,43,3,40,0,0,0,0,0,1
03413269,47,10,37,0,0,0,0,0,1
03413288,22,4,18,0,3,3,0,1,0
03413782,7,0,7,0,0,0,0,0,0
03413844,17,4,13,0,0,0,0,0,1
03413994,7,5,2,0,1,1,0,1,1
03414540,43,8,35,0,1,1,0,1,1
03414586,34,1,33,0,1,1,0,1,1
03414708,37,3,34,0,1,1,0,1,1
03415667,6,1,5,0,1,1,0,0,1
03416095,6,2,4,0,1,1,0,0,1
03416145,27,0,27,0,0,0,0,0,1
03416147,35,0,35,0,0,0,0,0,1
03416207,26,0,26,0,0,0,0,0,1
03416341,24,7,17,0,1,1,0,0,1
03416346,26,5,21,0,1,1,0,0,1
03417008,3,2,1,0,1,1,0,0,0
03417067,20,3,17,0,1,1,0,1,1
03417162,15,3,12,0,0,0,0,0,0
03417286,11,3,8,0,1,1,0,1,1
03417335,5,3,2,0,2,2,0,0,1
03417603,13,0,13,0,0,0,0,0,1
03417873,24,3,21,0,1,1,0,1,1
03417875,15,2,13,0,0,0,0,0,1
03418103,10,1,9,0,1,1,0,0,1
03418138,19,2,17,0,0,0,0,0,1
03418474,9,4,5,0,2,1,1,1,1
03418673,35,5,30,0,1,1,0,1,1
03418735,27,0,27,0,0,0,0,0,1
03418736,31,3,28,0,1,1,0,1,1
03418807,6,2,4,0,1,1,0,0,1
03418853,38,6,32,0,6,6,0,1,1
03418970,41,11,30,0,0,0,0,0,1
03419143,18,5,13,0,1,1,0,1,1
03419305,10,3,7,0,2,1,1,1,1
03419338,15,4,11,0,1,1,0,1,1
03419732,8,0,8,0,0,0,0,0,1
03419800,5,3,2,0,2,2,0,0,0
03419998,6,4,2,0,3,3,0,0,0
03420004,17,6,11,0,1,1,0,1,1
03420143,19,8,11,0,0,0,0,0,0
03420768,20,6,14,0,0,0,0,0,0
03421366,29,0,29,0,1,1,0,1,1
03421611,7,5,2,0,1,1,0,0,1
03421614,6,0,6,0,0,0,0,0,1
03421851,6,4,2,0,0,0,0,0,1
03421908,7,4,3,0,2,2,0,0,1
03422041,7,1,6,0,1,1,0,0,0
03422341,106,13,93,0,0,0,0,0,1
03422350,43,7,36,0,0,0,0,0,1
03422433,16,0,16,0,0,0,0,0,1
03422461,17,0,17,0,0,0,0,0,1
03422618,21,3,18,0,1,1,0,0,1
03422696,9,4,5,0,1,1,0,0,1
03422719,38,6,32,0,0,0,0,0,0
03422777,24,4,20,0,0,0,0,0,1
03422859,5,3,2,0,1,1,0,0,0
03422921,13,0,13,0,0,0,0,0,1
03422948,27,5,22,0,1,1,0,1,0
03424138,17,0,17,0,1,1,0,1,1
03424344,19,2,17,0,1,1,0,0,1
03424396,5,1,4,0,1,1,0,0,0
03424706,17,3,14,0,1,1,0,0,0
03424860,15,0,15,0,0,0,0,0,1
03425008,72,12,60,0,0,0,0,0,1
03425492,67,9,58,0,0,0,0,0,1
03425954,40,7,33,0,0,0,0,0,1
03425986,11,2,9,0,1,1,0,1,1
03426086,39,18,21,0,3,0,3,0,1
03426103,35,2,33,0,2,2,0,0,1
03426365,31,7,24,0,0,0,0,0,1
03426366,60,11,49,0,0,0,0,0,1
03426392,14,5,9,0,1,1,0,0,0
03426404,10,0,10,0,0,0,0,0,1
03426529,13,0,13,0,0,0,0,0,1
03426585,4,0,4,0,0,0,0,0,0
03426704,40,16,24,0,3,0,3,0,1
03426890,4,1,3,0,1,1,0,0,1
03427084,16,3,13,0,1,1,0,1,1
03427303,32,8,24,0,0,0,0,0,1
03428196,26,3,23,0,2,1,1,2,1
03428646,5,3,2,0,2,2,0,0,1
03428850,48,10,38,0,0,0,0,0,1
03428888,63,8,55,0,1,0,1,1,1
03428931,9,2,7,0,1,1,0,1,1
03429311,37,4,33,0,0,0,0,0,1
03429380,25,2,23,0,4,1,3,2,1
03429499,47,2,45,0,1,1,0,1,1
03429543,14,0,14,1,0,0,0,0,1
03429561,18,2,16,0,1,1,0,1,1
03429596,8,5,3,0,2,1,1,1,1
03429608,26,9,17,0,1,1,0,0,1
03429786,7,0,7,0,2,2,0,0,1
03429905,18,5,13,0,2,1,1,1,1
03430002,12,0,12,0,3,3,0,0,1
03430071,42,5,37,0,1,1,0,1,1
03430194,13,2,11,0,1,1,0,1,1
03430288,24,5,19,0,1,1,0,1,1
03430299,30,4,26,0,0,0,0,0,1
03430418,27,5,22,0,2,2,0,2,1
03430458,41,0,41,0,1,1,0,1,1
03430866,5,2,3,0,2,2,0,0,1
03430879,7,1,6,0,1,1,0,0,1
03430894,41,0,41,0,0,0,0,0,1
03430925,55,6,49,0,1,0,1,0,1
03431169,26,12,14,0,0,0,0,0,1
03431249,10,5,5,0,4,3,1,0,1
03431793,5,3,2,0,2,2,0,0,1
03431799,4,0,4,0,0,0,0,0,1
03431927,11,3,8,0,0,0,0,0,1
03431928,12,4,8,0,1,1,0,1,1
03431945,3,3,0,0,2,2,0,0,0
03431997,9,4,5,0,2,2,0,0,0
03432100,34,4,30,0,2,1,1,2,1
03432378,16,3,13,0,0,0,0,0,0
03432476,15,4,11,0,0,0,0,0,1
03432519,10,0,10,0,1,1,0,1,1
03432608,19,0,19,0,0,0,0,0,1
03432714,5,0,5,0,0,0,0,0,1
03432755,6,2,4,0,2,2,0,0,0
03432845,5,3,2,0,1,1,0,0,0
03433043,81,11,70,0,0,0,0,0,0
03433055,13,8,5,0,0,0,0,0,0
03433113,10,0,10,0,0,0,0,0,1
03433146,17,0,17,0,1,1,0,1,1
03433149,10,2,8,0,1,1,0,0,1
03433156,11,2,9,0,1,1,0,1,1
03433251,16,1,15,0,2,0,2,0,1
03433340,5,3,2,0,2,2,0,0,0
03433410,27,3,24,0,3,1,2,3,0
03433441,14,3,11,0,2,1,1,2,1
03433544,15,3,12,0,1,1,0,1,1
03434029,5,4,1,0,2,2,0,0,0
03434049,10,0,10,0,5,5,0,1,1
03434197,32,2,30,0,1,1,0,1,1
03434501,48,10,38,0,0,0,0,0,1
03434507,7,2,5,0,1,1,0,0,1
03434540,8,1,7,0,1,1,0,1,0
03434864,38,9,29,0,0,0,0,0,0
03435369,5,2,3,0,1,1,0,0,1
03435665,6,0,6,0,1,1,0,0,1
03435817,8,0,8,0,4,4,0,0,1
03437075,5,1,4,0,3,1,2,1,0
03437147,20,2,18,0,0,0,0,0,1
03437199,5,2,3,0,3,2,1,0,1
03437446,35,10,25,0,0,0,0,0,1
03437534,38,0,38,0,0,0,0,0,1
03437923,21,8,13,0,0,0,0,0,1
03437935,29,3,26,0,1,1,0,1,1
03438667,8,0,8,0,1,1,0,0,0
03438957,43,7,36,0,0,0,0,0,0
03439041,20,3,17,0,1,1,0,1,1
03439272,32,6,26,0,0,0,0,0,1
03439377,7,4,3,0,1,1,0,1,1
03439398,7,0,7,0,0,0,0,0,1
03439448,39,0,39,0,1,1,0,1,0
03439777,35,7,28,0,0,0,0,0,1
03439896,34,2,32,0,1,1,0,1,1
06700049,4,3,1,0,6,6,0,5,1
06700243,2,0,2,0,2,2,0,0,1
06700294,23,7,16,0,0,0,0,0,1
06700449,3,2,1,0,1,1,0,0,0
06700653,17,11,6,0,2,2,0,0,0
06700852,4,0,4,0,1,1,0,1,1
06700907,15,2,13,0,4,1,3,4,1
06700948,10,5,5,0,0,0,0,0,1
06701335,15,4,11,0,1,1,0,0,0
06701448,2,2,0,0,1,1,0,0,0
06701645,2,0,2,0,0,0,0,0,1
06702051,11,5,6,0,3,3,0,0,1
06702158,8,1,7,1,1,1,0,0,1
06702255,9,0,9,0,2,2,0,0,1
06703231,4,2,2,0,1,1,0,1,1
06703264,12,3,9,0,0,0,0,0,0
06703698,10,5,5,0,4,1,3,2,1
06703755,1,1,0,0,1,1,0,0,0
06704019,2,0,2,0,0,0,0,0,1
06704560,7,0,7,0,1,1,0,0,1
06704614,23,11,12,0,1,1,0,1,1
06705037,19,2,17,0,1,1,0,1,1
06706030,14,7,7,0,1,1,0,0,1
06706681,11,4,7,0,0,0,0,0,1
06706826,17,11,6,0,0,0,0,0,1
06707205,20,4,16,0,1,1,0,1,1
06707366,11,6,5,0,0,0,0,0,1
06707542,15,5,10,0,0,0,0,0,0
06708227,3,3,0,0,2,2,0,0,0
06708321,1,1,0,0,1,1,0,0,0
06708855,4,2,2,0,2,2,0,0,1
06708998,6,0,6,0,2,2,0,0,0
06709225,4,0,4,0,0,0,0,0,1
06709585,8,0,8,0,0,0,0,0,1
06709924,12,4,8,0,1,1,0,1,1
06709948,1,1,0,0,1,1,0,0,1
06710925,23,10,13,0,0,0,0,0,1
06710980,5,3,2,0,2,2,0,0,0
06710997,3,2,1,0,2,2,0,0,0
06711029,7,3,4,0,1,1,0,0,0
06711051,29,5,24,0,3,1,2,3,1
06711102,3,2,1,0,1,1,0,0,0
06711199,1,1,0,0,1,1,0,0,0
06711225,14,3,11,0,4,0,4,0,1
06711496,5,0,5,0,0,0,0,0,0
06711515,1,0,1,0,2,1,1,0,1
06711685,2,2,0,0,2,2,0,0,0
06711749,6,2,4,0,3,1,2,3,0
06711930,16,6,10,0,1,1,0,1,1
06712173,6,3,3,0,0,0,0,0,1
06712694,8,3,5,0,1,1,0,0,1
06713115,42,12,30,0,1,0,1,0,0
06713506,2,0,2,0,0,0,0,0,1
06713711,9,2,7,0,0,0,0,0,1
06713712,8,1,7,0,1,1,0,1,1
06713764,44,0,44,0,0,0,0,0,1
06714345,3,1,2,0,2,2,0,0,0
06714481,6,0,6,0,0,0,0,0,1
06714902,21,9,12,0,0,0,0,0,1
06714907,3,1,2,0,1,1,0,0,1
06714949,2,2,0,0,1,1,0,0,1
06715084,10,0,10,0,0,0,0,0,1
06715103,2,2,0,0,1,1,0,1,0
06715326,3,3,0,0,1,1,0,0,0
06715581,3,2,1,0,1,1,0,0,1
06715869,12,3,9,0,1,1,0,1,0
06716035,4,3,1,0,1,1,0,0,1
06716300,19,9,10,0,0,0,0,0,1
06716362,10,3,7,0,1,1,0,1,1
06716404,3,0,3,0,0,0,0,0,1
06716473,6,1,5,0,1,1,0,0,0
06716701,2,0,2,0,0,0,0,0,1
06716893,3,3,0,0,2,2,0,0,0
06717631,16,3,13,0,4,1,3,1,1
06718125,11,4,7,0,2,2,0,2,1
06718275,7,2,5,0,1,1,0,0,1
06718284,9,6,3,0,0,0,0,0,1
06718311,9,2,7,0,1,1,0,1,1
06718531,23,6,17,0,1,1,0,1,1
06718671,23,6,17,0,1,1,0,1,1
06718964,14,0,14,0,0,0,0,0,1
06719644,7,0,7,0,0,0,0,0,1
06719822,12,0,12,0,1,1,0,1,1
06719882,23,9,14,0,1,1,0,1,1
06719915,3,0,3,0,2,2,0,0,1
06720006,2,0,2,0,0,0,0,0,1
06720456,4,2,2,0,1,1,0,0,0
06720819,4,0,4,0,1,1,0,0,0
06721792,2,1,1,0,1,1,0,0,1
06722025,12,2,10,0,1,1,0,1,1
06722032,20,6,14,0,1,1,0,1,1
06722290,8,1,7,0,1,1,0,0,0
06722370,4,1,3,0,2,1,1,0,1
06722632,1,1,0,0,1,1,0,0,0
06722919,2,0,2,0,0,0,0,0,1
06722970,3,2,1,0,3,3,0,0,1
06723346,3,3,0,0,1,1,0,0,0
06723644,11,4,7,0,1,1,0,1,1
06723882,1,1,0,0,1,1,0,0,0
06724116,1,1,0,0,1,1,0,0,1
06724277,20,7,13,0,1,0,1,0,0
06724554,1,1,0,0,1,1,0,0,0
06724838,8,3,5,0,0,0,0,0,1
06725277,3,3,0,0,1,1,0,0,1
06725442,5,0,5,0,0,0,0,0,1
06725579,6,2,4,0,1,1,0,0,1
06725701,3,3,0,0,2,2,0,0,1
06725947,5,0,5,0,0,0,0,0,0
06726262,39,13,26,0,0,0,0,0,1
06726412,8,3,5,0,1,1,0,1,1
06726624,6,1,5,0,1,1,0,0,0
06726943,4,1,3,0,2,2,0,1,1
06726953,11,0,11,0,1,1,0,1,1
06726975,2,0,2,0,0,0,0,0,1
06726996,4,0,4,0,2,2,0,0,1
06727432,6,2,4,0,1,1,0,0,1
06727738,13,4,9,0,2,2,0,2,1
06728774,2,1,1,0,1,1,0,0,0
06729401,10,3,7,0,1,1,0,1,1
06729420,28,9,19,0,0,0,0,0,1
06729689,3,1,2,0,1,1,0,0,0
06730004,4,2,2,0,1,1,0,0,1
06730103,2,2,0,0,1,1,0,0,0
06730464,7,2,5,0,3,1,2,1,1
06730545,21,2,19,0,1,1,0,1,1
06730869,8,4,4,0,2,2,0,2,1
06731252,5,1,4,0,1,1,0,0,0
06731387,14,9,5,0,2,0,2,0,1
06731513,3,1,2,0,0,0,0,0,0
06731528,30,10,20,0,1,1,0,1,0
06731552,5,1,4,0,1,1,0,0,0
06732032,16,7,9,0,0,0,0,0,0
06732181,2,1,1,0,1,1,0,0,0
06732265,14,0,14,1,1,1,0,0,1
06732642,6,2,4,0,1,1,0,0,0
06732644,5,0,5,0,0,0,0,0,1
06733031,9,0,9,0,4,2,2,1,1
06733039,7,0,7,0,1,1,0,1,1
06733688,2,2,0,0,1,1,0,0,0
06734073,2,0,2,0,2,2,0,0,1
06734314,10,0,10,0,0,0,0,0,0
06734354,24,10,14,0,0,0,0,0,1
06734642,12,3,9,0,0,0,0,0,0
06735003,33,14,19,0,3,3,0,0,1
06735135,1,1,0,0,1,1,0,1,1
06735221,4,0,4,0,3,3,0,0,1
06735306,13,3,10,0,1,1,0,0,0
06735401,10,1,9,0,1,1,0,0,1
06735445,17,4,13,0,2,2,0,2,1
06735652,5,5,0,0,1,1,0,1,0
06735698,1,1,0,0,1,1,0,1,0
06735880,2,2,0,0,2,2,0,0,1
06735944,1,1,0,0,1,1,0,0,0
06736181,14,4,10,0,0,0,0,0,0
06736260,8,4,4,0,1,1,0,0,1
06736558,3,1,2,0,2,1,1,1,1
06736661,3,0,3,0,0,0,0,0,1
06736754,6,1,5,0,2,1,1,0,0
06736821,14,7,7,0,1,1,0,1,1
06737175,4,0,4,0,1,1,0,0,0
06737190,4,1,3,0,2,1,1,0,1
06737352,6,2,4,0,1,1,0,0,0
06737552,3,3,0,0,2,2,0,0,0
06738183,3,3,0,0,2,2,0,0,1
06738258,22,15,7,0,0,0,0,0,0
06738533,4,1,3,0,1,1,0,0,1
06739020,4,3,1,0,1,1,0,1,1
06739147,5,2,3,0,1,1,0,0,1
06739198,15,0,15,0,0,0,0,0,1
06739449,3,0,3,0,1,1,0,0,1
06739687,3,3,0,0,2,2,0,0,0
06739904,3,2,1,0,1,1,0,0,1
06740603,8,0,8,0,0,0,0,0,1
06740610,6,2,4,0,1,1,0,0,1
06740940,29,8,21,0,0,0,0,0,1
06740968,7,3,4,0,4,3,1,0,0
06741098,4,4,0,0,3,3,0,0,0
06741389,7,0,7,0,1,1,0,0,0
06741409,9,0,9,0,0,0,0,0,0
06741705,14,8,6,0,4,1,3,0,0
06741827,39,9,30,0,0,0,0,0,1
06741989,24,0,24,0,0,0,0,0,0
06742752,6,4,2,0,2,2,0,0,1
06742941,3,0,3,0,0,0,0,0,1
06743150,6,2,4,0,1,1,0,0,1
06743997,11,3,8,0,1,1,0,0,1
06744379,19,11,8,0,0,0,0,0,0
06744826,13,2,11,0,1,1,0,1,0
06744947,2,2,0,0,1,1,0,0,0
06744955,4,1,3,0,0,0,0,0,1
06745235,13,6,7,0,2,0,2,0,1
06745641,3,2,1,0,1,1,0,0,0
06746840,3,3,0,0,1,1,0,0,0
06747090,10,2,8,0,0,0,0,0,0
06747321,5,3,2,0,0,0,0,0,0
06747353,2,2,0,0,2,2,0,0,1
06747665,2,2,0,0,1,1,0,0,0
06748242,2,0,2,0,0,0,0,0,1
06748261,11,4,7,0,0,0,0,0,1
06748266,30,11,19,0,0,0,0,0,0
06748453,10,0,10,0,0,0,0,0,0
06748562,2,1,1,0,1,1,0,0,0
06748582,2,2,0,0,1,1,0,0,0
06748695,7,4,3,0,0,0,0,0,0
06748742,7,5,2,0,4,4,0,0,0
06749181,23,6,17,0,0,0,0,0,1
06749402,25,8,17,0,1,1,0,0,0
06749816,6,2,4,0,2,2,0,0,1
06750023,3,2,1,0,2,1,1,0,0
06750432,8,2,6,0,1,1,0,1,1
06750575,15,0,15,0,0,0,0,0,1
06751125,9,6,3,0,2,2,0,2,1
06751131,4,1,3,0,2,1,1,0,1
06751266,4,0,4,0,0,0,0,0,1
06752206,2,0,2,0,0,0,0,0,1
06752589,7,4,3,0,2,1,1,2,0
06752742,1,0,1,0,0,0,0,0,1
06752784,1,1,0,0,1,1,0,0,0
06753741,12,1,11,0,1,1,0,1,1
06753891,12,4,8,0,1,1,0,0,0
06754414,11,0,11,0,0,0,0,0,1
06754867,1,1,0,0,0,0,0,0,0
06754889,3,1,2,0,1,1,0,0,1
06755423,16,8,8,0,0,0,0,0,0
06755730,4,0,4,0,0,0,0,0,0
06755734,523,2,521,0,2,1,1,1,1
06755839,1,1,0,0,0,0,0,0,0
06757179,2,2,0,0,1,1,0,0,0
06757696,3,1,2,0,1,1,0,0,1
06757727,5,0,5,0,0,0,0,0,1
06757807,12,9,3,0,0,0,0,0,0
06757822,15,1,14,0,1,1,0,0,0
06758203,24,8,16,0,1,1,0,0,0
06758215,17,8,9,0,0,0,0,0,1
06758865,2,0,2,0,0,0,0,0,1
06759342,25,9,16,0,0,0,0,0,1
06759504,4,3,1,0,3,3,0,0,0
06759572,8,5,3,0,1,1,0,0,0
06759667,7,2,5,0,1,1,0,0,1
06759890,16,9,7,0,0,0,0,0,1
06760104,2,1,1,0,0,0,0,0,0
06760260,14,5,9,0,1,1,0,1,1
06760516,2,1,1,0,1,1,0,0,1
06760592,13,0,13,0,0,0,0,0,1
06760739,5,0,5,0,0,0,0,0,1
06760790,5,0,5,0,1,1,0,1,1
06760991,2,0,2,0,1,1,0,0,0
06761047,11,3,8,0,0,0,0,0,1
06761209,9,0,9,0,0,0,0,0,1
06761226,10,4,6,0,0,0,0,0,1
06761513,4,1,3,0,1,1,0,1,1
06761571,9,3,6,0,1,1,0,0,1
06761597,2,1,1,0,2,2,0,0,0
06761676,4,0,4,0,0,0,0,0,1
06761779,10,4,6,0,1,1,0,1,1
06762632,2,1,1,0,1,1,0,1,1
06763191,5,0,5,0,1,1,0,0,1
06763283,10,3,7,0,3,1,2,0,1
06763298,1,1,0,0,1,1,0,0,0
06763341,30,9,21,0,0,0,0,0,1
06763596,5,1,4,0,1,1,0,0,0
06764151,20,7,13,0,1,1,0,0,1
06764170,8,4,4,0,0,0,0,0,1
06764256,5,0,5,0,1,1,0,1,1
06764278,8,0,8,0,0,0,0,0,1
06764335,33,12,21,0,1,0,1,1,1
06764755,2,2,0,0,1,1,0,0,0
06765090,2,1,1,0,2,1,1,0,0
06765345,3,3,0,0,2,2,0,0,0
06765538,3,1,2,0,1,1,0,0,0
06765568,4,2,2,1,1,1,0,0,1
06765575,11,5,6,0,1,1,0,0,0
06765625,7,0,7,0,0,0,0,0,1
06765650,7,3,4,0,1,1,0,0,1
06765811,6,3,3,0,1,1,0,1,1
06766019,31,8,23,0,1,1,0,1,1
06766052,8,4,4,0,0,0,0,0,1
06766416,6,2,4,0,2,2,0,0,0
06766740,14,6,8,0,1,1,0,0,1
06766834,11,2,9,0,1,1,0,1,1
06766839,6,0,6,0,0,0,0,0,1
06766852,6,0,6,0,0,0,0,0,1
06766859,6,0,6,0,0,0,0,0,1
06766882,6,0,6,0,0,0,0,0,1
06766885,6,0,6,0,0,0,0,0,1
06767315,3,0,3,0,0,0,0,0,0
06767479,21,9,12,0,0,0,0,0,1
06767659,3,3,0,0,2,2,0,0,1
06767788,10,6,4,0,1,1,0,1,0
06768067,4,4,0,0,3,3,0,0,0
06768203,8,3,5,0,4,4,0,1,1
06768324,48,22,26,0,1,1,0,0,1
06768483,3,2,1,0,1,1,0,1,0
06768610,1,1,0,0,1,1,0,0,1
06768742,6,2,4,0,1,1,0,1,1
06768819,2,1,1,0,1,1,0,0,0
06768844,7,2,5,0,1,1,0,0,0
06769064,2,2,0,0,1,1,0,0,1
06769083,4,3,1,0,1,1,0,0,0
06769237,7,4,3,0,0,0,0,0,1
06769239,7,2,5,0,0,0,0,0,1
06769448,2,1,1,0,1,1,0,0,0
06769484,4,2,2,0,0,0,0,0,0
06769553,5,2,3,0,1,1,0,0,1
04370389,98,0,98,0,0,0,0,0,1
04370521,30,14,16,0,0,0,0,0,1
04370935,7,4,3,0,1,1,0,0,1
04371091,5,2,3,0,1,1,0,0,1
04371133,24,9,15,0,1,1,0,0,1
04371286,5,0,5,0,1,1,0,0,1
04371373,5,3,2,0,1,1,0,0,0
04371548,11,5,6,0,2,1,1,1,1
04371632,16,2,14,0,1,1,0,0,1
04371685,16,6,10,0,0,0,0,0,1
04371742,7,3,4,0,1,1,0,0,1
04371804,13,0,13,0,0,0,0,0,1
04372168,7,6,1,0,0,0,0,0,1
04372394,16,0,16,0,0,0,0,0,1
04372517,4,2,2,0,1,1,0,0,0
04372605,0,0,0,0,0,0,0,0,0
04372752,14,2,12,0,2,2,0,0,0
04372786,4,3,1,0,2,2,0,0,0
04372973,6,4,2,0,1,1,0,0,1
04372979,27,3,24,0,1,1,0,1,1
04373005,26,3,23,0,1,1,0,1,1
04373064,6,0,6,0,0,0,0,0,1
04373313,42,12,30,0,0,0,0,0,1
04373334,5,3,2,0,2,2,0,0,0
04373336,16,3,13,0,1,1,0,1,1
04373361,8,5,3,0,2,2,0,0,0
04373660,19,4,15,0,1,1,0,1,1
04373697,17,0,17,0,0,0,0,0,1
04373759,37,5,32,0,2,1,1,2,1
04373765,19,0,19,0,0,0,0,0,1
04373808,14,3,11,0,1,1,0,1,1
04373897,22,8,14,0,0,0,0,0,0
04373949,8,0,8,0,0,0,0,0,1
04374464,6,2,4,0,0,0,0,0,1
04374635,19,0,19,0,1,1,0,1,1
04374740,16,2,14,0,0,0,0,0,1
04374810,20,6,14,0,0,0,0,0,0
04374972,14,4,10,0,1,1,0,1,1
04374975,25,0,25,0,0,0,0,0,1
04375031,11,0,11,0,0,0,0,0,1
04375298,25,0,25,0,0,0,0,0,1
04375649,30,8,22,0,0,0,0,0,0
04375679,37,9,28,0,0,0,0,0,1
04375706,4,3,1,0,3,3,0,0,1
04375762,23,9,14,0,0,0,0,0,1
04375845,9,0,9,0,0,0,0,0,1
04376069,9,2,7,0,3,1,2,2,1
04376226,16,4,12,0,2,2,0,1,1
04376641,7,1,6,0,1,1,0,0,1
04376677,18,0,18,0,0,0,0,0,1
04376946,7,0,7,0,0,0,0,0,0
04376981,4,2,2,0,1,1,0,0,1
04377157,11,0,11,0,1,1,0,1,1
04377558,26,6,20,0,5,3,2,5,1
04377560,23,0,23,0,0,0,0,0,1
04377793,13,3,10,0,2,2,0,0,1
04377958,30,5,25,0,1,1,0,1,1
04378119,9,5,4,0,0,0,0,0,1
04378274,9,1,8,0,1,1,0,0,1
04378302,19,0,19,0,0,0,0,0,0
04378914,14,2,12,0,1,1,0,1,1
04378939,16,2,14,0,0,0,0,0,1
04379109,44,4,40,0,12,1,11,1,1
04379335,29,6,23,0,1,1,0,1,1
04379340,14,4,10,0,3,1,2,0,1
04379549,6,0,6,0,0,0,0,0,1
04379574,32,5,27,0,1,1,0,1,1
04379784,15,4,11,0,1,1,0,1,1
04379803,6,0,6,0,0,0,0,0,1
04380094,4,1,3,0,1,1,0,0,0
04380107,11,0,11,0,0,0,0,0,1
04380217,6,3,3,0,1,1,0,0,0
04380225,14,0,14,0,0,0,0,0,1
04380448,12,1,11,0,1,1,0,1,1
04380483,7,5,2,0,4,2,2,1,0
04380665,23,3,20,0,1,1,0,1,1
04380759,18,4,14,0,0,0,0,0,1
04380814,30,10,20,0,0,0,0,0,0
04380883,26,4,22,0,1,1,0,1,1
04381004,33,6,27,0,0,0,0,0,0
04381039,3,1,2,0,0,0,0,0,1
04381162,55,12,43,0,0,0,0,0,1
04381199,9,3,6,0,0,0,0,0,1
04381647,58,13,45,0,0,0,0,0,1
04381722,33,6,27,0,0,0,0,0,1
04381872,9,0,9,0,1,1,0,1,0
04381875,9,0,9,0,1,1,0,1,0
04382034,5,2,3,0,1,1,0,1,1
04382038,5,2,3,0,1,1,0,1,1
04382041,5,2,3,0,1,1,0,1,1
04382136,13,4,9,0,1,1,0,1,1
04382950,29,3,26,0,1,1,0,1,1
04383249,12,3,9,0,1,1,0,1,1
04383256,10,2,8,0,1,1,0,0,1
04383398,12,3,9,0,2,1,1,2,1
04383491,27,10,17,0,0,0,0,0,0
04383521,20,4,16,0,1,1,0,1,1
04383538,20,3,17,0,0,0,0,0,1
04383577,13,2,11,0,0,0,0,0,1
04383587,6,3,3,0,2,1,1,0,1
04383834,9,0,9,0,0,0,0,0,1
04383868,4,2,2,0,1,1,0,0,0
04384279,66,11,55,0,0,0,0,0,1
04384486,8,3,5,0,0,0,0,0,0
04384688,25,7,18,1,1,1,0,1,1
04384956,12,3,9,0,1,1,0,0,1
04385217,11,2,9,0,2,2,0,0,0
04385487,11,5,6,0,3,2,1,0,1
04385497,12,5,7,0,3,3,0,0,1
04385537,41,14,27,0,0,0,0,0,1
04385641,18,0,18,0,0,0,0,0,1
04385744,18,5,13,0,1,1,0,1,1
04385746,6,2,4,0,1,1,0,1,1
04385785,4,2,2,0,1,1,0,0,1
04385880,5,2,3,0,1,1,0,1,1
04385945,12,2,10,0,1,1,0,1,1
04386277,24,2,22,0,1,1,0,1,1
04386323,26,2,24,0,1,1,0,1,1
04386324,3,2,1,0,1,1,0,0,0
04386501,53,0,53,0,0,0,0,0,1
04386524,15,0,15,0,1,1,0,1,1
04386697,24,2,22,0,1,1,0,1,1
04386957,17,3,14,0,1,1,0,1,1
04387018,4,0,4,0,0,0,0,0,1
04387021,4,2,2,0,1,1,0,0,1
04387136,40,7,33,0,1,1,0,1,1
04387278,6,1,5,0,1,1,0,1,1
04388091,7,0,7,0,0,0,0,0,1
04388320,11,0,11,0,0,0,0,0,1
04388397,29,6,23,1,1,1,0,1,1
04388436,13,2,11,0,1,1,0,1,1
04388504,5,3,2,0,1,1,0,0,1
04388523,7,3,4,0,1,1,0,0,1
04388821,13,7,6,0,0,0,0,0,1
04388973,26,4,22,0,2,1,1,2,1
04388992,20,0,20,0,3,3,0,3,1
04389132,32,11,21,0,0,0,0,0,1
04389152,5,3,2,0,1,1,0,0,0
04389197,7,1,6,0,1,1,0,0,1
04389301,5,3,2,0,0,0,0,0,0
04389338,8,0,8,0,1,1,0,0,1
04389363,12,3,9,0,1,1,0,1,1
04389411,70,6,64,0,10,0,10,0,1
04389465,9,0,9,0,0,0,0,0,0
04389708,8,3,5,0,1,1,0,0,1
04390140,19,8,11,0,1,1,0,0,0
04390208,44,17,27,0,0,0,0,0,1
04390219,43,17,26,0,0,0,0,0,1
04390221,10,6,4,0,0,0,0,0,0
04390230,4,0,4,0,1,1,0,0,1
04390484,5,1,4,0,1,1,0,1,1
04390508,63,12,51,0,0,0,0,0,1
04390760,13,4,9,0,2,2,0,0,0
04391008,26,6,20,0,0,0,0,0,1
04391074,7,0,7,0,0,0,0,0,1
04391171,23,6,17,0,0,0,0,0,1
04391327,6,4,2,0,3,3,0,0,0
04391429,5,3,2,0,2,2,0,0,0
04391498,7,0,7,0,0,0,0,0,1
04391764,5,2,3,0,1,1,0,0,0
04391971,5,3,2,0,2,2,0,0,1
04392361,23,8,15,0,1,1,0,1,1
04392453,9,0,9,0,1,1,0,0,1
04392464,8,3,5,0,1,1,0,0,1
04392467,9,3,6,0,1,1,0,0,1
04392474,9,0,9,0,1,1,0,0,1
04392494,25,8,17,0,0,0,0,0,0
04392703,8,3,5,0,1,1,0,1,1
04392827,12,5,7,0,1,1,0,1,1
04392882,8,4,4,0,1,1,0,0,1
04393140,5,3,2,0,2,2,0,0,0
04393161,31,4,27,0,1,1,0,1,1
04393350,5,3,2,0,2,2,0,0,0
04393653,4,2,2,0,1,1,0,0,0
04393769,37,12,25,0,0,0,0,0,1
04393879,6,2,4,0,2,2,0,0,0
04393926,6,2,4,0,1,1,0,0,1
04394122,4,3,1,0,2,2,0,0,0
04394388,6,0,6,0,0,0,0,0,1
04394408,11,2,9,0,1,1,0,1,1
04394435,58,0,58,0,0,0,0,0,1
04394889,12,0,12,0,0,0,0,0,1
04394890,7,0,7,0,0,0,0,0,1
04394953,15,5,10,0,0,0,0,0,0
04395109,23,5,18,0,1,1,0,1,1
04395402,5,0,5,0,0,0,0,0,1
04395472,24,3,21,0,1,1,0,1,1
04395486,15,3,12,0,1,1,0,1,1
04395497,12,0,12,0,0,0,0,0,1
04395499,16,3,13,0,1,1,0,1,1
04395661,6,2,4,0,1,1,0,0,1
04395696,67,3,64,0,1,1,0,1,0
04395718,15,0,15,0,0,0,0,0,1
04395761,17,2,15,0,1,1,0,1,1
04395909,6,2,4,0,2,2,0,0,0
04396240,5,0,5,0,0,0,0,0,0
04396376,13,5,8,0,0,0,0,0,1
04396433,11,1,10,0,2,1,1,0,1
04396755,10,5,5,0,0,0,0,0,0
04396759,30,4,26,0,2,2,0,2,1
04396797,5,5,0,0,3,1,2,1,0
04396810,28,5,23,0,1,1,0,1,1
04397152,10,5,5,0,4,4,0,0,1
04397695,6,0,6,0,0,0,0,0,0
04397696,5,2,3,0,0,0,0,0,1
04398016,9,3,6,0,2,2,0,0,0
04398128,5,3,2,0,2,2,0,0,0
04398204,6,0,6,0,0,0,0,0,1
04398259,29,2,27,0,3,3,0,0,0
04398806,42,8,34,0,0,0,0,0,1
04398873,9,0,9,0,0,0,0,0,1
01580003,18,4,14,0,2,1,1,2,1
01580114,13,0,13,0,0,0,0,0,1
01580252,39,4,35,0,1,1,0,1,1
01580284,68,4,64,0,1,1,0,1,1
01581072,27,3,24,0,1,1,0,1,1
01581246,24,3,21,0,1,1,0,1,1
01581264,30,2,28,0,2,2,0,2,1
01581770,41,3,38,0,0,0,0,0,0
01581858,13,0,13,0,0,0,0,0,1
01581935,56,5,51,0,1,1,0,1,1
01582280,11,3,8,0,1,1,0,1,1
01582321,0,0,0,0,0,0,0,0,1
01583089,8,2,6,0,1,1,0,0,0
01583186,23,0,23,1,3,1,2,0,1
01583334,38,3,35,0,1,1,0,1,1
01583386,11,5,6,0,0,0,0,0,1
01583814,25,4,21,0,1,1,0,1,1
01584188,31,4,27,0,1,1,0,1,1
01584700,4,4,0,0,2,2,0,0,0
01584796,19,3,16,0,1,1,0,1,1
01584838,28,2,26,0,0,0,0,0,1
01585283,62,0,62,0,0,0,0,0,1
01585491,6,4,2,0,3,3,0,0,0
01586155,20,3,17,0,0,0,0,0,0
01587249,69,4,65,0,1,1,0,0,1
01587601,29,4,25,0,1,1,0,1,1
01587907,18,7,11,0,0,0,0,0,1
01587910,34,8,26,0,0,0,0,0,1
01587913,40,4,36,0,1,1,0,1,1
01587922,75,7,68,0,3,2,1,0,1
01588286,41,6,35,0,1,1,0,1,1
01588557,10,0,10,0,0,0,0,0,1
01588900,21,4,17,0,2,1,1,2,1
01589012,24,3,21,0,1,1,0,1,0
01589824,18,2,16,0,1,1,0,1,1
01590035,1,1,0,0,0,0,0,0,1
01590326,21,3,18,0,0,0,0,0,1
01591065,28,4,24,0,1,1,0,1,1
01591100,40,5,35,0,1,1,0,1,1
01591500,31,2,29,0,1,1,0,1,1
01591538,4,2,2,0,1,1,0,0,0
01591555,67,3,64,0,2,2,0,2,1
01591587,18,4,14,0,1,1,0,1,1
01592029,70,4,66,0,2,1,1,2,1
01592031,46,15,31,0,0,0,0,0,1
01592083,20,2,18,0,1,1,0,1,1
01592175,7,1,6,0,1,1,0,1,1
01592503,23,3,20,0,1,1,0,1,1
01593067,7,3,4,0,0,0,0,0,1
01593332,4,4,0,0,2,2,0,0,0
01593648,20,7,13,0,1,1,0,0,1
01593981,25,2,23,0,1,1,0,1,1
01594306,32,0,32,0,0,0,0,0,1
01594325,21,6,15,0,1,1,0,1,1
01594344,27,3,24,0,0,0,0,0,1
01594405,19,4,15,0,1,1,0,1,1
01594599,41,9,32,0,1,1,0,1,1
01594605,12,5,7,0,3,3,0,0,1
01595106,13,4,9,0,0,0,0,0,0
01595266,4,0,4,0,2,2,0,0,0
01595705,35,0,35,0,0,0,0,0,1
01595867,16,5,11,0,0,0,0,0,1
01596390,26,2,24,0,1,1,0,1,1
01596564,15,1,14,0,1,1,0,1,1
01596565,20,1,19,0,1,1,0,1,1
01596883,11,0,11,0,1,1,0,1,1
01596945,39,4,35,0,1,1,0,1,1
01597194,51,8,43,0,2,2,0,0,1
01597287,10,2,8,0,3,3,0,0,1
01597315,21,3,18,0,0,0,0,0,1
01597647,12,0,12,0,0,0,0,0,1
01597931,43,4,39,0,1,1,0,1,1
01597972,12,4,8,0,1,1,0,1,0
01598072,28,6,22,0,0,0,0,0,1
01598334,21,5,16,0,0,0,0,0,1
01598586,7,4,3,0,0,0,0,0,1
01599081,14,3,11,0,1,1,0,1,0
01599377,122,11,111,0,1,1,0,0,1
01599789,25,3,22,0,1,1,0,1,1
01599791,10,2,8,0,1,1,0,1,1
01599796,55,13,42,0,0,0,0,0,1
01600031,6,2,4,0,2,2,0,0,1
01600480,8,2,6,0,2,2,0,0,0
01600646,57,12,45,0,0,0,0,0,1
01600703,6,3,3,0,0,0,0,0,0
01601168,23,0,23,0,1,1,0,1,1
01601181,16,3,13,0,1,1,0,1,1
01601185,189,11,178,0,0,0,0,0,1
01601297,20,3,17,0,1,1,0,1,1
01601403,9,0,9,0,0,0,0,0,1
01601417,8,6,2,0,0,0,0,0,1
01601451,42,5,37,0,1,1,0,0,1
01601509,33,4,29,0,1,1,0,1,1
01601691,22,2,20,0,1,1,0,1,1
01601821,38,5,33,0,1,1,0,1,1
01602161,184,9,175,0,2,1,1,0,1
01602253,6,3,3,0,2,2,0,1,0
01602467,44,12,32,0,0,0,0,0,1
01602662,32,6,26,0,0,0,0,0,1
01602705,72,2,70,0,0,0,0,0,1
01602869,24,4,20,0,3,3,0,0,1
01602986,5,2,3,0,0,0,0,0,0
01603201,26,8,18,0,1,1,0,1,1
01603404,14,2,12,0,0,0,0,0,0
01603634,14,4,10,0,0,0,0,0,0
01603650,0,0,0,0,0,0,0,0,0
01603770,21,4,17,0,1,1,0,1,1
01604010,11,4,7,0,1,1,0,1,1
01604493,0,0,0,0,0,0,0,0,1
01604572,29,8,21,0,0,0,0,0,1
01604788,124,5,119,0,0,0,0,0,1
01604930,60,10,50,0,1,1,0,1,1
01605533,5,1,4,0,1,1,0,1,1
01605725,16,3,13,0,0,0,0,0,1
01606009,6,3,3,0,1,1,0,0,0
01606391,34,3,31,0,1,1,0,1,1
01606623,28,8,20,0,0,0,0,0,0
01606737,14,3,11,0,1,1,0,1,1
01607044,16,2,14,0,1,1,0,1,1
01607198,16,1,15,0,1,1,0,1,1
01607372,25,0,25,0,1,1,0,1,1
01607622,10,4,6,0,1,1,0,1,1
01607664,36,3,33,0,0,0,0,0,1
01607787,22,4,18,0,1,1,0,1,1
01608042,19,0,19,0,1,1,0,1,1
01608199,16,3,13,0,1,1,0,1,1
01608211,6,4,2,0,0,0,0,0,0
01608246,13,2,11,0,2,2,0,0,1
01608248,8,0,8,0,0,0,0,0,1
01608727,28,3,25,0,1,1,0,1,1
01608998,42,5,37,0,1,1,0,1,1
01609444,31,3,28,0,1,1,0,1,1
01609738,30,0,30,0,0,0,0,0,1
01609850,51,6,45,0,0,0,0,0,0
01610568,19,3,16,0,1,1,0,1,1
01611136,20,4,16,0,1,1,0,1,1
01611448,22,0,22,0,0,0,0,0,1
01611861,44,14,30,0,0,0,0,0,1
01611893,21,4,17,0,0,0,0,0,1
01612181,36,9,27,0,0,0,0,0,1
01612228,17,3,14,0,1,1,0,1,1
01612249,60,10,50,0,0,0,0,0,1
01612256,13,7,6,0,1,1,0,0,0
01612918,4,3,1,0,2,2,0,0,1
01612921,44,6,38,0,1,1,0,0,1
01613715,3,3,0,0,1,1,0,0,0
01614521,14,2,12,0,1,1,0,0,1
01615175,28,0,28,0,0,0,0,0,1
01615593,19,6,13,0,0,0,0,0,1
01615990,61,12,49,0,0,0,0,0,1
01616261,0,0,0,0,0,0,0,0,0
01616494,9,3,6,0,1,1,0,0,1
01617370,29,0,29,0,0,0,0,0,1
01617653,22,0,22,0,0,0,0,0,1
01617719,20,7,13,0,2,2,0,0,1
01618226,12,5,7,0,2,1,1,1,1
01618279,13,3,10,0,1,1,0,1,1
01618548,12,3,9,0,0,0,0,0,1
01618610,82,14,68,0,0,0,0,0,1
01618677,44,3,41,0,1,1,0,1,1
01618678,7,3,4,0,1,1,0,1,1
01618685,43,3,40,0,1,1,0,1,1
01618825,16,1,15,0,2,1,1,0,0
01619236,30,6,24,0,2,2,0,1,1
01619253,143,14,129,0,0,0,0,0,1
01619845,8,3,5,0,1,1,0,1,1
01620484,10,3,7,0,1,1,0,0,0
01620758,20,6,14,0,0,0,0,0,0
01621060,40,6,34,0,1,1,0,1,1
01621120,6,0,6,0,0,0,0,0,1
01621244,4,2,2,0,1,1,0,0,0
01621367,37,3,34,0,1,1,0,1,1
01621384,32,7,25,0,0,0,0,0,0
01621431,0,0,0,0,0,0,0,0,1
01621718,58,6,52,0,0,0,0,0,1
01621973,7,2,5,0,1,1,0,0,0
01622226,216,4,212,0,1,1,0,1,1
01622344,13,3,10,0,1,1,0,0,1
01622496,28,4,24,0,1,1,0,1,1
01622531,22,6,16,0,1,1,0,1,1
01622771,9,2,7,0,1,1,0,0,0
01622834,60,4,56,0,3,3,0,0,1
01623213,26,6,20,0,5,4,1,0,1
01623294,33,5,28,0,3,0,3,0,0
01623766,60,3,57,0,1,1,0,1,1
01624144,72,8,64,0,1,1,0,1,1
01624247,34,0,34,0,0,0,0,0,1
01624297,24,4,20,0,1,1,0,1,1
01624433,12,2,10,0,1,1,0,1,0
01624814,26,0,26,0,0,0,0,0,1
01624909,22,2,20,0,2,1,1,2,1
01625094,11,4,7,0,0,0,0,0,1
01625837,9,6,3,0,2,2,0,0,1
01625880,12,1,11,0,1,1,0,1,1
01626040,3,2,1,0,1,1,0,0,1
01626049,44,7,37,0,1,1,0,1,1
01626190,7,3,4,0,2,2,0,0,0
01626506,25,8,17,0,0,0,0,0,1
01626563,29,9,20,0,1,1,0,1,1
01626586,8,2,6,0,1,1,0,1,1
01626992,12,2,10,0,1,1,0,0,0
01627155,18,3,15,0,1,1,0,1,1
01627174,3,1,2,0,1,1,0,0,0
01627471,35,3,32,0,1,1,0,1,1
01627492,16,6,10,0,1,1,0,0,1
01627626,26,5,21,0,1,1,0,1,1
01628523,25,3,22,0,1,1,0,1,1
01628541,3,3,0,0,2,2,0,0,0
01628566,42,7,35,0,0,0,0,0,1
01628797,20,5,15,0,0,0,0,0,0
01629484,32,5,27,0,3,0,3,0,0
01629510,7,2,5,0,0,0,0,0,0
01629514,9,0,9,0,0,0,0,0,1
01630237,83,10,73,0,0,0,0,0,1
01630240,10,3,7,0,2,2,0,0,0
01630349,10,0,10,0,0,0,0,0,1
01630402,36,4,32,0,1,1,0,1,1
01630936,27,0,27,0,0,0,0,0,1
01631016,28,4,24,0,1,1,0,0,0
01631188,29,0,29,0,0,0,0,0,1
01631613,45,0,45,0,1,1,0,1,1
01631659,52,6,46,0,0,0,0,0,0
01632364,4,4,0,0,2,2,0,0,0
01632590,47,12,35,0,1,1,0,0,1
01632599,11,3,8,0,2,1,1,1,1
01633042,39,3,36,0,1,1,0,1,1
01633260,73,4,69,0,0,0,0,0,0
01633651,3,3,0,0,2,2,0,0,1
01633951,29,6,23,0,0,0,0,0,1
01634346,3,2,1,0,1,1,0,0,0
01635024,47,6,41,0,4,4,0,0,1
01635142,4,1,3,0,2,2,0,0,0
01635787,109,6,103,0,1,1,0,0,0
01635916,50,13,37,0,0,0,0,0,1
01636098,69,10,59,0,0,0,0,0,1
01636136,15,0,15,0,1,1,0,1,1
01636470,28,7,21,0,0,0,0,0,1
01636570,16,4,12,0,1,1,0,0,1
01636817,14,7,7,0,0,0,0,0,1
01636921,5,3,2,0,1,1,0,0,0
01637205,19,5,14,0,0,0,0,0,1
01637885,31,3,28,0,1,1,0,1,1
01638126,13,4,9,0,1,1,0,1,1
01638304,66,8,58,0,13,7,6,0,1
01638742,14,3,11,0,1,1,0,1,1
01639017,32,8,24,0,1,1,0,1,1
01639334,23,3,20,0,1,1,0,1,1
01639364,19,0,19,0,0,0,0,0,1
01639519,224,10,214,1,1,1,0,1,1
01639557,27,4,23,0,1,1,0,1,1
01640181,16,2,14,0,1,1,0,0,1
01640186,1,1,0,0,0,0,0,0,1
01640359,9,3,6,0,0,0,0,0,0
01640762,22,3,19,0,1,1,0,1,1
01640958,1,1,0,0,0,0,0,0,1
01641088,40,0,40,0,0,0,0,0,1
01641421,39,3,36,0,1,1,0,1,1
01641619,23,3,20,0,1,1,0,1,1
01641954,38,4,34,0,1,1,0,1,1
01641968,58,9,49,0,0,0,0,0,0
01641984,86,14,72,0,0,0,0,0,1
01643672,39,0,39,0,1,1,0,1,1
01643779,9,0,9,0,0,0,0,0,1
01643943,13,3,10,0,3,3,0,1,0
01644127,62,3,59,0,1,1,0,1,1
01645102,36,0,36,0,0,0,0,0,1
01645195,23,5,18,0,1,1,0,0,0
01645201,135,15,120,0,0,0,0,0,1
01645294,4,2,2,0,2,1,1,0,1
01645397,46,6,40,0,0,0,0,0,1
01645444,31,0,31,0,1,1,0,1,1
01645543,9,2,7,0,0,0,0,0,1
01645574,8,3,5,0,2,2,0,0,1
01645674,16,6,10,1,0,0,0,0,1
01645707,23,2,21,0,1,1,0,1,1
01645720,5,0,5,0,0,0,0,0,1
01645888,50,11,39,0,0,0,0,0,1
01645915,35,4,31,0,0,0,0,0,1
01646013,30,0,30,0,0,0,0,0,1
01646146,32,7,25,0,0,0,0,0,1
01646340,21,3,18,0,0,0,0,0,1
01646660,106,19,87,0,0,0,0,0,0
01647021,6,0,6,0,0,0,0,0,0
01647162,32,0,32,0,0,0,0,0,1
01647173,19,0,19,0,1,1,0,0,1
01647362,45,5,40,0,2,2,0,2,1
01647510,29,2,27,0,2,2,0,2,1
01647559,5,0,5,0,1,1,0,0,1
01647974,14,4,10,0,3,3,0,0,0
01648115,17,4,13,0,2,2,0,2,1
01648208,6,3,3,0,1,1,0,0,0
01648295,17,3,14,0,1,1,0,1,1
01648435,29,12,17,0,0,0,0,0,0
01648574,16,4,12,0,1,1,0,1,1
01648767,36,4,32,0,2,1,1,1,1
01648903,77,11,66,0,0,0,0,0,1
00740414,8,7,1,0,2,2,0,0,0
00740442,7,3,4,0,1,1,0,0,0
00740891,43,6,37,0,1,1,0,0,1
00741489,45,2,43,0,1,1,0,1,1
00741597,44,10,34,0,1,1,0,1,1
00741598,56,4,52,0,1,1,0,1,1
00741624,39,5,34,0,1,1,0,1,1
00741937,8,3,5,0,1,1,0,0,0
00742615,26,0,26,0,0,0,0,0,1
00742695,13,6,7,0,1,1,0,1,1
00743200,7,3,4,0,1,1,0,0,1
00743334,14,0,14,0,0,0,0,0,1
00743967,7,2,5,0,1,1,0,0,0
00744017,93,10,83,0,0,0,0,0,1
00744229,53,12,41,0,0,0,0,0,1
00744256,39,4,35,0,2,1,1,2,1
00744369,26,3,23,0,1,1,0,1,1
00744398,6,2,4,0,1,1,0,0,0
00744679,29,0,29,0,0,0,0,0,1
00744856,15,8,7,0,0,0,0,0,0
00745398,192,34,158,0,0,0,0,0,1
00745440,9,0,9,0,0,0,0,0,0
00745598,37,7,30,0,2,1,1,2,1
00745621,204,11,193,0,0,0,0,0,1
00745673,18,1,17,0,1,1,0,0,1
00745917,41,6,35,0,1,1,0,1,1
00746250,16,0,16,0,0,0,0,0,1
00746358,6,3,3,0,2,2,0,0,0
00746465,33,5,28,0,1,1,0,1,1
00746571,2,1,1,0,0,0,0,0,1
00746956,63,5,58,0,2,2,0,2,1
00747611,24,4,20,0,3,1,2,3,1
00748090,6,2,4,0,3,2,1,0,0
00748236,5,2,3,0,4,2,2,0,1
00748679,8,3,5,0,1,1,0,0,0
00748865,94,14,80,0,2,0,2,0,1
00749110,6,2,4,0,3,3,0,0,0
00749112,10,4,6,0,4,4,0,1,1
00749317,33,4,29,0,1,1,0,1,1
00749504,77,11,66,0,0,0,0,0,1
00749645,63,6,57,0,0,0,0,0,1
00749646,6,3,3,0,1,1,0,0,0
00750110,13,3,10,0,1,1,0,1,0
00750921,8,2,6,0,1,1,0,1,0
00750978,7,4,3,0,2,2,0,0,1
00751061,27,3,24,0,1,1,0,1,1
00751434,6,3,3,0,2,2,0,0,0
00751560,12,0,12,0,0,0,0,0,1
00752321,3,2,1,0,1,1,0,0,0
00752569,14,7,7,0,3,3,0,0,1
00753110,25,5,20,0,1,1,0,1,1
00753340,49,5,44,0,1,1,0,1,1
00753518,36,5,31,0,1,1,0,1,1
00753648,53,13,40,0,0,0,0,0,0
00753782,19,0,19,0,0,0,0,0,1
00753967,4,3,1,0,2,1,1,0,1
00754167,59,9,50,0,1,1,0,1,1
00754472,31,4,27,0,2,2,0,2,1
00754743,8,2,6,0,1,1,0,0,0
00755502,27,10,17,0,0,0,0,0,1
00755561,31,5,26,0,1,1,0,1,1
00755581,31,5,26,0,1,1,0,1,1
00755944,31,5,26,0,1,1,0,1,1
00756007,86,15,71,0,0,0,0,0,1
00756025,5,4,1,0,1,1,0,0,0
00756188,30,0,30,0,0,0,0,0,1
00756539,6,4,2,0,3,3,0,0,0
00756619,53,0,53,0,0,0,0,0,1
00756681,52,4,48,0,1,1,0,1,1
00756745,14,4,10,0,2,2,0,0,1
00756798,62,14,48,0,0,0,0,0,1
00757372,1256,16,1240,0,0,0,0,0,1
00757539,14,4,10,0,1,1,0,1,1
00758047,6,3,3,0,2,2,0,0,0
00758924,47,0,47,0,0,0,0,0,1
00758966,35,0,35,0,0,0,0,0,1
00759111,15,9,6,0,2,1,1,1,1
00759241,4,0,4,0,1,1,0,0,0
00759327,69,14,55,0,0,0,0,0,1
00759472,12,5,7,0,1,1,0,0,0
00759557,32,11,21,0,0,0,0,0,1
00759572,26,4,22,0,1,1,0,1,1
00759657,52,6,46,0,3,1,2,3,1
00759903,21,0,21,0,1,1,0,1,1
00760475,8,2,6,0,0,0,0,0,0
00760914,24,5,19,0,1,1,0,1,1
00761149,89,0,89,0,0,0,0,0,1
00761650,9,3,6,0,1,1,0,0,1
00762087,23,3,20,0,0,0,0,0,0
00762158,32,0,32,0,0,0,0,0,1
00762949,74,3,71,0,1,1,0,1,1
00763044,32,0,32,0,5,5,0,0,1
00763253,13,0,13,0,0,0,0,0,1
00763779,33,3,30,0,0,0,0,0,1
00763836,67,12,55,0,0,0,0,0,1
00764118,7,2,5,0,1,1,0,1,0
00764727,73,7,66,0,0,0,0,0,1
00765289,23,0,23,0,0,0,0,0,1
00765370,9,0,9,0,0,0,0,0,1
00765943,17,3,14,0,1,1,0,1,1
00766067,14,4,10,0,1,1,0,1,1
00766332,30,5,25,0,0,0,0,0,1
00766441,15,0,15,0,3,3,0,1,1
00766959,36,4,32,0,1,1,0,1,1
00767573,3,3,0,0,1,1,0,0,0
00767728,20,3,17,0,1,1,0,1,1
00769811,25,0,25,0,0,0,0,0,1
00770074,14,3,11,0,2,2,0,0,1
00770086,11,4,7,0,1,1,0,0,0
00770781,9,4,5,0,3,3,0,0,0
00770891,30,12,18,0,0,0,0,0,1
00771013,14,4,10,0,1,1,0,1,1
00771335,19,8,11,0,0,0,0,0,1
00771516,19,0,19,0,0,0,0,0,1
00772318,279,5,274,0,0,0,0,0,1
00772490,8,4,4,0,3,3,0,0,1
00773009,74,19,55,0,0,0,0,0,0
00773839,34,1,33,0,1,1,0,1,1
00774062,16,0,16,0,1,1,0,1,1
00774126,6,4,2,0,1,1,0,0,1
00774336,15,4,11,0,3,3,0,1,0
00774883,11,5,6,0,1,1,0,1,0
00775598,32,8,24,0,0,0,0,0,1
00775776,5,2,3,0,1,1,0,1,0
00775890,4,3,1,0,2,2,0,0,0
00776214,12,0,12,0,0,0,0,0,1
00776338,29,0,29,0,1,1,0,1,1
00776384,40,4,36,0,1,1,0,1,1
00776582,8,2,6,0,1,1,0,1,0
00776716,3,3,0,0,2,2,0,0,0
00777186,18,4,14,1,0,0,0,0,0
00777379,3,3,0,0,2,2,0,0,0
00777509,13,6,7,0,0,0,0,0,0
00777576,7,4,3,0,2,2,0,0,0
00777705,34,0,34,0,0,0,0,0,1
00777895,45,2,43,0,1,1,0,1,1
00778293,130,13,117,0,0,0,0,0,1
00778304,8,1,7,0,1,1,0,0,0
00778398,46,4,42,0,1,1,0,1,1
00778593,22,0,22,0,0,0,0,0,1
00778753,9,6,3,0,6,6,0,0,0
00779207,18,6,12,0,1,1,0,0,1
00779528,14,4,10,0,2,2,0,0,0
00779626,12,0,12,0,0,0,0,0,1
00779670,14,3,11,0,1,1,0,1,1
00780504,30,8,22,0,0,0,0,0,0
00780630,26,7,19,0,1,1,0,1,1
00780792,3,3,0,0,0,0,0,0,0
00781024,27,14,13,0,1,1,0,1,1
00781416,21,3,18,0,0,0,0,0,1
00782017,15,0,15,0,0,0,0,0,1
00782229,42,12,30,0,0,0,0,0,0
00782546,44,6,38,0,0,0,0,0,1
00782659,4,2,2,0,1,1,0,0,0
00783226,65,9,56,0,0,0,0,0,1
00783421,8,0,8,0,0,0,0,0,0
00783757,6,5,1,0,4,4,0,0,0
00783854,34,0,34,0,0,0,0,0,1
00784555,2,2,0,0,1,1,0,0,0
00784687,27,3,24,0,2,2,0,2,1
00784919,6,5,1,0,4,3,1,1,0
00784921,16,0,16,0,0,0,0,0,1
00785032,2,2,0,0,1,1,0,0,0
00785488,44,0,44,0,0,0,0,0,0
00785646,207,7,200,0,0,0,0,0,1
00785740,34,0,34,0,2,2,0,2,1
00785951,15,3,12,0,0,0,0,0,1
00786308,6,2,4,0,1,1,0,0,0
00786343,0,0,0,0,0,0,0,0,1
00786404,8,4,4,0,2,2,0,0,1
00786819,46,4,42,0,1,1,0,1,1
00786826,39,3,36,0,1,1,0,1,1
00787389,69,10,59,0,0,0,0,0,0
00787886,55,7,48,0,0,0,0,0,0
00787905,5,0,5,0,0,0,0,0,1
00788208,18,7,11,0,0,0,0,0,1
00788617,20,5,15,0,1,1,0,1,1
00788728,19,0,19,0,0,0,0,0,1
00788778,15,5,10,0,1,1,0,1,1
00790136,26,11,15,0,0,0,0,0,1
00790619,37,3,34,0,1,1,0,1,1
00791110,14,4,10,0,1,1,0,1,1
00791165,26,5,21,0,1,1,0,1,1
00791239,12,3,9,0,1,1,0,1,1
00791766,132,2,130,0,0,0,0,0,1
00792220,3,2,1,0,1,1,0,1,0
00792568,9,3,6,0,1,1,0,1,1
00792622,13,3,10,0,1,1,0,1,1
00792822,3,3,0,0,2,2,0,1,0
00792877,31,13,18,0,1,1,0,1,1
00793345,16,2,14,0,1,1,0,1,1
00793416,21,3,18,0,1,0,1,1,1
00793447,5,2,3,0,3,3,0,0,0
00793558,63,8,55,0,0,0,0,0,1
00793639,32,0,32,0,0,0,0,0,1
00794059,8,2,6,0,2,2,0,0,1
00794272,33,9,24,0,0,0,0,0,1
00794310,38,0,38,0,0,0,0,0,1
00794821,13,5,8,0,0,0,0,0,1
00794985,10,4,6,0,3,3,0,0,0
00795076,6,4,2,0,0,0,0,0,1
00795099,7,3,4,0,1,1,0,0,1
00795346,17,3,14,0,0,0,0,0,0
00795531,34,0,34,0,0,0,0,0,1
00795957,13,0,13,0,0,0,0,0,1
00796402,9,3,6,0,3,3,0,0,0
00796740,23,3,20,0,2,1,1,2,1
00796794,65,12,53,0,0,0,0,0,1
00797142,24,0,24,0,0,0,0,0,1
00797195,13,3,10,0,1,1,0,1,0
00797437,33,5,28,0,1,1,0,0,1
00797472,3,1,2,0,2,2,0,0,0
00797495,3,3,0,0,2,2,0,0,1
00797543,24,3,21,0,1,1,0,1,1
00797598,2,0,2,0,0,0,0,0,1
00797697,6,2,4,0,3,1,2,1,0
00797757,13,3,10,0,1,1,0,1,1
00797997,69,17,52,0,23,18,5,0,1
00798460,10,3,7,0,1,1,0,1,0
00798958,26,0,26,0,1,1,0,1,1
00799179,0,0,0,0,0,0,0,0,0
00799263,23,0,23,0,1,1,0,1,1
00799297,79,12,67,0,0,0,0,0,1
00799369,51,0,51,0,0,0,0,0,1
00800311,31,5,26,0,1,1,0,1,1
00800818,31,0,31,0,0,0,0,0,1
00800819,8,0,8,0,0,0,0,0,0
00800824,7,2,5,0,1,1,0,1,0
00801261,10,0,10,0,0,0,0,0,0
00801519,19,0,19,0,0,0,0,0,1
00802315,6,2,4,0,2,2,0,0,0
00802706,11,3,8,0,1,1,0,1,0
00802848,12,3,9,0,1,1,0,1,1
00803059,6,2,4,0,2,2,0,0,0
00803241,36,0,36,0,1,1,0,1,1
00804449,7,0,7,0,0,0,0,0,1
00804555,7,0,7,0,0,0,0,0,1
00804907,25,3,22,0,1,1,0,1,1
00806462,34,0,34,0,1,1,0,1,1
00807346,43,3,40,0,1,1,0,1,1
00807834,7,5,2,0,1,1,0,1,0
00807844,14,4,10,0,1,1,0,1,1
00808245,25,0,25,0,0,0,0,0,1
00808329,34,9,25,0,0,0,0,0,1
00808709,20,8,12,0,0,0,0,0,0
00809079,30,5,25,0,1,1,0,1,1
00809134,48,11,37,0,0,0,0,0,1
00809228,11,8,3,0,1,1,0,0,0
00809632,6,2,4,0,1,1,0,0,0
00809688,10,5,5,0,3,3,0,0,1
11080032,9,8,1,0,1,1,0,1,1
11080177,1,1,0,0,0,0,0,0,0
11080234,3,2,1,0,0,0,0,0,0
11080276,2,2,0,0,2,2,0,0,0
11080968,1,1,0,0,1,1,0,0,0
11081245,2,0,2,0,1,1,0,0,0
11081368,1,0,1,0,1,1,0,1,0
11081458,2,2,0,0,2,2,0,0,1
11081522,2,2,0,0,1,1,0,0,1
11081682,4,4,0,0,0,0,0,0,0
11081893,2,2,0,0,2,2,0,0,1
11081903,2,0,2,0,2,2,0,0,0
11081964,6,6,0,0,2,2,0,0,1
11082024,1,0,1,0,1,1,0,0,0
11082027,2,2,0,0,1,1,0,1,1
11082397,1,1,0,0,1,1,0,0,0
11082748,2,2,0,0,2,2,0,0,0
11082758,1,1,0,0,0,0,0,0,1
11083369,1,1,0,0,1,1,0,0,0
11083555,3,2,1,0,1,1,0,0,0
11083875,1,0,1,0,1,1,0,0,0
11084397,4,4,0,0,1,1,0,1,1
11084430,4,4,0,0,1,1,0,1,1
11084702,1,1,0,0,1,1,0,0,0
11084743,1,1,0,0,1,1,0,0,0
11085120,1,1,0,0,1,1,0,0,0
11085178,1,1,0,0,1,1,0,0,0
11085216,1,0,1,0,1,1,0,0,0
11085651,5,5,0,0,1,1,0,1,1
11085738,2,2,0,0,2,2,0,0,0
11085746,3,3,0,0,0,0,0,0,0
11085877,1,0,1,0,1,1,0,0,0
11086105,4,4,0,1,0,0,0,0,1
11086119,4,4,0,1,0,0,0,0,1
11086339,4,4,0,1,1,1,0,1,1
11086345,4,4,0,1,1,1,0,1,1
11086436,1,1,0,0,1,1,0,0,0
11086462,4,2,2,0,1,1,0,1,0
11086873,1,1,0,0,1,1,0,0,0
11086943,1,1,0,0,1,1,0,0,0
11086957,2,1,1,0,2,1,1,0,0
11087075,3,3,0,0,2,1,1,1,1
11087170,1,1,0,0,1,1,0,0,0
11087297,2,1,1,0,2,1,1,0,0
11087370,1,1,0,0,1,1,0,0,0
11087420,1,1,0,0,1,1,0,0,0
11087628,1,1,0,0,1,1,0,0,0
11087843,1,0,1,0,1,1,0,0,0
11087872,1,0,1,0,1,1,0,0,0
11087939,1,1,0,0,1,1,0,0,0
11088301,1,1,0,0,1,1,0,0,0
11088741,2,2,0,0,1,1,0,1,1
11088780,1,1,0,0,1,1,0,0,0
11088950,4,2,2,0,4,2,2,1,1
11089024,2,2,0,0,2,2,0,0,0
11089585,14,6,8,0,0,0,0,0,0
11089900,2,2,0,0,2,2,0,0,1
11090190,1,1,0,0,0,0,0,0,0
11090286,17,13,4,0,2,0,2,0,0
11090739,8,5,3,0,0,0,0,0,1
11090861,1,1,0,0,1,1,0,0,0
11090952,1,1,0,0,1,1,0,0,1
11090953,1,1,0,0,1,1,0,0,1
11091482,2,1,1,0,1,1,0,0,0
11092545,1,1,0,0,1,1,0,0,0
11092568,10,5,5,0,2,0,2,1,0
11092596,3,0,3,0,1,1,0,0,0
11093266,2,2,0,0,2,2,0,0,0
11093336,2,0,2,0,0,0,0,0,0
11093377,1,1,0,0,1,1,0,0,0
11093502,4,4,0,0,1,1,0,1,1
11093574,2,2,0,0,2,2,0,0,0
11093663,1,1,0,0,1,1,0,0,0
11093779,1,1,0,0,1,1,0,0,0
11094017,1,1,0,0,0,0,0,0,0
11094068,1,1,0,0,0,0,0,0,0
11094515,1,0,1,0,1,1,0,0,0
11094577,1,1,0,0,0,0,0,0,0
11095408,2,2,0,0,1,1,0,0,0
11095468,1,1,0,0,0,0,0,0,0
11095955,3,3,0,0,2,2,0,0,1
11096220,1,0,1,0,1,1,0,0,0
11096421,1,1,0,0,1,1,0,0,0
11096772,2,2,0,0,1,1,0,1,0
11096926,1,1,0,0,1,1,0,0,0
11096984,4,3,1,0,1,1,0,0,1
11097438,1,1,0,0,1,1,0,0,0
11097627,1,0,1,0,1,1,0,0,0
11097677,5,5,0,0,4,2,2,3,1
11098633,1,0,1,0,0,0,0,0,0
11098688,6,3,3,0,1,1,0,1,1
11099048,1,1,0,0,1,1,0,0,0
11099179,6,4,2,0,3,2,1,1,1
11099400,2,2,0,0,2,2,0,0,1
11099521,4,2,2,0,1,1,0,1,0
11099917,7,4,3,0,2,1,1,2,1
11099988,2,2,0,0,1,1,0,1,1
11100225,4,3,1,0,2,1,1,2,1
11100325,4,4,0,0,1,1,0,1,1
11100472,4,4,0,0,1,1,0,1,1
11101056,3,3,0,0,1,1,0,0,0
11101584,3,2,1,0,1,1,0,0,1
11101864,1,1,0,0,1,1,0,0,0
11102141,2,2,0,0,2,2,0,0,1
11104018,6,5,1,0,0,0,0,0,1
11104076,5,3,2,0,2,1,1,1,1
11104111,2,2,0,0,1,1,0,1,1
11104114,3,3,0,0,2,2,0,0,1
11104403,9,8,1,0,3,3,0,0,1
11104589,1,1,0,0,1,1,0,0,1
11104604,3,3,0,0,1,1,0,0,0
11104688,1,1,0,0,1,1,0,0,0
11104728,1,1,0,0,1,1,0,0,0
11104857,1,1,0,0,1,1,0,0,0
11104867,2,2,0,0,2,2,0,0,0
11104874,3,1,2,0,3,1,2,0,0
11104904,2,2,0,0,2,2,0,0,0
11104964,3,1,2,0,3,1,2,0,0
11105089,1,1,0,0,1,1,0,0,0
11105112,4,4,0,0,0,0,0,0,0
11105210,1,1,0,0,1,1,0,0,0
11105503,4,4,0,0,0,0,0,0,0
11105583,1,0,1,0,1,1,0,0,0
11105902,5,5,0,0,1,1,0,1,0
11105910,1,0,1,0,1,1,0,0,0
11106180,2,0,2,0,1,1,0,0,0
11106516,5,0,5,0,0,0,0,0,0
11106994,1,1,0,0,1,1,0,0,1
11107110,1,1,0,0,1,1,0,0,0
11107131,1,1,0,0,1,1,0,0,0
11107183,1,1,0,0,1,1,0,0,0
11107343,1,1,0,0,1,1,0,0,0
11108172,7,3,4,0,1,1,0,0,1
11108180,4,3,1,0,0,0,0,0,1
11108260,2,2,0,0,3,2,1,1,1
11108303,3,3,0,0,1,1,0,1,0
11108512,3,2,1,0,2,1,1,0,0
11108658,2,2,0,0,4,4,0,1,0
11108804,8,8,0,0,0,0,0,0,0
11109075,2,2,0,0,1,1,0,0,0
11109183,2,2,0,0,1,1,0,0,0
11109198,2,2,0,0,1,1,0,0,0
11109623,8,8,0,0,0,0,0,0,0
11109661,1,1,0,0,1,1,0,0,0
11109770,1,1,0,0,1,1,0,0,0
11109878,2,2,0,0,1,1,0,0,0
11109896,2,2,0,0,2,2,0,0,0
11110705,7,3,4,0,1,1,0,0,1
11110976,1,0,1,0,1,1,0,0,0
11111232,2,2,0,0,1,1,0,0,1
11111323,3,0,3,0,1,1,0,1,1
11111676,1,0,1,0,1,1,0,0,0
11111772,3,2,1,0,1,1,0,1,0
11111912,8,5,3,0,2,1,1,2,1
11112021,1,1,0,0,1,1,0,0,0
11112048,6,2,4,0,2,1,1,2,0
11112272,2,2,0,0,1,1,0,1,1
11112754,1,1,0,0,1,1,0,0,0
11112823,1,1,0,0,2,2,0,1,0
11112857,4,2,2,0,3,2,1,1,1
11112924,2,2,0,0,2,2,0,0,0
11112969,1,1,0,0,1,1,0,0,0
11113030,1,1,0,0,1,1,0,0,0
11113201,2,2,0,0,2,2,0,0,0
11113214,1,1,0,0,1,1,0,1,0
11113327,5,3,2,0,3,2,1,2,1
11113377,1,1,0,0,1,1,0,0,0
11113470,3,0,3,0,1,1,0,1,1
11113704,3,0,3,0,1,1,0,1,1
11113963,1,1,0,0,1,1,0,0,0
11114077,7,6,1,0,1,0,1,1,1
11114086,1,1,0,0,1,1,0,0,0
11114194,2,2,0,0,2,2,0,0,0
11114276,2,2,0,0,0,0,0,0,0
11115107,4,3,1,0,1,1,0,0,1
11115134,3,3,0,0,3,3,0,0,0
11115453,1,1,0,0,1,1,0,0,0
11115497,3,3,0,0,2,2,0,0,0
11115546,4,3,1,0,1,1,0,0,1
11115671,2,2,0,0,2,2,0,0,0
11115986,6,4,2,0,0,0,0,0,1
11116029,1,0,1,0,0,0,0,0,0
11116121,1,1,0,0,1,1,0,0,0
11116196,2,1,1,0,2,1,1,0,0
11116395,1,1,0,0,2,1,1,0,0
11116668,2,1,1,0,1,1,0,1,0
11116670,1,1,0,0,1,1,0,0,0
11116788,1,1,0,0,1,1,0,0,0
11117463,2,0,2,0,2,2,0,0,0
11117740,1,0,1,0,1,1,0,0,0
11118155,3,0,3,0,1,1,0,1,1
11118162,5,5,0,0,3,2,1,3,1
11118547,4,1,3,0,4,1,3,0,0
11118591,2,2,0,0,0,0,0,0,1
11118665,1,1,0,0,1,1,0,0,0
11118680,2,2,0,0,2,2,0,0,0
11118708,3,3,0,0,1,1,0,1,1
11118810,1,1,0,0,1,1,0,0,0
11118888,1,1,0,0,1,1,0,0,0
11118935,3,0,3,0,2,2,0,0,0
11119032,2,2,0,0,0,0,0,0,0
11119079,2,2,0,0,0,0,0,0,1
11119098,2,2,0,0,0,0,0,0,1
11119176,1,1,0,0,1,1,0,0,1
11119283,2,0,2,0,1,1,0,0,0
11119471,1,1,0,0,1,1,0,0,0
11119514,3,0,3,0,1,1,0,1,1
11119667,2,0,2,0,1,0,1,0,1
11119757,1,1,0,0,1,1,0,0,0
11120119,1,1,0,0,1,1,0,0,0
11120237,2,2,0,0,1,1,0,0,0
11120393,2,1,1,0,2,1,1,0,0
11120418,1,1,0,0,1,1,0,0,0
11120860,2,2,0,0,1,1,0,0,1
11120869,2,2,0,0,1,1,0,0,1
11121371,1,1,0,0,1,1,0,0,1
11121461,2,0,2,0,2,2,0,0,0
11121484,3,3,0,0,3,3,0,0,0
11121739,3,1,2,0,2,1,1,0,1
11122095,2,2,0,0,2,2,0,0,0
11122633,1,1,0,0,1,1,0,0,0
11122780,2,2,0,0,1,1,0,0,0
11122816,4,4,0,0,0,0,0,0,1
11122936,1,0,1,0,0,0,0,0,0
11123207,2,0,2,0,2,1,1,0,0
11123698,1,1,0,0,1,1,0,0,1
11123700,4,0,4,0,0,0,0,0,0
11124118,1,1,0,0,1,1,0,0,0
11124746,1,1,0,0,1,1,0,0,1
11124815,2,2,0,0,1,1,0,0,0
11125570,1,0,1,0,1,1,0,0,0
11125703,2,1,1,0,2,1,1,1,0
11126747,0,0,0,0,1,1,0,0,0
11127086,4,2,2,0,0,0,0,0,0
11127444,1,1,0,0,1,1,0,0,0
11128484,1,1,0,0,1,1,0,0,0
11128551,1,1,0,0,1,1,0,0,0
11128574,1,1,0,0,1,1,0,0,0
11128742,1,1,0,0,1,1,0,1,0
11128816,2,2,0,0,1,1,0,1,0
11128968,4,3,1,0,2,1,1,0,0
11129726,1,1,0,0,1,1,0,0,0
11131375,3,3,0,0,0,0,0,0,0
11131425,5,3,2,0,1,1,0,0,0
11131466,1,1,0,0,0,0,0,0,0
11131682,1,1,0,0,1,1,0,0,0
11131908,1,1,0,0,0,0,0,0,0
11131948,2,2,0,0,1,1,0,0,0
11132160,1,1,0,0,1,1,0,0,0
11132594,4,4,0,0,3,2,1,2,1
11132803,1,1,0,0,1,1,0,0,0
11134055,2,1,1,0,0,0,0,0,0
11134167,2,2,0,0,2,2,0,0,0
11134185,4,0,4,0,4,3,1,1,0
11134210,7,6,1,0,1,1,0,1,1
11134420,1,1,0,0,1,1,0,0,0
11134829,2,2,0,0,2,2,0,0,0
11135424,1,1,0,0,1,1,0,0,0
11135652,1,1,0,0,1,1,0,0,0
11135972,2,1,1,0,1,1,0,0,0
11135989,2,0,2,0,1,1,0,0,0
11136109,6,3,3,0,0,0,0,0,1
11136491,1,1,0,0,0,0,0,0,0
11136835,1,1,0,0,1,1,0,0,1
11137105,1,1,0,0,2,2,0,0,0
11137165,1,1,0,0,1,1,0,0,0
11137215,1,1,0,0,1,1,0,0,0
11137275,2,2,0,0,1,1,0,0,1
11137534,5,5,0,0,1,1,0,1,0
11137739,1,1,0,0,1,0,1,0,0
11137816,1,1,0,0,1,1,0,0,0
11138075,2,2,0,0,2,2,0,0,0
11138329,1,0,1,0,2,2,0,0,0
11138423,1,1,0,0,1,1,0,1,0
11139351,4,4,0,0,3,3,0,0,1
11139437,1,1,0,0,1,1,0,0,0
11139624,1,1,0,0,2,2,0,0,0
11140621,2,2,0,0,1,1,0,0,0
11140641,2,2,0,0,1,1,0,0,0
11141076,1,1,0,0,1,1,0,0,0
11141928,1,1,0,0,1,1,0,0,0
11142014,1,1,0,0,1,1,0,0,0
11142173,3,3,0,0,3,3,0,0,1
11142180,2,2,0,0,2,2,0,0,0
11142487,3,3,0,0,0,0,0,0,0
11143187,1,1,0,0,0,0,0,0,0
11143312,8,4,4,0,4,3,1,2,1
11143328,6,2,4,0,2,0,2,1,1
11143343,2,2,0,0,1,1,0,0,0
11143603,3,3,0,0,1,1,0,0,0
11143718,1,1,0,0,1,1,0,0,0
11143828,1,1,0,0,1,1,0,0,0
11143859,1,1,0,0,1,1,0,0,0
11143981,1,1,0,0,1,1,0,1,0
11144071,1,1,0,0,1,1,0,0,0
11144227,1,0,1,0,1,1,0,0,1
11144238,7,4,3,0,4,3,1,0,1
11144307,2,2,0,0,0,0,0,0,0
11144350,1,1,0,0,1,1,0,0,0
11144704,1,1,0,0,1,1,0,0,0
11145179,2,2,0,0,1,1,0,0,0
11145188,2,2,0,0,2,2,0,0,1
11145234,3,2,1,0,2,2,0,2,1
11145315,3,3,0,0,1,1,0,1,0
11145427,1,1,0,0,1,1,0,0,0
11145740,2,1,1,0,1,1,0,0,0
11145797,10,10,0,0,1,0,1,0,0
11146172,1,1,0,0,1,1,0,0,0
11146203,2,2,0,0,2,2,0,0,0
11146490,1,1,0,0,1,1,0,0,0
11146878,1,1,0,0,0,0,0,0,0
11146919,1,1,0,0,1,1,0,0,0
11146984,1,1,0,0,0,0,0,0,0
11147353,2,2,0,0,1,1,0,1,1
11147483,2,2,0,0,1,1,0,1,1
11147762,1,0,1,0,1,1,0,0,0
11148014,2,1,1,0,1,1,0,0,0
11148043,4,3,1,0,2,2,0,1,0
11148203,1,1,0,0,1,1,0,0,0
11148343,2,2,0,0,2,2,0,0,0
11148552,1,1,0,0,1,1,0,0,0
11148610,5,5,0,0,3,3,0,2,1
11148724,1,1,0,0,1,1,0,0,0
11148993,10,10,0,0,2,2,0,2,1
11149001,3,1,2,0,3,1,2,0,0
11149085,3,3,0,0,0,0,0,0,1
11149289,3,3,0,0,3,3,0,0,0
11149480,1,1,0,0,1,1,0,0,0
11149762,1,1,0,0,1,1,0,0,0
11149817,2,2,0,0,2,2,0,0,0
11150703,4,3,1,0,1,1,0,1,1
11150784,3,2,1,0,1,1,0,1,1
11150972,2,1,1,0,1,1,0,0,0
11151108,7,6,1,0,0,0,0,0,0
11151301,3,1,2,0,3,1,2,0,0
11151329,2,2,0,0,2,2,0,0,0
11151459,9,9,0,0,0,0,0,0,1
11151713,5,4,1,0,2,2,0,0,1
11151726,2,2,0,0,2,2,0,0,0
11151745,3,2,1,0,1,1,0,0,0
11151879,1,1,0,0,1,1,0,0,0
11151881,1,1,0,0,1,1,0,0,0
11151893,1,1,0,0,1,1,0,0,0
11151904,1,1,0,0,0,0,0,0,0
11152011,1,1,0,0,1,1,0,0,0
11152423,3,1,2,0,2,1,1,0,0
11152618,1,1,0,0,1,1,0,0,0
11153107,1,1,0,0,0,0,0,0,0
11153134,2,1,1,0,2,1,1,0,0
11153473,1,1,0,0,1,1,0,0,0
11153586,1,1,0,0,3,2,1,2,1
11153621,1,1,0,0,1,1,0,0,0
11153626,3,3,0,0,2,2,0,0,0
11153631,3,3,0,0,1,1,0,1,0
11153865,1,1,0,0,1,1,0,0,0
11153975,2,2,0,0,1,1,0,1,1
11154211,2,2,0,0,2,2,0,0,1
11154415,4,4,0,0,2,1,1,0,1
11154912,1,1,0,0,1,1,0,0,0
11155126,3,3,0,0,3,3,0,0,0
11155381,2,2,0,0,1,1,0,0,0
11155798,1,1,0,0,1,1,0,0,0
11155806,2,2,0,0,1,1,0,0,0
11156077,4,2,2,0,1,1,0,1,0
11156391,2,2,0,0,2,2,0,0,1
11156732,2,2,0,0,1,1,0,0,0
11158839,4,4,0,0,1,1,0,1,0
11159085,1,1,0,0,1,1,0,0,0
11159135,1,1,0,0,1,1,0,0,0
11159174,1,1,0,0,1,1,0,0,0
05690245,16,3,13,0,1,1,0,1,1
05691238,3,2,1,0,1,1,0,0,1
05691679,15,3,12,0,0,0,0,0,1
05691766,9,5,4,0,1,1,0,1,1
05692034,17,7,10,0,0,0,0,0,0
05692180,4,2,2,0,2,2,0,0,1
05692427,23,7,16,0,0,0,0,0,1
05692762,3,3,0,0,2,2,0,0,1
05693055,9,4,5,0,1,1,0,1,1
05693091,11,4,7,0,1,1,0,1,1
05693101,13,6,7,0,0,0,0,0,1
05693127,11,4,7,0,1,1,0,1,1
05693397,9,7,2,0,1,1,0,0,0
05693575,16,5,11,0,1,0,1,0,1
05693583,5,3,2,0,1,1,0,0,0
05693745,8,0,8,0,0,0,0,0,1
05693850,22,0,22,0,0,0,0,0,1
05694592,10,2,8,0,1,1,0,1,1
05694721,32,11,21,0,0,0,0,0,1
05695017,10,2,8,0,1,1,0,1,1
05695035,3,1,2,0,1,1,0,0,0
05695702,8,4,4,0,3,3,0,0,0
05695889,13,0,13,0,0,0,0,0,1
05697251,35,6,29,0,0,0,0,0,1
05697708,34,0,34,0,0,0,0,0,1
05697961,4,2,2,0,2,2,0,0,0
05698154,8,0,8,0,0,0,0,0,1
05698169,16,3,13,0,1,1,0,1,1
05698316,9,3,6,0,1,1,0,1,1
05698334,23,1,22,0,1,1,0,1,1
05699285,10,3,7,0,2,2,0,0,1
05699438,3,0,3,0,1,1,0,1,1
05699770,4,0,4,0,0,0,0,0,1
05700276,11,0,11,0,2,1,1,0,0
05700562,6,3,3,0,1,1,0,0,1
05700746,19,4,15,0,1,1,0,1,1
05700958,8,1,7,0,1,1,0,1,1
05701014,6,3,3,0,0,0,0,0,1
05701021,18,6,12,0,1,1,0,1,1
05701029,4,2,2,0,1,1,0,0,0
05701261,7,0,7,0,0,0,0,0,1
05701337,2,0,2,0,0,0,0,0,1
05701552,9,2,7,0,1,1,0,1,1
05701579,7,3,4,0,1,1,0,1,1
05701790,25,13,12,0,1,1,0,1,1
05701911,8,3,5,0,1,1,0,0,1
05701918,21,3,18,0,1,1,0,1,1
05701921,21,3,18,0,1,1,0,1,1
05701930,8,1,7,0,1,1,0,0,1
05702041,4,2,2,0,1,1,0,0,0
05702423,2,2,0,0,1,1,0,0,1
05702597,4,4,0,0,1,1,0,1,0
05702920,4,0,4,0,0,0,0,0,1
05703062,6,0,6,0,0,0,0,0,1
05703322,3,2,1,0,1,1,0,0,0
05703376,3,1,2,0,1,1,0,0,0
05703544,3,0,3,0,0,0,0,0,1
05704258,10,0,10,0,0,0,0,0,1
05704295,7,1,6,0,1,1,0,0,1
05704457,9,5,4,0,2,2,0,0,0
05704687,7,0,7,0,0,0,0,0,1
05705332,4,0,4,0,1,1,0,0,1
05705432,6,0,6,0,1,1,0,0,1
05705887,9,2,7,1,2,2,0,1,1
05706449,19,3,16,0,1,1,0,1,1
05706456,9,0,9,0,0,0,0,0,1
05706702,4,1,3,0,1,1,0,0,0
05706715,19,8,11,0,0,0,0,0,1
05706720,37,13,24,0,1,1,0,1,1
05706814,8,4,4,0,2,2,0,0,1
05707123,12,5,7,0,5,5,0,1,1
05707124,12,5,7,0,5,5,0,1,1
05707180,19,2,17,0,1,1,0,1,1
05707410,14,2,12,0,2,1,1,1,1
05708093,30,5,25,0,1,1,0,0,0
05708176,3,2,1,0,2,2,0,0,0
05708275,7,2,5,0,1,1,0,0,0
05708283,4,4,0,0,1,1,0,0,1
05708712,6,0,6,0,0,0,0,0,1
05708871,54,13,41,0,0,0,0,0,1
05708933,5,0,5,0,0,0,0,0,1
05709019,6,2,4,0,1,1,0,1,1
05709353,9,0,9,0,0,0,0,0,1
05709704,4,1,3,0,1,1,0,0,0
05709792,15,3,12,0,3,1,2,3,1
05710001,24,7,17,0,0,0,0,0,0
05710073,4,2,2,0,1,1,0,0,1
05710239,8,5,3,0,1,1,0,0,1
05710240,3,1,2,0,1,1,0,0,0
05710332,5,2,3,0,1,1,0,1,1
05710339,5,3,2,0,2,2,0,2,1
05710396,8,3,5,0,2,2,0,0,1
05710523,11,0,11,0,0,0,0,0,1
05710575,3,0,3,0,0,0,0,0,1
05710765,6,3,3,0,1,1,0,0,0
05710969,4,0,4,0,0,0,0,0,1
05711489,3,2,1,0,2,2,0,0,0
05711803,12,7,5,0,0,0,0,0,0
05711851,14,5,9,0,0,0,0,0,1
05712078,6,3,3,0,2,2,0,0,0
05712156,9,0,9,1,0,0,0,0,1
05712174,7,2,5,0,2,2,0,1,0
05712610,14,7,7,0,0,0,0,0,1
05712825,17,7,10,0,0,0,0,0,1
05713403,42,12,30,0,0,0,0,0,1
05713487,3,3,0,0,1,1,0,0,0
05713959,16,7,9,0,0,0,0,0,1
05714376,4,0,4,0,0,0,0,0,1
05714545,9,6,3,0,5,5,0,0,0
05714756,2,2,0,0,1,1,0,0,0
05715119,8,3,5,0,0,0,0,0,0
05715200,9,3,6,0,2,2,0,0,0
05715312,4,2,2,0,1,1,0,0,0
05715575,13,4,9,0,1,1,0,0,1
05715888,6,2,4,0,1,1,0,1,1
05716016,7,0,7,0,0,0,0,0,1
05716113,4,1,3,0,1,1,0,0,1
05716175,5,3,2,0,1,1,0,0,1
05716199,8,1,7,0,2,1,1,0,1
05716536,20,3,17,0,1,1,0,1,1
05716730,4,0,4,0,0,0,0,0,1
05716804,7,3,4,0,2,1,1,1,1
05716909,5,3,2,0,2,2,0,0,0
05716995,5,0,5,0,0,0,0,0,0
05717056,3,3,0,0,2,2,0,0,1
05717108,2,1,1,0,1,1,0,0,0
05717476,22,7,15,0,1,1,0,0,0
05717973,4,2,2,0,2,2,0,0,1
05718033,5,0,5,0,0,0,0,0,1
05718176,22,4,18,0,0,0,0,0,1
05718419,7,4,3,0,1,1,0,0,1
05718474,3,3,0,0,2,2,0,0,0
05718668,7,3,4,0,1,1,0,0,0
05719163,2,1,1,0,1,1,0,0,0
05719402,2,0,2,0,0,0,0,0,1
05719479,15,4,11,0,0,0,0,0,1
05720319,5,0,5,0,1,1,0,0,0
05720682,6,1,5,0,1,1,0,0,1
05720712,3,2,1,0,0,0,0,0,1
05720803,24,0,24,0,1,1,0,1,1
05720957,7,3,4,0,1,1,0,0,0
05721066,2,1,1,0,1,1,0,0,0
05721395,4,2,2,0,1,1,0,0,0
05721591,4,0,4,0,0,0,0,0,1
05721592,4,0,4,0,0,0,0,0,1
05721821,7,2,5,0,1,1,0,0,1
05721832,7,1,6,0,1,1,0,0,0
05722050,5,2,3,0,1,1,0,0,0
05722136,4,1,3,0,2,2,0,0,1
05722435,21,7,14,0,1,1,0,1,1
05722771,11,0,11,0,0,0,0,0,1
05722879,4,2,2,0,1,1,0,0,0
05722926,8,2,6,0,2,2,0,0,1
05722976,8,5,3,0,1,1,0,1,1
05723743,22,7,15,0,2,1,1,1,1
05723903,17,0,17,0,1,1,0,1,1
05724116,16,6,10,0,0,0,0,0,1
05724233,16,6,10,0,0,0,0,0,1
05724284,22,8,14,0,2,1,1,2,1
05724660,45,13,32,0,0,0,0,0,1
05724929,2,1,1,0,1,1,0,0,0
05724972,24,4,20,0,0,0,0,0,1
05724979,27,3,24,0,1,1,0,1,1
05724982,9,3,6,0,1,1,0,1,1
05725569,9,4,5,0,1,1,0,0,1
05726006,10,0,10,0,0,0,0,0,1
05726059,12,2,10,0,1,1,0,0,0
05726148,8,3,5,0,1,1,0,1,1
05726694,5,0,5,0,0,0,0,0,1
05726913,11,3,8,0,1,1,0,1,1
05727121,2,2,0,0,1,1,0,0,0
05727238,5,3,2,0,2,2,0,0,0
05728008,10,7,3,0,0,0,0,0,1
05728105,22,0,22,0,0,0,0,0,1
05728110,22,4,18,0,1,1,0,1,1
05728116,15,6,9,0,0,0,0,0,1
05728436,28,4,24,0,1,1,0,1,1
05728439,26,4,22,0,1,1,0,1,1
05728558,4,0,4,0,0,0,0,0,1
05728641,17,4,13,0,1,1,0,1,1
05729028,25,9,16,0,0,0,0,0,0
05729112,3,3,0,0,1,1,0,0,0
05729301,4,0,4,0,1,1,0,0,0
05730606,10,0,10,0,0,0,0,0,1
05730661,19,4,15,0,1,1,0,1,1
05730980,10,2,8,0,2,1,1,2,1
05731084,1,1,0,0,0,0,0,0,0
05731116,8,5,3,0,0,0,0,0,0
05731255,32,13,19,0,10,2,8,0,1
05731397,7,1,6,0,1,0,1,0,1
05731494,15,4,11,0,1,1,0,1,0
05731596,12,4,8,0,1,1,0,1,0
05732339,7,5,2,0,0,0,0,0,0
05732482,5,4,1,0,1,1,0,0,0
05732508,6,3,3,0,1,1,0,0,0
05732517,6,3,3,0,1,1,0,0,0
05732526,12,4,8,0,1,1,0,1,0
05732627,5,5,0,0,0,0,0,0,0
05732682,6,4,2,0,2,2,0,0,1
05733055,4,3,1,0,2,2,0,0,1
05733098,12,5,7,0,2,1,1,2,1
05733182,6,4,2,0,1,1,0,0,1
05733281,11,8,3,0,1,1,0,0,1
05733287,14,2,12,0,2,1,1,2,1
05733761,7,3,4,0,1,1,0,1,1
05734515,13,2,11,0,1,1,0,1,1
05735151,5,0,5,0,0,0,0,0,1
05735294,15,5,10,0,1,1,0,1,1
05735309,8,0,8,0,0,0,0,0,1
05735485,5,2,3,0,1,1,0,0,1
05735565,6,3,3,0,1,1,0,0,0
05735787,5,3,2,0,2,2,0,0,0
05735872,4,2,2,0,1,1,0,0,0
05735923,17,5,12,0,1,1,0,1,1
05735959,14,5,9,0,1,1,0,1,1
05736092,15,4,11,0,1,1,0,1,1
05736318,3,1,2,0,1,1,0,0,0
05736364,14,2,12,1,2,2,0,0,1
05736621,9,5,4,0,1,1,0,0,1
05736693,4,1,3,0,0,0,0,0,0
05736904,10,2,8,0,0,0,0,0,0
05737016,12,5,7,0,0,0,0,0,0
05737166,29,3,26,0,1,1,0,1,1
05737261,12,6,6,0,0,0,0,0,0
05737659,13,5,8,0,1,1,0,1,1
05737715,7,2,5,0,2,2,0,0,1
05737749,33,5,28,0,2,2,0,2,1
05737779,12,0,12,0,0,0,0,0,1
05738223,3,3,0,0,2,2,0,0,1
05738353,16,3,13,0,1,1,0,0,1
05738735,14,3,11,0,1,1,0,1,1
05739102,8,0,8,1,1,1,0,0,1
05739258,7,2,5,0,0,0,0,0,1
05739565,5,1,4,0,1,1,0,0,0
05739893,4,0,4,0,0,0,0,0,0
05740177,14,3,11,0,2,1,1,1,0
05740182,4,1,3,0,1,1,0,0,0
05740226,27,0,27,0,0,0,0,0,1
05740313,13,5,8,0,2,2,0,2,1
05740361,13,5,8,0,1,1,0,1,1
05740449,31,2,29,0,1,1,0,1,1
05740526,5,3,2,0,0,0,0,0,0
05740791,11,2,9,0,1,1,0,1,0
05740847,10,1,9,0,0,0,0,0,1
05740858,6,3,3,0,1,1,0,0,1
05740870,7,3,4,0,0,0,0,0,1
05740944,13,0,13,0,0,0,0,0,0
05741011,9,0,9,0,0,0,0,0,1
05741012,16,1,15,0,1,1,0,0,1
05741034,14,0,14,0,0,0,0,0,1
05741128,4,2,2,0,1,1,0,0,1
05741145,25,4,21,0,0,0,0,0,0
05741174,5,3,2,0,2,2,0,0,0
05741496,19,4,15,0,0,0,0,0,1
05741514,11,1,10,0,2,2,0,0,1
05741777,3,0,3,0,0,0,0,0,1
05741852,5,0,5,0,2,2,0,0,1
05741880,6,2,4,0,1,1,0,1,1
05741955,8,2,6,0,1,1,0,1,1
05742011,6,0,6,0,0,0,0,0,1
05742076,11,3,8,0,1,1,0,1,1
05742087,7,2,5,0,2,2,0,0,0
05742319,29,9,20,0,0,0,0,0,0
05742840,41,13,28,0,1,1,0,0,1
05742866,12,0,12,0,0,0,0,0,1
05742998,4,2,2,0,1,1,0,0,0
05743338,3,3,0,0,2,2,0,0,0
05743364,5,3,2,0,2,2,0,0,1
05743550,6,5,1,0,1,1,0,0,0
05743626,4,0,4,0,0,0,0,0,1
05743773,7,0,7,0,0,0,0,0,1
05743805,18,2,16,0,0,0,0,0,1
05744177,4,0,4,0,0,0,0,0,1
05744419,2,2,0,0,1,1,0,0,0
05744511,12,1,11,0,1,1,0,1,1
05744593,19,2,17,0,1,1,0,1,1
05744856,3,1,2,0,1,1,0,0,1
05744857,4,2,2,0,1,1,0,0,1
05744864,3,1,2,0,1,1,0,0,1
05745174,5,3,2,0,1,1,0,0,0
05745175,12,0,12,0,0,0,0,0,1
05745458,8,2,6,0,0,0,0,0,0
05745526,22,3,19,0,1,1,0,1,1
05745527,11,3,8,0,1,1,0,1,1
05745877,5,1,4,0,2,1,1,0,0
05746189,4,2,2,0,1,1,0,0,0
05746358,4,2,2,0,1,1,0,0,0
05746491,6,2,4,0,1,1,0,0,0
05746601,3,0,3,0,0,0,0,0,1
05747124,15,6,9,0,0,0,0,0,1
05747512,19,3,16,0,0,0,0,0,1
05748303,6,3,3,0,1,1,0,0,1
05748613,3,2,1,0,1,1,0,0,0
05749342,3,0,3,0,0,0,0,0,1
05749662,13,4,9,0,1,1,0,0,0
05750102,5,3,2,0,2,1,1,1,1
05750418,17,5,12,1,1,0,1,1,1
05750840,38,8,30,0,0,0,0,0,1
05750941,8,0,8,0,1,1,0,1,1
05750957,4,0,4,0,0,0,0,0,1
05751113,6,2,4,0,1,1,0,1,1
05751230,9,5,4,0,0,0,0,0,1
05751473,13,9,4,0,0,0,0,0,1
05751540,47,16,31,0,0,0,0,0,1
05751804,7,5,2,0,3,1,2,1,0
05751857,8,0,8,0,0,0,0,0,1
05751932,4,1,3,0,0,0,0,0,1
05751974,7,5,2,0,1,1,0,0,0
05752217,13,6,7,0,1,1,0,1,1
05752350,3,3,0,0,2,2,0,0,0
05752533,16,4,12,0,1,0,1,0,0
05752886,11,0,11,0,1,1,0,1,1
05752896,6,0,6,0,0,0,0,0,1
05752898,5,0,5,0,0,0,0,0,1
05754077,8,3,5,0,1,0,1,0,0
05754570,8,5,3,0,3,2,1,0,0
05754890,6,0,6,0,0,0,0,0,1
05754977,4,2,2,0,0,0,0,0,0
05755135,5,1,4,0,0,0,0,0,1
05755331,7,2,5,0,2,1,1,1,0
05755341,14,6,8,0,1,1,0,0,1
05755417,3,3,0,0,2,2,0,0,1
05755637,4,3,1,0,2,2,0,0,0
05755788,9,7,2,0,0,0,0,0,0
05755836,3,1,2,0,1,1,0,0,0
05756087,10,2,8,0,1,1,0,1,1
05756183,15,7,8,0,1,1,0,1,1
05756258,6,2,4,0,1,1,0,0,0
05756266,14,4,10,0,1,1,0,1,1
05756295,5,3,2,0,2,2,0,0,1
05757208,66,26,40,0,1,1,0,1,1
05757422,16,4,12,0,1,1,0,1,1
05757423,12,4,8,0,1,1,0,1,0
05757471,5,4,1,0,1,1,0,1,1
05757493,11,6,5,0,0,0,0,0,1
05757621,42,13,29,0,0,0,0,0,0
05757679,6,1,5,0,1,1,0,0,0
05757852,6,3,3,0,2,2,0,0,0
05758223,25,5,20,0,0,0,0,0,0
05758421,3,3,0,0,0,0,0,0,0
05758431,7,1,6,0,2,2,0,1,0
05758908,15,5,10,0,1,1,0,1,1
05758967,3,2,1,0,1,1,0,0,1
05759401,20,3,17,0,1,1,0,1,1
05759409,10,0,10,0,0,0,0,0,1
05759848,19,0,19,0,0,0,0,0,1
05760228,3,2,1,0,1,1,0,0,0
05760282,5,4,1,0,1,1,0,0,0
05760300,8,2,6,0,2,2,0,0,0
05760664,4,0,4,0,0,0,0,0,1
05760804,5,3,2,0,1,1,0,0,1
05760865,9,2,7,0,1,1,0,0,1
05761174,23,7,16,0,0,0,0,0,1
05761329,7,3,4,0,1,1,0,1,1
05762028,4,1,3,0,1,1,0,0,0
05762302,25,0,25,0,0,0,0,0,1
05762557,9,0,9,0,0,0,0,0,1
05762618,4,1,3,0,2,2,0,0,1
05763037,8,2,6,0,1,1,0,1,1
05763509,25,7,18,0,0,0,0,0,1
SC070173,10,0,10,0,2,1,1,1,1
SC070220,22,0,22,0,0,0,0,0,1
SC070286,24,6,18,0,1,1,0,1,1
SC070332,35,6,29,0,1,1,0,1,1
SC070429,43,3,40,0,3,2,1,2,1
SC070511,9,4,5,0,0,0,0,0,0
SC070568,31,0,31,0,0,0,0,0,1
SC070606,9,3,6,1,2,2,0,0,1
SC071059,5,2,3,0,1,1,0,0,1
SC071485,74,4,70,0,1,1,0,1,1
SC071689,22,0,22,0,0,0,0,0,1
SC071763,16,4,12,1,1,1,0,1,1
SC071830,9,7,2,0,1,1,0,0,1
SC071934,16,3,13,0,1,1,0,1,1
SC072014,45,3,42,0,1,1,0,1,1
SC072316,18,0,18,0,1,1,0,1,1
SC072348,7,5,2,0,0,0,0,0,0
SC072422,98,39,59,1,0,0,0,0,1
SC072717,38,6,32,0,1,1,0,1,1
SC072819,5,0,5,0,1,1,0,0,1
SC072907,10,3,7,0,1,1,0,1,1
SC073119,58,8,50,0,2,2,0,0,1
SC073158,56,3,53,0,1,1,0,1,1
SC073209,38,0,38,0,0,0,0,0,0
SC073230,20,0,20,0,0,0,0,0,1
SC073356,44,8,36,0,1,1,0,1,1
SC073508,76,9,67,0,1,1,0,1,1
SC073512,6,0,6,0,0,0,0,0,1
SC073606,7,3,4,0,1,1,0,0,0
SC073966,36,0,36,0,0,0,0,0,1
SC073994,36,5,31,0,1,1,0,1,1
SC073998,55,3,52,0,2,1,1,2,1
SC074005,37,0,37,0,0,0,0,0,1
SC074212,9,5,4,0,2,1,1,2,1
SC074261,4,3,1,0,1,1,0,0,1
SC074264,101,12,89,0,0,0,0,0,1
SC074361,33,2,31,0,1,1,0,0,0
SC074384,23,0,23,0,0,0,0,0,1
SC074446,11,4,7,1,1,1,0,1,1
SC074992,13,2,11,0,1,1,0,1,0
SC074997,8,3,5,0,2,2,0,0,1
SC075047,55,5,50,0,1,1,0,1,1
SC075079,96,10,86,0,1,0,1,0,1
SC075133,48,7,41,0,1,1,0,1,1
SC075411,26,3,23,0,1,1,0,1,1
SC075514,16,0,16,0,0,0,0,0,1
SC075596,7,2,5,0,1,1,0,0,0
SC075638,12,3,9,0,1,1,0,1,1
SC075790,11,1,10,0,2,1,1,1,1
SC075805,40,10,30,0,1,1,0,0,0
SC075898,8,3,5,0,2,2,0,0,1
SC075913,39,5,34,0,1,1,0,1,1
SC075947,67,12,55,0,0,0,0,0,1
SC075954,18,6,12,1,0,0,0,0,1
SC076037,56,7,49,0,9,6,3,0,1
SC076094,6,3,3,0,3,3,0,0,0
SC076285,25,0,25,0,0,0,0,0,1
SC076501,40,2,38,0,1,1,0,1,1
SC076552,10,7,3,0,1,1,0,0,1
SC076832,4,0,4,0,0,0,0,0,0
SC077025,5,2,3,0,2,2,0,0,0
SC077052,33,0,33,0,1,1,0,1,1
SC077088,4,4,0,0,1,1,0,1,1
SC077200,14,5,9,0,3,3,0,0,1
SC077276,17,1,16,0,1,1,0,1,1
SC077475,45,10,35,0,0,0,0,0,1
SC077741,35,0,35,0,0,0,0,0,1
SC077750,68,8,60,0,1,1,0,1,1
SC077859,12,4,8,0,1,1,0,0,0
SC078039,167,49,118,0,2,1,1,2,1
SC078040,168,49,119,0,2,1,1,2,1
SC078057,38,3,35,0,1,1,0,1,1
SC078083,4,0,4,0,1,1,0,0,1
SC078098,7,3,4,0,1,1,0,0,0
SC078155,21,0,21,0,2,2,0,1,1
SC078423,19,4,15,0,1,1,0,0,1
SC078478,12,2,10,0,1,1,0,0,1
SC078678,15,4,11,0,1,1,0,1,0
SC078814,19,0,19,0,0,0,0,0,1
SC079157,12,0,12,0,1,1,0,1,1
SC079393,8,1,7,0,4,1,3,1,1
SC079500,5,4,1,0,1,1,0,0,1
SC079520,40,8,32,0,0,0,0,0,1
SC079593,6,5,1,0,2,2,0,0,0
SC079672,24,4,20,0,0,0,0,0,1
SC079721,80,10,70,0,0,0,0,0,1
SC079739,25,4,21,0,1,1,0,1,1
SC079777,75,0,75,0,0,0,0,0,1
SC079865,19,0,19,1,1,1,0,1,1
SC079988,9,5,4,0,1,1,0,0,0
SC080127,44,0,44,0,0,0,0,0,1
SC080209,11,8,3,0,0,0,0,0,0
SC080257,9,1,8,0,1,1,0,0,1
SC080355,171,3,168,0,1,1,0,1,1
SC080506,17,5,12,0,1,1,0,0,0
SC080572,4,1,3,1,1,1,0,0,1
SC080622,8,0,8,0,0,0,0,0,1
SC080641,4,3,1,0,2,2,0,0,1
SC080649,4,1,3,0,1,1,0,0,1
SC080815,54,4,50,0,3,1,2,3,1
SC081123,69,10,59,0,0,0,0,0,1
SC081141,85,39,46,1,1,1,0,1,1
SC081257,34,6,28,0,1,1,0,0,1
SC081289,4,4,0,0,3,3,0,0,0
SC081648,38,3,35,0,2,1,1,2,1
SC081893,27,4,23,0,0,0,0,0,1
SC081922,32,0,32,0,0,0,0,0,1
SC082081,58,11,47,0,1,1,0,1,1
SC082292,38,3,35,0,1,1,0,1,1
SC082430,5,1,4,0,1,1,0,0,0
SC082496,14,3,11,0,1,1,0,1,1
SC082689,9,2,7,0,1,1,0,1,1
SC082727,37,3,34,0,1,1,0,1,1
SC082945,36,0,36,0,1,1,0,1,1
SC083022,39,7,32,0,1,1,0,1,1
SC083026,75,17,58,0,2,1,1,2,1
SC083045,21,3,18,1,1,1,0,1,1
SC083058,9,2,7,0,1,1,0,0,1
SC083144,51,0,51,0,0,0,0,0,1
SC083166,5,0,5,0,0,0,0,0,1
SC083345,7,6,1,0,3,3,0,0,0
SC083487,34,4,30,0,1,1,0,1,1
SC083612,6,1,5,1,3,1,2,1,0
SC083620,16,1,15,0,0,0,0,0,1
SC083702,96,7,89,0,0,0,0,0,1
SC083788,66,0,66,0,0,0,0,0,1
SC083958,16,3,13,0,1,1,0,1,1
SC084008,71,18,53,0,0,0,0,0,1
SC084170,50,7,43,0,1,1,0,1,1
SC084281,21,0,21,0,0,0,0,0,1
SC084363,14,0,14,0,0,0,0,0,1
SC084451,102,3,99,0,1,1,0,1,1
SC084588,5,0,5,0,2,2,0,0,1
SC084702,7,4,3,0,3,2,1,0,1
SC084807,37,9,28,0,2,2,0,0,1
SC085061,15,5,10,0,1,1,0,0,1
SC085147,19,0,19,0,0,0,0,0,1
SC085314,75,8,67,0,1,1,0,1,1
SC085405,24,6,18,0,1,1,0,1,1
SC085645,32,4,28,0,1,1,0,1,1
SC085878,17,0,17,0,0,0,0,0,1
SC086065,77,8,69,0,8,6,2,0,1
SC086425,12,0,12,0,0,0,0,0,1
SC086710,8,0,8,0,0,0,0,0,1
SC086995,25,3,22,0,2,1,1,2,1
SC087033,20,0,20,0,0,0,0,0,1
SC087105,62,0,62,0,1,1,0,1,1
SC087174,59,7,52,0,1,1,0,1,1
SC087376,38,2,36,0,1,1,0,1,1
SC087442,18,6,12,0,1,1,0,0,1
SC087546,14,4,10,0,4,1,3,1,0
SC087888,58,11,47,0,0,0,0,0,1
SC087933,16,0,16,0,0,0,0,0,1
SC088127,9,4,5,0,2,2,0,2,0
SC088361,71,12,59,0,0,0,0,0,1
SC088674,47,0,47,0,1,1,0,1,1
SC089404,8,6,2,0,2,2,0,0,1
SC089417,9,0,9,0,0,0,0,0,1
SC089706,21,3,18,0,1,1,0,1,1
SC089892,131,13,118,0,0,0,0,0,1
SC089895,14,0,14,0,0,0,0,0,1
SC090149,34,0,34,0,1,1,0,1,1
SC090157,22,1,21,0,1,1,0,1,1
SC090312,98,8,90,0,1,1,0,1,1
SC090317,16,4,12,0,1,1,0,1,1
SC090368,14,3,11,0,1,1,0,1,1
SC090459,5,3,2,0,1,1,0,0,0
SC090492,22,0,22,0,1,1,0,1,1
SC090546,3,3,0,0,2,2,0,0,0
SC090599,6,3,3,0,1,1,0,0,1
SC090614,7,4,3,0,1,1,0,1,1
SC090880,23,0,23,0,0,0,0,0,1
SC090936,9,3,6,0,1,1,0,0,1
SC090996,20,0,20,0,1,1,0,1,1
SC091052,18,6,12,0,0,0,0,0,1
SC091156,19,5,14,3,2,1,1,1,1
SC091239,63,12,51,0,0,0,0,0,1
SC091255,7,0,7,0,3,3,0,1,1
SC091353,14,0,14,0,1,1,0,0,1
SC091407,7,0,7,1,0,0,0,0,1
SC091497,5,3,2,0,1,1,0,1,0
SC091552,57,7,50,0,0,0,0,0,1
SC091650,23,0,23,0,0,0,0,0,1
SC091698,39,24,15,0,3,2,1,0,1
SC091780,19,2,17,0,1,1,0,1,1
SC091781,8,2,6,0,1,1,0,1,1
SC091850,18,7,11,0,2,1,1,0,1
SC091971,18,0,18,0,0,0,0,0,1
SC092088,22,6,16,0,0,0,0,0,1
SC092120,33,0,33,0,0,0,0,0,1
SC092391,22,6,16,0,0,0,0,0,1
SC092426,25,4,21,0,1,1,0,1,1
SC092463,65,8,57,0,0,0,0,0,1
SC092520,33,10,23,0,0,0,0,0,1
SC092749,48,3,45,0,0,0,0,0,1
SC092820,8,2,6,0,1,1,0,1,0
SC092891,11,3,8,0,0,0,0,0,1
SC092950,19,0,19,2,1,1,0,1,1
SC093088,144,8,136,0,0,0,0,0,1
SC093170,7,3,4,0,1,1,0,0,1
SC093250,127,10,117,0,1,1,0,1,1
SC093332,0,0,0,0,0,0,0,0,0
SC093413,31,2,29,0,2,1,1,2,1
SC093544,92,13,79,0,13,0,13,0,1
SC093587,7,3,4,0,2,2,0,0,1
SC093638,6,1,5,0,1,1,0,0,0
SC093685,26,8,18,0,1,1,0,1,1
SC093693,19,2,17,0,1,1,0,1,1
SC093939,20,5,15,2,1,1,0,1,1
SC093962,29,0,29,0,0,0,0,0,1
SC094096,69,11,58,0,0,0,0,0,1
SC094376,3,3,0,0,0,0,0,0,0
SC094479,35,3,32,0,2,2,0,2,1
SC094490,57,7,50,0,0,0,0,0,1
SC094733,16,3,13,0,1,1,0,1,1
SC094787,8,2,6,0,1,1,0,1,1
SC094792,29,11,18,0,0,0,0,0,1
SC094795,28,4,24,0,1,1,0,1,1
SC094860,78,10,68,0,0,0,0,0,1
SC095000,127,13,114,0,0,0,0,0,1
SC095237,83,12,71,0,1,1,0,1,1
SC095267,2,2,0,0,0,0,0,0,1
SC095343,120,7,113,0,0,0,0,0,1
SC095442,25,4,21,0,1,1,0,1,0
SC095471,15,2,13,0,1,1,0,0,1
SC095585,51,5,46,0,1,1,0,1,1
SC095600,13,8,5,0,0,0,0,0,0
SC095678,107,3,104,0,1,1,0,1,1
SC095705,28,3,25,0,1,1,0,1,1
SC095811,8,0,8,0,1,1,0,1,1
SC095908,21,6,15,0,1,1,0,1,1
SC096029,0,0,0,0,0,0,0,0,1
SC096179,20,3,17,0,0,0,0,0,1
SC096211,117,2,115,0,1,1,0,1,1
SC096327,4,0,4,0,0,0,0,0,1
SC096613,9,5,4,0,1,1,0,0,0
SC096623,39,8,31,0,1,1,0,1,0
SC096624,33,7,26,0,3,3,0,3,0
SC096627,22,4,18,0,1,1,0,1,0
SC096647,15,2,13,0,1,1,0,0,1
SC096763,11,3,8,0,1,1,0,1,1
SC096794,3,3,0,0,1,1,0,0,0
SC096849,64,10,54,0,1,1,0,1,1
SC097020,6,3,3,0,2,2,0,0,1
SC097057,12,3,9,0,1,1,0,1,1
SC097140,19,3,16,0,1,1,0,1,0
SC097184,18,0,18,0,2,2,0,1,1
SC097248,2,2,0,0,0,0,0,0,1
SC097275,33,2,31,0,2,2,0,0,1
SC097408,32,3,29,0,1,1,0,1,0
SC097437,14,4,10,0,1,1,0,1,1
SC097505,56,6,50,0,0,0,0,0,1
SC097518,4,4,0,0,1,1,0,0,0
SC097606,67,5,62,0,1,1,0,1,1
SC097808,4,3,1,0,1,1,0,1,0
SC097869,58,2,56,0,0,0,0,0,1
SC098089,7,4,3,0,1,1,0,0,0
SC098202,9,4,5,0,3,3,0,0,1
SC098335,21,6,15,0,0,0,0,0,1
SC098390,9,0,9,1,0,0,0,0,1
SC098476,4,3,1,0,2,2,0,0,0
SC098728,6,3,3,0,2,2,0,0,0
SC098858,21,8,13,0,1,1,0,1,1
SC098884,20,11,9,1,1,1,0,1,1
SC098937,7,0,7,1,0,0,0,0,1
SC099154,15,8,7,0,1,1,0,1,1
SC099209,4,3,1,0,1,1,0,1,1
SC099218,8,0,8,0,0,0,0,0,1
SC099251,17,4,13,0,1,1,0,1,1
SC099391,21,0,21,0,1,1,0,1,1
SC099757,6,4,2,0,5,5,0,0,1
SC099841,25,4,21,0,3,1,2,3,1
SC100000,77,13,64,0,0,0,0,0,1
SC100139,19,2,17,0,1,1,0,1,1
SC100141,51,11,40,0,1,1,0,1,1
SC100167,25,0,25,0,1,1,0,1,1
SC100361,11,0,11,0,0,0,0,0,1
SC100377,29,13,16,0,3,2,1,0,1
SC100612,17,0,17,0,0,0,0,0,1
SC100679,23,0,23,0,0,0,0,0,1
SC100700,18,0,18,0,1,1,0,1,1
SC100742,11,0,11,0,0,0,0,0,0
SC100763,15,3,12,0,3,2,1,0,1
SC100803,18,1,17,0,1,1,0,1,1
SC100845,26,0,26,0,1,1,0,0,1
SC101005,19,9,10,0,2,2,0,0,1
SC101334,24,8,16,0,2,2,0,0,1
SC101342,37,0,37,0,0,0,0,0,1
SC101343,37,1,36,0,0,0,0,0,1
SC101344,62,0,62,0,2,2,0,2,1
SC101466,30,3,27,0,0,0,0,0,1
SC101645,30,15,15,1,1,1,0,1,1
SC101660,95,11,84,0,0,0,0,0,1
SC101671,69,14,55,0,1,1,0,0,1
SC101725,5,1,4,0,1,1,0,0,1
SC101729,9,1,8,0,1,1,0,0,1
SC101837,5,3,2,0,1,1,0,0,1
SC101839,10,0,10,0,1,1,0,1,1
SC101903,47,22,25,0,1,1,0,1,1
SC101959,37,8,29,0,1,1,0,1,0
SC102012,39,24,15,0,2,2,0,0,1
SC102034,9,4,5,0,1,1,0,0,0
SC102139,16,0,16,0,0,0,0,0,1
SC102144,57,6,51,0,2,1,1,2,1
SC102208,102,3,99,0,1,1,0,1,1
SC102470,56,3,53,0,3,2,1,3,1
SC102549,6,0,6,0,0,0,0,0,1
SC102604,9,3,6,0,1,1,0,0,0
SC102624,22,7,15,0,1,1,0,1,1
SC102741,55,10,45,0,0,0,0,0,1
SC102790,64,10,54,0,0,0,0,0,1
02930014,19,3,16,0,0,0,0,0,1
02930099,12,3,9,0,1,1,0,1,1
02930355,23,0,23,0,0,0,0,0,1
02930528,46,8,38,0,0,0,0,0,1
02930531,62,6,56,0,1,1,0,0,1
02930571,12,4,8,0,1,1,0,0,1
02930819,48,9,39,0,0,0,0,0,1
02930887,10,3,7,0,2,2,0,0,1
02930977,18,0,18,0,0,0,0,0,1
02931088,18,0,18,0,0,0,0,0,1
02931163,73,11,62,0,0,0,0,0,1
02931186,8,0,8,0,2,2,0,0,0
02931193,46,0,46,0,0,0,0,0,1
02931297,9,1,8,0,1,1,0,0,0
02931464,4,0,4,0,0,0,0,0,0
02931566,27,0,27,0,0,0,0,0,1
02931636,93,9,84,0,0,0,0,0,1
02931640,42,13,29,0,3,3,0,0,1
02931643,48,4,44,0,0,0,0,0,1
02931660,5,0,5,0,0,0,0,0,1
02931809,26,3,23,0,0,0,0,0,1
02932069,41,3,38,0,2,2,0,0,1
02932120,7,3,4,0,0,0,0,0,1
02932195,38,9,29,0,0,0,0,0,1
02932381,6,0,6,0,0,0,0,0,1
02933031,58,0,58,0,0,0,0,0,1
02933171,13,4,9,0,0,0,0,0,1
02933258,7,2,5,0,0,0,0,0,1
02933319,12,5,7,0,3,3,0,0,1
02933588,9,3,6,0,2,2,0,0,1
02933627,12,4,8,0,1,1,0,1,0
02933711,3,2,1,0,1,1,0,0,1
02933980,33,6,27,0,0,0,0,0,1
02934029,105,8,97,0,0,0,0,0,1
02934093,19,5,14,0,1,1,0,0,1
02934202,15,7,8,0,4,1,3,1,0
02934393,7,3,4,0,3,1,2,1,0
02934475,15,0,15,0,0,0,0,0,1
02934959,19,9,10,0,1,1,0,0,1
02935458,16,0,16,0,0,0,0,0,1
02935485,15,4,11,0,0,0,0,0,1
02935593,42,3,39,0,1,1,0,1,1
02936024,22,3,19,0,0,0,0,0,1
02936084,10,2,8,0,0,0,0,0,0
02936119,9,3,6,0,1,1,0,0,1
02936262,10,0,10,0,0,0,0,0,1
02936276,7,2,5,0,1,1,0,0,0
02936337,23,6,17,0,2,1,1,2,1
02936374,7,2,5,0,1,1,0,0,1
02936831,22,2,20,0,1,1,0,0,0
02936903,44,5,39,0,0,0,0,0,1
02937075,11,2,9,0,1,1,0,0,1
02937203,27,3,24,0,0,0,0,0,1
02937296,36,10,26,0,0,0,0,0,1
02937310,87,2,85,0,2,2,0,0,0
02937365,16,2,14,0,2,2,0,0,1
02937377,17,7,10,0,3,3,0,0,1
02937464,17,10,7,0,0,0,0,0,0
02937496,15,5,10,0,1,1,0,1,1
02937514,17,0,17,0,0,0,0,0,1
02937788,39,3,36,0,1,1,0,1,1
02937796,13,2,11,0,0,0,0,0,1
02937812,13,2,11,0,0,0,0,0,1
02938084,130,15,115,0,0,0,0,0,1
02938138,25,6,19,0,0,0,0,0,1
02938183,29,2,27,0,1,1,0,1,1
02938295,11,0,11,0,0,0,0,0,1
02938392,42,3,39,0,0,0,0,0,1
02938539,24,2,22,0,0,0,0,0,1
02938700,19,3,16,0,1,1,0,1,1
02938723,18,3,15,0,1,1,0,1,1
02938824,13,2,11,0,0,0,0,0,1
02938939,6,0,6,0,0,0,0,0,1
02938965,9,0,9,0,0,0,0,0,0
02938983,19,4,15,0,1,1,0,1,1
02938993,60,3,57,0,1,1,0,1,1
02938994,44,2,42,0,1,1,0,1,1
02938995,46,0,46,0,0,0,0,0,1
02939132,32,7,25,0,2,2,0,2,1
02939152,5,0,5,0,0,0,0,0,1
02939329,18,0,18,0,0,0,0,0,1
02939376,8,0,8,0,1,1,0,0,0
02939574,19,0,19,0,2,2,0,0,0
02939840,114,14,100,0,0,0,0,0,1
02939892,5,2,3,0,2,2,0,0,1
02939918,9,3,6,0,1,1,0,0,1
02940485,14,2,12,0,1,1,0,0,1
02940609,19,5,14,0,2,1,1,2,1
02940712,30,6,24,0,0,0,0,0,1
02940993,6,0,6,0,0,0,0,0,1
02941244,9,0,9,0,1,1,0,0,0
02941330,26,4,22,0,1,1,0,1,1
02941460,11,4,7,0,1,1,0,1,1
02941522,13,2,11,0,1,1,0,1,1
02942062,7,2,5,0,1,1,0,0,0
02942105,30,3,27,0,2,1,1,2,1
02942276,22,0,22,0,1,1,0,1,1
02942297,3,2,1,0,2,1,1,0,1
02942310,7,2,5,0,2,2,0,0,1
02942541,35,3,32,0,1,1,0,1,1
02942582,3,2,1,0,1,1,0,0,1
02942594,16,0,16,0,0,0,0,0,1
02943110,10,0,10,0,0,0,0,0,1
02943713,6,2,4,0,0,0,0,0,1
02943978,20,1,19,0,1,1,0,1,1
02944000,21,0,21,0,0,0,0,0,1
02944057,33,3,30,0,0,0,0,0,1
02944156,39,7,32,0,0,0,0,0,1
02944269,23,6,17,0,1,1,0,1,0
02944310,10,0,10,0,0,0,0,0,1
02944472,13,0,13,0,1,1,0,0,1
02944546,21,9,12,0,0,0,0,0,1
02944724,34,6,28,0,0,0,0,0,1
02945295,11,0,11,0,0,0,0,0,1
02945457,30,4,26,0,1,1,0,1,1
02945478,5,3,2,0,1,1,0,0,1
02945546,10,4,6,0,1,1,0,0,0
02945571,17,6,11,0,2,1,1,1,1
02945636,47,9,38,0,0,0,0,0,1
02945786,13,2,11,0,2,0,2,2,1
02945838,38,4,34,0,0,0,0,0,1
02945968,11,3,8,0,2,2,0,0,1
02946010,41,7,34,0,0,0,0,0,1
02946205,17,0,17,0,0,0,0,0,0
02946299,16,3,13,0,1,1,0,1,1
02946363,9,0,9,0,2,2,0,0,1
02946371,18,3,15,0,2,2,0,0,1
02946427,4,0,4,0,0,0,0,0,1
02946579,16,2,14,0,1,1,0,1,1
02946644,11,3,8,0,1,1,0,1,0
02946650,21,0,21,0,0,0,0,0,1
02946679,59,3,56,0,1,1,0,1,1
02946773,22,8,14,0,0,0,0,0,1
02946818,29,0,29,0,1,1,0,1,1
02946833,22,0,22,0,0,0,0,0,1
02946918,20,0,20,0,0,0,0,0,1
02946968,15,0,15,0,0,0,0,0,1
02947208,26,0,26,0,0,0,0,0,1
02947322,46,9,37,0,1,1,0,0,1
02947357,11,0,11,0,2,2,0,0,1
02947500,16,2,14,0,1,1,0,0,0
02947527,16,3,13,0,1,1,0,1,1
02947662,13,3,10,0,1,1,0,0,1
02947820,14,3,11,0,0,0,0,0,1
02948248,5,0,5,0,0,0,0,0,1
02948329,10,3,7,0,1,1,0,1,1
02948352,25,0,25,0,0,0,0,0,1
02948392,19,0,19,0,0,0,0,0,1
02948500,71,16,55,0,0,0,0,0,1
02948648,28,5,23,1,4,3,1,1,1
02948671,45,5,40,0,1,1,0,1,1
02949000,43,3,40,0,2,1,1,2,1
02949646,59,0,59,0,0,0,0,0,1
02949674,67,12,55,0,0,0,0,0,1
02949715,12,6,6,0,2,1,1,0,0
02949922,23,4,19,0,0,0,0,0,1
02950018,10,5,5,0,2,2,0,0,1
02950206,21,2,19,0,1,1,0,1,1
02950349,6,3,3,0,2,2,0,0,0
02950678,10,3,7,0,2,2,0,0,1
02950858,22,2,20,0,1,1,0,1,1
02950884,18,0,18,0,0,0,0,0,1
02950889,27,7,20,0,0,0,0,0,1
02950995,20,3,17,0,1,1,0,1,1
02951562,6,3,3,0,1,1,0,0,1
02951567,55,7,48,0,1,1,0,1,1
02951736,7,1,6,0,1,1,0,0,0
02951828,16,2,14,0,0,0,0,0,1
02951884,32,0,32,0,0,0,0,0,1
02952260,51,11,40,0,2,2,0,2,1
02952373,25,8,17,0,1,1,0,1,1
02952381,7,0,7,0,0,0,0,0,0
02952583,30,6,24,0,0,0,0,0,1
02952665,10,1,9,0,2,1,1,0,1
02952737,4,2,2,0,1,1,0,0,1
02952926,20,8,12,0,0,0,0,0,1
02953045,13,0,13,0,1,1,0,1,0
02953277,19,0,19,0,0,0,0,0,1
02953299,60,4,56,0,1,1,0,1,1
02953431,85,15,70,0,0,0,0,0,1
02953884,19,3,16,0,3,3,0,0,1
02954568,4,1,3,0,1,1,0,0,1
02954692,41,8,33,0,0,0,0,0,1
02954734,24,2,22,0,1,1,0,1,1
02955169,23,8,15,0,2,1,1,0,0
02955271,15,3,12,0,2,2,0,0,1
02955505,4,2,2,0,2,2,0,0,0
02955756,29,3,26,0,2,2,0,2,1
02956027,16,4,12,0,1,1,0,1,0
02956089,14,3,11,0,1,1,0,1,1
02956095,15,3,12,0,1,1,0,1,1
02956297,19,4,15,0,1,1,0,0,1
02956667,20,5,15,0,3,0,3,0,0
02956873,12,2,10,0,1,1,0,0,1
02957012,22,3,19,0,1,1,0,1,1
02957181,33,2,31,0,1,1,0,1,1
02957327,65,10,55,0,1,1,0,1,1
02957397,19,5,14,0,2,1,1,0,1
02957432,25,0,25,0,1,1,0,0,1
02957574,4,3,1,0,2,2,0,0,0
02957629,30,0,30,0,1,1,0,1,1
02957667,49,5,44,0,0,0,0,0,0
02957844,4,2,2,0,2,2,0,0,0
02957968,24,0,24,0,0,0,0,0,1
02958128,18,3,15,0,1,1,0,1,1
02958269,10,4,6,0,2,2,0,0,1
02958399,31,6,25,0,1,1,0,1,1
02958741,10,4,6,0,1,1,0,0,1
02958820,33,7,26,0,0,0,0,0,1
02958846,4,3,1,0,1,1,0,0,1
02959076,22,3,19,0,1,1,0,1,1
02959240,12,4,8,0,1,1,0,0,1
02959317,5,3,2,0,1,1,0,0,0
02959484,9,3,6,0,0,0,0,0,1
02959697,6,0,6,0,0,0,0,0,1
02959712,37,7,30,0,0,0,0,0,1
02959849,33,4,29,0,1,1,0,1,1
02959989,22,3,19,0,0,0,0,0,1
02959991,15,2,13,0,1,1,0,1,0
02960039,10,2,8,0,1,1,0,1,1
02960284,52,5,47,0,0,0,0,0,1
02960454,96,6,90,0,0,0,0,0,1
02960571,26,1,25,0,1,1,0,1,1
02960617,11,10,1,0,0,0,0,0,1
02960625,18,2,16,0,1,1,0,1,1
02960715,35,6,29,0,1,1,0,1,1
02960812,7,1,6,0,1,1,0,0,1
02961239,9,4,5,0,1,1,0,0,1
02961352,28,4,24,0,1,1,0,1,1
02961387,34,5,29,0,0,0,0,0,1
02961748,6,1,5,0,3,3,0,2,1
02961881,7,3,4,0,3,3,0,1,0
02962116,66,5,61,0,0,0,0,0,0
02962601,45,9,36,0,0,0,0,0,0
02962694,55,15,40,0,1,1,0,1,1
02962834,8,2,6,0,1,1,0,0,0
02963386,46,6,40,0,2,2,0,0,1
02963692,82,7,75,0,0,0,0,0,1
02963747,65,22,43,0,2,2,0,0,1
02963790,20,0,20,0,0,0,0,0,1
02963940,9,4,5,0,1,1,0,0,1
07780228,2,1,1,0,1,1,0,0,1
07780239,4,2,2,0,1,1,0,1,1
07780681,13,7,6,0,0,0,0,0,1
07780711,4,3,1,2,3,2,1,2,0
07781030,1,1,0,0,1,1,0,0,0
07781631,4,4,0,0,1,1,0,0,0
07782187,3,3,0,0,3,3,0,0,0
07782470,7,3,4,0,5,2,3,2,1
07782517,3,0,3,0,1,1,0,0,0
07782639,3,1,2,0,2,2,0,0,1
07782822,2,0,2,0,0,0,0,0,1
07782823,2,2,0,0,2,2,0,0,1
07782832,2,0,2,0,0,0,0,0,1
07782903,3,3,0,0,1,1,0,1,1
07782905,1,0,1,0,0,0,0,0,0
07783051,2,0,2,0,0,0,0,0,0
07783459,3,3,0,0,0,0,0,0,1
07783490,5,3,2,0,1,1,0,1,0
07783670,3,3,0,0,1,1,0,0,0
07783711,8,7,1,0,1,1,0,0,1
07784359,2,2,0,0,1,1,0,1,1
07784865,4,0,4,0,0,0,0,0,1
07785052,4,4,0,0,1,1,0,0,1
07785068,1,0,1,0,0,0,0,0,1
07785097,3,1,2,0,2,1,1,0,0
07785239,2,2,0,0,1,1,0,0,1
07785338,6,0,6,0,0,0,0,0,1
07785769,1,1,0,0,1,1,0,0,0
07785972,2,0,2,0,0,0,0,0,1
07786534,8,5,3,0,1,1,0,0,1
07786702,15,3,12,0,2,1,1,2,1
07786955,11,3,8,0,1,1,0,1,1
07787494,3,0,3,0,0,0,0,0,1
07787537,1,1,0,0,1,1,0,0,0
07787738,4,2,2,0,2,2,0,0,0
07787881,1,0,1,0,0,0,0,0,0
07788296,4,0,4,0,0,0,0,0,0
07788403,4,3,1,0,2,2,0,0,0
07788593,27,12,15,0,0,0,0,0,1
07788661,2,1,1,0,1,1,0,0,1
07788811,19,12,7,0,0,0,0,0,0
07789108,4,0,4,0,0,0,0,0,1
07789388,1,1,0,0,2,2,0,0,1
07789672,4,0,4,0,0,0,0,0,1
07789841,2,1,1,0,1,1,0,0,0
07789920,2,2,0,0,2,2,0,0,0
07789940,1,1,0,0,1,1,0,0,0
07790330,1,1,0,0,1,1,0,0,0
07790390,4,0,4,0,0,0,0,0,1
07791828,5,2,3,0,2,2,0,0,0
07792311,3,3,0,0,3,3,0,0,0
07792553,1,1,0,0,1,1,0,0,0
07793088,2,2,0,0,3,3,0,0,0
07793117,1,1,0,0,1,1,0,0,0
07793381,2,0,2,0,0,0,0,0,0
07793895,12,6,6,0,3,3,0,1,1
07793925,17,5,12,1,1,1,0,1,1
07794318,2,1,1,0,1,1,0,0,0
07794414,3,0,3,0,0,0,0,0,0
07794425,12,9,3,0,0,0,0,0,1
07794755,1,1,0,0,1,1,0,0,0
07794812,3,0,3,0,0,0,0,0,0
07794882,3,0,3,0,0,0,0,0,0
07794900,5,0,5,0,0,0,0,0,0
07794943,3,0,3,0,0,0,0,0,0
07795024,9,4,5,0,0,0,0,0,1
07795138,4,2,2,0,0,0,0,0,1
07795302,3,0,3,0,0,0,0,0,0
07795368,3,0,3,0,0,0,0,0,0
07795500,3,2,1,0,2,2,0,0,1
07795576,2,2,0,0,2,2,0,0,0
07796143,8,2,6,0,1,1,0,1,1
07796376,16,10,6,0,5,5,0,2,1
07796503,3,2,1,0,2,2,0,0,1
07796702,1,0,1,0,1,1,0,0,1
07796775,19,13,6,0,2,2,0,0,1
07797119,3,1,2,0,3,2,1,1,1
07797254,1,0,1,0,0,0,0,0,0
07797430,2,0,2,0,0,0,0,0,1
07797455,3,1,2,0,2,1,1,0,1
07797611,3,0,3,0,0,0,0,0,0
07797788,3,0,3,1,0,0,0,0,1
07797795,3,0,3,1,0,0,0,0,1
07798255,12,5,7,0,0,0,0,0,1
07798381,3,0,3,0,0,0,0,0,0
07798490,4,2,2,0,1,1,0,0,0
07798639,29,9,20,0,0,0,0,0,1
07798755,1,1,0,0,1,1,0,0,0
07798786,9,6,3,0,1,1,0,0,1
07798935,1,1,0,0,1,1,0,0,0
07799127,1,0,1,0,0,0,0,0,0
07799444,1,0,1,0,0,0,0,0,1
07799562,5,5,0,0,2,2,0,1,1
07799680,4,4,0,0,2,2,0,0,1
07800129,3,2,1,0,1,1,0,0,0
07800255,8,2,6,0,1,1,0,1,1
07800536,12,6,6,0,2,2,0,2,1
07800879,16,4,12,0,1,1,0,1,1
07800962,6,2,4,0,1,1,0,0,0
07800966,1,1,0,0,1,1,0,0,1
07801200,2,0,2,0,0,0,0,0,1
07801531,3,0,3,0,0,0,0,0,0
07801547,3,0,3,0,0,0,0,0,0
07801568,3,0,3,0,0,0,0,0,0
07801599,3,0,3,0,0,0,0,0,0
07801602,3,0,3,0,0,0,0,0,0
07801716,1,1,0,0,1,1,0,0,0
07801854,3,0,3,0,0,0,0,0,1
07801855,4,3,1,0,3,3,0,0,1
07801997,2,0,2,0,0,0,0,0,0
07802030,1,1,0,0,1,1,0,0,0
07802214,2,2,0,0,2,2,0,0,1
07802458,16,4,12,0,1,1,0,1,1
07803396,3,2,1,0,2,2,0,0,0
07803658,1,1,0,0,1,1,0,0,1
07804043,23,10,13,0,4,3,1,0,1
07804182,3,2,1,0,0,0,0,0,0
07804203,5,0,5,0,2,2,0,0,0
07804324,38,10,28,0,0,0,0,0,0
07804339,1,1,0,0,1,1,0,0,0
07804393,12,4,8,0,1,1,0,1,1
07804549,3,1,2,0,1,1,0,0,0
07804770,4,2,2,0,1,1,0,0,0
07804865,1,0,1,0,0,0,0,0,1
07804943,1,0,1,0,0,0,0,0,0
07805306,12,5,7,0,6,3,3,0,0
07805312,2,0,2,0,1,1,0,0,0
07805382,5,2,3,0,1,1,0,0,0
07805412,6,3,3,0,2,1,1,2,0
07805449,3,3,0,0,2,2,0,0,0
07805763,3,3,0,0,2,2,0,0,0
07805971,1,1,0,0,1,1,0,0,0
07806157,2,2,0,0,2,2,0,0,0
07806475,4,2,2,1,1,1,0,0,0
07806557,1,1,0,0,2,2,0,0,0
07807128,3,3,0,0,1,1,0,0,1
07807380,4,2,2,0,1,1,0,0,0
07807382,4,2,2,0,3,2,1,1,1
07807524,4,2,2,0,1,1,0,1,1
07807562,19,12,7,0,0,0,0,0,1
07807756,3,1,2,0,2,2,0,0,1
07808003,5,3,2,0,2,2,0,2,1
07808346,2,2,0,0,1,1,0,0,0
07808382,4,0,4,0,1,1,0,0,1
07808551,1,1,0,0,1,1,0,0,0
07808859,2,2,0,0,1,1,0,0,0
07809063,3,0,3,0,0,0,0,0,1
07809078,2,1,1,0,1,1,0,0,0
07809298,1,1,0,0,1,1,0,0,0
07809306,1,0,1,0,0,0,0,0,1
07809547,3,1,2,0,1,1,0,0,0
07809595,6,3,3,0,0,0,0,0,0
07809756,4,3,1,0,1,1,0,0,1
07809772,3,2,1,0,2,2,0,0,0
07810330,14,5,9,0,1,1,0,0,1
07810624,2,0,2,0,0,0,0,0,1
07810711,1,1,0,0,1,1,0,0,1
07810715,1,0,1,0,0,0,0,0,1
07810719,1,0,1,0,2,2,0,0,0
07811222,5,0,5,0,1,1,0,1,0
07811282,1,1,0,0,2,2,0,0,0
07811317,21,6,15,0,1,1,0,1,1
07811331,2,2,0,0,1,1,0,0,0
07811354,26,9,17,0,0,0,0,0,1
07811410,22,3,19,0,1,1,0,1,1
07811511,2,0,2,0,1,1,0,0,0
07812094,3,0,3,0,0,0,0,0,0
07812240,27,10,17,0,0,0,0,0,1
07812454,2,1,1,0,1,1,0,0,0
07812655,3,0,3,0,0,0,0,0,1
07812815,2,2,0,0,1,1,0,0,1
07812826,6,4,2,0,2,2,0,0,0
07813044,3,0,3,0,0,0,0,0,1
07813299,3,0,3,0,0,0,0,0,1
07813373,3,1,2,0,0,0,0,0,1
07813651,5,3,2,0,1,1,0,1,0
07814000,31,5,26,0,0,0,0,0,0
07814130,15,8,7,0,0,0,0,0,1
07814192,13,8,5,0,3,3,0,1,1
07814243,7,2,5,0,1,1,0,1,1
07814465,1,1,0,0,1,1,0,0,0
07814732,10,6,4,0,1,1,0,1,1
07815338,3,0,3,0,0,0,0,0,0
07815696,10,5,5,0,0,0,0,0,0
07815821,3,2,1,0,1,1,0,0,0
07815973,5,2,3,0,3,3,0,0,0
07816582,4,2,2,0,2,1,1,0,0
07817432,6,3,3,0,0,0,0,0,1
07817554,12,3,9,0,1,1,0,1,0
07817641,2,2,0,0,1,1,0,0,0
07817878,1,0,1,0,1,1,0,0,1
07817954,3,2,1,0,1,1,0,0,0
07817959,3,1,2,0,1,1,0,1,1
07818144,1,0,1,0,0,0,0,0,1
07818477,1,1,0,0,1,1,0,0,0
07818821,2,1,1,0,1,1,0,0,1
07818986,3,2,1,0,1,1,0,0,0
07819045,21,12,9,0,0,0,0,0,1
07819194,2,0,2,0,0,0,0,0,1
07819206,2,0,2,0,0,0,0,0,1
07819513,3,3,0,0,0,0,0,0,1
07819787,2,0,2,0,0,0,0,0,1
07819870,22,9,13,0,2,1,1,1,1
07819872,10,9,1,0,2,1,1,0,1
07819951,2,1,1,0,1,1,0,0,0
07820197,2,2,0,0,2,2,0,0,0
07820491,2,2,0,0,3,3,0,0,0
07820660,4,1,3,0,2,1,1,0,0
07820764,3,3,0,0,2,2,0,0,1
07820869,2,0,2,0,1,1,0,0,0
07821221,1,0,1,0,0,0,0,0,0
07821306,1,1,0,0,1,1,0,0,0
07821346,15,7,8,0,0,0,0,0,1
07821368,10,3,7,0,2,1,1,2,1
07821375,11,3,8,0,2,1,1,2,1
07821451,1,1,0,0,1,1,0,0,0
07821691,1,1,0,0,1,1,0,0,0
07821773,2,1,1,0,2,2,0,0,0
07821830,2,1,1,0,1,1,0,0,0
07821911,10,3,7,0,1,1,0,1,1
07822413,12,5,7,0,1,1,0,0,1
07822479,11,4,7,0,1,1,0,1,1
07822514,22,10,12,0,0,0,0,0,1
07822612,1,1,0,0,2,2,0,0,0
07822625,4,4,0,0,1,1,0,0,0
07822668,1,1,0,0,2,2,0,0,0
07822898,2,1,1,0,1,1,0,0,0
07823588,14,8,6,0,0,0,0,0,1
07824276,14,3,11,0,1,1,0,1,0
07824653,2,2,0,0,1,1,0,0,0
07824764,4,4,0,0,2,1,1,0,1
07825140,7,0,7,0,0,0,0,0,1
07825238,3,0,3,0,0,0,0,0,0
07825248,2,2,0,0,1,1,0,0,1
07825249,6,3,3,0,3,2,1,0,1
07825848,20,10,10,0,3,3,0,0,0
07825856,48,11,37,0,0,0,0,0,0
07826471,12,5,7,0,0,0,0,0,1
07826474,4,2,2,0,2,2,0,0,0
07826816,2,1,1,0,2,1,1,0,0
07827214,15,7,8,0,0,0,0,0,1
07827600,1,0,1,0,0,0,0,0,0
07828055,20,10,10,0,0,0,0,0,1
07828414,17,9,8,0,0,0,0,0,1
07828944,4,0,4,0,0,0,0,0,1
07829370,2,0,2,0,0,0,0,0,1
07829384,5,0,5,0,0,0,0,0,1
07829395,2,0,2,0,0,0,0,0,1
07829396,2,0,2,0,0,0,0,0,1
07829420,2,0,2,0,0,0,0,0,1
07829441,2,0,2,0,0,0,0,0,1
07829521,2,0,2,0,0,0,0,0,1
07829536,2,0,2,0,0,0,0,0,1
07829766,20,5,15,0,4,2,2,0,0
07829915,2,0,2,0,0,0,0,0,0
07829948,9,5,4,0,1,1,0,0,1
07830172,17,7,10,0,3,3,0,3,0
07830948,21,8,13,0,2,2,0,0,0
07831080,36,11,25,0,0,0,0,0,0
07831184,3,0,3,0,0,0,0,0,1
07831291,4,4,0,0,0,0,0,0,0
07831377,10,7,3,0,0,0,0,0,0
07831879,1,1,0,0,1,1,0,0,0
07832343,5,4,1,0,1,1,0,0,0
07832394,1,1,0,0,1,1,0,0,0
07832501,12,6,6,0,1,1,0,1,1
07832663,6,4,2,0,0,0,0,0,0
07833189,1,1,0,0,1,1,0,0,0
07833350,2,0,2,0,0,0,0,0,1
07833472,2,2,0,0,2,2,0,0,0
07833708,7,2,5,0,1,1,0,1,1
07833825,14,3,11,0,3,2,1,0,1
07833989,2,1,1,0,1,1,0,0,0
07834112,2,1,1,0,1,1,0,0,1
07834179,1,0,1,0,0,0,0,0,1
07834284,3,3,0,0,0,0,0,0,1
07834335,7,3,4,0,1,1,0,1,1
07834351,5,4,1,0,2,2,0,0,1
07834382,1,0,1,0,0,0,0,0,0
02110626,21,5,16,0,0,0,0,0,1
02110876,15,0,15,0,0,0,0,0,1
02111149,38,11,27,0,1,1,0,1,1
02111218,32,3,29,0,1,1,0,1,1
02111276,11,3,8,0,1,1,0,1,1
02111327,11,3,8,0,1,1,0,1,1
02111417,34,2,32,0,0,0,0,0,1
02112115,4,4,0,0,2,2,0,0,0
02112188,18,3,15,0,3,3,0,1,1
02112298,6,2,4,0,1,1,0,0,0
02112944,91,4,87,0,1,1,0,1,1
02113079,23,7,16,0,1,1,0,1,1
02113253,43,7,36,0,1,1,0,1,1
02113367,12,5,7,0,3,3,0,0,0
02113404,24,3,21,0,1,1,0,1,1
02113687,40,5,35,0,1,1,0,1,1
02113721,13,1,12,0,1,1,0,1,1
02113750,37,5,32,0,6,5,1,0,0
02114114,14,3,11,0,1,1,0,1,0
02114287,28,3,25,0,1,1,0,1,1
02114427,9,0,9,0,0,0,0,0,1
02114430,71,6,65,0,1,1,0,1,1
02114435,42,12,30,0,0,0,0,0,0
02114543,53,3,50,0,1,1,0,1,1
02114602,39,3,36,0,1,1,0,1,1
02114802,34,3,31,0,1,1,0,1,1
02114849,63,9,54,0,0,0,0,0,1
02114901,49,3,46,0,1,1,0,1,1
02114948,32,8,24,0,0,0,0,0,1
02115336,32,3,29,0,2,2,0,0,1
02115499,135,13,122,0,0,0,0,0,1
02115913,109,19,90,0,0,0,0,0,1
02115949,26,0,26,0,0,0,0,0,1
02116009,6,2,4,1,1,1,0,0,1
02116519,54,6,48,0,1,1,0,1,1
02116696,16,3,13,0,1,1,0,1,1
02116704,73,5,68,0,1,1,0,1,0
02116710,14,3,11,0,1,1,0,1,1
02116907,96,4,92,0,0,0,0,0,1
02116957,23,4,19,0,0,0,0,0,1
02116971,39,4,35,0,1,1,0,1,1
02117828,48,4,44,0,4,2,2,0,1
02117901,21,3,18,0,0,0,0,0,1
02118349,101,9,92,0,1,1,0,0,1
02118527,36,10,26,0,1,1,0,1,1
02118766,31,3,28,0,1,1,0,1,1
02119268,26,2,24,0,1,1,0,1,1
02119536,15,2,13,0,0,0,0,0,1
02119682,81,14,67,0,0,0,0,0,1
02119686,14,5,9,0,0,0,0,0,1
02119792,13,3,10,0,1,1,0,1,0
02119811,3,2,1,0,1,1,0,0,1
02119988,17,3,14,0,1,1,0,0,1
02120124,53,4,49,0,1,1,0,1,1
02120126,39,4,35,0,1,1,0,1,1
02120177,24,0,24,0,0,0,0,0,1
02120687,3,3,0,0,2,2,0,0,0
02120855,29,0,29,0,0,0,0,0,1
02121909,6,0,6,0,0,0,0,0,0
02121927,23,5,18,0,1,1,0,1,1
02121957,4,3,1,0,2,2,0,0,0
02122174,55,8,47,0,0,0,0,0,1
02122308,22,6,16,0,2,1,1,0,1
02122340,68,15,53,0,1,1,0,1,1
02122431,13,2,11,0,1,1,0,1,1
02122585,14,5,9,0,5,4,1,0,0
02122701,17,3,14,0,0,0,0,0,0
02123106,17,6,11,0,0,0,0,0,1
02123111,10,3,7,0,1,1,0,0,1
02123483,70,4,66,0,0,0,0,0,1
02123704,13,0,13,0,0,0,0,0,1
02123798,18,10,8,0,1,1,0,1,1
02124666,4,4,0,0,3,3,0,0,1
02124671,4,2,2,0,1,1,0,0,1
02124695,172,9,163,0,0,0,0,0,1
02124766,29,5,24,0,1,1,0,1,1
02125354,15,2,13,0,1,1,0,1,1
02125674,54,10,44,0,0,0,0,0,1
02125681,91,6,85,0,10,6,4,0,1
02125799,83,7,76,0,1,1,0,1,1
02125881,6,0,6,0,0,0,0,0,1
02125883,8,3,5,0,0,0,0,0,0
02125982,28,4,24,0,4,2,2,4,1
02126017,20,5,15,0,1,1,0,1,1
02126105,23,3,20,0,1,1,0,1,1
02126304,9,0,9,0,1,1,0,1,1
02126349,12,3,9,0,1,1,0,1,1
02126881,24,0,24,0,0,0,0,0,1
02126998,10,2,8,0,1,1,0,0,1
02127066,30,0,30,0,0,0,0,0,1
02127408,37,9,28,0,1,1,0,1,1
02127577,25,0,25,0,0,0,0,0,1
02127831,11,0,11,0,0,0,0,0,1
02127833,29,6,23,0,1,1,0,0,1
02127866,35,10,25,0,3,1,2,1,0
02128556,28,2,26,0,0,0,0,0,1
02128666,90,10,80,0,1,1,0,1,1
02128961,24,3,21,0,1,1,0,1,0
02129019,50,8,42,0,0,0,0,0,0
02129187,21,6,15,0,0,0,0,0,1
02129219,26,0,26,0,0,0,0,0,1
02129262,27,3,24,0,1,1,0,1,1
02129331,38,3,35,0,0,0,0,0,0
02129484,9,3,6,0,3,1,2,1,0
02129734,43,2,41,0,1,1,0,1,1
02130156,25,5,20,0,1,1,0,1,0
02130447,67,13,54,0,1,1,0,1,1
02130459,4,3,1,0,1,1,0,1,1
02130654,27,0,27,0,0,0,0,0,1
02130659,24,0,24,0,0,0,0,0,1
02130660,26,0,26,0,0,0,0,0,1
02131188,21,6,15,0,1,1,0,0,0
02131240,27,5,22,0,1,1,0,1,1
02131276,14,0,14,0,0,0,0,0,1
02131610,26,2,24,0,1,1,0,1,1
02131748,20,3,17,0,0,0,0,0,1
02131941,18,0,18,0,0,0,0,0,1
02132081,12,7,5,0,2,2,0,0,0
02132094,26,12,14,0,1,1,0,1,1
02132098,6,2,4,0,2,2,0,0,0
02132245,22,0,22,0,0,0,0,0,1
02132311,19,6,13,0,1,1,0,1,1
02132603,51,14,37,0,0,0,0,0,0
02132765,27,6,21,0,0,0,0,0,1
02132799,3,0,3,0,0,0,0,0,0
02132862,25,12,13,0,1,1,0,1,1
02132891,24,3,21,0,1,1,0,1,1
02132955,30,4,26,1,2,0,2,0,1
02133169,13,4,9,0,3,3,0,0,1
02133283,135,23,112,0,0,0,0,0,1
02133464,6,2,4,0,1,1,0,0,1
02133533,34,4,30,0,1,1,0,1,1
02133624,18,5,13,0,0,0,0,0,1
02133854,12,5,7,0,3,3,0,2,0
02134039,16,3,13,0,1,1,0,1,1
02134529,34,6,28,0,2,0,2,0,0
02134563,7,4,3,0,0,0,0,0,1
02134680,56,0,56,0,1,1,0,1,1
02134888,17,0,17,0,0,0,0,0,1
02135540,25,5,20,0,1,1,0,1,1
02135920,26,4,22,0,1,1,0,1,1
02136044,26,0,26,0,0,0,0,0,1
02136304,15,2,13,0,1,1,0,0,1
02136404,40,3,37,0,1,1,0,1,1
02136619,36,0,36,0,1,1,0,1,1
02137487,9,2,7,0,1,1,0,0,1
02137647,72,12,60,0,0,0,0,0,1
02137969,10,3,7,0,1,1,0,0,1
02138177,31,6,25,0,2,1,1,2,1
02138268,30,4,26,0,1,1,0,1,1
02138331,63,5,58,0,1,1,0,0,0
02138416,17,3,14,0,1,1,0,1,1
02138433,6,3,3,0,1,1,0,0,0
02138994,61,13,48,0,0,0,0,0,1
02139114,37,10,27,0,0,0,0,0,1
02139203,22,6,16,0,1,1,0,0,1
02139640,12,2,10,0,0,0,0,0,1
02139866,17,0,17,0,0,0,0,0,1
02139876,16,3,13,0,0,0,0,0,1
02139881,37,7,30,0,0,0,0,0,1
02139909,56,8,48,0,0,0,0,0,1
02139931,9,5,4,1,1,1,0,0,1
02140217,3,3,0,0,2,2,0,0,1
02140433,27,3,24,0,1,1,0,1,1
02141096,22,3,19,0,0,0,0,0,1
02141245,31,0,31,0,0,0,0,0,1
02141310,31,4,27,0,0,0,0,0,0
02141878,17,3,14,0,2,1,1,2,1
02142347,17,0,17,0,0,0,0,0,1
02143039,24,3,21,0,1,1,0,1,1
02143135,39,3,36,0,1,1,0,1,1
02143249,8,6,2,0,1,1,0,0,1
02143253,63,7,56,0,1,1,0,1,1
02143312,4,3,1,0,1,1,0,0,0
02143540,39,3,36,0,2,1,1,2,1
02143641,37,5,32,0,2,1,1,2,1
02143773,39,3,36,0,1,1,0,1,1
02143797,29,6,23,0,0,0,0,0,1
02143862,30,0,30,0,0,0,0,0,1
02143865,30,0,30,0,0,0,0,0,1
02144156,21,0,21,0,0,0,0,0,1
02144339,56,5,51,0,0,0,0,0,0
02144713,7,0,7,0,0,0,0,0,0
02144801,6,3,3,0,2,2,0,0,0
02144808,15,0,15,0,0,0,0,0,1
02144999,17,2,15,0,1,1,0,1,1
02145231,26,0,26,0,0,0,0,0,1
02145413,11,3,8,0,1,1,0,1,1
02145732,13,3,10,0,2,1,1,0,1
02146022,22,3,19,0,1,1,0,1,1
02146049,12,4,8,0,1,1,0,1,1
02146174,22,4,18,0,1,1,0,1,1
02146767,10,4,6,0,1,1,0,0,1
02146781,7,4,3,0,2,2,0,0,0
02146856,19,5,14,0,4,4,0,0,1
02147152,15,4,11,0,2,1,1,0,1
02147198,28,0,28,0,0,0,0,0,1
02147473,22,11,11,0,0,0,0,0,1
02147515,14,0,14,0,0,0,0,0,1
02147537,54,0,54,0,0,0,0,0,1
02147788,20,3,17,0,1,1,0,1,1
02147897,17,4,13,0,2,1,1,2,1
02148259,8,0,8,0,0,0,0,0,1
02148607,33,3,30,0,1,1,0,1,1
02148675,36,0,36,0,0,0,0,0,1
02148705,49,6,43,0,1,1,0,1,0
02148740,15,6,9,0,1,1,0,1,1
02148808,34,3,31,0,1,1,0,1,1
02148964,3,3,0,0,2,1,1,0,0
02149256,22,4,18,0,1,1,0,1,1
02149289,5,2,3,0,2,2,0,0,1
02149293,68,9,59,0,1,1,0,0,1
02149757,8,3,5,0,0,0,0,0,1
02149796,5,4,1,0,1,1,0,0,0
02149840,11,0,11,0,0,0,0,0,1
02149892,23,0,23,0,0,0,0,0,1
02150221,43,13,30,0,0,0,0,0,1
02150584,3,3,0,0,2,2,0,0,1
02150733,21,3,18,0,1,1,0,1,1
02150914,34,5,29,0,1,1,0,1,1
02150933,7,5,2,0,1,1,0,1,0
02151006,81,15,66,0,0,0,0,0,1
02151319,22,5,17,0,3,1,2,2,1
02151789,7,2,5,0,2,2,0,0,0
02151812,7,1,6,0,3,1,2,1,0
02152229,29,7,22,0,2,1,1,2,1
02152435,0,0,0,0,0,0,0,0,0
02152850,33,4,29,0,0,0,0,0,1
02152965,3,3,0,0,1,1,0,0,0
02152967,8,4,4,0,2,2,0,0,1
02153164,36,3,33,0,1,1,0,1,1
02153228,14,5,9,0,1,0,1,0,1
02153355,33,4,29,0,1,1,0,1,1
02153443,3,3,0,0,2,2,0,0,1
02153445,4,0,4,0,0,0,0,0,1
02154007,2,2,0,0,0,0,0,0,1
02154127,29,6,23,0,2,1,1,2,1
02154818,6,4,2,0,1,1,0,0,1
02154841,61,3,58,0,1,1,0,1,1
02155355,21,3,18,0,1,1,0,1,1
02155484,5,3,2,0,1,1,0,0,0
02155691,3,3,0,0,2,2,0,0,0
02155712,22,0,22,0,0,0,0,0,1
02155951,30,4,26,0,1,1,0,1,0
02156009,22,0,22,0,1,1,0,1,1
02156028,68,0,68,0,1,1,0,1,1
02156143,28,0,28,0,0,0,0,0,1
02156192,34,3,31,0,1,1,0,1,1
02156725,30,0,30,0,1,1,0,1,1
02156765,19,0,19,0,0,0,0,0,1
02157228,7,0,7,0,0,0,0,0,1
02157292,28,3,25,0,1,1,0,1,1
02157405,18,2,16,0,1,1,0,1,1
02157418,11,3,8,0,2,2,0,0,0
02157453,19,0,19,0,0,0,0,0,1
02157606,6,3,3,0,1,1,0,0,0
02157875,15,4,11,0,1,1,0,1,1
02157985,6,0,6,0,2,2,0,1,1
02158531,3,2,1,0,2,2,0,0,1
02158783,14,3,11,0,1,1,0,1,1
02158854,14,0,14,0,1,1,0,1,1
02159282,52,4,48,0,1,1,0,1,1
02159554,25,4,21,0,1,1,0,0,1
02159897,60,9,51,0,1,1,0,1,1
02160268,44,6,38,0,1,1,0,0,1
02160419,18,13,5,0,0,0,0,0,1
02160431,8,4,4,0,1,1,0,1,0
02160449,3,3,0,0,3,3,0,0,1
02160684,4,0,4,0,0,0,0,0,1
02160777,5,3,2,0,1,1,0,0,1
02160833,21,3,18,0,1,1,0,1,1
02161087,41,9,32,0,0,0,0,0,1
02161095,20,0,20,0,0,0,0,0,1
02161565,20,8,12,0,0,0,0,0,1
02161644,4,2,2,0,1,1,0,0,0
02162028,43,6,37,0,1,1,0,1,1
02162264,8,2,6,0,1,1,0,1,0
02162383,41,9,32,0,0,0,0,0,1
02163368,19,3,16,0,0,0,0,0,1
02163856,11,2,9,0,5,3,2,0,1
02163925,17,0,17,0,1,1,0,1,1
02164130,19,0,19,0,0,0,0,0,1
02164600,44,7,37,0,0,0,0,0,1
02164612,14,3,11,0,0,0,0,0,0
02164880,49,9,40,0,1,1,0,0,1
02165061,22,4,18,0,2,2,0,2,1
02165062,39,0,39,0,1,1,0,1,1
02165067,32,10,22,0,0,0,0,0,1
02165745,3,0,3,0,0,0,0,0,0
02166263,37,12,25,0,0,0,0,0,0
02166320,7,2,5,0,1,1,0,0,1
02166429,66,4,62,0,0,0,0,0,0
02166697,39,10,29,0,1,1,0,1,1
02166743,7,5,2,0,2,2,0,0,1
02166933,125,12,113,0,0,0,0,0,1
06414018,2,1,1,0,1,1,0,0,1
06414050,4,2,2,0,1,1,0,0,1
06414056,3,2,1,0,2,2,0,0,1
06414128,4,4,0,0,2,2,0,0,0
06414423,17,4,13,0,2,2,0,2,1
06414559,2,2,0,0,1,1,0,0,0
06415098,5,1,4,0,1,1,0,0,1
06415120,7,4,3,0,1,1,0,1,1
06415229,14,3,11,1,1,1,0,1,1
06415429,5,0,5,0,0,0,0,0,1
06415540,2,2,0,0,1,1,0,0,0
06415721,6,2,4,0,1,1,0,1,1
06416162,4,2,2,0,1,1,0,0,1
06416407,3,2,1,0,1,1,0,1,1
06416410,10,2,8,0,0,0,0,0,1
06416439,10,5,5,0,5,5,0,4,1
06416546,5,2,3,0,1,1,0,1,1
06416610,16,0,16,0,0,0,0,0,1
06416622,3,3,0,0,1,1,0,0,0
06416734,29,6,23,0,0,0,0,0,0
06417317,2,1,1,0,1,1,0,0,1
06417460,8,7,1,0,1,1,0,0,0
06417488,5,3,2,0,1,1,0,0,1
06417683,11,0,11,0,1,1,0,1,1
06417728,4,1,3,0,1,1,0,0,0
06418273,5,2,3,0,2,2,0,0,1
06418282,10,2,8,0,1,1,0,1,1
06418300,18,4,14,0,1,1,0,1,1
06418331,6,3,3,0,1,1,0,0,1
06418438,3,3,0,0,1,1,0,0,0
06418577,2,1,1,0,2,2,0,0,1
06418649,11,3,8,0,1,1,0,1,1
06418816,3,2,1,0,1,1,0,0,0
06418869,4,2,2,0,2,2,0,0,1
06419025,3,0,3,0,1,1,0,0,0
06419185,5,0,5,0,0,0,0,0,1
06419192,5,3,2,0,1,1,0,0,1
06419359,12,1,11,0,2,1,1,1,1
06419578,23,12,11,0,0,0,0,0,1
06419705,2,1,1,0,1,1,0,0,1
06419813,3,0,3,0,0,0,0,0,1
06420354,5,0,5,0,2,2,0,0,1
06420555,19,3,16,0,1,1,0,1,1
06420564,7,0,7,0,0,0,0,0,1
06420568,7,0,7,0,0,0,0,0,1
06420574,8,0,8,0,0,0,0,0,1
06420693,3,2,1,0,1,1,0,0,1
06420723,4,2,2,0,1,1,0,0,1
06420732,27,0,27,0,0,0,0,0,1
06420758,4,2,2,0,1,1,0,0,1
06420783,7,4,3,0,0,0,0,0,0
06420825,5,2,3,0,2,2,0,0,1
06420927,21,0,21,0,0,0,0,0,1
06420934,21,0,21,0,0,0,0,0,1
06420946,9,3,6,0,0,0,0,0,1
06420969,23,0,23,0,0,0,0,0,1
06421118,3,0,3,0,1,1,0,0,1
06421238,5,0,5,0,0,0,0,0,1
06421258,7,3,4,0,1,1,0,0,1
06421290,3,3,0,0,2,2,0,0,1
06421365,21,6,15,0,0,0,0,0,1
06421615,7,0,7,0,0,0,0,0,1
06421966,21,7,14,0,3,2,1,3,1
06421992,2,0,2,0,0,0,0,0,1
06421999,5,0,5,0,0,0,0,0,1
06422017,4,2,2,0,1,1,0,1,1
06422142,13,2,11,0,2,2,0,0,0
06422165,5,3,2,0,2,2,0,0,1
06422190,41,8,33,0,0,0,0,0,1
06422358,6,4,2,0,3,3,0,0,1
06422431,4,1,3,0,1,1,0,0,0
06422502,5,1,4,0,1,1,0,0,1
06422508,4,2,2,0,2,2,0,0,1
06422648,4,2,2,0,1,1,0,0,1
06422675,4,2,2,0,1,1,0,0,1
06422685,3,0,3,0,0,0,0,0,1
06422804,5,0,5,0,2,2,0,0,1
06422920,5,0,5,0,0,0,0,0,1
06422947,2,2,0,0,1,1,0,0,1
06423033,16,0,16,0,0,0,0,0,1
06423117,14,0,14,0,0,0,0,0,1
06423292,4,1,3,0,1,1,0,0,1
06423349,7,0,7,0,1,1,0,0,1
06423465,12,0,12,0,1,1,0,1,1
06423525,3,3,0,0,1,1,0,0,0
06423529,11,2,9,0,2,1,1,2,1
06423637,53,7,46,0,1,1,0,1,1
06424228,3,0,3,0,0,0,0,0,1
06424400,18,3,15,0,1,1,0,1,1
06424479,3,0,3,0,0,0,0,0,1
06424545,7,5,2,0,0,0,0,0,1
06424711,4,0,4,0,0,0,0,0,0
06425158,5,2,3,0,1,1,0,0,1
06425264,5,3,2,0,2,2,0,0,1
06425376,4,2,2,0,1,1,0,1,1
06425482,29,6,23,0,2,1,1,2,1
06425771,7,0,7,0,0,0,0,0,1
06425774,6,4,2,0,3,3,0,0,1
06425800,67,0,67,0,2,2,0,2,1
06425881,6,2,4,0,0,0,0,0,1
06425892,8,0,8,0,0,0,0,0,0
06426366,4,2,2,0,1,1,0,0,1
06426462,5,1,4,0,1,1,0,0,1
06426466,12,3,9,0,1,1,0,1,1
06426516,2,2,0,0,0,0,0,0,0
06426697,9,7,2,0,1,1,0,0,1
06426905,6,1,5,0,1,1,0,0,0
06426933,5,2,3,0,1,1,0,0,1
06426966,49,14,35,0,0,0,0,0,1
06427136,4,2,2,0,1,1,0,0,1
06427150,5,1,4,0,1,1,0,1,1
06427182,6,0,6,0,0,0,0,0,1
06427235,5,0,5,0,1,1,0,1,1
06427290,10,4,6,0,3,3,0,3,1
06427329,4,1,3,0,1,1,0,0,0
06428011,6,2,4,0,1,1,0,1,0
06428025,5,0,5,0,0,0,0,0,1
06428199,10,5,5,0,5,4,1,0,0
06428205,5,0,5,0,0,0,0,0,0
06428244,5,0,5,0,2,2,0,0,1
06428287,6,0,6,0,0,0,0,0,1
06428342,12,4,8,0,1,1,0,1,1
06428372,29,5,24,0,0,0,0,0,1
06428374,27,3,24,0,1,1,0,1,1
06428375,34,7,27,0,1,1,0,1,1
06428444,4,2,2,0,1,1,0,0,1
06428534,27,3,24,0,1,1,0,1,1
06428537,10,0,10,0,1,1,0,1,1
06428565,3,2,1,0,1,1,0,0,1
06428748,6,2,4,0,3,1,2,3,0
06428869,2,2,0,0,1,1,0,0,0
06429084,7,5,2,0,2,2,0,0,1
06429115,6,2,4,0,1,1,0,1,1
06429337,18,4,14,0,0,0,0,0,1
06429764,4,0,4,0,0,0,0,0,1
06430170,17,3,14,0,7,1,6,1,1
06430441,8,0,8,0,0,0,0,0,1
06430507,4,2,2,0,1,1,0,0,1
06430540,6,2,4,0,1,1,0,0,1
06430575,2,0,2,0,0,0,0,0,0
06430729,4,0,4,0,0,0,0,0,1
06430760,3,3,0,0,1,1,0,0,0
06430766,7,5,2,0,1,1,0,1,1
06431030,19,8,11,0,0,0,0,0,1
06431045,5,2,3,0,1,1,0,0,1
06431502,15,2,13,0,2,1,1,2,1
06431862,6,4,2,0,1,1,0,0,1
06431908,3,0,3,0,1,1,0,1,1
06431986,5,3,2,0,1,1,0,0,1
06432016,2,2,0,0,1,1,0,0,0
06432026,4,2,2,0,1,1,0,0,1
06432063,2,0,2,0,1,1,0,0,0
06432220,4,4,0,0,3,3,0,0,0
06432285,9,5,4,0,1,1,0,1,1
06432526,2,1,1,0,1,1,0,0,1
06432648,10,0,10,0,0,0,0,0,1
06432698,4,0,4,0,0,0,0,0,1
06432741,3,3,0,0,2,2,0,0,1
06432763,12,0,12,0,0,0,0,0,1
06432952,11,5,6,0,0,0,0,0,0
06433016,11,3,8,0,1,1,0,1,1
06433377,8,2,6,0,1,1,0,0,1
06433674,3,0,3,0,0,0,0,0,1
06433889,6,0,6,0,0,0,0,0,1
06434138,5,2,3,0,1,1,0,0,0
06434214,14,3,11,0,1,1,0,1,1
06434555,8,0,8,0,0,0,0,0,1
06434574,8,0,8,0,0,0,0,0,1
06434621,11,3,8,0,4,3,1,2,1
06434632,19,9,10,0,4,1,3,2,1
06434634,7,3,4,0,3,3,0,0,1
06434643,4,3,1,0,2,2,0,0,1
06434650,46,6,40,0,2,1,1,2,1
06434912,13,3,10,0,1,1,0,1,1
06435008,5,3,2,0,2,2,0,0,1
06435040,6,0,6,0,2,2,0,0,1
06435094,3,1,2,0,1,1,0,0,0
06435373,7,0,7,0,2,2,0,1,1
06435503,17,0,17,0,0,0,0,0,1
06435659,5,3,2,0,2,2,0,0,0
06435671,4,2,2,0,1,1,0,0,1
06435876,6,3,3,0,1,1,0,1,1
06436009,15,4,11,0,6,3,3,3,1
06436047,10,3,7,0,1,1,0,1,1
06436101,49,7,42,0,1,1,0,1,1
06436142,10,0,10,0,0,0,0,0,1
06436245,20,6,14,0,5,3,2,0,1
06436255,15,3,12,0,1,1,0,1,1
06436264,19,4,15,0,2,2,0,2,1
06436722,27,8,19,0,1,1,0,1,1
06436784,4,2,2,0,1,1,0,0,0
06437028,7,4,3,0,2,2,0,0,1
06437062,7,0,7,0,0,0,0,0,1
06437082,3,0,3,0,1,1,0,1,1
06437104,10,2,8,0,1,1,0,1,1
06437140,8,4,4,0,1,1,0,0,1
06437263,6,4,2,0,2,2,0,0,1
06437349,7,0,7,0,0,0,0,0,1
06437380,7,4,3,0,3,3,0,0,0
06437496,4,0,4,0,1,1,0,0,1
06437909,3,1,2,0,1,1,0,0,1
06438156,36,8,28,0,0,0,0,0,1
06438706,13,3,10,0,1,1,0,1,1
06438736,13,3,10,0,1,1,0,1,1
06438936,26,0,26,0,0,0,0,0,1
06438989,8,0,8,1,1,1,0,0,1
06439083,8,0,8,0,0,0,0,0,1
06439209,6,2,4,0,1,1,0,0,1
06439246,23,14,9,0,5,3,2,0,1
06439693,11,4,7,0,1,1,0,1,1
06439761,20,9,11,0,1,1,0,1,1
06439812,4,2,2,0,1,1,0,0,0
06439825,16,0,16,0,0,0,0,0,1
06439864,16,3,13,0,2,2,0,2,1
06439876,4,0,4,0,1,1,0,0,1
06439913,5,2,3,0,1,1,0,0,0
06439986,3,0,3,0,0,0,0,0,1
06440096,3,1,2,0,1,1,0,0,0
06440198,23,15,8,0,0,0,0,0,1
06440267,3,3,0,0,0,0,0,0,0
06440378,5,3,2,0,3,3,0,0,1
06440464,7,2,5,0,2,2,0,0,1
06440620,17,2,15,0,0,0,0,0,1
06440822,5,0,5,0,0,0,0,0,1
06440824,5,0,5,0,0,0,0,0,1
06440861,5,0,5,0,0,0,0,0,1
06440922,5,2,3,0,1,1,0,0,1
06440969,3,0,3,0,0,0,0,0,1
06440993,7,4,3,0,3,3,0,0,1
06441063,24,2,22,0,1,1,0,1,1
06441150,9,0,9,0,0,0,0,0,1
06441350,7,4,3,0,1,1,0,0,1
06441382,5,0,5,0,0,0,0,0,1
06441426,33,13,20,0,0,0,0,0,1
06441533,6,0,6,0,0,0,0,0,1
06441549,6,4,2,0,2,2,0,0,1
06441589,6,4,2,0,1,1,0,1,1
06441617,3,3,0,0,1,1,0,0,0
06441704,8,0,8,0,0,0,0,0,1
06442028,18,5,13,0,1,1,0,1,1
06442102,3,3,0,0,2,2,0,0,0
06442133,5,3,2,0,1,1,0,0,1
06442134,5,0,5,0,0,0,0,0,1
06442137,5,0,5,0,0,0,0,0,1
06442232,5,0,5,0,0,0,0,0,1
06442235,5,0,5,0,0,0,0,0,1
06442236,5,0,5,0,1,1,0,1,1
06442276,6,4,2,0,1,1,0,1,1
06442490,6,0,6,0,0,0,0,0,1
06442595,4,3,1,0,2,2,0,0,1
06442628,35,15,20,0,6,3,3,0,1
06442668,15,5,10,0,0,0,0,0,0
06442875,6,2,4,0,1,1,0,0,1
06442932,5,3,2,0,1,1,0,1,1
06442948,6,2,4,0,1,1,0,0,1
06443083,5,1,4,0,1,1,0,0,1
06443474,5,3,2,0,1,1,0,1,1
06443476,5,0,5,0,0,0,0,0,1
06443528,5,2,3,0,1,1,0,1,1
06443612,5,0,5,0,0,0,0,0,1
06443669,5,0,5,0,0,0,0,0,1
06443698,5,0,5,0,0,0,0,0,1
06443703,8,7,1,0,0,0,0,0,0
06443736,6,2,4,0,1,1,0,0,1
04119112,18,4,14,0,1,1,0,0,1
04119278,15,3,12,0,2,1,1,1,1
04119491,6,3,3,0,1,1,0,1,0
04119516,6,2,4,0,0,0,0,0,1
04119581,45,13,32,0,0,0,0,0,1
04119644,8,3,5,0,1,1,0,1,0
04119659,27,5,22,0,1,1,0,1,1
04120060,26,9,17,0,0,0,0,0,1
04120189,11,0,11,0,0,0,0,0,1
04120286,18,5,13,0,1,1,0,1,1
04120303,23,6,17,0,0,0,0,0,1
04120344,43,11,32,0,0,0,0,0,1
04120415,12,3,9,0,0,0,0,0,0
04120521,10,0,10,0,0,0,0,0,1
04120531,9,2,7,0,1,1,0,0,1
04120583,9,2,7,0,1,1,0,0,1
04120608,9,2,7,0,1,1,0,0,1
04120627,10,2,8,0,1,1,0,0,1
04120739,13,0,13,0,0,0,0,0,1
04120826,22,0,22,0,0,0,0,0,1
04121117,53,0,53,0,0,0,0,0,1
04121422,9,0,9,0,1,1,0,1,1
04121650,14,3,11,0,2,2,0,2,1
04121681,21,2,19,0,1,1,0,1,1
04121875,10,2,8,0,2,2,0,0,0
04121894,10,0,10,0,1,1,0,1,1
04122078,19,3,16,1,1,1,0,1,1
04122343,6,1,5,0,1,1,0,0,0
04122355,16,5,11,0,0,0,0,0,1
04122358,27,0,27,0,0,0,0,0,1
04122636,24,8,16,0,0,0,0,0,1
04122675,28,6,22,0,0,0,0,0,0
04122784,18,5,13,0,1,1,0,1,1
04122795,18,5,13,0,1,1,0,1,1
04122959,12,4,8,0,1,1,0,1,1
04123100,19,6,13,0,0,0,0,0,1
04123307,8,3,5,0,2,2,0,0,0
04123475,19,0,19,0,0,0,0,0,1
04123578,15,0,15,0,0,0,0,0,1
04123885,9,1,8,0,1,1,0,0,0
04124330,5,3,2,0,1,1,0,0,1
04124438,12,0,12,0,0,0,0,0,1
04124727,10,0,10,0,2,2,0,2,1
04124728,9,7,2,0,1,1,0,0,1
04124749,10,0,10,0,2,2,0,2,1
04124758,10,0,10,0,2,2,0,2,1
04124777,21,0,21,0,0,0,0,0,1
04124813,7,4,3,0,1,1,0,0,1
04125139,46,9,37,0,0,0,0,0,1
04125287,7,0,7,0,0,0,0,0,1
04125326,23,5,18,0,0,0,0,0,1
04125327,16,0,16,0,0,0,0,0,1
04125371,18,4,14,0,7,6,1,1,1
04125713,28,11,17,0,4,4,0,0,1
04125764,43,8,35,0,0,0,0,0,1
04125784,5,3,2,0,2,2,0,0,0
04125925,8,4,4,0,3,1,2,0,1
04125984,26,3,23,0,1,1,0,1,1
04126050,15,0,15,0,0,0,0,0,1
04126355,8,2,6,0,2,1,1,0,0
04126826,30,4,26,0,1,1,0,1,1
04126944,11,0,11,0,0,0,0,0,1
04126958,34,4,30,0,1,1,0,1,1
04127077,36,5,31,0,0,0,0,0,1
04127557,8,0,8,0,0,0,0,0,1
04128034,17,4,13,0,2,2,0,0,0
04128687,49,13,36,0,1,1,0,1,1
04128804,12,1,11,0,2,2,0,1,0
04128820,17,3,14,0,1,1,0,1,1
04128850,32,4,28,0,0,0,0,0,1
04128862,14,2,12,0,1,1,0,1,1
04129083,10,3,7,0,1,1,0,1,1
04129103,16,5,11,0,1,1,0,1,1
04129132,16,4,12,0,1,1,0,1,1
04129141,10,2,8,0,2,1,1,1,1
04129242,6,2,4,0,1,0,1,0,1
04129360,11,0,11,0,0,0,0,0,1
04129383,4,0,4,0,0,0,0,0,1
04129499,9,2,7,0,1,1,0,0,0
04129500,19,4,15,0,1,1,0,1,1
04129523,12,5,7,0,4,4,0,0,1
04129558,14,5,9,0,0,0,0,0,0
04129587,11,2,9,0,1,1,0,0,1
04129701,18,11,7,0,0,0,0,0,0
04130096,11,3,8,0,1,1,0,1,1
04130113,49,10,39,0,10,0,10,0,0
04130320,12,3,9,0,0,0,0,0,1
04130543,3,2,1,0,1,1,0,0,1
04130566,34,3,31,0,1,1,0,1,1
04130831,5,3,2,0,2,2,0,0,0
04130878,27,3,24,0,1,1,0,1,1
04130898,26,3,23,0,1,1,0,1,1
04130914,4,2,2,0,1,1,0,0,0
04131025,10,2,8,0,0,0,0,0,1
04131084,0,0,0,0,0,0,0,0,1
04131100,15,0,15,0,0,0,0,0,1
04131293,41,2,39,0,2,2,0,0,1
04131376,12,3,9,0,1,1,0,1,1
04131409,9,0,9,0,1,1,0,1,0
04131534,26,4,22,0,1,1,0,1,1
04131879,26,3,23,0,1,1,0,1,1
04132120,11,0,11,0,0,0,0,0,1
04132205,38,5,33,0,1,1,0,1,1
04132393,20,3,17,0,1,1,0,1,1
04132464,6,2,4,0,1,1,0,0,1
04132469,6,2,4,0,1,1,0,0,1
04132544,22,0,22,0,0,0,0,0,1
04132577,25,3,22,0,1,1,0,1,1
04132704,47,3,44,0,1,1,0,1,1
04132712,16,4,12,0,0,0,0,0,0
04132730,6,0,6,0,0,0,0,0,1
04132733,11,2,9,0,1,1,0,0,0
04132819,11,0,11,0,0,0,0,0,1
04133346,87,23,64,0,0,0,0,0,1
04133585,42,3,39,0,1,1,0,1,1
04134325,7,0,7,0,0,0,0,0,1
04134398,41,11,30,0,0,0,0,0,1
04134550,25,4,21,0,1,1,0,1,1
04134584,5,3,2,0,1,1,0,0,0
04134697,35,3,32,0,1,1,0,1,1
04134714,19,0,19,0,1,1,0,1,1
04134744,23,0,23,0,1,1,0,1,1
04134765,6,5,1,0,4,4,0,0,1
04135183,8,5,3,0,1,1,0,0,1
04135223,11,0,11,0,0,0,0,0,1
04135225,33,8,25,0,0,0,0,0,1
04135229,11,4,7,0,1,1,0,1,1
04135307,18,6,12,0,1,0,1,1,1
04135596,20,4,16,0,1,1,0,1,1
04135634,4,0,4,0,0,0,0,0,1
04135802,16,2,14,0,0,0,0,0,1
04135947,10,0,10,0,1,1,0,0,1
04136011,2,2,0,0,1,1,0,0,0
04136093,6,3,3,0,1,1,0,0,0
04136336,7,4,3,0,1,1,0,0,0
04136371,4,1,3,0,1,1,0,0,1
04136636,8,1,7,0,1,1,0,0,1
04136936,12,1,11,0,2,0,2,0,1
04137191,25,3,22,0,0,0,0,0,1
04137272,29,4,25,0,1,1,0,1,1
04137280,19,6,13,0,1,1,0,0,1
04137300,12,3,9,0,1,1,0,1,1
04137375,16,1,15,0,1,1,0,1,1
04137460,15,0,15,0,0,0,0,0,1
04137550,56,8,48,0,2,1,1,2,1
04137582,11,0,11,0,2,2,0,2,1
04137673,11,0,11,0,2,2,0,2,1
04137812,11,0,11,0,2,2,0,2,1
04137826,11,0,11,0,2,2,0,2,1
04137890,38,6,32,0,1,1,0,1,1
04137894,11,0,11,0,2,2,0,2,1
04137901,11,0,11,0,2,2,0,2,1
04137976,11,0,11,0,2,2,0,2,1
04138232,18,2,16,0,1,1,0,1,1
04138254,14,0,14,0,0,0,0,0,1
04138348,19,4,15,0,1,1,0,0,0
04138448,61,15,46,0,1,1,0,0,1
04138515,5,3,2,0,1,1,0,0,1
04138550,10,5,5,0,0,0,0,0,0
04138787,21,0,21,0,0,0,0,0,1
04138790,4,0,4,0,0,0,0,0,1
04139040,16,1,15,0,2,1,1,2,1
04139057,4,0,4,0,0,0,0,0,1
04139124,29,0,29,0,1,1,0,1,1
04139129,17,0,17,0,0,0,0,0,1
04139141,32,0,32,0,1,1,0,1,1
04139144,29,1,28,0,1,1,0,1,1
04139328,15,0,15,0,1,1,0,1,1
04139763,14,5,9,0,1,1,0,1,1
04139770,14,5,9,0,1,1,0,1,1
04139777,14,5,9,0,1,1,0,1,1
04139999,13,0,13,0,0,0,0,0,1
04140357,25,3,22,0,0,0,0,0,1
04140379,21,8,13,0,0,0,0,0,1
04140442,15,2,13,0,1,1,0,1,1
04140444,8,0,8,0,0,0,0,0,1
04140467,23,4,19,0,1,1,0,1,1
04140517,9,5,4,0,1,1,0,0,1
04140658,13,1,12,0,2,2,0,1,1
04140715,5,3,2,0,2,2,0,0,0
04140761,12,2,10,0,1,1,0,0,1
04140970,22,3,19,0,0,0,0,0,1
04141197,12,2,10,0,9,7,2,0,1
04141277,6,2,4,0,1,1,0,1,1
04141322,28,3,25,0,1,1,0,1,1
04141352,10,0,10,0,0,0,0,0,1
04141403,9,0,9,0,1,1,0,1,1
04141452,11,8,3,0,0,0,0,0,0
04141481,6,2,4,0,1,1,0,0,1
04141483,35,4,31,0,1,1,0,1,1
04141546,12,5,7,0,0,0,0,0,1
04141767,57,0,57,0,2,1,1,2,1
04141854,29,6,23,0,0,0,0,0,0
04141946,21,0,21,0,0,0,0,0,1
04141953,34,11,23,0,0,0,0,0,1
04142070,4,3,1,0,2,2,0,0,0
04142158,32,0,32,0,0,0,0,0,1
04142410,5,3,2,0,2,2,0,0,0
04142505,10,5,5,0,1,1,0,0,1
04142723,8,3,5,0,1,1,0,0,0
04142850,32,8,24,0,0,0,0,0,1
04143066,5,2,3,0,2,2,0,0,0
04143588,21,6,15,0,0,0,0,0,1
04144116,4,1,3,0,1,1,0,0,1
04144259,6,3,3,0,1,1,0,0,1
04144412,16,5,11,0,1,1,0,1,1
04144486,17,5,12,0,1,1,0,1,1
04144719,8,3,5,0,2,1,1,1,1
04144745,73,12,61,0,0,0,0,0,1
04144764,16,1,15,0,2,2,0,2,1
04144791,19,4,15,0,2,2,0,2,1
04144911,19,2,17,0,1,1,0,1,1
04145018,14,0,14,0,0,0,0,0,1
04145068,5,3,2,0,2,2,0,0,1
04145262,31,8,23,0,1,1,0,1,0
04145329,32,2,30,0,1,1,0,1,1
04145357,15,10,5,0,0,0,0,0,1
04145421,9,0,9,0,1,1,0,1,1
04145427,9,0,9,0,1,1,0,1,1
04145431,8,0,8,0,1,1,0,1,1
04145482,19,4,15,0,1,1,0,1,1
04145508,9,0,9,0,1,1,0,1,1
04145522,11,3,8,0,1,1,0,1,1
04145536,7,0,7,0,0,0,0,0,1
04145584,40,16,24,0,0,0,0,0,1
04145595,20,4,16,0,4,0,4,0,1
04145901,8,3,5,0,0,0,0,0,1
09770083,3,3,0,0,0,0,0,0,0
09770355,5,5,0,0,1,1,0,1,0
09770360,5,5,0,0,1,1,0,1,0
09770814,2,2,0,0,1,1,0,0,0
09770996,1,0,1,0,1,1,0,0,0
09771349,5,2,3,0,2,0,2,0,0
09771439,2,2,0,0,2,2,0,0,0
09771509,1,0,1,0,1,1,0,1,0
09771556,12,7,5,0,1,1,0,1,1
09771559,3,3,0,0,3,2,1,1,0
09771570,1,1,0,0,1,1,0,0,0
09771586,11,6,5,0,1,1,0,1,1
09771968,1,1,0,0,2,2,0,1,0
09771974,16,6,10,0,2,1,1,2,1
09772068,8,4,4,0,3,1,2,1,1
09772405,11,6,5,0,1,1,0,1,1
09772695,2,1,1,0,2,1,1,0,0
09772715,3,3,0,0,2,2,0,0,1
09773108,9,3,6,0,1,1,0,0,1
09773197,1,0,1,0,1,1,0,0,0
09773548,6,2,4,1,4,1,3,1,0
09773632,4,0,4,0,0,0,0,0,1
09773776,5,3,2,0,1,0,1,0,1
09773963,5,2,3,0,1,1,0,1,1
09774005,3,3,0,0,2,2,0,0,1
09774291,3,3,0,0,1,1,0,1,1
09774296,13,11,2,0,1,1,0,1,1
09774447,2,1,1,0,1,1,0,1,0
09775048,2,1,1,0,1,1,0,1,0
09775601,4,0,4,0,3,1,2,0,0
09775645,2,2,0,0,2,2,0,0,0
09776090,3,3,0,0,1,1,0,0,1
09776264,5,4,1,0,1,1,0,0,1
09776461,2,2,0,0,1,1,0,0,0
09776888,2,2,0,0,2,2,0,0,1
09777155,2,0,2,0,2,2,0,0,0
09777273,5,0,5,0,3,3,0,0,1
09777713,4,4,0,0,4,4,0,0,0
09777885,5,3,2,0,2,1,1,1,1
09778970,3,2,1,0,2,2,0,0,1
09779111,3,0,3,0,0,0,0,0,1
09779405,7,1,6,0,2,2,0,1,1
09779572,2,2,0,0,1,1,0,0,0
09779593,6,4,2,0,1,1,0,1,1
09779626,1,1,0,0,1,1,0,0,1
09779671,3,0,3,0,0,0,0,0,0
09779672,4,2,2,0,3,1,2,1,1
09779726,8,7,1,0,6,6,0,0,0
09779893,1,0,1,0,0,0,0,0,0
09780382,10,5,5,0,1,1,0,1,1
09780469,2,2,0,0,2,2,0,0,1
09780864,1,1,0,0,1,1,0,0,0
09780898,2,0,2,0,1,1,0,0,0
09781403,6,2,4,0,4,2,2,0,0
09781551,2,0,2,0,1,1,0,0,0
09781909,2,0,2,0,2,2,0,0,0
09782095,4,4,0,0,5,4,1,2,1
09782134,5,3,2,0,1,1,0,1,1
09782141,1,1,0,0,1,1,0,0,0
09782451,5,2,3,0,1,1,0,1,1
09783560,3,3,0,0,2,2,0,0,0
09784069,2,0,2,0,1,1,0,0,0
09784084,2,1,1,0,1,1,0,0,0
09784104,1,0,1,0,1,1,0,0,0
09784367,12,7,5,0,1,1,0,1,1
09784540,4,3,1,0,2,1,1,0,1
09784671,2,1,1,0,1,1,0,0,0
09784699,4,2,2,0,0,0,0,0,1
09785103,3,3,0,0,1,1,0,1,0
09785255,26,4,22,0,3,3,0,0,1
09785647,2,2,0,0,2,2,0,0,0
09785652,10,8,2,0,0,0,0,0,1
09785677,2,2,0,0,1,1,0,0,0
09786059,1,0,1,0,1,1,0,0,0
09786142,1,1,0,0,1,1,0,0,0
09786487,2,2,0,0,2,2,0,0,0
09786852,1,1,0,0,1,1,0,0,0
09786902,2,2,0,0,2,2,0,0,0
09787749,7,4,3,0,1,1,0,1,1
09787994,6,4,2,0,1,1,0,0,1
09788260,1,1,0,0,1,1,0,0,1
09788786,1,0,1,0,1,1,0,0,0
09789655,2,1,1,0,1,1,0,0,0
09789712,3,2,1,0,1,1,0,0,0
09790047,6,3,3,0,2,1,1,0,1
09790718,5,5,0,0,1,1,0,1,1
09790731,2,1,1,0,2,1,1,0,1
09790912,8,4,4,0,1,1,0,1,1
09790918,8,4,4,0,3,1,2,3,1
09792029,3,3,0,0,2,2,0,0,0
09792152,6,0,6,0,2,1,1,0,1
09792222,1,1,0,0,1,1,0,0,0
09792223,1,0,1,0,1,1,0,0,0
09792330,1,0,1,0,1,1,0,0,0
09792556,4,3,1,0,3,2,1,0,0
09792655,8,7,1,0,0,0,0,0,0
09793309,11,5,6,0,0,0,0,0,1
09793871,1,0,1,0,0,0,0,0,0
09794147,5,4,1,0,1,1,0,1,1
09794154,9,4,5,0,1,1,0,1,1
09794223,14,6,8,0,3,1,2,1,1
09794274,9,4,5,0,1,1,0,1,1
09794280,10,5,5,0,1,0,1,1,1
09794281,10,5,5,0,1,1,0,1,1
09794282,10,5,5,0,2,1,1,2,1
09794696,4,0,4,0,1,1,0,0,0
09794968,1,1,0,0,1,1,0,0,0
09795185,3,2,1,0,1,1,0,0,0
09795251,4,2,2,0,2,1,1,0,0
09795354,1,0,1,0,0,0,0,0,1
09795392,2,1,1,0,1,1,0,1,1
09795636,12,4,8,0,1,1,0,1,1
09795638,12,4,8,0,1,1,0,1,1
09795648,12,4,8,0,1,1,0,1,1
09795731,1,1,0,0,1,1,0,0,0
09795849,1,1,0,0,1,1,0,0,0
09796240,12,10,2,0,0,0,0,0,0
09796309,2,1,1,0,2,2,0,0,0
09796498,2,2,0,0,2,2,0,0,0
09796521,2,2,0,0,1,1,0,0,1
09796577,3,2,1,0,1,1,0,0,0
09796817,2,2,0,0,2,2,0,0,0
09797419,3,3,0,0,2,2,0,0,1
09797737,1,0,1,0,1,1,0,0,1
09798581,6,1,5,0,1,1,0,0,1
09798915,2,1,1,0,2,1,1,0,0
09799292,2,2,0,0,2,2,0,0,0
09799746,2,1,1,0,1,1,0,0,0
09799854,6,6,0,0,5,5,0,0,1
09800151,1,1,0,0,1,1,0,0,1
09800947,1,0,1,0,1,1,0,0,0
09801125,2,1,1,0,1,1,0,0,0
09801175,2,1,1,0,1,1,0,0,1
09801446,2,2,0,0,2,2,0,0,1
09802152,4,2,2,0,3,2,1,0,0
09802249,12,4,8,0,1,1,0,1,1
09802468,4,4,0,0,3,3,0,0,1
09802788,11,3,8,0,1,1,0,1,1
09803063,1,1,0,0,1,1,0,0,0
09803652,2,1,1,0,2,1,1,1,0
09803844,2,0,2,0,1,1,0,0,1
09803857,1,0,1,0,0,0,0,0,1
09804130,8,6,2,0,1,1,0,1,1
09804584,1,0,1,0,0,0,0,0,0
09804622,1,0,1,0,1,1,0,0,0
09804637,3,2,1,0,0,0,0,0,0
09805103,6,4,2,0,2,1,1,1,0
09805111,1,0,1,0,0,0,0,0,1
09805293,6,1,5,0,1,1,0,0,1
09805388,1,1,0,0,1,1,0,0,0
09805543,3,1,2,0,1,1,0,0,0
09805744,4,4,0,0,4,3,1,1,0
09805821,9,9,0,1,0,0,0,0,1
09806108,6,6,0,0,0,0,0,0,1
09806176,6,0,6,0,1,1,0,0,1
09806193,2,1,1,0,1,1,0,0,0
09806267,2,2,0,0,1,1,0,0,0
09806821,1,0,1,0,0,0,0,0,0
09806885,1,0,1,0,1,1,0,0,0
09807268,6,4,2,0,2,1,1,0,0
09807631,6,4,2,0,2,1,1,0,0
09808293,2,2,0,0,1,1,0,0,0
09808833,2,2,0,0,0,0,0,0,1
09808857,2,0,2,0,2,1,1,0,0
09809040,6,5,1,0,0,0,0,0,0
09809046,3,3,0,0,2,2,0,0,1
09809724,1,1,0,0,1,1,0,0,0
09809767,9,5,4,0,0,0,0,0,1
09809921,1,1,0,0,0,0,0,0,0
09810170,1,1,0,0,1,1,0,0,0
09810465,3,3,0,0,3,3,0,0,0
09810763,5,4,1,0,3,0,3,0,1
09812491,3,0,3,0,1,1,0,0,1
09813175,1,1,0,0,1,1,0,0,1
09813246,4,1,3,0,1,1,0,0,0
09813307,1,1,0,0,1,1,0,0,0
09814021,4,3,1,0,4,3,1,1,0
09814183,2,0,2,0,0,0,0,0,0
09814246,1,0,1,0,2,2,0,0,1
09814498,2,2,0,0,2,2,0,0,0
09814832,5,3,2,0,1,1,0,1,1
09814839,1,1,0,0,1,1,0,0,0
09814968,1,0,1,0,1,1,0,0,0
09815017,6,3,3,0,2,1,1,1,1
09815202,6,4,2,0,4,4,0,0,0
09815232,2,2,0,0,2,2,0,0,0
09815605,2,2,0,0,2,2,0,0,1
09816333,6,3,3,0,2,1,1,0,0
09816334,8,3,5,0,1,1,0,1,1
09816385,7,6,1,0,0,0,0,0,1
09816484,4,4,0,0,3,3,0,0,1
09816531,1,0,1,0,1,1,0,0,0
09816694,1,0,1,0,0,0,0,0,1
09816945,8,5,3,0,0,0,0,0,1
09817082,1,0,1,0,1,1,0,0,0
09817571,6,6,0,0,2,1,1,1,1
09817580,6,6,0,0,2,1,1,1,1
09818161,2,2,0,0,1,1,0,0,1
09818265,1,0,1,0,0,0,0,0,1
09818460,1,1,0,0,1,1,0,0,0
09818831,1,0,1,0,1,1,0,0,0
09819634,4,3,1,0,1,1,0,1,1
09819644,4,2,2,0,3,1,2,1,0
09820173,2,0,2,0,0,0,0,0,0
09820183,8,0,8,0,0,0,0,0,1
09820421,2,2,0,0,1,1,0,0,0
09820568,8,7,1,0,1,0,1,0,1
09820920,1,0,1,0,1,1,0,0,1
09821420,1,1,0,0,3,1,2,0,0
09821856,1,1,0,0,1,1,0,0,0
09822374,2,0,2,0,2,1,1,0,0
09822404,1,0,1,0,0,0,0,0,0
09822597,22,10,12,0,0,0,0,0,1
09822627,2,0,2,0,0,0,0,0,0
09822657,1,1,0,0,1,1,0,0,0
09822724,1,1,0,0,1,1,0,0,0
09822774,2,0,2,0,1,1,0,0,0
09822875,2,2,0,0,1,1,0,1,0
09822893,1,1,0,0,1,1,0,0,0
09823178,2,2,0,0,2,2,0,0,0
09823494,1,1,0,0,1,1,0,0,0
09823615,2,1,1,0,1,1,0,0,0
09823652,2,2,0,0,1,1,0,0,0
09823670,2,2,0,0,0,0,0,0,0
09823943,1,1,0,0,1,1,0,0,0
09824205,3,3,0,0,2,2,0,0,0
09824411,1,0,1,0,1,1,0,0,0
09824573,4,3,1,0,1,1,0,1,1
09824870,3,0,3,0,1,1,0,1,1
09825029,1,1,0,0,1,1,0,0,1
09825172,2,0,2,0,0,0,0,0,1
09825444,4,1,3,0,1,1,0,1,0
09825527,5,5,0,0,1,1,0,0,0
09825656,1,0,1,0,0,0,0,0,1
09825663,1,1,0,0,1,1,0,0,0
09825710,8,5,3,0,1,0,1,1,1
09825905,2,2,0,0,1,1,0,0,0
09825935,2,1,1,0,1,1,0,0,0
09826166,3,3,0,0,1,1,0,1,0
09826669,11,5,6,0,3,3,0,0,1
09826735,2,2,0,0,1,1,0,1,0
09826758,10,5,5,0,3,3,0,0,1
09826773,10,5,5,0,3,3,0,0,1
09826774,7,6,1,0,0,0,0,0,1
09826787,46,16,30,0,0,0,0,0,1
09826824,2,2,0,0,2,2,0,0,1
09826941,1,1,0,0,1,1,0,0,0
09827313,1,1,0,0,1,1,0,0,0
09827460,2,2,0,0,2,2,0,0,0
09827741,2,1,1,0,2,1,1,0,1
09828156,2,1,1,0,0,0,0,0,0
09828793,1,0,1,0,1,1,0,0,0
09828874,1,1,0,0,1,1,0,0,1
09828928,8,0,8,0,1,1,0,1,1
09828971,1,1,0,0,1,1,0,0,0
09828986,3,0,3,0,1,1,0,1,0
09829080,8,4,4,0,3,2,1,3,1
09829770,1,1,0,0,1,1,0,0,0
09829878,1,1,0,0,1,1,0,0,0
09830007,1,1,0,0,2,1,1,0,0
09830051,2,0,2,0,1,1,0,0,1
09830054,1,1,0,0,2,2,0,0,1
09831081,2,2,0,0,1,1,0,0,1
09831198,1,1,0,0,1,1,0,0,1
09831286,2,2,0,0,1,1,0,0,0
09831332,4,4,0,0,0,0,0,0,0
09831869,2,1,1,0,1,1,0,0,0
09831894,2,2,0,0,1,1,0,1,1
09831909,2,2,0,0,1,1,0,1,1
09831926,2,2,0,0,1,1,0,1,1
09831948,2,2,0,0,1,1,0,1,1
09831988,2,2,0,0,1,1,0,1,1
09832178,1,1,0,0,2,2,0,0,0
09832381,1,0,1,0,1,1,0,0,0
09832582,7,2,5,0,3,3,0,0,1
09833178,1,1,0,0,1,1,0,0,0
09833371,1,0,1,0,0,0,0,0,0
09833391,3,3,0,0,1,1,0,0,0
09833396,1,0,1,0,0,0,0,0,0
09833747,15,6,9,0,1,1,0,1,1
09833945,4,0,4,0,1,1,0,0,0
09834084,6,4,2,0,1,1,0,1,1
09834735,1,1,0,0,1,1,0,0,0
09835077,1,1,0,0,1,1,0,0,0
09835272,1,1,0,0,1,1,0,0,0
09835312,2,0,2,0,1,1,0,0,1
09835443,2,0,2,0,1,1,0,0,0
09836034,1,1,0,0,1,1,0,0,0
09836249,1,0,1,0,0,0,0,0,1
09836264,2,1,1,0,1,1,0,0,0
09836627,14,8,6,0,0,0,0,0,1
09836842,1,1,0,0,1,1,0,1,0
09837381,1,0,1,0,1,1,0,0,0
09837401,2,0,2,0,1,1,0,0,0
09837651,2,2,0,0,1,1,0,0,0
09837720,3,0,3,0,1,1,0,0,0
09837962,1,1,0,0,1,1,0,0,0
09838286,2,0,2,0,2,2,0,0,0
09838335,1,0,1,0,0,0,0,0,0
09838384,6,3,3,0,0,0,0,0,1
09838461,2,2,0,0,2,2,0,0,0
09838581,1,0,1,0,0,0,0,0,1
09838661,1,0,1,0,0,0,0,0,0
09838757,6,2,4,0,2,1,1,2,1
09838838,1,1,0,0,3,1,2,1,0
09838960,2,0,2,0,2,2,0,0,0
09839257,3,3,0,0,1,1,0,0,0
09839322,2,0,2,0,1,1,0,0,0
09839414,9,3,6,0,1,1,0,1,1
09839481,2,2,0,0,2,2,0,0,0
09840061,2,2,0,0,2,2,0,0,1
09840181,6,2,4,0,1,1,0,0,0
09840281,1,1,0,0,1,1,0,0,0
09840409,2,2,0,0,2,2,0,0,1
09840577,3,1,2,0,0,0,0,0,1
09841328,2,0,2,0,2,2,0,0,0
09842110,1,0,1,0,1,1,0,0,1
09843188,4,4,0,0,0,0,0,0,1
09844031,2,1,1,0,1,1,0,0,0
09844502,16,5,11,0,3,1,2,3,1
09844523,4,3,1,0,0,0,0,0,0
09844711,1,1,0,0,1,1,0,0,0
09844732,3,2,1,0,2,1,1,2,0
09844805,12,5,7,0,1,1,0,1,1
09844938,1,0,1,0,1,1,0,0,0
04670219,4,0,4,0,1,1,0,0,1
04670276,19,5,14,0,0,0,0,0,0
04670417,9,1,8,0,1,1,0,0,1
04670427,6,0,6,0,0,0,0,0,1
04670562,8,3,5,0,2,2,0,0,1
04670570,13,2,11,0,0,0,0,0,0
04670571,12,10,2,0,0,0,0,0,1
04670617,14,4,10,0,1,1,0,1,1
04670754,4,4,0,0,3,3,0,0,0
04670795,4,2,2,0,1,1,0,0,0
04670804,5,3,2,0,2,2,0,0,0
04670961,8,3,5,0,0,0,0,0,0
04671020,22,2,20,0,1,1,0,1,1
04671421,40,0,40,0,1,1,0,1,1
04671563,5,3,2,0,0,0,0,0,0
04671645,12,1,11,0,0,0,0,0,1
04671977,7,4,3,0,1,1,0,0,0
04672292,40,2,38,0,0,0,0,0,1
04673075,9,0,9,0,0,0,0,0,1
04673175,32,14,18,0,0,0,0,0,1
04673193,8,0,8,0,0,0,0,0,1
04673202,13,4,9,0,2,2,0,0,1
04674213,5,3,2,0,1,1,0,0,1
04674817,26,5,21,0,1,1,0,1,1
04675264,6,2,4,0,1,1,0,0,0
04675439,14,3,11,0,2,2,0,0,1
04675453,17,0,17,0,0,0,0,0,1
04675657,28,7,21,0,0,0,0,0,0
04675720,14,4,10,0,0,0,0,0,1
04675801,24,0,24,0,0,0,0,0,1
04675911,7,3,4,0,3,3,0,0,0
04676006,7,4,3,0,1,1,0,1,1
04676470,6,3,3,0,1,1,0,1,1
04676473,7,1,6,0,2,2,0,0,1
04676572,41,0,41,0,1,1,0,1,1
04676590,36,0,36,0,1,1,0,1,1
04676602,35,0,35,0,1,1,0,1,1
04676870,14,2,12,0,1,1,0,1,0
04677103,16,4,12,0,1,1,0,1,1
04677597,19,6,13,0,0,0,0,0,0
04677768,5,3,2,0,1,1,0,0,0
04677863,4,0,4,0,1,1,0,0,0
04677925,8,2,6,0,1,1,0,0,1
04677951,5,3,2,0,2,2,0,0,0
04677961,9,5,4,0,0,0,0,0,1
04678161,19,7,12,0,0,0,0,0,1
04678356,4,2,2,0,2,2,0,0,0
04678382,17,7,10,0,0,0,0,0,1
04678522,5,3,2,0,2,2,0,0,1
04678537,6,3,3,0,1,1,0,0,0
04679298,9,6,3,0,1,1,0,0,1
04679458,40,6,34,0,1,1,0,1,1
04679597,9,5,4,0,1,1,0,1,0
04679643,4,1,3,0,2,2,0,0,0
04680088,5,3,2,0,2,2,0,0,0
04680474,5,3,2,0,2,2,0,0,0
04680739,14,0,14,0,0,0,0,0,1
04680748,15,4,11,0,2,2,0,0,1
04681156,9,4,5,0,0,0,0,0,0
04681159,13,4,9,0,2,1,1,1,1
04681228,35,0,35,0,0,0,0,0,1
04681461,4,0,4,0,0,0,0,0,0
04681599,13,3,10,0,1,1,0,1,1
04681724,6,2,4,0,1,1,0,0,0
04681891,13,0,13,0,0,0,0,0,1
04682066,3,2,1,0,1,1,0,0,1
04682088,19,1,18,0,1,1,0,1,1
04682208,75,29,46,0,0,0,0,0,0
04682244,7,3,4,0,2,2,0,0,1
04682257,7,3,4,0,1,1,0,1,1
04682293,6,4,2,0,1,1,0,0,1
04682347,9,2,7,0,2,2,0,0,1
04682436,5,0,5,0,0,0,0,0,0
04682514,23,0,23,0,0,0,0,0,1
04683163,6,0,6,0,0,0,0,0,0
04683430,6,4,2,0,3,2,1,0,1
04683683,18,3,15,0,1,1,0,1,1
04683843,14,0,14,0,0,0,0,0,1
04684034,45,9,36,0,1,1,0,1,1
04684104,14,0,14,0,0,0,0,0,1
04684127,24,10,14,0,0,0,0,0,1
04684165,9,0,9,0,0,0,0,0,1
04684691,7,3,4,0,1,1,0,0,0
04685252,9,3,6,0,2,2,0,0,0
04685439,9,0,9,0,0,0,0,0,1
04685453,4,0,4,0,0,0,0,0,1
04685532,6,1,5,0,1,1,0,0,0
04685546,6,1,5,0,1,1,0,0,0
04685732,5,3,2,0,2,2,0,0,0
04685842,7,2,5,0,2,2,0,0,1
04685947,18,0,18,0,0,0,0,0,1
04686026,8,0,8,0,1,1,0,0,0
04686860,21,2,19,0,1,1,0,1,1
04687048,5,3,2,0,2,2,0,0,0
04687753,8,2,6,0,2,2,0,0,0
04687799,24,4,20,0,0,0,0,0,0
04687877,6,1,5,0,2,1,1,1,1
04687880,6,1,5,0,2,1,1,1,1
04687884,6,1,5,0,2,1,1,1,1
04687892,6,1,5,0,2,1,1,1,1
04688544,8,2,6,0,1,1,0,1,1
04688545,5,1,4,0,1,1,0,0,0
04688590,22,3,19,0,1,1,0,1,1
04688610,18,3,15,0,1,1,0,1,1
04688632,18,3,15,0,1,1,0,1,1
04688740,37,22,15,0,0,0,0,0,0
04688758,8,3,5,0,1,1,0,0,0
04688824,5,3,2,0,2,2,0,0,0
04688927,3,0,3,0,4,2,2,0,0
04689062,16,4,12,0,1,1,0,1,1
04689125,6,0,6,0,0,0,0,0,1
04689130,26,4,22,0,1,0,1,0,1
04689191,6,1,5,0,2,1,1,1,1
04689413,3,2,1,0,1,1,0,0,0
04689558,6,5,1,0,0,0,0,0,1
04689828,4,3,1,0,2,2,0,0,0
04689911,7,0,7,0,1,1,0,0,1
04689950,15,10,5,0,9,9,0,0,0
04690183,3,1,2,0,1,1,0,0,0
04690411,10,0,10,0,0,0,0,0,1
04690712,16,0,16,1,0,0,0,0,1
04690961,4,2,2,0,1,1,0,0,1
04691176,24,5,19,0,6,4,2,0,1
04691575,21,4,17,0,1,1,0,0,1
04691604,17,5,12,0,1,1,0,1,1
04692207,9,2,7,0,1,1,0,0,1
04692388,13,2,11,0,2,2,0,2,1
04692616,4,2,2,0,2,2,0,0,1
04692883,4,0,4,0,0,0,0,0,1
04692993,5,3,2,0,1,1,0,1,1
04693084,5,0,5,0,0,0,0,0,1
04693357,10,0,10,0,0,0,0,0,1
04693440,5,3,2,0,2,2,0,0,0
04693848,6,1,5,0,1,1,0,0,0
04693934,5,2,3,0,1,1,0,0,0
04694002,2,2,0,0,2,2,0,0,0
04694045,11,2,9,0,1,1,0,0,1
04694798,19,0,19,0,0,0,0,0,1
04695434,10,5,5,0,1,1,0,0,1
04695597,5,0,5,0,0,0,0,0,1
04695706,6,0,6,0,0,0,0,0,0
04696047,8,3,5,0,1,1,0,0,1
04696505,5,2,3,0,1,1,0,0,1
04696691,14,0,14,0,0,0,0,0,1
04696751,12,0,12,0,0,0,0,0,1
04696833,13,0,13,0,1,1,0,1,1
04696839,27,4,23,0,7,1,6,4,1
04696878,15,3,12,0,1,1,0,1,0
04696882,14,3,11,0,1,1,0,1,0
04696971,6,4,2,0,1,1,0,0,0
04697004,18,4,14,0,1,1,0,1,1
04697051,6,3,3,0,2,2,0,0,1
04697125,7,0,7,0,0,0,0,0,1
04697300,12,2,10,0,1,1,0,1,1
04697602,64,10,54,0,0,0,0,0,0
04697650,4,2,2,0,1,1,0,1,1
04697779,7,3,4,0,2,2,0,0,1
04697839,4,2,2,0,1,1,0,0,1
04697883,24,5,19,0,2,2,0,0,1
04697889,6,2,4,0,1,1,0,0,1
04697898,8,3,5,0,2,2,0,0,1
04697927,7,2,5,0,2,2,0,0,1
04697928,7,2,5,0,2,2,0,0,1
04697930,6,0,6,0,0,0,0,0,1
04697936,7,2,5,0,1,1,0,0,1
04698093,22,5,17,0,1,1,0,1,1
04698146,15,4,11,0,0,0,0,0,1
04698400,18,2,16,0,1,1,0,1,1
04698669,9,0,9,0,1,1,0,0,1
04698690,5,3,2,0,1,1,0,0,1
04698808,9,3,6,0,3,3,0,0,1
04698817,32,0,32,0,0,0,0,0,1
04699036,11,4,7,0,0,0,0,0,1
04699155,10,5,5,0,0,0,0,0,1
04699209,13,0,13,0,0,0,0,0,1
04699267,10,0,10,0,0,0,0,0,1
04699401,31,1,30,0,1,1,0,1,0
04699484,3,2,1,0,2,2,0,0,0
04699524,11,2,9,0,11,11,0,11,1
04699732,49,0,49,0,0,0,0,0,1
04699779,3,2,1,0,1,1,0,0,0
04699825,42,17,25,0,0,0,0,0,1
04700445,6,3,3,0,1,1,0,0,1
04701097,4,1,3,0,1,1,0,0,0
04701158,8,6,2,0,0,0,0,0,0
04701175,5,3,2,0,2,2,0,0,1
04702025,8,3,5,0,2,1,1,1,1
04702108,7,2,5,0,1,1,0,0,0
04702271,27,3,24,0,1,1,0,1,1
04702654,5,3,2,0,2,2,0,0,0
04702946,16,9,7,0,1,1,0,1,1
04702958,5,3,2,0,1,1,0,0,0
04703172,10,3,7,0,0,0,0,0,1
04703206,5,2,3,0,1,1,0,1,1
04703224,19,7,12,0,1,1,0,1,1
04703975,9,3,6,0,0,0,0,0,1
04704399,12,0,12,0,0,0,0,0,1
04704728,18,4,14,0,1,1,0,1,1
04704729,4,1,3,0,0,0,0,0,1
04705025,9,2,7,0,1,1,0,0,0
04705067,15,7,8,0,0,0,0,0,1
04705100,24,5,19,0,1,1,0,1,1
04705207,7,2,5,0,2,1,1,0,1
04705315,4,2,2,0,1,1,0,0,0
04705365,18,6,12,0,0,0,0,0,1
04705848,13,4,9,0,1,1,0,1,1
04706060,7,2,5,0,1,1,0,0,1
04706331,6,0,6,0,0,0,0,0,1
04706447,10,3,7,0,1,1,0,0,1
04706529,19,0,19,0,0,0,0,0,1
04706691,5,2,3,0,1,1,0,0,0
04706776,4,2,2,0,1,1,0,0,0
04706898,4,2,2,0,1,1,0,0,1
04706913,22,0,22,0,0,0,0,0,1
04707293,7,3,4,0,4,4,0,0,0
04707328,20,5,15,0,1,1,0,1,1
04707422,4,2,2,0,1,1,0,0,0
04707794,6,2,4,0,2,2,0,0,1
04707842,10,4,6,0,0,0,0,0,1
04707857,14,0,14,0,0,0,0,0,1
04707932,10,0,10,0,0,0,0,0,1
04707996,9,2,7,0,0,0,0,0,1
04708272,8,0,8,0,0,0,0,0,1
04708528,5,3,2,0,1,1,0,0,0
04708641,5,0,5,0,0,0,0,0,1
04708856,6,1,5,0,1,1,0,0,0
04708868,6,3,3,0,3,3,0,0,0
04708897,5,2,3,0,2,2,0,0,0
04708929,5,0,5,0,0,0,0,0,1
04709081,19,3,16,0,1,1,0,1,1
04709270,10,4,6,0,1,1,0,1,1
04710047,5,2,3,0,1,1,0,0,0
04710234,10,4,6,0,1,1,0,0,1
04710243,6,2,4,0,2,2,0,0,0
04710434,4,1,3,0,1,1,0,0,0
04710574,18,7,11,0,3,1,2,2,1
04710701,5,0,5,0,0,0,0,0,0
04710761,26,8,18,0,0,0,0,0,0
04710789,43,6,37,0,1,1,0,0,0
04711682,12,2,10,0,1,1,0,1,1
04711859,4,3,1,0,2,2,0,0,0
04712027,5,3,2,0,1,1,0,0,1
04712136,5,1,4,1,1,1,0,0,1
04712782,10,3,7,0,2,2,0,0,1
04712925,11,0,11,0,0,0,0,0,1
04712990,7,1,6,0,1,1,0,0,1
04713134,22,2,20,0,1,1,0,1,1
04713302,5,0,5,0,2,2,0,0,0
04713417,7,3,4,0,3,3,0,0,0
04713887,33,0,33,0,0,0,0,0,1
04713977,7,2,5,0,1,1,0,0,1
04713985,5,2,3,0,1,1,0,0,1
04714015,10,1,9,0,1,1,0,0,1
04714039,11,4,7,0,2,2,0,0,1
04714406,18,3,15,0,0,0,0,0,1
04714526,4,0,4,0,2,2,0,0,0
03680535,26,4,22,0,1,1,0,1,1
03680601,12,5,7,0,0,0,0,0,1
03680673,15,2,13,0,0,0,0,0,1
03680702,9,2,7,0,2,2,0,1,1
03680931,6,0,6,0,0,0,0,0,1
03680937,39,3,36,0,1,1,0,1,1
03680951,31,3,28,0,1,1,0,1,1
03681188,8,0,8,0,1,1,0,1,1
03681199,24,2,22,0,1,1,0,1,1
03681557,7,0,7,0,0,0,0,0,1
03681753,15,0,15,0,0,0,0,0,1
03681869,12,5,7,0,1,1,0,0,1
03682104,5,2,3,0,2,2,0,0,0
03682203,16,0,16,0,0,0,0,0,1
03682218,20,4,16,0,1,1,0,1,1
03682385,7,3,4,0,2,2,0,0,1
03682671,5,0,5,0,0,0,0,0,1
03682804,16,2,14,0,1,1,0,1,1
03682822,15,5,10,0,2,1,1,1,0
03682831,12,2,10,0,0,0,0,0,0
03683003,25,7,18,0,1,1,0,0,1
03683014,35,9,26,0,0,0,0,0,1
03683292,11,1,10,0,1,1,0,1,1
03683344,13,5,8,0,3,3,0,0,1
03684034,32,5,27,0,0,0,0,0,1
03684577,16,9,7,0,4,1,3,1,0
03684674,6,1,5,0,1,1,0,0,1
03684736,6,4,2,0,1,1,0,0,1
03684761,5,0,5,0,2,2,0,0,1
03684770,18,3,15,0,1,1,0,1,1
03685043,25,4,21,0,1,1,0,1,1
03685051,15,3,12,0,1,1,0,1,1
03685161,30,6,24,0,1,1,0,1,1
03685167,35,0,35,0,1,1,0,1,1
03685337,13,0,13,0,0,0,0,0,1
03685428,12,0,12,0,1,1,0,1,1
03685477,24,10,14,0,0,0,0,0,1
03685553,49,9,40,0,0,0,0,0,1
03685684,5,4,1,0,3,3,0,0,1
03685725,4,2,2,0,1,1,0,0,1
03685753,39,7,32,0,0,0,0,0,1
03685787,31,2,29,0,0,0,0,0,1
03685803,10,0,10,0,0,0,0,0,1
03685968,15,0,15,0,0,0,0,0,1
03686187,8,4,4,0,3,3,0,1,1
03686219,21,0,21,0,0,0,0,0,1
03686262,12,0,12,0,1,1,0,0,1
03686284,43,11,32,0,3,3,0,0,0
03686309,37,21,16,0,1,1,0,1,1
03686487,5,2,3,0,1,1,0,0,0
03686665,17,5,12,0,0,0,0,0,1
03686740,14,1,13,0,1,1,0,1,1
03686837,13,3,10,0,0,0,0,0,0
03686910,18,2,16,0,1,1,0,1,1
03686914,19,0,19,0,0,0,0,0,1
03687193,6,1,5,0,2,2,0,0,1
03687396,103,11,92,0,0,0,0,0,1
03687688,39,11,28,0,1,1,0,0,1
03687879,6,1,5,0,3,1,2,0,0
03687910,54,5,49,0,0,0,0,0,1
03688303,18,0,18,0,0,0,0,0,1
03688405,19,0,19,0,0,0,0,0,1
03688701,8,4,4,0,0,0,0,0,1
03688817,42,12,30,0,1,1,0,1,0
03688839,21,0,21,0,1,1,0,1,1
03688872,21,5,16,0,0,0,0,0,0
03688927,18,1,17,1,1,1,0,0,1
03688949,46,8,38,0,0,0,0,0,1
03689006,36,0,36,0,0,0,0,0,1
03689105,15,0,15,0,0,0,0,0,1
03689127,14,4,10,0,1,1,0,1,1
03689320,6,4,2,0,2,2,0,0,0
03689508,31,6,25,0,3,3,0,3,1
03689584,20,2,18,0,1,1,0,1,1
03689599,13,0,13,0,0,0,0,0,1
03689727,48,2,46,0,1,1,0,1,1
03689966,37,2,35,0,1,1,0,1,1
03690055,7,2,5,0,1,1,0,0,0
03690057,8,0,8,0,1,1,0,1,1
03690060,11,3,8,0,1,1,0,1,1
03690065,62,5,57,0,1,1,0,1,1
03690115,10,4,6,0,1,1,0,1,1
03690277,37,10,27,0,0,0,0,0,0
03690823,17,4,13,0,0,0,0,0,0
03690916,101,14,87,0,0,0,0,0,1
03691175,24,4,20,0,0,0,0,0,1
03691242,15,4,11,0,1,1,0,0,1
03691291,28,8,20,0,1,1,0,1,1
03691756,13,3,10,0,1,1,0,1,1
03691770,4,1,3,0,1,1,0,0,1
03691800,21,0,21,0,0,0,0,0,1
03691898,46,9,37,0,1,1,0,1,1
03691917,38,11,27,0,1,1,0,0,1
03692001,20,2,18,0,1,1,0,1,1
03692140,7,2,5,0,1,1,0,0,1
03692172,28,6,22,0,0,0,0,0,1
03692917,5,1,4,0,1,1,0,0,0
03693032,12,4,8,0,0,0,0,0,1
03693103,9,0,9,0,0,0,0,0,1
03693245,10,3,7,0,4,4,0,0,1
03693626,18,2,16,0,2,2,0,1,1
03693892,10,2,8,0,1,1,0,0,1
03693914,32,4,28,0,2,2,0,2,1
03694409,26,4,22,0,1,1,0,1,1
03694613,26,6,20,0,0,0,0,0,1
03694734,7,2,5,0,1,1,0,1,0
03694779,9,3,6,0,2,2,0,0,1
03695114,48,10,38,0,0,0,0,0,1
03695161,14,4,10,0,1,1,0,1,1
03695235,28,10,18,0,0,0,0,0,0
03696164,5,2,3,0,1,1,0,0,0
03696187,14,3,11,0,0,0,0,0,1
03696339,21,5,16,0,4,3,1,1,1
03696562,28,0,28,0,0,0,0,0,1
03696564,70,15,55,0,1,1,0,1,1
03696615,21,2,19,0,1,1,0,1,1
03696638,14,0,14,0,0,0,0,0,1
03696650,14,0,14,0,0,0,0,0,1
03696654,44,11,33,0,3,1,2,3,1
03696656,33,4,29,0,0,0,0,0,1
03696681,56,11,45,0,15,2,13,0,1
03696830,5,0,5,0,2,2,0,0,1
03697015,43,13,30,0,1,1,0,1,1
03697358,53,22,31,0,1,1,0,1,1
03697438,10,3,7,0,1,1,0,0,1
03697505,39,5,34,0,1,1,0,1,1
03697507,24,0,24,0,0,0,0,0,1
03697525,25,3,22,0,2,1,1,2,0
03697765,24,4,20,0,0,0,0,0,1
03697962,6,0,6,0,0,0,0,0,1
03698048,6,4,2,0,2,2,0,0,0
03698243,10,5,5,0,1,1,0,0,1
03698720,5,2,3,0,1,1,0,0,0
03698902,5,2,3,0,1,1,0,0,1
03698922,10,3,7,0,1,1,0,1,0
03699269,48,7,41,0,0,0,0,0,0
03699279,10,3,7,0,2,2,0,0,1
03699735,8,2,6,0,1,1,0,0,1
03699792,13,5,8,0,1,1,0,1,0
03700019,4,1,3,0,2,1,1,0,1
03701005,29,4,25,0,1,1,0,1,1
03701101,5,2,3,0,1,1,0,0,1
03701224,6,0,6,0,0,0,0,0,1
03701328,16,2,14,0,1,1,0,1,1
03701610,36,4,32,0,0,0,0,0,1
03702070,5,0,5,0,0,0,0,0,1
03702208,16,10,6,0,0,0,0,0,1
03702428,35,3,32,0,1,1,0,1,1
03702545,24,9,15,0,0,0,0,0,1
03702575,25,4,21,0,1,1,0,1,1
03702727,7,2,5,0,0,0,0,0,1
03703097,25,3,22,0,2,1,1,2,1
03703182,22,7,15,0,1,1,0,1,1
03703240,29,0,29,0,1,1,0,1,1
03703370,11,4,7,0,3,3,0,0,1
03703643,28,0,28,0,0,0,0,0,1
03703703,14,3,11,0,4,3,1,1,0
03704346,5,3,2,0,2,2,0,0,1
03704495,49,0,49,0,0,0,0,0,1
03704603,6,2,4,0,1,1,0,0,1
03704778,10,0,10,0,0,0,0,0,1
03704874,17,6,11,0,0,0,0,0,1
03704978,19,0,19,0,0,0,0,0,1
03705039,14,2,12,0,0,0,0,0,1
03705788,23,8,15,0,2,2,0,0,0
03705809,38,2,36,0,3,1,2,3,1
03705992,41,7,34,0,1,1,0,1,1
03706064,18,4,14,0,1,1,0,1,1
03706914,11,0,11,0,0,0,0,0,1
03706946,5,3,2,0,2,2,0,0,1
03707214,46,5,41,0,1,1,0,1,1
03707221,47,5,42,0,1,1,0,1,1
03707223,52,4,48,0,1,1,0,1,1
03707246,19,3,16,1,0,0,0,0,1
03707697,11,4,7,1,0,0,0,0,1
03707787,18,3,15,0,1,1,0,1,1
03708031,4,2,2,0,1,1,0,0,0
03708250,5,2,3,0,1,1,0,0,1
03708517,17,3,14,0,1,1,0,1,1
03708834,26,4,22,0,1,1,0,1,1
03708940,12,3,9,0,1,1,0,1,1
03709392,19,3,16,0,0,0,0,0,1
03709465,9,0,9,0,1,1,0,1,1
03709565,33,9,24,0,0,0,0,0,0
03709785,30,3,27,0,1,1,0,1,1
03709922,5,0,5,0,2,2,0,0,1
03710232,9,3,6,0,1,1,0,1,1
03710297,13,0,13,0,0,0,0,0,1
03710407,23,5,18,0,2,1,1,2,1
03710529,11,2,9,0,0,0,0,0,1
03710536,77,23,54,0,1,1,0,1,1
03710549,12,2,10,0,0,0,0,0,0
03710736,6,3,3,0,1,1,0,0,0
03710765,7,2,5,0,1,1,0,0,0
03710781,7,4,3,0,3,3,0,0,0
03710937,64,7,57,0,2,1,1,2,1
03712058,8,2,6,0,1,1,0,0,1
03712188,29,6,23,0,1,1,0,1,1
03712283,37,5,32,0,0,0,0,0,1
03712295,8,1,7,0,1,1,0,0,0
03712556,5,3,2,0,1,1,0,0,1
03712813,47,4,43,0,1,1,0,1,1
03712966,7,3,4,0,1,1,0,1,0
03712972,17,4,13,0,1,1,0,1,1
03713030,10,3,7,0,4,4,0,2,1
03713154,5,0,5,0,1,1,0,0,0
03713328,99,20,79,0,0,0,0,0,1
03713679,30,1,29,0,1,1,0,1,1
03714138,6,2,4,0,1,1,0,0,1
03714277,12,2,10,0,1,1,0,1,1
03714361,34,9,25,0,1,1,0,1,1
03714428,12,0,12,0,1,1,0,1,1
03714444,4,0,4,0,0,0,0,0,0
03714547,8,0,8,0,0,0,0,0,1
03714633,21,4,17,0,1,1,0,0,0
03714669,15,3,12,0,1,1,0,1,0
03715032,16,0,16,0,1,1,0,0,1
03715044,20,4,16,0,1,1,0,1,0
03715081,12,3,9,0,2,2,0,0,1
03715221,12,7,5,0,1,1,0,1,0
03715349,25,8,17,0,0,0,0,0,1
03715375,5,3,2,0,1,1,0,0,0
03715387,6,3,3,0,2,2,0,0,0
03715409,5,2,3,0,1,1,0,0,1
03715410,36,5,31,0,1,1,0,1,1
03715419,6,4,2,0,3,3,0,0,0
03715615,27,4,23,0,1,1,0,1,1
03715690,29,0,29,0,0,0,0,0,1
03716362,30,4,26,0,1,1,0,1,1
03716519,16,2,14,0,1,1,0,1,1
03716604,5,2,3,0,1,1,0,0,1
03716738,36,0,36,0,1,1,0,1,1
03716749,17,1,16,0,1,1,0,0,1
03716907,10,2,8,0,1,1,0,0,1
03717464,13,3,10,0,2,2,0,0,1
03717664,26,7,19,0,0,0,0,0,0
03717973,10,0,10,0,0,0,0,0,1
03718193,9,2,7,0,1,1,0,0,1
03718283,6,2,4,0,1,1,0,0,1
03718338,61,10,51,0,0,0,0,0,1
03718505,10,0,10,0,0,0,0,0,1
03718801,19,0,19,0,0,0,0,0,1
03718955,11,4,7,0,3,3,0,0,1
03718976,15,0,15,0,0,0,0,0,1
03719020,15,4,11,0,0,0,0,0,1
03719208,8,0,8,0,0,0,0,0,1
03719293,23,3,20,0,1,1,0,1,1
03719472,18,3,15,0,1,1,0,1,1
03719634,24,8,16,0,1,1,0,1,1
03719637,18,0,18,0,0,0,0,0,1
03720071,18,4,14,0,1,1,0,1,1
03720135,9,3,6,0,1,1,0,0,0
03720141,11,6,5,0,1,1,0,1,1
03720188,35,8,27,0,0,0,0,0,1
03720195,44,0,44,0,0,0,0,0,1
03720217,14,2,12,0,5,5,0,2,1
03720393,17,3,14,0,1,1,0,1,1
03720434,6,3,3,0,2,2,0,0,1
03720483,8,4,4,0,1,1,0,0,0
03720556,21,2,19,0,1,1,0,0,1
03721232,8,1,7,0,1,1,0,1,1
03721374,12,3,9,0,3,1,2,3,1
03721556,5,3,2,0,2,2,0,0,1
03721564,42,13,29,0,0,0,0,0,1
03721723,69,7,62,0,0,0,0,0,1
03721837,11,4,7,0,3,3,0,0,0
03722585,5,3,2,0,0,0,0,0,0
03722587,28,0,28,0,0,0,0,0,1
03722673,9,4,5,0,2,2,0,0,1
03722693,34,2,32,0,0,0,0,0,1
03722790,33,6,27,0,1,1,0,0,0
03722939,15,3,12,0,0,0,0,0,1
03723180,27,4,23,0,0,0,0,0,1
03723445,9,2,7,0,3,3,0,1,1
03723561,19,0,19,0,0,0,0,0,1
03723929,7,1,6,0,1,1,0,0,0
03724051,22,2,20,0,1,1,0,1,1
03724275,29,10,19,0,0,0,0,0,1
03724277,45,4,41,0,1,1,0,1,1
03724572,4,2,2,0,1,1,0,0,1
03724823,4,1,3,0,1,1,0,0,1
03725015,41,7,34,0,1,1,0,1,1
03725026,30,3,27,0,1,1,0,1,1
03725037,53,0,53,0,1,1,0,1,1
03725039,36,4,32,0,1,1,0,1,1
03725600,5,3,2,0,1,1,0,0,0
03726262,12,3,9,0,0,0,0,0,1
03726264,17,0,17,0,0,0,0,0,1
03726272,18,3,15,0,1,1,0,1,1
03726292,21,3,18,0,1,1,0,1,1
03726471,47,7,40,0,0,0,0,0,1
03726482,8,2,6,0,0,0,0,0,1
03726512,5,0,5,0,0,0,0,0,1
03726537,11,3,8,0,2,2,0,0,1
03726682,4,0,4,0,1,1,0,0,0
03726807,3,3,0,0,1,1,0,0,1
03726930,16,6,10,0,2,2,0,2,1
03727166,9,2,7,0,0,0,0,0,1
03727210,19,3,16,0,0,0,0,0,1
03727496,6,1,5,0,1,1,0,0,1
03727663,14,0,14,0,0,0,0,0,1
03727702,14,0,14,0,0,0,0,0,1
03728244,59,20,39,0,1,1,0,0,1
03728739,8,3,5,0,1,1,0,1,0
03729073,18,3,15,0,1,1,0,1,1
03729125,14,4,10,0,1,1,0,1,1
03729646,18,3,15,0,1,1,0,1,1
03729878,9,2,7,0,0,0,0,0,1
03729913,25,0,25,0,1,1,0,1,1
03729917,16,0,16,0,0,0,0,0,1
03729928,26,7,19,0,1,1,0,1,1
03730009,7,0,7,0,0,0,0,0,0
03730065,12,1,11,0,1,1,0,1,1
03730130,8,2,6,0,1,1,0,1,1
03730131,10,3,7,0,0,0,0,0,0
03730139,8,2,6,0,1,1,0,1,1
03730141,4,0,4,0,0,0,0,0,0
03730147,22,3,19,0,2,1,1,2,1
03730602,34,2,32,0,1,1,0,1,1
03730788,7,0,7,0,0,0,0,0,1
03731200,46,0,46,0,0,0,0,0,1
03731267,11,3,8,0,1,1,0,1,1
03731333,8,0,8,0,0,0,0,0,0
03731439,4,2,2,0,1,1,0,0,1
03731605,12,2,10,0,1,1,0,1,0
03731620,10,4,6,0,0,0,0,0,1
03731797,20,4,16,0,4,3,1,0,0
03731819,16,5,11,0,0,0,0,0,1
03731886,7,0,7,0,0,0,0,0,1
03731938,6,0,6,0,0,0,0,0,1
03731943,35,9,26,0,0,0,0,0,1
03732115,12,4,8,0,2,2,0,0,1
03732127,8,3,5,0,2,2,0,0,1
03732200,5,3,2,0,2,2,0,0,0
03732253,23,6,17,0,0,0,0,0,1
03732285,6,2,4,0,1,1,0,0,1
03732513,28,4,24,0,1,1,0,1,1
03732607,22,0,22,0,0,0,0,0,1
03732835,13,5,8,0,1,1,0,0,1
03732993,33,0,33,0,0,0,0,0,0
03733058,22,3,19,0,1,1,0,1,1
03733077,27,3,24,0,1,1,0,1,1
03733088,22,4,18,0,1,1,0,1,1
03733663,4,2,2,0,1,1,0,0,0
03733679,11,0,11,0,1,1,0,1,1
03733859,10,4,6,0,0,0,0,0,0
03733939,20,5,15,0,0,0,0,0,1
03734124,4,1,3,0,1,1,0,0,1
03734423,17,2,15,0,1,1,0,1,1
03734456,10,2,8,0,2,2,0,0,0
03734472,20,5,15,0,1,1,0,1,1
03734892,4,2,2,0,1,1,0,0,0
03735007,14,4,10,0,2,1,1,1,1
03735154,19,5,14,0,1,1,0,1,1
03735333,5,2,3,0,1,1,0,0,0
03735433,9,1,8,0,1,1,0,1,0
03735884,5,3,2,0,2,2,0,0,1
03736192,11,0,11,0,0,0,0,0,1
03736485,5,0,5,0,1,1,0,0,0
03736692,8,2,6,0,1,1,0,1,1
03736751,18,0,18,0,1,1,0,1,1
03736895,6,3,3,0,2,2,0,0,0
03736918,24,0,24,0,0,0,0,0,1
03737171,5,0,5,0,0,0,0,0,0
03737260,23,2,21,0,0,0,0,0,1
03737629,9,2,7,0,2,2,0,2,1
03737642,10,2,8,0,1,1,0,0,0
03737678,5,0,5,0,2,2,0,0,1
03170141,25,3,22,0,1,1,0,0,1
03170142,35,2,33,0,0,0,0,0,1
03170306,39,5,34,0,0,0,0,0,1
03170972,6,2,4,0,1,1,0,0,1
03171110,31,4,27,0,0,0,0,0,1
03171118,16,0,16,0,0,0,0,0,1
03171162,29,0,29,0,0,0,0,0,1
03171320,44,12,32,0,1,1,0,1,1
03171326,9,1,8,0,1,1,0,0,1
03171596,4,1,3,0,1,1,0,0,1
03171767,5,2,3,0,1,1,0,0,0
03171822,8,0,8,0,0,0,0,0,1
03171961,14,3,11,0,1,1,0,1,1
03172032,23,3,20,0,1,1,0,1,1
03172073,6,1,5,0,1,1,0,0,1
03172290,5,1,4,0,1,1,0,0,1
03172527,29,3,26,0,1,1,0,1,1
03172543,37,5,32,0,1,1,0,0,0
03172713,77,10,67,0,1,1,0,0,1
03173395,11,0,11,0,0,0,0,0,1
03173410,19,0,19,0,0,0,0,0,1
03173414,81,10,71,0,0,0,0,0,1
03173418,69,8,61,0,1,1,0,1,1
03173461,5,0,5,0,0,0,0,0,1
03173552,42,4,38,0,1,1,0,1,1
03173666,22,3,19,0,1,1,0,1,1
03173815,30,8,22,0,1,1,0,1,1
03173890,24,7,17,0,0,0,0,0,1
03173933,8,3,5,0,1,1,0,0,0
03173991,38,3,35,0,2,2,0,1,1
03173996,14,1,13,0,0,0,0,0,1
03174160,31,0,31,0,0,0,0,0,1
03174367,30,7,23,0,0,0,0,0,1
03174637,47,0,47,0,1,1,0,1,1
03174665,25,5,20,0,1,1,0,1,1
03174667,39,2,37,0,1,1,0,1,1
03174756,20,4,16,0,1,1,0,1,1
03174874,7,1,6,0,1,1,0,0,1
03174904,10,3,7,0,1,1,0,1,1
03174932,41,5,36,0,0,0,0,0,1
03175203,93,14,79,0,0,0,0,0,1
03175221,4,1,3,0,1,1,0,0,0
03175234,4,0,4,0,0,0,0,0,1
03175443,63,10,53,0,0,0,0,0,1
03175497,10,3,7,0,1,1,0,1,1
03175565,8,1,7,0,1,1,0,0,0
03175758,20,6,14,0,0,0,0,0,1
03175892,11,5,6,1,1,1,0,0,1
03175909,33,0,33,0,1,1,0,1,1
03176107,16,3,13,0,2,2,0,2,1
03176659,4,1,3,0,1,1,0,0,1
03176906,53,7,46,0,1,1,0,1,1
03176922,8,4,4,0,3,3,0,0,0
03177091,14,5,9,0,0,0,0,0,1
03177133,7,0,7,0,0,0,0,0,1
03177211,17,1,16,0,1,1,0,0,0
03177263,15,2,13,0,1,1,0,0,1
03177280,17,3,14,0,2,2,0,0,1
03177372,6,2,4,0,1,1,0,0,1
03177407,8,3,5,0,2,2,0,0,0
03177754,16,5,11,0,1,1,0,0,1
03178522,14,0,14,0,0,0,0,0,1
03178571,18,0,18,0,0,0,0,0,1
03178602,5,3,2,0,2,2,0,0,1
03178606,10,0,10,0,1,1,0,0,0
03178925,18,0,18,0,0,0,0,0,1
03179063,72,12,60,0,17,13,4,0,1
03179265,17,4,13,0,0,0,0,0,1
03179314,43,8,35,0,1,1,0,1,1
03179462,10,4,6,0,0,0,0,0,1
03179528,8,2,6,0,1,1,0,1,0
03179628,30,0,30,0,1,1,0,1,1
03179707,18,5,13,0,0,0,0,0,1
03179785,71,8,63,0,0,0,0,0,1
03180066,9,2,7,0,2,2,0,0,1
03180164,21,4,17,0,0,0,0,0,1
03180355,22,6,16,0,0,0,0,0,1
03180361,35,7,28,0,3,2,1,0,1
03180455,5,0,5,0,0,0,0,0,1
03180484,6,1,5,0,1,1,0,0,0
03180490,12,0,12,0,1,1,0,1,1
03180496,30,0,30,0,0,0,0,0,1
03180927,15,6,9,0,2,1,1,1,0
03181013,8,0,8,0,0,0,0,0,1
03181132,7,3,4,0,1,1,0,1,0
03181383,12,2,10,0,0,0,0,0,1
03181389,12,2,10,0,0,0,0,0,1
03181463,15,6,9,0,0,0,0,0,1
03181570,5,3,2,0,2,2,0,0,1
03181571,5,3,2,0,2,2,0,0,1
03181629,35,9,26,0,5,5,0,0,0
03181671,12,3,9,0,1,1,0,1,1
03181874,19,0,19,0,0,0,0,0,1
03182025,7,0,7,0,0,0,0,0,1
03182140,10,0,10,0,0,0,0,0,0
03182188,4,1,3,0,1,1,0,0,1
03182378,15,1,14,0,1,1,0,1,1
03182433,11,0,11,0,0,0,0,0,1
03182741,31,0,31,0,0,0,0,0,1
03182770,24,0,24,0,0,0,0,0,1
03182775,36,1,35,0,1,1,0,1,1
03182827,49,9,40,0,0,0,0,0,1
03183595,18,2,16,0,1,1,0,1,1
03183815,5,2,3,0,1,1,0,0,1
03183919,20,6,14,0,0,0,0,0,1
03183968,6,1,5,0,1,1,0,0,1
03184234,33,5,28,0,0,0,0,0,0
03184309,24,3,21,0,1,1,0,1,1
03184319,26,3,23,0,0,0,0,0,1
03184332,27,4,23,0,1,1,0,1,1
03184583,18,6,12,0,2,1,1,1,0
03184629,4,2,2,0,2,2,0,0,1
03184724,7,2,5,0,1,1,0,0,0
03184750,23,0,23,0,0,0,0,0,1
03185047,28,4,24,0,1,1,0,1,1
03185107,12,0,12,0,1,1,0,0,0
03185132,6,0,6,0,1,1,0,1,1
03185151,6,0,6,0,0,0,0,0,1
03185249,10,1,9,0,0,0,0,0,0
03185896,8,2,6,0,2,2,0,0,1
03185923,34,2,32,0,1,1,0,1,1
03186043,29,4,25,0,1,1,0,1,1
03186364,40,4,36,0,1,1,0,1,1
03186541,47,7,40,0,0,0,0,0,1
03186655,18,4,14,0,2,2,0,2,1
03186915,5,2,3,0,2,2,0,0,0
03187034,14,0,14,0,1,1,0,1,1
03187038,13,3,10,0,1,1,0,1,1
03187287,17,0,17,0,1,1,0,0,1
03187571,18,0,18,0,0,0,0,0,1
03188002,32,3,29,0,1,1,0,1,1
03188068,0,0,0,0,0,0,0,0,0
03188476,17,1,16,0,1,1,0,0,1
03188580,12,1,11,0,1,1,0,0,1
03188787,34,6,28,0,0,0,0,0,1
03188792,9,3,6,0,1,1,0,1,1
03189176,29,0,29,0,0,0,0,0,1
03189185,44,3,41,0,2,1,1,2,0
03189363,40,0,40,0,1,1,0,1,1
03189443,34,7,27,0,0,0,0,0,1
03189566,6,2,4,0,1,1,0,0,1
03189630,40,7,33,0,4,1,3,2,0
03189671,34,6,28,0,1,1,0,1,1
03189911,11,0,11,0,1,1,0,1,1
03190491,13,0,13,0,0,0,0,0,1
03190519,52,10,42,0,0,0,0,0,1
03190602,9,3,6,0,1,1,0,0,1
03190609,8,3,5,0,0,0,0,0,1
03190618,12,4,8,0,3,1,2,1,1
03190619,27,3,24,0,0,0,0,0,0
03191152,15,3,12,1,2,2,0,2,1
03191370,26,6,20,0,1,1,0,1,1
03191538,20,4,16,0,1,1,0,1,1
03191639,22,5,17,0,1,1,0,1,1
03191734,28,5,23,0,0,0,0,0,1
03191793,6,2,4,0,1,1,0,0,0
03191955,71,8,63,0,0,0,0,0,1
03192004,10,2,8,0,0,0,0,0,1
03192400,25,2,23,0,0,0,0,0,1
03192424,16,3,13,0,2,1,1,0,0
03192534,7,0,7,0,0,0,0,0,1
03193203,18,7,11,0,1,1,0,1,1
03193400,71,8,63,0,0,0,0,0,0
03193661,8,2,6,0,1,1,0,0,1
03193672,7,0,7,0,0,0,0,0,1
03193844,13,0,13,0,0,0,0,0,1
03193979,26,2,24,0,1,1,0,1,1
03194230,4,0,4,0,0,0,0,0,1
03194476,43,9,34,0,0,0,0,0,1
03194626,9,4,5,0,1,1,0,0,1
03194731,55,10,45,0,0,0,0,0,1
03194733,48,4,44,0,1,1,0,1,1
03194985,21,2,19,0,1,1,0,1,1
03194991,24,7,17,0,0,0,0,0,1
03195027,5,0,5,0,0,0,0,0,1
03195123,4,2,2,0,0,0,0,0,0
03195198,6,2,4,0,2,2,0,0,0
03195293,7,2,5,0,1,1,0,0,0
03195344,6,4,2,0,1,1,0,1,1
03195527,19,3,16,0,1,1,0,1,1
03195584,45,3,42,0,1,1,0,1,1
03195723,52,0,52,0,0,0,0,0,1
03195829,7,0,7,0,1,1,0,0,1
03195878,48,6,42,0,2,1,1,0,1
03196171,80,12,68,0,1,1,0,1,1
03196204,41,6,35,0,1,1,0,1,1
03196209,74,14,60,0,0,0,0,0,1
03196335,43,5,38,0,1,1,0,0,0
03196483,5,3,2,0,2,2,0,0,0
03196532,28,3,25,0,1,1,0,1,1
03196691,27,9,18,0,0,0,0,0,1
03196714,34,1,33,0,1,1,0,1,1
03196892,4,0,4,0,0,0,0,0,0
03197138,12,3,9,0,2,2,0,0,1
03197142,17,0,17,0,0,0,0,0,1
03197210,4,2,2,0,2,2,0,0,1
03197238,9,0,9,0,0,0,0,0,1
03197263,10,0,10,0,0,0,0,0,1
03197318,24,4,20,0,1,1,0,1,1
03197327,5,1,4,0,1,1,0,1,0
03197645,37,2,35,0,1,1,0,1,1
03197756,61,5,56,0,3,3,0,0,1
03198223,4,1,3,0,1,1,0,0,1
03198299,23,4,19,0,1,1,0,1,1
03198488,7,5,2,0,2,2,0,0,0
03198718,22,2,20,0,1,1,0,1,1
03198904,18,2,16,0,0,0,0,0,1
03199423,32,6,26,0,8,6,2,1,1
03199618,6,2,4,0,1,1,0,0,0
03199626,5,3,2,0,1,1,0,0,0
03199656,20,0,20,0,0,0,0,0,1
03199745,19,2,17,0,1,1,0,1,1
02740084,14,2,12,0,1,1,0,0,1
02740157,0,0,0,0,0,0,0,0,1
02740316,15,3,12,0,0,0,0,0,1
02740378,32,5,27,0,1,1,0,1,1
02740621,4,2,2,0,1,1,0,0,0
02740665,46,12,34,0,0,0,0,0,1
02740753,7,3,4,0,1,1,0,0,1
02740842,9,1,8,0,1,1,0,0,0
02740910,39,3,36,0,1,1,0,1,1
02740965,8,2,6,0,1,1,0,0,0
02741358,7,2,5,0,1,1,0,0,0
02742166,6,3,3,0,1,1,0,0,0
02742455,7,5,2,0,1,1,0,1,1
02742764,40,0,40,0,0,0,0,0,1
02742969,45,5,40,0,1,1,0,1,1
02743032,28,0,28,0,0,0,0,0,1
02743223,5,0,5,0,1,1,0,0,0
02743557,0,0,0,0,0,0,0,0,1
02743897,36,0,36,0,0,0,0,0,1
02744333,37,0,37,0,0,0,0,0,1
02744549,11,2,9,0,2,2,0,0,1
02744696,26,2,24,0,1,1,0,1,1
02744892,151,3,148,0,0,0,0,0,1
02744995,25,7,18,0,0,0,0,0,1
02745602,34,0,34,0,1,1,0,1,1
02745903,17,0,17,0,0,0,0,0,1
02745919,12,0,12,0,0,0,0,0,1
02746083,43,8,35,0,1,1,0,1,1
02746356,17,0,17,0,0,0,0,0,1
02746405,30,0,30,0,0,0,0,0,1
02746479,19,5,14,0,1,1,0,1,1
02746530,15,5,10,0,0,0,0,0,1
02746610,14,0,14,0,0,0,0,0,1
02746616,68,3,65,0,1,1,0,1,1
02746621,46,3,43,0,1,1,0,1,1
02746627,10,0,10,0,0,0,0,0,1
02746641,37,5,32,0,1,1,0,1,1
02746655,13,0,13,0,0,0,0,0,1
02746733,29,3,26,0,1,1,0,1,1
02746998,13,2,11,0,2,2,0,0,0
02747008,30,3,27,0,1,1,0,1,1
02747011,11,4,7,0,1,1,0,0,0
02747525,10,3,7,0,1,1,0,0,1
02747859,5,2,3,0,4,2,2,0,0
02747901,28,5,23,0,1,1,0,1,1
02747909,36,3,33,0,1,1,0,1,1
02747911,19,0,19,0,0,0,0,0,1
02747934,19,6,13,0,0,0,0,0,1
02747977,4,2,2,0,1,1,0,0,0
02748260,12,4,8,0,3,3,0,0,0
02748342,5,0,5,0,0,0,0,0,1
02748408,61,6,55,0,0,0,0,0,1
02748477,37,5,32,0,1,1,0,1,1
02748501,39,2,37,0,1,1,0,1,1
02748513,10,3,7,0,3,3,0,1,0
02748659,36,7,29,0,1,1,0,0,1
02748840,47,8,39,0,0,0,0,0,1
02748954,5,3,2,0,1,1,0,1,1
02749030,25,12,13,0,0,0,0,0,1
02749292,21,2,19,0,1,1,0,1,1
02749367,0,0,0,0,0,0,0,0,1
02749500,22,0,22,0,1,1,0,1,1
02749523,35,0,35,0,0,0,0,0,1
02749624,34,4,30,0,1,1,0,1,1
02749692,17,0,17,0,0,0,0,0,1
02749784,24,3,21,0,1,1,0,1,1
02749785,17,7,10,0,1,1,0,1,1
02750459,17,3,14,0,1,1,0,1,1
02750711,4,1,3,0,0,0,0,0,0
02751104,35,11,24,0,0,0,0,0,1
02751106,20,2,18,0,1,1,0,0,0
02751131,11,3,8,0,0,0,0,0,0
02751186,23,0,23,0,1,1,0,1,1
02751196,37,0,37,0,0,0,0,0,1
02751304,12,0,12,0,0,0,0,0,1
02751404,15,6,9,0,1,1,0,1,0
02751460,17,4,13,0,1,1,0,1,1
02751470,54,0,54,0,0,0,0,0,1
02751549,77,13,64,0,0,0,0,0,1
02751669,44,2,42,0,0,0,0,0,1
02751922,7,2,5,0,1,1,0,0,1
02751955,16,3,13,0,0,0,0,0,1
02752056,4,3,1,0,2,2,0,0,1
02752154,52,3,49,0,1,1,0,1,1
02752337,11,3,8,0,1,1,0,1,1
02752603,27,6,21,0,1,1,0,1,1
02752793,76,9,67,0,1,1,0,1,0
02752811,22,7,15,0,1,1,0,1,0
02752982,291,7,284,0,3,1,2,3,1
02753023,102,4,98,0,4,0,4,0,1
02753142,31,1,30,0,3,1,2,0,1
02753246,27,0,27,0,0,0,0,0,1
02753743,7,0,7,0,0,0,0,0,1
02754010,37,0,37,0,0,0,0,0,1
02754054,5,3,2,0,1,1,0,0,1
02754057,7,5,2,0,5,5,0,0,1
02754104,25,4,21,0,1,1,0,1,1
02754249,19,4,15,0,1,1,0,1,1
02754253,18,4,14,0,1,1,0,1,1
02754458,0,0,0,0,0,0,0,0,1
02754525,33,8,25,0,0,0,0,0,1
02754744,12,4,8,0,1,1,0,1,1
02754784,26,3,23,0,1,1,0,1,1
02754884,6,2,4,0,1,1,0,0,1
02754921,19,4,15,0,1,1,0,1,1
02754943,34,5,29,0,1,1,0,1,1
02755423,23,0,23,0,0,0,0,0,1
02755578,16,0,16,0,1,1,0,1,1
02755583,53,6,47,0,0,0,0,0,0
02755730,30,5,25,0,1,1,0,1,1
02755791,7,3,4,0,0,0,0,0,1
02755827,16,3,13,0,1,1,0,1,1
02756034,11,0,11,0,0,0,0,0,1
02756105,7,5,2,0,2,2,0,0,0
02756193,7,3,4,0,2,2,0,0,1
02756466,23,0,23,0,0,0,0,0,1
02756521,173,14,159,0,0,0,0,0,1
02756660,128,53,75,0,1,1,0,0,0
02756795,25,8,17,0,0,0,0,0,1
02756971,6,3,3,0,0,0,0,0,1
02757039,35,0,35,0,0,0,0,0,1
02757055,40,11,29,0,0,0,0,0,1
02757062,59,13,46,0,1,1,0,1,1
02757614,7,3,4,0,1,1,0,0,0
02757622,6,2,4,0,1,1,0,0,0
02757675,39,6,33,0,0,0,0,0,0
02757677,42,3,39,0,2,1,1,2,1
02757681,21,2,19,0,1,1,0,1,1
02757768,69,7,62,0,1,1,0,1,1
02757907,17,4,13,0,1,1,0,1,1
02758130,10,1,9,1,0,0,0,0,0
02758408,19,5,14,0,1,1,0,1,1
02758419,5,3,2,0,2,2,0,0,1
02758433,60,0,60,0,0,0,0,0,1
02758844,9,3,6,0,1,1,0,0,1
02758851,15,3,12,0,4,4,0,1,1
02759174,44,6,38,0,1,1,0,1,1
02759428,54,3,51,0,1,1,0,1,1
02759673,35,0,35,0,0,0,0,0,1
02759759,14,4,10,0,7,5,2,0,0
02759806,11,4,7,0,4,4,0,1,0
02760393,80,4,76,0,0,0,0,0,1
02760491,18,1,17,0,2,1,1,2,1
02761034,19,0,19,0,0,0,0,0,1
02761410,8,3,5,0,0,0,0,0,0
02761574,25,5,20,0,1,1,0,1,1
02761796,18,4,14,0,1,1,0,1,1
02762169,9,4,5,0,1,1,0,0,1
02762173,8,0,8,0,0,0,0,0,1
02762283,16,6,10,0,0,0,0,0,1
02762287,28,6,22,0,0,0,0,0,1
02762460,35,2,33,0,1,1,0,1,1
02762570,8,0,8,0,0,0,0,0,1
02762675,24,3,21,0,0,0,0,0,1
02762691,16,4,12,0,0,0,0,0,1
02762721,28,3,25,0,1,1,0,1,1
02762729,15,2,13,0,1,1,0,1,1
02762774,7,0,7,0,0,0,0,0,1
02762823,7,2,5,0,1,1,0,0,1
02762989,9,3,6,0,1,1,0,1,1
02762997,20,5,15,0,1,1,0,1,1
02763030,16,0,16,0,1,1,0,1,1
02763177,19,8,11,0,1,1,0,0,1
02763263,23,4,19,0,1,1,0,1,1
02763400,40,3,37,0,1,1,0,1,1
02763560,13,3,10,0,1,1,0,0,1
02763611,20,2,18,0,1,1,0,1,1
02763658,17,3,14,0,1,1,0,1,1
02763667,35,3,32,0,1,1,0,1,1
02763688,57,5,52,0,1,1,0,1,1
02763992,83,10,73,0,0,0,0,0,1
02764183,62,11,51,0,0,0,0,0,1
02764525,62,8,54,0,5,0,5,0,1
02765006,5,2,3,0,1,1,0,0,0
02765110,10,3,7,0,1,1,0,1,0
02765223,9,1,8,0,1,1,0,1,1
02765282,30,4,26,0,1,1,0,1,1
02765546,10,0,10,0,0,0,0,0,1
02765697,0,0,0,0,0,0,0,0,1
02765705,13,0,13,0,1,1,0,0,0
02765744,107,25,82,0,0,0,0,0,1
02765769,14,3,11,0,1,1,0,0,1
02766114,10,4,6,0,0,0,0,0,1
02766255,28,1,27,0,1,1,0,1,1
02766258,25,0,25,0,1,1,0,1,1
02766324,25,5,20,0,1,1,0,1,1
02766339,14,3,11,0,2,2,0,0,1
02766412,27,0,27,0,0,0,0,0,1
02766993,67,15,52,0,2,2,0,2,1
02767055,83,9,74,0,3,1,2,0,1
02767184,32,5,27,0,1,1,0,1,1
02767224,28,4,24,0,1,1,0,1,1
02767551,19,5,14,0,0,0,0,0,1
02767558,38,12,26,0,1,1,0,1,1
02767742,40,2,38,0,3,2,1,0,1
02767796,15,0,15,0,0,0,0,0,1
02767875,30,3,27,0,1,1,0,1,1
02767932,6,0,6,0,1,1,0,0,1
02767939,45,3,42,0,1,1,0,1,1
02767942,69,12,57,0,0,0,0,0,1
02768136,12,3,9,0,1,1,0,1,1
02768525,9,3,6,0,1,1,0,1,0
02768587,11,4,7,0,1,1,0,1,1
02768796,19,3,16,0,1,1,0,1,1
02769250,24,4,20,0,1,1,0,1,1
02769350,27,0,27,0,0,0,0,0,1
02769631,7,2,5,0,1,1,0,1,1
02769778,24,3,21,0,0,0,0,0,1
02769904,52,4,48,0,1,1,0,1,1
02770197,8,5,3,0,1,1,0,0,0
02770257,73,8,65,0,0,0,0,0,1
02770415,20,6,14,0,0,0,0,0,0
02770495,4,0,4,0,1,1,0,0,0
02770744,5,3,2,0,2,2,0,0,1
02770904,29,3,26,0,1,1,0,1,1
02771418,26,4,22,0,2,2,0,0,1
02771489,18,2,16,0,1,1,0,1,1
02771508,7,5,2,0,2,2,0,0,0
02771869,8,2,6,0,1,1,0,0,0
02771891,26,5,21,0,1,1,0,0,1
02771925,36,2,34,0,1,1,0,1,1
02771937,31,3,28,0,1,1,0,1,1
02772063,8,3,5,0,2,2,0,0,1
02772148,21,8,13,0,1,1,0,0,1
02772202,20,5,15,0,1,1,0,1,1
02772271,18,3,15,0,1,1,0,1,1
02772394,34,5,29,0,1,1,0,1,1
02772412,42,9,33,0,0,0,0,0,1
02772596,30,0,30,0,0,0,0,0,1
02772709,20,4,16,0,1,1,0,1,1
02772888,18,3,15,0,1,1,0,1,1
02772916,37,12,25,0,0,0,0,0,1
02773010,11,2,9,0,0,0,0,0,1
02773046,10,3,7,0,1,1,0,0,1
02773345,35,8,27,0,0,0,0,0,1
02773351,16,3,13,0,0,0,0,0,1
02773409,28,4,24,0,1,1,0,1,1
02773919,9,4,5,0,4,3,1,0,1
02773923,6,3,3,0,1,1,0,0,1
02773968,17,3,14,0,4,3,1,0,1
02774043,19,1,18,0,1,1,0,1,1
02774366,34,4,30,0,1,1,0,1,1
02774533,47,6,41,0,1,1,0,1,1
02774803,51,0,51,0,0,0,0,0,1
02774914,12,0,12,0,0,0,0,0,1
02775242,25,2,23,0,1,1,0,1,1
02775358,24,3,21,0,2,1,1,2,1
02775485,50,6,44,0,1,1,0,1,1
02775761,15,7,8,0,1,1,0,1,1
02775922,11,1,10,0,1,1,0,0,1
02776085,4,3,1,0,2,2,0,0,0
02776119,5,2,3,0,2,2,0,0,1
02776424,13,3,10,0,1,1,0,1,1
02776469,6,1,5,0,1,1,0,1,1
02776699,31,0,31,0,0,0,0,0,1
02776882,34,4,30,0,2,2,0,2,1
02776892,27,0,27,0,0,0,0,0,1
02776914,62,14,48,0,0,0,0,0,1
02776963,36,9,27,0,1,1,0,1,1
02777017,24,4,20,0,0,0,0,0,0
02777131,29,0,29,0,0,0,0,0,1
02777138,29,0,29,0,0,0,0,0,1
02777188,18,3,15,0,0,0,0,0,0
02777541,21,2,19,0,1,1,0,0,1
02777638,13,2,11,0,1,1,0,0,1
02777804,18,0,18,0,0,0,0,0,1
02778116,33,8,25,0,1,1,0,1,1
02778118,64,7,57,0,0,0,0,0,1
02778285,21,3,18,0,1,1,0,1,1
02778288,29,3,26,0,1,1,0,1,1
02778373,17,0,17,0,0,0,0,0,1
02778379,9,4,5,0,2,1,1,1,1
02778386,6,3,3,0,1,1,0,0,1
02778520,13,2,11,0,1,1,0,1,1
02778626,28,3,25,0,1,1,0,1,1
02778741,58,4,54,0,1,1,0,1,1
02778794,27,1,26,0,1,1,0,1,1
02778957,26,3,23,0,1,1,0,1,1
02779199,123,21,102,0,0,0,0,0,1
02779446,27,5,22,0,1,1,0,1,1
02779500,9,2,7,0,1,1,0,0,0
02779751,59,11,48,0,0,0,0,0,1
02780631,26,9,17,0,0,0,0,0,1
02780643,69,9,60,0,1,0,1,0,1
02780748,77,7,70,0,1,1,0,1,1
02780856,18,0,18,0,0,0,0,0,1
02780943,24,3,21,0,0,0,0,0,1
02780962,16,3,13,0,0,0,0,0,1
02781151,20,2,18,0,1,1,0,1,1
02781249,12,3,9,0,1,1,0,0,1
02781304,24,5,19,0,1,1,0,1,1
02781375,11,3,8,0,1,1,0,1,1
02782422,34,4,30,0,2,1,1,0,1
02782477,19,4,15,0,1,1,0,1,1
02782480,39,5,34,0,2,2,0,2,1
02782638,33,4,29,0,1,1,0,1,1
02782818,44,3,41,0,1,1,0,1,1
02782845,9,2,7,0,1,1,0,1,0
02783237,27,3,24,0,1,1,0,1,1
02783251,72,4,68,0,2,1,1,2,1
02783356,10,3,7,0,1,1,0,0,0
02783372,8,2,6,0,1,1,0,0,1
02783452,33,2,31,0,2,1,1,2,1
02783524,14,0,14,0,0,0,0,0,1
02783745,15,0,15,0,1,1,0,1,1
02783747,14,3,11,0,2,1,1,0,1
02784097,7,2,5,0,2,2,0,0,0
02784232,7,0,7,0,2,2,0,0,1
02784445,11,4,7,0,3,3,0,0,0
02784453,13,2,11,0,0,0,0,0,1
02784766,21,5,16,0,1,1,0,0,1
02784958,15,0,15,0,1,1,0,1,1
02785133,62,5,57,0,0,0,0,0,1
02785559,18,2,16,0,2,2,0,0,0
02785592,55,0,55,0,0,0,0,0,1
02785607,33,10,23,0,2,0,2,0,1
02785830,7,0,7,0,0,0,0,0,0
02786099,70,14,56,0,0,0,0,0,1
02786265,5,3,2,0,0,0,0,0,1
02786597,62,6,56,0,0,0,0,0,0
02786730,60,12,48,0,0,0,0,0,1
02787097,79,11,68,0,0,0,0,0,1
02787363,6,3,3,0,1,1,0,0,1
02787520,12,7,5,0,1,1,0,1,1
02787689,51,7,44,0,0,0,0,0,1
02787912,114,11,103,0,1,1,0,0,1
02788226,73,11,62,0,0,0,0,0,1
02789023,58,16,42,0,0,0,0,0,1
02789074,20,3,17,0,0,0,0,0,1
02789354,13,0,13,0,1,1,0,1,1
02789495,13,3,10,0,1,1,0,1,1
02789828,35,0,35,0,0,0,0,0,1
02789932,24,5,19,0,1,1,0,1,1
02790416,23,6,17,0,0,0,0,0,0
02790570,50,2,48,0,2,1,1,2,1
02790922,36,0,36,0,0,0,0,0,1
02791115,33,3,30,0,1,1,0,1,1
02791181,8,3,5,0,1,1,0,0,1
02791218,25,0,25,0,1,1,0,1,0
02791541,83,8,75,0,0,0,0,0,1
02791621,7,2,5,0,1,1,0,1,0
02791730,4,3,1,0,0,0,0,0,0
02791743,23,0,23,0,0,0,0,0,1
02791889,74,4,70,0,1,1,0,1,1
02791896,23,0,23,0,0,0,0,0,1
02791957,7,1,6,0,0,0,0,0,1
02792001,35,3,32,0,1,1,0,1,1
02792006,66,3,63,0,1,1,0,1,1
02792051,21,0,21,0,0,0,0,0,1
02792052,23,0,23,0,0,0,0,0,1
02792113,13,0,13,0,0,0,0,0,1
02792166,37,12,25,0,0,0,0,0,1
02792272,10,3,7,0,1,1,0,0,0
02792457,27,1,26,0,0,0,0,0,1
02792601,35,0,35,0,0,0,0,0,1
02792946,6,1,5,0,1,1,0,0,1
NI030155,17,6,11,0,0,0,0,0,0
NI030431,5,2,3,0,1,1,0,0,0
NI030540,5,3,2,0,0,0,0,0,1
NI030626,19,4,15,0,4,3,1,0,0
NI030634,18,0,18,0,0,0,0,0,1
NI030798,5,3,2,0,1,1,0,0,0
NI030901,14,2,12,0,1,1,0,0,0
NI030959,31,0,31,0,0,0,0,0,0
NI031078,14,8,6,0,0,0,0,0,1
NI031145,26,3,23,0,1,1,0,1,1
NI031186,6,5,1,0,2,2,0,1,1
NI031227,9,3,6,0,1,0,1,1,1
NI031233,4,3,1,0,1,1,0,0,0
NI031255,3,0,3,0,0,0,0,0,0
NI031325,15,6,9,0,0,0,0,0,0
NI031351,11,3,8,0,0,0,0,0,1
NI031409,20,5,15,0,1,1,0,0,0
NI031416,18,7,11,0,1,1,0,1,1
NI031424,4,0,4,0,0,0,0,0,0
NI031494,3,3,0,0,1,1,0,0,1
NI031550,3,3,0,0,1,1,0,0,0
NI031851,19,1,18,0,0,0,0,0,0
NI031855,18,6,12,0,1,1,0,1,1
NI031884,18,7,11,0,2,2,0,2,1
NI031997,52,9,43,0,2,2,0,0,1
NI032115,78,11,67,0,0,0,0,0,1
NI032276,23,8,15,0,1,1,0,0,1
NI032294,8,3,5,0,0,0,0,0,0
NI032413,19,5,14,0,4,4,0,0,0
NI032652,17,3,14,0,1,1,0,1,1
NI032803,23,4,19,0,1,1,0,1,1
NI032847,31,10,21,0,1,1,0,0,0
NI032961,21,0,21,0,0,0,0,0,0
NI032994,19,7,12,0,0,0,0,0,0
NI033106,48,13,35,0,0,0,0,0,1
NI033478,49,8,41,0,0,0,0,0,0
NI033497,28,8,20,0,0,0,0,0,1
NI033849,9,5,4,0,1,1,0,0,1
NI033913,33,7,26,0,0,0,0,0,0
NI034042,20,6,14,0,3,3,0,0,1
NI034106,30,6,24,0,0,0,0,0,0
NI034278,7,3,4,0,5,5,0,0,1
NI034280,17,5,12,0,6,4,2,2,1
NI034309,20,5,15,0,0,0,0,0,0
NI034377,3,3,0,0,2,2,0,0,0
NI034679,9,0,9,0,0,0,0,0,0
NI034750,23,9,14,0,0,0,0,0,0
NI034898,4,3,1,0,2,2,0,0,1
NI034977,8,3,5,0,2,2,0,0,0
NI034980,16,4,12,0,1,1,0,1,1
NI035042,4,4,0,0,1,1,0,0,0
NI035496,31,12,19,0,2,0,2,0,0
NI035515,7,5,2,0,4,4,0,0,0
NI035582,51,13,38,0,0,0,0,0,1
NI035605,6,4,2,0,1,1,0,0,0
NI035654,48,6,42,0,0,0,0,0,0
NI035703,12,3,9,0,2,2,0,0,0
NI035752,3,0,3,0,1,1,0,0,1
NI035826,20,0,20,0,1,1,0,0,0
NI036046,7,5,2,0,1,1,0,0,0
NI036069,26,8,18,0,1,1,0,0,0
NI036073,22,7,15,0,7,7,0,0,0
NI036108,10,2,8,0,0,0,0,0,0
NI036184,5,3,2,0,2,2,0,0,0
NI036297,4,2,2,0,0,0,0,0,0
NI036370,15,3,12,0,1,1,0,0,0
NI036466,5,3,2,0,1,1,0,0,0
NI036491,10,7,3,0,5,2,3,2,0
NI036513,3,0,3,0,0,0,0,0,0
NI036590,46,6,40,0,0,0,0,0,0
NI036621,7,3,4,0,0,0,0,0,0
NI036726,11,7,4,0,3,1,2,1,0
NI036727,12,8,4,0,3,1,2,1,0
NI036962,30,8,22,0,1,1,0,1,1
NI036963,7,2,5,0,1,1,0,0,0
NI037129,12,4,8,0,4,2,2,1,0
NI037407,3,3,0,0,1,1,0,0,0
NI037477,14,3,11,0,2,2,0,2,1
NI037709,14,2,12,0,1,1,0,1,1
NI037759,19,9,10,0,1,1,0,0,0
NI037932,37,8,29,0,0,0,0,0,0
NI037997,25,0,25,0,1,1,0,1,1
NI038021,5,3,2,0,1,1,0,0,0
NI038025,8,0,8,0,1,1,0,1,0
NI038029,11,4,7,0,1,1,0,1,1
NI038380,18,8,10,0,0,0,0,0,0
NI038692,4,0,4,0,0,0,0,0,0
NI038905,11,3,8,0,0,0,0,0,1
NI038939,7,1,6,0,1,0,1,0,0
NI038987,26,8,18,0,1,1,0,1,1
NI038988,20,3,17,0,1,1,0,1,1
NI039041,24,11,13,0,1,1,0,0,0
NI039294,39,14,25,0,1,1,0,1,1
NI039336,5,5,0,0,1,1,0,1,0
NI039485,4,3,1,0,0,0,0,0,0
NI039510,4,2,2,0,1,1,0,1,1
NI039620,4,3,1,0,1,1,0,0,1
NI039674,12,3,9,0,0,0,0,0,0
NI039688,9,2,7,0,1,1,0,1,0
NI039804,5,3,2,0,1,1,0,0,0
NI039848,8,6,2,0,0,0,0,0,0
NI039926,20,0,20,0,0,0,0,0,1
NI039929,3,1,2,0,2,1,1,0,0
NI039935,18,2,16,0,1,1,0,1,1
NI039959,30,0,30,0,0,0,0,0,1
NI040006,3,3,0,0,1,1,0,0,0
NI040225,6,2,4,0,2,2,0,1,0
NI040237,7,0,7,0,0,0,0,0,0
NI040323,4,3,1,0,2,2,0,0,0
NI040379,14,9,5,0,1,1,0,0,1
NI040536,8,4,4,0,3,3,0,0,0
NI040557,49,11,38,0,2,0,2,0,0
NI040607,25,6,19,0,1,1,0,0,0
NI040686,3,2,1,0,2,2,0,0,0
NI040825,5,3,2,0,2,2,0,0,0
NI041157,4,1,3,0,1,1,0,0,0
NI041194,10,4,6,0,1,1,0,0,0
NI041233,3,3,0,0,1,1,0,0,0
NI041579,5,3,2,0,2,2,0,0,0
NI041606,15,3,12,0,0,0,0,0,0
NI041625,33,7,26,0,2,1,1,0,0
NI041660,13,0,13,0,0,0,0,0,1
NI041773,10,8,2,0,0,0,0,0,0
NI041838,4,3,1,0,2,2,0,0,0
NI042209,26,7,19,0,0,0,0,0,0
NI042339,12,2,10,0,1,1,0,0,0
NI042344,3,3,0,0,2,2,0,0,0
NI042511,27,0,27,0,0,0,0,0,1
NI042546,15,3,12,0,0,0,0,0,0
NI042547,12,3,9,0,0,0,0,0,0
NI042566,3,3,0,0,0,0,0,0,0
NI042574,8,3,5,0,2,2,0,0,1
NI042658,9,0,9,0,0,0,0,0,0
NI042767,8,5,3,0,0,0,0,0,0
NI042774,2,2,0,0,1,1,0,0,0
NI042973,46,9,37,0,0,0,0,0,0
NI043064,43,8,35,0,0,0,0,0,0
NI043129,16,10,6,0,6,6,0,0,0
NI043190,6,2,4,0,1,1,0,0,0
NI043241,7,4,3,0,0,0,0,0,0
NI043559,7,5,2,0,1,1,0,0,0
NI043960,5,3,2,0,1,1,0,0,0
NI044143,12,5,7,0,0,0,0,0,0
NI044281,13,0,13,0,0,0,0,0,1
NI044660,11,7,4,0,7,7,0,0,0
NI044663,2,2,0,0,0,0,0,0,0
NI044728,15,3,12,0,0,0,0,0,0
NI044991,22,6,16,0,0,0,0,0,0
NI044998,6,3,3,1,2,2,0,0,1
NI045085,4,2,2,0,3,2,1,0,0
NI045153,15,3,12,0,1,1,0,0,0
NI045588,3,2,1,0,1,1,0,0,0
NI045694,5,4,1,0,0,0,0,0,0
NI045809,43,12,31,0,0,0,0,0,1
NI045927,5,5,0,0,1,1,0,0,0
NI046376,4,0,4,0,0,0,0,0,0
NI046460,3,3,0,0,2,2,0,0,0
NI046622,6,2,4,0,1,1,0,0,0
NI046703,7,4,3,0,0,0,0,0,0
NI046737,8,2,6,0,1,1,0,0,0
NI046751,9,5,4,0,0,0,0,0,0
NI046794,5,4,1,0,3,3,0,0,0
NI046843,3,2,1,0,1,1,0,0,0
NI046845,6,5,1,0,0,0,0,0,1
NI047040,25,0,25,0,0,0,0,0,1
NI047102,26,6,20,0,1,1,0,1,0
NI047497,9,0,9,0,1,1,0,1,0
NI048102,33,10,23,0,0,0,0,0,0
NI048218,2,2,0,0,1,1,0,0,0
NI048715,8,2,6,0,1,1,0,0,0
NI048734,8,0,8,0,0,0,0,0,0
NI048778,3,2,1,0,1,1,0,0,1
NI048923,12,4,8,0,0,0,0,0,0
NI049026,17,2,15,0,0,0,0,0,1
NI049115,3,3,0,0,2,2,0,0,0
NI049255,8,4,4,0,0,0,0,0,0
NI049395,5,0,5,0,0,0,0,0,0
NI049506,7,1,6,0,0,0,0,0,0
NI049512,4,4,0,0,0,0,0,0,0
NI049619,10,3,7,0,1,1,0,0,0
NI049890,9,4,5,0,2,1,1,0,0
NI049964,7,6,1,0,5,5,0,0,0
NI049991,8,2,6,0,0,0,0,0,0
NI049992,9,2,7,0,0,0,0,0,0
NI050229,3,3,0,0,2,2,0,0,0
NI050250,4,0,4,0,0,0,0,0,0
NI050366,3,3,0,0,0,0,0,0,0
NI050415,6,0,6,0,0,0,0,0,0
NI050431,8,4,4,0,0,0,0,0,0
NI050488,6,3,3,0,1,1,0,0,0
NI050507,3,0,3,0,1,1,0,1,0
NI050685,8,2,6,0,3,2,1,0,0
NI050716,13,1,12,0,0,0,0,0,0
NI050719,3,2,1,0,0,0,0,0,0
NI050771,42,9,33,0,0,0,0,0,1
NI050776,5,0,5,0,1,1,0,0,0
NI050795,9,3,6,0,0,0,0,0,0
NI050863,50,11,39,0,1,1,0,0,1
NI051034,16,8,8,0,1,1,0,0,0
NI051048,4,3,1,0,1,1,0,0,0
NI051123,3,2,1,0,2,2,0,0,0
NI051291,4,2,2,0,2,2,0,0,0
NI051519,2,2,0,0,1,1,0,0,0
NI051681,18,0,18,0,0,0,0,0,0
NI051793,12,0,12,0,0,0,0,0,1
NI052050,8,3,5,0,0,0,0,0,0
NI052138,5,5,0,0,1,1,0,0,0
NI052171,14,8,6,0,1,1,0,0,0
NI052221,11,3,8,0,0,0,0,0,0
NI053107,19,2,17,0,1,1,0,1,1
NI053389,4,4,0,0,0,0,0,0,0
NI053390,7,1,6,0,0,0,0,0,0
NI053391,4,1,3,0,0,0,0,0,0
NI053392,3,3,0,0,0,0,0,0,0
NI053663,5,3,2,0,3,3,0,1,0
NI053703,3,2,1,0,1,1,0,0,0
NI053823,21,0,21,0,0,0,0,0,1
NI054095,7,3,4,0,2,2,0,0,0
NI054184,33,10,23,0,1,1,0,0,0
NI054193,5,2,3,0,2,2,0,0,0
NI054463,32,10,22,0,1,1,0,1,1
NI054520,17,6,11,0,0,0,0,0,0
NI054602,3,2,1,0,1,1,0,0,0
NI054742,33,5,28,0,1,1,0,1,0
NI054928,11,1,10,0,2,2,0,1,0
NI054947,19,7,12,0,1,1,0,1,1
NI055028,7,3,4,0,1,1,0,1,0
NI055124,4,0,4,0,2,2,0,0,0
NI055319,3,3,0,0,1,1,0,0,0
NI055402,4,3,1,0,2,2,0,0,0
NI055440,6,5,1,0,1,1,0,0,0
NI055460,4,3,1,0,1,1,0,0,0
NI055487,5,1,4,0,1,1,0,0,0
NI055506,15,3,12,0,1,1,0,1,1
NI055651,8,1,7,0,1,1,0,0,0
NI056048,5,0,5,0,0,0,0,0,0
NI056385,4,0,4,0,0,0,0,0,1
NI056386,4,2,2,0,1,1,0,0,1
NI056451,31,5,26,0,2,2,0,2,0
NI056463,26,4,22,0,1,1,0,1,1
NI056574,30,2,28,0,2,1,1,0,0
NI056638,6,4,2,0,2,1,1,0,0
NI056719,4,3,1,0,2,2,0,0,1
NI057006,7,1,6,0,1,1,0,0,0
NI057110,7,4,3,0,2,2,0,0,1
NI057161,5,3,2,0,1,1,0,0,0
NI057216,3,2,1,0,0,0,0,0,0
NI057297,11,6,5,0,0,0,0,0,0
NI057618,31,7,24,0,1,1,0,0,0
NI057680,9,4,5,0,2,2,0,0,0
NI057785,4,4,0,0,1,1,0,0,1
NI058025,27,4,23,0,0,0,0,0,0
NI058026,9,3,6,0,0,0,0,0,0
NI058038,4,1,3,0,1,1,0,1,0
NI058131,4,1,3,0,2,2,0,1,0
NI058398,4,3,1,0,2,2,0,0,0
NI058400,4,3,1,0,2,2,0,0,0
NI058449,5,4,1,0,0,0,0,0,0
NI058673,8,0,8,0,0,0,0,0,0
NI058843,6,2,4,0,1,1,0,0,0
NI058854,4,0,4,0,0,0,0,0,0
NI058940,5,2,3,0,1,1,0,0,0
NI058984,8,3,5,0,2,2,0,0,0
NI059010,4,2,2,0,1,1,0,0,0
NI059022,12,5,7,0,1,1,0,1,1
NI059039,4,2,2,0,2,2,0,0,1
NI059148,4,2,2,0,1,1,0,0,0
NI059323,7,5,2,0,4,4,0,0,0
NI059428,10,4,6,0,0,0,0,0,0
NI059464,11,3,8,0,2,2,0,2,1
NI059525,4,3,1,0,0,0,0,0,0
NI059617,7,0,7,0,0,0,0,0,0
NI059659,2,2,0,0,1,1,0,0,0
NI059694,15,0,15,0,0,0,0,0,1
NI059715,18,2,16,0,1,1,0,0,0
NI059862,4,2,2,0,1,1,0,0,0
NI059894,16,0,16,0,1,1,0,1,1
NI059996,3,2,1,0,1,1,0,0,0
NI060060,5,2,3,0,1,1,0,0,0
NI060131,17,11,6,0,0,0,0,0,0
NI061021,4,3,1,0,1,1,0,0,0
NI061166,9,3,6,0,0,0,0,0,0
NI061196,11,3,8,0,1,1,0,0,0
NI061539,5,3,2,0,1,1,0,0,1
NI061633,7,0,7,0,0,0,0,0,0
NI061859,8,5,3,0,4,4,0,0,0
NI061995,8,0,8,0,0,0,0,0,0
NI062153,8,4,4,0,0,0,0,0,0
NI062216,6,5,1,0,0,0,0,0,1
NI062255,5,3,2,0,1,1,0,1,0
NI062271,3,3,0,0,2,2,0,0,0
NI062429,3,2,1,0,1,1,0,0,0
NI062798,3,2,1,0,0,0,0,0,0
NI063344,38,7,31,0,3,2,1,3,1
NI063599,9,2,7,0,0,0,0,0,0
NI063617,7,2,5,0,1,1,0,0,0
NI063653,11,7,4,0,0,0,0,0,0
NI063803,38,7,31,0,1,1,0,1,1
NI063813,13,7,6,0,0,0,0,0,1
NI063836,26,9,17,0,0,0,0,0,1
NI063927,5,3,2,0,1,1,0,0,0
NI063992,39,7,32,0,1,1,0,1,1
05370051,4,0,4,0,0,0,0,0,1
05370539,3,3,0,0,1,1,0,0,1
05370544,29,7,22,0,0,0,0,0,0
05370771,16,6,10,0,3,3,0,0,1
05370822,8,0,8,0,0,0,0,0,1
05371070,6,3,3,0,2,2,0,0,0
05371203,45,6,39,0,0,0,0,0,1
05371228,25,7,18,0,2,1,1,0,1
05371294,12,0,12,0,0,0,0,0,1
05371756,6,4,2,0,1,1,0,1,1
05371964,8,3,5,0,2,2,0,0,1
05372217,35,7,28,0,1,1,0,1,1
05372330,10,5,5,0,1,1,0,0,0
05372378,36,11,25,0,0,0,0,0,1
05372438,4,2,2,0,1,1,0,0,1
05372665,4,1,3,0,1,1,0,0,0
05372859,17,3,14,0,1,1,0,1,1
05373002,4,0,4,0,0,0,0,0,0
05373368,12,4,8,0,1,1,0,1,1
05373392,3,2,1,0,1,1,0,0,0
05373481,9,0,9,0,0,0,0,0,1
05373496,7,2,5,0,2,2,0,0,0
05373556,6,2,4,0,1,1,0,0,0
05373890,10,5,5,0,2,2,0,0,1
05373909,13,4,9,0,2,2,0,0,1
05373916,15,0,15,0,0,0,0,0,1
05373919,11,4,7,0,2,2,0,0,1
05373951,13,4,9,0,2,2,0,0,1
05373991,13,4,9,0,2,2,0,0,1
05374319,5,3,2,0,1,1,0,0,0
05374338,5,2,3,0,1,1,0,1,0
05374534,5,3,2,0,2,2,0,0,0
05374632,21,7,14,0,1,1,0,0,1
05374633,9,5,4,0,1,1,0,1,1
05374635,18,4,14,0,1,1,0,1,1
05375019,7,2,5,0,1,1,0,1,1
05375055,7,3,4,0,2,2,0,0,1
05375065,28,8,20,0,0,0,0,0,0
05375076,10,3,7,0,1,1,0,1,1
05375141,22,2,20,0,0,0,0,0,1
05375371,17,0,17,0,0,0,0,0,1
05375424,11,5,6,0,2,2,0,0,1
05375769,11,3,8,0,0,0,0,0,1
05375913,16,5,11,0,2,2,0,2,1
05376299,5,4,1,0,1,1,0,0,1
05376523,9,0,9,0,0,0,0,0,1
05376952,12,2,10,0,1,1,0,1,1
05376960,6,4,2,0,1,1,0,0,0
05377023,8,0,8,0,0,0,0,0,1
05377145,3,2,1,0,2,2,0,0,0
05377666,5,0,5,0,0,0,0,0,1
05378080,9,4,5,0,1,1,0,0,0
05378265,13,4,9,0,0,0,0,0,1
05378485,11,6,5,0,4,1,3,1,1
05378721,6,1,5,0,1,1,0,1,1
05378755,4,3,1,0,2,2,0,0,1
05378991,2,2,0,0,1,1,0,0,0
05379251,14,2,12,0,1,1,0,0,1
05379403,5,3,2,0,2,2,0,0,0
05379485,9,0,9,0,0,0,0,0,1
05379553,13,0,13,0,0,0,0,0,1
05379647,4,2,2,0,2,2,0,0,0
05380026,7,0,7,0,1,1,0,1,1
05380315,8,5,3,0,0,0,0,0,0
05380396,9,0,9,0,0,0,0,0,1
05380817,2,0,2,0,0,0,0,0,1
05381080,5,0,5,0,0,0,0,0,1
05381180,5,3,2,0,0,0,0,0,1
05381785,18,7,11,0,0,0,0,0,1
05381872,7,3,4,0,1,1,0,1,1
05381889,3,0,3,0,0,0,0,0,1
05382008,4,3,1,0,2,2,0,0,0
05382160,5,3,2,0,2,2,0,0,1
05382220,16,3,13,0,1,1,0,1,1
05382221,16,3,13,0,1,1,0,1,1
05382262,26,2,24,0,1,1,0,1,1
05383055,43,11,32,0,0,0,0,0,1
05383234,20,3,17,0,2,2,0,2,1
05383414,33,8,25,0,0,0,0,0,1
05383450,4,0,4,0,0,0,0,0,0
05383949,4,0,4,0,0,0,0,0,0
05384148,53,11,42,0,0,0,0,0,0
05384487,37,10,27,0,0,0,0,0,1
05384616,19,5,14,0,1,1,0,1,1
05384910,4,0,4,0,2,2,0,0,0
05385025,29,7,22,0,1,1,0,1,1
05385204,4,0,4,0,0,0,0,0,1
05385359,7,2,5,0,1,1,0,0,1
05385638,9,0,9,0,0,0,0,0,1
05385821,5,0,5,0,0,0,0,0,1
05385912,16,5,11,0,1,1,0,1,1
05386058,50,3,47,0,1,1,0,0,1
05386071,9,1,8,0,0,0,0,0,1
05386079,20,8,12,0,0,0,0,0,1
05386112,5,2,3,0,1,1,0,0,1
05386418,10,7,3,0,2,2,0,0,1
05386427,13,0,13,0,0,0,0,0,1
05386490,14,3,11,0,0,0,0,0,1
05386559,6,2,4,0,2,2,0,0,1
05386636,6,4,2,0,1,1,0,0,1
05386784,41,0,41,0,0,0,0,0,1
05386788,11,0,11,0,0,0,0,0,1
05386790,11,0,11,0,0,0,0,0,1
05386803,6,3,3,0,1,1,0,1,1
05386955,17,0,17,0,0,0,0,0,1
05386956,28,2,26,0,1,1,0,1,1
05387005,5,0,5,0,0,0,0,0,1
05387790,5,3,2,0,2,2,0,0,0
05388372,14,4,10,0,1,1,0,1,1
05388511,4,0,4,0,0,0,0,0,1
05388595,5,2,3,0,1,1,0,0,0
05388651,5,3,2,0,2,2,0,0,0
05388869,25,3,22,0,3,1,2,3,1
05389048,7,2,5,0,1,1,0,1,1
05389067,4,3,1,0,2,2,0,0,0
05389282,12,4,8,0,1,1,0,1,1
05389427,33,11,22,0,1,0,1,0,1
05389451,7,1,6,0,1,1,0,1,1
05389456,6,5,1,0,2,2,0,0,0
05389525,25,3,22,0,1,1,0,1,1
05389720,6,1,5,0,1,1,0,0,1
05389866,16,3,13,0,1,1,0,1,1
05390028,8,0,8,0,0,0,0,0,1
05390127,5,3,2,0,1,1,0,0,0
05390293,26,2,24,0,1,1,0,1,1
05390347,25,3,22,0,2,1,1,2,1
05390668,8,5,3,0,1,1,0,1,1
05390861,5,1,4,0,2,1,1,0,1
05390887,11,0,11,0,0,0,0,0,1
05391032,4,0,4,0,0,0,0,0,1
05391058,8,5,3,0,4,4,0,1,0
05391061,19,3,16,0,1,1,0,1,1
05391076,23,2,21,0,3,1,2,3,1
05391240,24,3,21,0,1,1,0,1,1
05391321,4,0,4,2,0,0,0,0,1
05391337,4,2,2,0,1,1,0,0,0
05391388,5,0,5,0,0,0,0,0,0
05391452,15,2,13,0,1,1,0,1,1
05391455,8,1,7,0,1,1,0,1,1
05391538,7,4,3,0,2,2,0,0,0
05391622,5,2,3,0,0,0,0,0,0
05391778,10,2,8,0,0,0,0,0,0
05391794,6,4,2,0,3,3,0,0,0
05392125,3,3,0,0,2,2,0,1,1
05392233,10,2,8,0,2,1,1,2,1
05392524,13,5,8,0,5,4,1,0,1
05392652,2,2,0,0,1,1,0,0,0
05392995,7,6,1,0,2,2,0,0,1
05393117,9,0,9,0,0,0,0,0,1
05393180,18,1,17,0,1,1,0,1,1
05393279,30,9,21,0,0,0,0,0,1
05393344,26,5,21,0,1,1,0,1,1
05393382,17,10,7,0,0,0,0,0,0
05393383,4,2,2,0,1,1,0,0,1
05393387,12,4,8,3,2,1,1,0,1
05393437,3,2,1,0,1,1,0,0,1
05393607,5,3,2,0,2,2,0,0,0
05393793,10,3,7,0,1,1,0,0,1
05393844,20,3,17,0,1,1,0,1,1
05394501,6,1,5,0,1,1,0,0,1
05395059,4,1,3,0,1,1,0,0,0
05395743,20,4,16,0,4,4,0,4,1
05396081,25,4,21,0,1,1,0,1,1
05396181,13,3,10,0,1,1,0,1,1
05396227,5,1,4,0,1,1,0,0,0
05396270,11,4,7,0,1,1,0,1,1
05396314,6,3,3,0,1,1,0,0,0
05396529,2,2,0,0,1,1,0,0,0
05396539,28,0,28,0,0,0,0,0,1
05396610,19,5,14,0,0,0,0,0,0
05396870,22,6,16,0,0,0,0,0,1
05396879,30,13,17,0,19,13,6,0,1
05397004,17,4,13,0,2,2,0,2,1
05397063,19,4,15,0,0,0,0,0,1
05397100,8,3,5,0,3,3,0,0,1
05397159,6,4,2,0,2,2,0,0,0
05397447,5,4,1,0,2,2,0,0,0
05397676,5,3,2,0,3,3,0,0,0
05397785,18,5,13,0,0,0,0,0,0
05397840,26,10,16,0,2,1,1,0,1
05397878,9,3,6,0,1,1,0,1,1
05398028,40,0,40,0,0,0,0,0,1
05398168,9,0,9,0,0,0,0,0,1
05398483,23,8,15,0,0,0,0,0,1
05398580,16,4,12,0,0,0,0,0,1
05398840,5,0,5,0,0,0,0,0,1
05399093,4,3,1,0,2,2,0,0,0
05399201,8,0,8,0,1,1,0,1,1
05399443,5,0,5,0,0,0,0,0,1
05399766,6,2,4,0,2,2,0,0,0
05399807,4,4,0,0,3,3,0,0,0
05400020,24,2,22,0,1,1,0,1,1
05400086,5,5,0,0,2,2,0,0,1
05400140,8,6,2,0,1,1,0,0,1
05400512,8,3,5,0,2,1,1,0,0
05400811,6,2,4,0,1,1,0,0,0
05400854,29,6,23,1,1,1,0,1,1
05400865,15,0,15,0,0,0,0,0,1
05401036,6,0,6,0,0,0,0,0,1
05401165,23,5,18,0,1,1,0,0,1
05401378,7,1,6,0,1,1,0,0,1
05401393,5,1,4,0,1,1,0,0,0
05401672,6,1,5,0,4,4,0,0,0
05402228,5,0,5,0,0,0,0,0,0
05402303,42,10,32,0,0,0,0,0,1
05402968,5,0,5,0,0,0,0,0,0
05403280,11,4,7,0,1,1,0,1,1
05403766,25,6,19,0,0,0,0,0,1
05404150,26,3,23,0,2,2,0,2,1
05404490,10,4,6,0,1,1,0,1,1
05405393,17,0,17,0,1,1,0,1,1
05405452,13,0,13,0,0,0,0,0,0
05405982,23,0,23,0,0,0,0,0,1
05406056,10,4,6,0,1,1,0,1,1
05406226,4,0,4,0,0,0,0,0,0
05406238,11,7,4,0,0,0,0,0,1
05406320,4,3,1,0,1,1,0,0,1
05406955,11,4,7,0,1,1,0,1,1
05407406,4,1,3,0,1,1,0,0,0
05407683,5,2,3,0,0,0,0,0,0
05407741,12,3,9,0,1,0,1,0,0
05407768,20,7,13,0,0,0,0,0,1
05407893,5,3,2,0,2,2,0,0,0
05408107,24,10,14,0,0,0,0,0,0
05408314,19,4,15,0,2,2,0,2,1
05408339,7,0,7,0,0,0,0,0,1
05409076,44,0,44,0,0,0,0,0,1
05409178,3,0,3,0,1,1,0,0,0
05409239,5,2,3,0,1,1,0,0,1
05409369,4,3,1,0,2,2,0,0,0
05409372,5,1,4,0,1,1,0,0,0
05409735,20,11,9,0,0,0,0,0,0
05410140,14,3,11,0,1,1,0,1,1
05410412,17,0,17,0,0,0,0,0,1
05410415,5,4,1,0,1,1,0,0,0
05410573,14,1,13,0,1,1,0,1,1
05410792,10,3,7,0,1,1,0,1,1
05410859,19,0,19,0,0,0,0,0,1
05411198,2,2,0,0,1,1,0,0,1
05411942,5,2,3,0,1,1,0,0,1
05412034,11,3,8,0,1,1,0,1,1
05412040,4,0,4,0,0,0,0,0,1
05412359,10,6,4,0,0,0,0,0,0
05412552,5,0,5,0,0,0,0,0,1
05412731,5,2,3,0,1,1,0,0,0
05413028,3,0,3,0,0,0,0,0,1
05413648,4,2,2,0,1,1,0,0,1
05413781,11,4,7,0,1,1,0,1,1
05413935,34,0,34,0,0,0,0,0,0
05414220,4,2,2,0,1,1,0,1,0
05414417,5,3,2,0,1,1,0,0,0
05414546,3,1,2,0,1,1,0,1,1
05414629,7,2,5,0,1,1,0,0,1
05414676,5,3,2,0,2,2,0,0,0
05414715,8,0,8,0,0,0,0,0,1
05415093,27,5,22,0,1,1,0,1,1
05415094,27,5,22,0,1,1,0,1,1
05415226,5,3,2,0,1,1,0,0,1
05415348,6,2,4,0,1,1,0,0,0
05415907,18,3,15,0,1,1,0,1,0
05417092,9,5,4,0,1,1,0,1,1
05417108,9,5,4,0,1,1,0,1,1
05417120,9,5,4,0,1,1,0,1,1
05417367,2,0,2,0,0,0,0,0,1
05417551,5,3,2,0,2,2,0,0,0
05417879,4,1,3,0,1,1,0,0,0
05418234,12,1,11,0,2,2,0,0,0
05418271,11,4,7,0,0,0,0,0,1
05418401,4,0,4,0,1,1,0,0,1
05418408,10,0,10,0,0,0,0,0,1
05418426,17,0,17,0,0,0,0,0,1
05418540,6,3,3,0,3,3,0,0,1
05419072,6,3,3,0,2,2,0,0,1
05419073,10,2,8,0,1,1,0,0,1
05419601,17,7,10,0,0,0,0,0,1
05419682,19,0,19,0,2,2,0,0,1
05420025,16,3,13,0,1,1,0,1,1
05420256,3,3,0,0,1,1,0,0,0
05420647,28,2,26,0,1,1,0,0,1
05420913,30,9,21,0,0,0,0,0,1
05420963,91,14,77,0,0,0,0,0,1
05421073,9,5,4,0,1,1,0,1,1
05421132,3,3,0,0,2,2,0,0,0
05421184,5,4,1,0,2,1,1,2,1
05421554,4,2,2,0,1,1,0,0,0
05421969,15,6,9,1,0,0,0,0,0
05422042,2,2,0,0,1,1,0,0,0
05422073,5,3,2,0,1,1,0,0,0
05422146,4,4,0,0,1,1,0,1,0
05422348,10,5,5,0,1,1,0,1,1
05422551,15,0,15,0,0,0,0,0,1
05422559,12,3,9,0,1,1,0,0,1
05422898,10,3,7,0,0,0,0,0,1
05423137,8,2,6,0,1,1,0,0,0
05423205,8,6,2,0,1,1,0,1,1
05423350,17,0,17,0,1,1,0,1,1
05423632,10,4,6,0,1,1,0,0,0
05423833,19,0,19,0,0,0,0,0,1
05423878,19,0,19,0,0,0,0,0,1
05424023,11,2,9,0,1,1,0,0,1
05424063,7,1,6,0,1,1,0,0,1
05424187,2,0,2,0,1,1,0,0,1
05424686,5,2,3,0,1,1,0,0,1
05424810,13,3,10,0,1,1,0,1,1
05425369,26,8,18,0,0,0,0,0,1
05425795,26,3,23,0,1,1,0,1,1
05425951,14,0,14,0,0,0,0,0,1
05426028,3,2,1,0,0,0,0,0,0
05426182,4,1,3,0,1,1,0,0,0
05426207,8,3,5,0,1,1,0,0,1
05426223,4,1,3,0,1,1,0,0,0
05426326,4,0,4,0,0,0,0,0,1
05426470,5,0,5,0,0,0,0,0,1
05426553,18,5,13,0,1,1,0,1,1
05426874,4,0,4,0,0,0,0,0,1
05427128,5,4,1,0,1,1,0,1,1
05427389,14,3,11,0,1,1,0,1,1
05427412,18,8,10,0,0,0,0,0,1
05427458,5,3,2,0,2,2,0,0,0
05428154,6,3,3,0,1,1,0,1,0
05428502,5,1,4,0,0,0,0,0,0
05428633,3,3,0,0,2,2,0,0,0
05428911,8,0,8,0,0,0,0,0,1
05428987,4,0,4,0,0,0,0,0,1
05429032,10,2,8,0,1,1,0,1,1
05429081,4,2,2,0,2,2,0,0,0
05429423,18,0,18,0,0,0,0,0,1
05429520,15,2,13,0,1,1,0,1,1
05429878,5,0,5,0,0,0,0,0,1
05429891,10,0,10,0,1,1,0,1,1
05430106,10,2,8,0,0,0,0,0,0
05430320,13,9,4,0,4,4,0,0,1
05431238,3,3,0,0,1,1,0,0,0
05431528,8,0,8,0,0,0,0,0,1
05431580,3,0,3,0,0,0,0,0,1
05431774,4,0,4,0,0,0,0,0,1
05431946,8,2,6,0,1,1,0,1,1
05431986,26,10,16,0,0,0,0,0,0
05432285,5,2,3,0,2,2,0,0,1
05432471,20,4,16,0,0,0,0,0,0
05432688,13,3,10,0,4,3,1,2,1
05432957,6,2,4,0,1,1,0,0,0
05433034,4,2,2,0,1,1,0,0,0
05433076,20,6,14,0,0,0,0,0,1
05433298,7,3,4,0,2,2,0,0,1
05433333,9,3,6,0,1,1,0,0,1
05433529,15,1,14,0,1,1,0,1,1
05433531,4,3,1,0,2,2,0,0,1
05433717,12,9,3,0,0,0,0,0,1
05434055,13,7,6,0,0,0,0,0,1
05434222,7,3,4,0,0,0,0,0,1
05434255,7,0,7,0,0,0,0,0,1
05434383,18,5,13,0,0,0,0,0,1
05434515,9,3,6,0,2,1,1,0,0
05434660,5,3,2,0,2,2,0,0,0
05434864,5,2,3,0,1,1,0,0,0
05435008,4,1,3,0,1,1,0,0,0
05435061,55,12,43,0,1,1,0,1,1
05435204,8,5,3,0,0,0,0,0,0
05435622,18,0,18,0,0,0,0,0,1
05435682,19,0,19,0,0,0,0,0,1
05435708,5,0,5,0,0,0,0,0,1
05435724,5,0,5,0,0,0,0,0,1
05435760,27,8,19,0,1,0,1,1,1
05435811,7,1,6,0,0,0,0,0,1
05435925,5,2,3,0,2,2,0,0,1
07170250,9,2,7,0,3,1,2,3,0
07170291,9,2,7,0,3,1,2,3,0
07170292,6,4,2,0,3,1,2,1,1
07170306,2,0,2,0,1,1,0,0,0
07170314,9,2,7,0,3,1,2,3,0
07170574,8,5,3,0,1,1,0,1,1
07171019,1,1,0,0,2,2,0,0,0
07171199,7,3,4,0,1,1,0,1,1
07171362,5,0,5,0,1,1,0,0,1
07171467,2,2,0,0,0,0,0,0,0
07171549,2,2,0,0,1,1,0,0,0
07172034,1,1,0,0,1,1,0,0,0
07172136,4,2,2,0,3,3,0,0,0
07172355,4,0,4,0,0,0,0,0,1
07173090,19,5,14,0,0,0,0,0,0
07173114,3,0,3,0,0,0,0,0,1
07173247,6,4,2,0,0,0,0,0,0
07173304,2,0,2,0,2,2,0,0,1
07173888,1,0,1,0,1,1,0,0,0
07173979,5,4,1,0,1,1,0,0,0
07174001,3,1,2,0,1,1,0,0,0
07174271,2,2,0,0,2,2,0,0,0
07174573,12,11,1,0,0,0,0,0,1
07174949,2,0,2,0,2,2,0,0,1
07174978,14,5,9,0,1,1,0,1,1
07175106,5,0,5,0,0,0,0,0,1
07175447,12,6,6,0,4,1,3,1,1
07175639,7,3,4,0,2,1,1,1,1
07176116,1,1,0,0,1,1,0,0,1
07176392,10,4,6,0,0,0,0,0,0
07176393,19,3,16,0,2,2,0,2,1
07176653,3,3,0,0,0,0,0,0,0
07176689,3,2,1,0,1,1,0,0,0
07176792,3,0,3,0,0,0,0,0,1
07176902,4,0,4,0,0,0,0,0,1
07176911,16,8,8,0,2,2,0,2,1
07176919,7,2,5,0,1,1,0,1,1
07176931,10,4,6,0,1,1,0,0,0
07177995,3,2,1,0,2,2,0,0,1
07178295,19,6,13,0,2,2,0,2,1
07178463,10,2,8,0,2,1,1,2,0
07178592,1,1,0,0,2,2,0,0,1
07178621,4,1,3,0,1,1,0,1,1
07178638,15,0,15,0,0,0,0,0,1
07178844,12,0,12,0,0,0,0,0,1
07179041,2,1,1,0,1,1,0,0,1
07179107,2,2,0,0,1,1,0,0,0
07179148,1,1,0,0,1,1,0,0,0
07179246,5,3,2,0,1,1,0,1,0
07179316,2,2,0,0,1,1,0,0,0
07179494,10,6,4,0,1,1,0,1,1
07179630,1,1,0,0,2,2,0,0,0
07179948,14,0,14,0,0,0,0,0,1
07179949,12,0,12,0,0,0,0,0,1
07180072,1,0,1,0,0,0,0,0,1
07180318,30,6,24,0,3,3,0,3,1
07180620,14,10,4,0,0,0,0,0,1
07181095,2,2,0,0,1,1,0,0,1
07181701,25,5,20,0,0,0,0,0,1
07181739,3,2,1,0,1,1,0,0,0
07182183,18,10,8,0,0,0,0,0,1
07182792,1,1,0,0,1,1,0,0,0
07182954,8,0,8,0,1,1,0,1,1
07183455,1,0,1,0,0,0,0,0,0
07183552,3,2,1,0,2,2,0,0,0
07183563,2,0,2,0,0,0,0,0,1
07184033,1,1,0,0,1,1,0,0,0
07184260,2,0,2,0,1,1,0,0,0
07184590,2,0,2,0,0,0,0,0,1
07184743,6,6,0,0,6,6,0,0,0
07185018,26,14,12,0,1,1,0,1,1
07185286,6,0,6,0,0,0,0,0,1
07185303,6,0,6,0,0,0,0,0,1
07185370,8,5,3,0,3,1,2,1,1
07185482,7,3,4,0,1,1,0,1,1
07185491,5,3,2,0,1,1,0,1,0
07185540,3,0,3,0,0,0,0,0,1
07185594,18,4,14,0,2,2,0,2,1
07186247,1,1,0,0,1,1,0,0,0
07186317,2,0,2,0,0,0,0,0,0
07186727,2,0,2,0,0,0,0,0,1
07186955,9,5,4,0,1,1,0,1,1
07186989,4,3,1,0,2,2,0,0,0
07187444,3,3,0,0,2,2,0,0,0
07187991,7,6,1,0,1,1,0,0,0
07188049,27,3,24,0,2,1,1,1,1
07188060,10,4,6,0,1,1,0,1,1
07188238,2,0,2,0,1,1,0,0,0
07188347,3,0,3,0,0,0,0,0,1
07188405,14,0,14,0,0,0,0,0,0
07188654,9,6,3,0,2,1,1,1,1
07188671,18,11,7,0,0,0,0,0,1
07188687,7,5,2,0,1,1,0,1,1
07188858,13,3,10,0,0,0,0,0,1
07188952,3,2,1,0,2,2,0,0,0
07189004,5,2,3,0,0,0,0,0,1
07189080,28,11,17,0,0,0,0,0,1
07189102,4,0,4,0,0,0,0,0,1
07189179,4,2,2,0,1,1,0,0,1
07189345,1,1,0,0,1,1,0,0,1
07189398,1,1,0,0,1,1,0,0,0
07189647,20,12,8,0,0,0,0,0,1
07189668,5,1,4,0,1,1,0,0,0
07189806,3,2,1,0,2,1,1,0,0
07189822,1,1,0,0,1,1,0,0,1
07189960,2,2,0,0,2,2,0,0,1
07190355,3,0,3,0,0,0,0,0,1
07190386,15,3,12,0,1,1,0,1,0
07190658,4,3,1,0,3,3,0,0,1
07191166,1,1,0,0,1,1,0,0,0
07191473,4,2,2,0,1,1,0,0,1
07191605,1,1,0,0,1,1,0,0,0
07191721,2,0,2,0,0,0,0,0,1
07191806,16,0,16,0,1,1,0,1,1
07191989,6,0,6,0,0,0,0,0,1
07192043,6,0,6,0,0,0,0,0,1
07192065,3,2,1,0,1,1,0,1,0
07193119,5,2,3,0,2,2,0,0,1
07193145,13,4,9,0,1,1,0,0,0
07193306,8,5,3,0,0,0,0,0,0
07193336,4,2,2,0,1,1,0,0,1
07193337,4,4,0,0,0,0,0,0,0
07193348,4,3,1,0,1,1,0,0,0
07193527,10,6,4,0,1,1,0,0,1
07193737,4,3,1,0,1,1,0,0,0
07193747,2,2,0,0,2,1,1,2,0
07193792,22,6,16,0,3,0,3,0,1
07193797,3,0,3,0,0,0,0,0,1
07193829,10,4,6,0,1,1,0,1,1
07194054,7,4,3,0,1,1,0,1,1
07194580,15,0,15,0,0,0,0,0,1
07194584,1,1,0,0,1,1,0,0,0
07194678,1,0,1,0,1,1,0,0,1
07194832,13,5,8,0,2,2,0,2,1
07194862,5,3,2,0,1,1,0,0,0
07194879,2,2,0,0,1,1,0,0,0
07195168,5,2,3,0,1,1,0,0,0
07195191,6,2,4,0,3,1,2,3,0
07195560,2,2,0,0,1,1,0,0,0
07196230,10,4,6,0,2,2,0,2,0
07196462,37,12,25,0,0,0,0,0,1
07196594,7,4,3,0,1,1,0,1,1
07196663,4,0,4,0,0,0,0,0,1
07196905,2,1,1,0,1,1,0,0,0
07197045,12,6,6,0,2,2,0,1,0
07197180,2,2,0,0,2,1,1,0,1
07197446,4,4,0,0,2,1,1,0,0
07197843,7,2,5,0,1,1,0,1,1
07197885,5,0,5,0,0,0,0,0,0
07198613,22,7,15,0,0,0,0,0,0
07198747,2,2,0,0,1,1,0,0,1
07199023,8,0,8,0,0,0,0,0,1
07200049,8,0,8,0,2,2,0,0,0
07200267,36,11,25,0,0,0,0,0,1
07200499,22,4,18,0,1,1,0,1,1
07200773,9,3,6,0,1,1,0,1,1
07200912,2,1,1,0,1,1,0,0,0
07201098,4,2,2,0,3,3,0,1,0
07201754,11,6,5,0,3,1,2,1,1
07202030,7,2,5,0,4,1,3,1,1
07202115,9,5,4,0,1,1,0,1,1
07202268,2,2,0,0,1,1,0,0,0
07202984,2,0,2,0,0,0,0,0,1
07203374,3,1,2,0,1,1,0,0,1
07203550,6,2,4,0,2,2,0,0,1
07203614,6,0,6,0,0,0,0,0,1
07203928,5,2,3,0,5,1,4,3,1
07204027,2,2,0,0,2,2,0,0,1
07204072,14,5,9,0,0,0,0,0,1
07204209,5,2,3,0,1,1,0,0,0
07204282,2,2,0,0,1,1,0,0,0
07204467,2,0,2,0,0,0,0,0,1
07204705,2,2,0,0,0,0,0,0,0
07204783,2,2,0,0,2,2,0,0,0
07204791,3,0,3,0,0,0,0,0,1
07204982,12,6,6,0,1,1,0,0,1
07205003,8,2,6,0,2,2,0,0,1
07205118,1,1,0,0,1,1,0,0,0
07205152,1,1,0,0,1,1,0,0,1
07205160,3,0,3,0,0,0,0,0,1
07205301,1,0,1,0,0,0,0,0,0
07205402,18,5,13,0,0,0,0,0,1
07205442,2,2,0,0,1,1,0,0,0
07205505,1,1,0,0,1,1,0,0,0
07205535,1,1,0,0,1,1,0,0,0
07206861,10,0,10,0,0,0,0,0,1
07207084,22,5,17,0,1,1,0,1,1
07207251,1,1,0,0,1,1,0,0,0
07207636,2,2,0,0,2,2,0,0,0
07207848,3,0,3,0,1,1,0,0,0
07207861,8,0,8,0,0,0,0,0,1
07207904,2,2,0,0,1,1,0,0,1
07208351,3,3,0,0,2,2,0,0,0
07208517,9,5,4,0,0,0,0,0,1
07208581,4,2,2,0,1,1,0,0,0
07208651,14,4,10,0,1,1,0,1,1
07208888,10,0,10,0,1,1,0,1,1
07209057,7,0,7,0,0,0,0,0,1
07209557,1,1,0,0,1,1,0,0,0
07209837,8,4,4,0,1,1,0,1,1
07210040,14,0,14,0,0,0,0,0,1
07210463,3,1,2,0,1,1,0,0,0
07210495,2,2,0,0,2,2,0,0,0
07210798,18,11,7,0,0,0,0,0,1
07210806,1,1,0,0,1,1,0,0,0
07210824,1,1,0,0,2,2,0,0,0
07210846,3,1,2,0,1,1,0,0,0
07211002,1,1,0,0,2,2,0,0,1
07211158,2,1,1,0,4,2,2,0,1
07211163,4,1,3,0,1,1,0,0,0
07211722,12,0,12,0,1,1,0,1,1
07211801,13,6,7,0,0,0,0,0,0
07212146,2,1,1,0,1,1,0,0,0
07212830,6,0,6,0,0,0,0,0,1
07212917,5,1,4,0,3,1,2,0,1
07213059,1,0,1,0,0,0,0,0,0
07213330,3,3,0,0,1,1,0,1,1
07213374,6,2,4,0,1,1,0,0,1
07213859,2,1,1,0,2,1,1,0,0
07214035,3,2,1,0,2,2,0,0,0
07214063,16,0,16,0,0,0,0,0,1
07214488,15,5,10,0,1,1,0,0,0
07214673,2,2,0,0,2,2,0,0,0
07215284,1,0,1,0,0,0,0,0,1
07215658,9,5,4,0,1,1,0,0,0
07215684,4,4,0,0,2,2,0,0,0
07215795,3,0,3,0,0,0,0,0,1
07215828,5,4,1,0,2,2,0,0,1
07216417,3,0,3,0,0,0,0,0,1
07216539,2,2,0,0,2,2,0,0,0
07216558,2,1,1,0,1,1,0,0,0
07216586,8,3,5,0,1,1,0,0,1
07217394,3,2,1,0,1,1,0,0,0
07217418,23,9,14,0,0,0,0,0,0
07218431,5,3,2,0,1,1,0,1,1
07218799,2,1,1,0,3,1,2,0,0
07219102,2,2,0,0,1,1,0,0,1
07219124,10,0,10,0,0,0,0,0,1
07219522,2,0,2,0,1,1,0,0,0
07219847,6,6,0,0,1,1,0,0,1
07219919,4,4,0,0,0,0,0,0,0
07220414,5,4,1,0,5,5,0,0,0
07220432,11,4,7,0,1,1,0,1,1
07220459,10,4,6,0,0,0,0,0,1
07220461,2,1,1,0,1,1,0,0,1
07220609,2,1,1,0,1,1,0,0,1
07220664,18,0,18,0,0,0,0,0,0
07221014,1,1,0,0,1,1,0,0,0
07221232,3,2,1,0,1,1,0,0,1
07221241,3,3,0,0,2,2,0,0,1
07221472,8,0,8,0,0,0,0,0,1
07221498,2,0,2,0,0,0,0,0,0
07221697,5,4,1,0,2,2,0,0,0
07222256,8,0,8,0,0,0,0,0,1
07222275,22,11,11,0,0,0,0,0,1
07222408,5,0,5,3,0,0,0,0,1
07222527,2,2,0,0,1,1,0,0,1
07222896,2,0,2,0,0,0,0,0,1
07223072,2,2,0,0,2,2,0,0,0
07223583,4,0,4,0,0,0,0,0,0
07223617,3,2,1,0,2,2,0,0,0
07224115,7,6,1,0,0,0,0,0,0
07224322,5,3,2,0,0,0,0,0,0
07224396,7,2,5,0,1,1,0,0,1
07224399,5,2,3,0,0,0,0,0,1
07224886,2,2,0,0,1,1,0,0,0
07224997,1,1,0,0,1,1,0,0,0
07225668,3,2,1,0,1,1,0,0,0
07226359,13,6,7,0,2,2,0,2,1
07226626,4,2,2,0,1,1,0,1,1
07226689,2,1,1,0,1,1,0,0,0
07226699,3,3,0,0,3,3,0,0,0
07226837,15,0,15,0,0,0,0,0,1
07227027,2,2,0,0,2,2,0,0,0
07227401,4,2,2,0,2,2,0,0,0
07227439,2,1,1,0,1,1,0,0,0
07227736,3,2,1,0,3,2,1,0,1
07227937,17,10,7,0,0,0,0,0,1
07228502,2,1,1,0,1,1,0,0,0
07228598,3,2,1,0,2,2,0,0,0
07228709,1,1,0,0,1,1,0,0,0
07229424,7,0,7,0,1,1,0,1,1
07230072,2,0,2,0,1,1,0,0,1
07230283,2,2,0,0,2,2,0,0,0
07230595,10,4,6,0,1,1,0,0,0
07230745,3,2,1,0,1,1,0,0,1
07230782,32,10,22,0,0,0,0,0,1
07230825,2,0,2,0,0,0,0,0,1
07230960,3,3,0,0,2,2,0,0,0
07231010,18,15,3,0,1,1,0,1,1
07231064,2,2,0,0,2,2,0,0,0
07231295,4,2,2,0,1,1,0,0,0
07231303,13,5,8,0,3,1,2,1,1
07231778,5,0,5,0,1,1,0,0,1
07231981,3,1,2,0,1,1,0,0,0
07232058,5,5,0,0,3,0,3,0,1
07233113,25,10,15,0,8,6,2,0,0
07233489,25,5,20,0,1,1,0,1,1
07233528,7,2,5,0,1,1,0,1,1
07233624,34,4,30,0,1,1,0,1,1
07234008,5,3,2,0,1,1,0,0,0
07234051,2,0,2,0,0,0,0,0,0
07234097,4,2,2,0,2,2,0,0,1
07234143,4,3,1,0,1,1,0,0,1
07234707,22,4,18,0,1,1,0,1,1
07234974,5,2,3,0,1,1,0,0,1
07235198,12,2,10,0,1,1,0,1,1
07235265,6,2,4,0,1,1,0,0,1
07235280,13,6,7,0,1,1,0,1,1
07235376,12,0,12,0,0,0,0,0,1
07235384,1,1,0,0,1,1,0,0,0
07235417,8,3,5,0,1,1,0,0,0
07235501,24,3,21,0,1,1,0,1,1
07235869,3,2,1,0,2,2,0,0,0
07236021,5,0,5,0,0,0,0,0,1
07236607,2,0,2,0,0,0,0,0,1
07236812,17,0,17,0,0,0,0,0,1
07237059,3,1,2,0,3,1,2,1,0
07237375,3,3,0,0,1,1,0,0,0
07237547,34,12,22,0,0,0,0,0,1
07237935,17,7,10,0,0,0,0,0,0
07239505,20,7,13,0,3,2,1,3,1
07239666,3,3,0,0,3,3,0,0,0
07239727,11,7,4,0,1,1,0,1,1
07240177,1,1,0,0,1,1,0,0,0
07240624,21,7,14,0,0,0,0,0,0
07241442,5,3,2,0,3,3,0,0,1
07242200,2,0,2,0,0,0,0,0,1
07242265,2,0,2,0,0,0,0,0,0
07242669,23,11,12,0,0,0,0,0,1
07242994,1,0,1,0,0,0,0,0,0
07243033,26,13,13,0,1,0,1,0,0
07243213,3,1,2,0,0,0,0,0,0
07243410,1,0,1,0,0,0,0,0,1
07243747,3,2,1,0,1,1,0,0,0
07243768,3,2,1,0,3,3,0,0,1
07243895,2,0,2,0,0,0,0,0,1
07244204,4,2,2,0,2,2,0,0,0
07244955,6,5,1,0,3,3,0,0,1
07246535,19,8,11,0,0,0,0,0,1
07246975,16,4,12,0,1,1,0,0,0
07247058,11,1,10,0,1,1,0,0,1
07247064,1,1,0,0,2,2,0,0,0
07247118,5,2,3,0,1,1,0,1,1
07247238,18,7,11,0,0,0,0,0,0
07247325,2,2,0,0,2,2,0,0,1
07247341,4,3,1,0,2,2,0,0,0
07247511,2,2,0,0,1,1,0,0,0
07247717,5,2,3,0,1,1,0,0,1
07247963,4,0,4,0,2,2,0,0,0
07248444,7,0,7,0,0,0,0,0,1
07248456,1,0,1,0,0,0,0,0,0
07248508,13,3,10,0,2,1,1,2,1
07248633,6,3,3,0,0,0,0,0,1
07248698,14,3,11,0,1,1,0,1,1
07248813,12,6,6,0,0,0,0,0,1
07248818,8,7,1,0,0,0,0,0,0
07250181,6,1,5,0,1,1,0,0,0
07250291,1,1,0,0,2,2,0,0,0
07250549,7,5,2,0,0,0,0,0,1
07250873,6,5,1,0,0,0,0,0,0
07251141,24,4,20,0,2,1,1,0,1
07251193,3,0,3,0,0,0,0,0,1
07251197,9,0,9,0,0,0,0,0,1
07251302,3,3,0,0,3,3,0,0,1
07251533,2,1,1,0,1,1,0,0,0
07251702,4,0,4,0,0,0,0,0,1
07252481,5,1,4,0,1,1,0,0,1
07252707,10,2,8,0,4,2,2,0,1
07252984,22,5,17,0,1,1,0,1,1
07253015,24,9,15,0,1,0,1,0,1
07253213,13,6,7,0,1,1,0,1,1
07253336,2,2,0,0,2,2,0,0,0
07253475,14,2,12,0,0,0,0,0,1
07253712,2,0,2,0,1,1,0,0,0
07254702,1,0,1,0,0,0,0,0,1
07254977,3,3,0,0,3,3,0,0,1
07255704,11,7,4,0,0,0,0,0,1
07255735,2,0,2,0,0,0,0,0,1
07255865,3,2,1,0,2,2,0,0,1
07255929,7,2,5,0,1,1,0,1,1
07256045,3,3,0,0,4,4,0,1,1
07256308,2,2,0,0,1,1,0,0,0
07256654,2,0,2,0,0,0,0,0,1
07256655,9,4,5,0,1,1,0,1,1
05970005,3,2,1,0,2,2,0,0,1
05970100,8,3,5,0,1,1,0,1,1
05970330,2,2,0,0,2,2,0,0,0
05970386,3,3,0,0,2,2,0,0,0
05970602,2,2,0,0,2,2,0,0,0
05970606,34,13,21,0,0,0,0,0,1
05970667,11,0,11,0,0,0,0,0,1
05971173,19,4,15,0,2,1,1,2,1
05971189,19,0,19,0,1,1,0,1,1
05971347,15,2,13,0,2,1,1,2,1
05971434,6,4,2,0,3,3,0,0,0
05971616,3,3,0,0,2,2,0,0,0
05971924,25,7,18,0,1,1,0,1,1
05972364,2,0,2,0,0,0,0,0,1
05972501,9,5,4,0,1,1,0,1,1
05972612,5,0,5,0,2,2,0,0,0
05972734,4,2,2,0,1,1,0,0,1
05973040,22,0,22,0,0,0,0,0,1
05973116,4,2,2,0,0,0,0,0,1
05973370,33,10,23,0,0,0,0,0,1
05973571,11,0,11,0,0,0,0,0,1
05973813,4,1,3,0,1,1,0,0,1
05974173,2,0,2,0,0,0,0,0,1
05974175,9,3,6,0,1,1,0,1,1
05974195,15,2,13,0,1,1,0,1,1
05974354,3,3,0,0,2,2,0,0,0
05974870,3,3,0,0,4,2,2,0,0
05975770,5,0,5,0,0,0,0,0,1
05975864,5,0,5,0,0,0,0,0,1
05976388,3,0,3,0,0,0,0,0,1
05976507,20,4,16,0,2,2,0,2,1
05976786,12,3,9,0,1,1,0,1,1
05976906,11,0,11,0,3,3,0,1,1
05976924,4,2,2,0,1,1,0,0,1
05976933,7,4,3,0,3,3,0,0,1
05977250,25,5,20,0,0,0,0,0,0
05977271,4,0,4,0,2,2,0,0,1
05977277,80,14,66,0,0,0,0,0,1
05977584,5,3,2,0,2,2,0,1,0
05977603,42,10,32,0,1,0,1,0,0
05977625,3,2,1,0,2,2,0,0,0
05977819,4,2,2,0,1,1,0,0,1
05977968,21,5,16,0,2,2,0,2,1
05978292,2,1,1,0,1,1,0,0,1
05978522,30,2,28,0,5,2,3,2,0
05978596,4,3,1,0,1,1,0,0,0
05978660,22,8,14,0,2,2,0,2,1
05978765,7,1,6,0,1,1,0,0,0
05979250,11,2,9,0,1,1,0,1,1
05979415,3,3,0,0,1,1,0,0,1
05979736,44,6,38,0,1,1,0,1,1
05980202,15,3,12,0,1,1,0,1,1
05980315,8,5,3,0,1,1,0,0,0
05980442,3,0,3,0,0,0,0,0,1
05980515,5,3,2,0,2,2,0,0,0
05980796,5,1,4,0,1,1,0,0,1
05980797,3,0,3,1,0,0,0,0,0
05980811,5,1,4,0,1,1,0,0,1
05980832,12,5,7,0,1,1,0,1,1
05981009,12,3,9,0,2,2,0,0,0
05981825,14,0,14,0,1,1,0,1,1
05982592,4,2,2,0,2,2,0,0,0
05982711,30,10,20,0,0,0,0,0,0
05982830,24,0,24,0,0,0,0,0,1
05982966,21,2,19,0,1,1,0,1,1
05983125,39,10,29,0,0,0,0,0,1
05983198,16,4,12,0,0,0,0,0,0
05983202,5,2,3,0,2,2,0,0,0
05983289,8,2,6,0,3,3,0,1,1
05983680,7,4,3,0,1,1,0,0,1
05983938,15,4,11,0,1,1,0,1,0
05983946,11,3,8,0,2,2,0,0,0
05984145,5,0,5,0,1,1,0,0,1
05984539,22,10,12,0,1,1,0,1,1
05984658,8,0,8,0,0,0,0,0,1
05984671,6,0,6,0,0,0,0,0,1
05984676,7,2,5,0,0,0,0,0,1
05984845,12,0,12,0,0,0,0,0,1
05984855,21,8,13,0,0,0,0,0,1
05985255,11,2,9,0,1,1,0,1,0
05985393,4,0,4,0,0,0,0,0,1
05985445,3,0,3,0,1,1,0,0,0
05985609,22,8,14,0,0,0,0,0,0
05985626,20,6,14,0,0,0,0,0,0
05985636,11,0,11,0,0,0,0,0,1
05985661,13,0,13,0,0,0,0,0,1
05986176,11,0,11,0,0,0,0,0,1
05986463,6,2,4,0,1,1,0,0,0
05986544,6,3,3,0,1,1,0,1,1
05986575,4,2,2,0,2,1,1,1,0
05986596,5,2,3,0,2,2,0,0,0
05986711,16,4,12,0,2,2,0,2,1
05987080,44,6,38,0,1,1,0,1,1
05987096,44,6,38,0,1,1,0,1,1
05987129,45,6,39,0,1,1,0,1,1
05987130,45,6,39,0,1,1,0,1,1
05987141,43,6,37,0,1,1,0,1,1
05987376,5,2,3,0,1,1,0,0,0
05987524,8,0,8,0,3,2,1,1,1
05987533,8,0,8,0,3,2,1,1,1
05987601,54,6,48,0,0,0,0,0,0
05987620,8,0,8,0,3,2,1,1,1
05987714,15,4,11,0,2,1,1,2,1
05987732,3,2,1,0,2,2,0,0,0
05987938,7,4,3,0,1,1,0,0,1
05988028,14,7,7,0,0,0,0,0,1
05988211,29,11,18,0,0,0,0,0,1
05988371,25,9,16,0,0,0,0,0,1
05988389,20,3,17,0,1,1,0,1,0
05988581,18,0,18,0,0,0,0,0,1
05989598,3,0,3,0,0,0,0,0,1
05990314,3,2,1,0,1,1,0,0,0
05991408,6,2,4,0,2,2,0,0,0
05991659,11,3,8,0,1,1,0,1,1
05991689,14,2,12,0,0,0,0,0,1
05991708,2,2,0,0,1,1,0,0,0
05991759,7,4,3,0,0,0,0,0,1
05992073,18,10,8,0,0,0,0,0,1
05992192,21,0,21,0,0,0,0,0,1
05992353,7,2,5,0,2,2,0,0,0
05992482,5,3,2,0,1,1,0,0,0
05992489,12,4,8,1,1,0,1,0,1
05992502,12,4,8,1,1,0,1,0,1
05992642,70,14,56,0,0,0,0,0,1
05992808,21,5,16,0,2,2,0,0,0
05992828,4,3,1,0,1,1,0,0,1
05993202,3,2,1,0,1,1,0,0,0
05993256,16,5,11,0,2,1,1,1,1
05993666,5,3,2,0,0,0,0,0,0
05993823,6,0,6,0,0,0,0,0,1
05994433,15,0,15,0,4,2,2,0,1
05994621,23,2,21,0,2,2,0,2,1
05994760,7,1,6,0,2,2,0,0,0
05994920,4,0,4,0,0,0,0,0,1
05995026,26,6,20,0,2,2,0,2,1
05995030,24,6,18,0,2,2,0,2,1
05995084,5,5,0,0,2,2,0,0,0
05995730,7,1,6,0,1,1,0,0,1
05995854,11,0,11,0,0,0,0,0,1
05995943,13,4,9,0,2,2,0,2,1
05996672,2,0,2,0,1,1,0,0,1
05996933,7,0,7,0,0,0,0,0,1
05996960,7,0,7,0,0,0,0,0,1
05996964,21,1,20,0,1,1,0,1,1
05996973,13,0,13,0,0,0,0,0,1
05997200,3,2,1,0,1,1,0,0,0
05997786,8,0,8,0,0,0,0,0,1
05997930,5,2,3,0,2,2,0,0,1
05998128,4,0,4,0,1,1,0,0,0
05998367,19,0,19,0,0,0,0,0,1
05998477,4,2,2,0,1,1,0,0,1
05998531,4,0,4,0,0,0,0,0,1
05998669,7,2,5,0,1,1,0,0,1
05998995,9,3,6,0,0,0,0,0,0
05999216,6,0,6,0,0,0,0,0,1
05999302,4,2,2,0,2,2,0,0,1
05999876,9,2,7,0,2,2,0,1,1
05999883,3,3,0,0,0,0,0,0,0
05999908,22,0,22,0,0,0,0,0,1
06000032,8,6,2,0,1,1,0,1,1
06000071,3,2,1,0,2,2,0,0,0
06000179,4,4,0,0,1,1,0,0,1
06000442,2,0,2,0,0,0,0,0,1
06000449,11,3,8,0,1,1,0,0,0
06000815,7,1,6,0,2,1,1,0,1
06000890,9,4,5,0,1,1,0,0,1
06000941,20,3,17,0,2,1,1,2,1
06001016,4,2,2,0,1,1,0,0,0
06001141,12,4,8,0,1,1,0,1,1
06001168,14,3,11,0,0,0,0,0,1
06001442,29,9,20,0,1,1,0,1,1
06001450,6,3,3,0,3,2,1,0,0
06001920,8,3,5,0,1,1,0,0,1
06002133,24,6,18,0,1,1,0,1,1
06002135,25,7,18,0,1,1,0,1,1
06002138,19,7,12,0,0,0,0,0,1
06002143,24,7,17,0,1,1,0,1,1
06002148,26,6,20,0,1,1,0,1,1
06002154,24,6,18,0,1,1,0,1,1
06002232,20,0,20,0,0,0,0,0,1
06002255,10,6,4,0,1,1,0,0,0
06002309,14,8,6,0,0,0,0,0,0
06002530,6,1,5,0,1,1,0,0,1
06002695,4,2,2,0,1,1,0,0,0
06003227,3,3,0,0,2,2,0,0,0
06003254,8,3,5,0,1,1,0,0,0
06003288,10,5,5,0,0,0,0,0,1
06003427,16,0,16,0,1,1,0,1,1
06003430,18,0,18,0,1,1,0,1,1
06003756,10,3,7,0,1,1,0,1,1
06004163,3,0,3,0,0,0,0,0,1
06004187,21,7,14,0,1,1,0,1,1
06004338,3,3,0,0,1,1,0,0,0
06004512,9,6,3,0,2,2,0,0,1
06004886,5,3,2,0,2,2,0,0,0
06004947,4,3,1,0,2,2,0,0,0
06005190,15,1,14,0,3,1,2,2,0
06005412,26,0,26,0,0,0,0,0,1
06005591,7,2,5,0,1,1,0,0,0
06005752,9,2,7,0,1,1,0,1,1
06005766,11,3,8,0,1,1,0,1,1
06006201,10,0,10,0,0,0,0,0,1
06006589,21,0,21,0,1,1,0,1,1
06007230,5,3,2,0,2,2,0,0,0
06007250,4,0,4,0,0,0,0,0,1
06007484,7,2,5,0,1,1,0,1,1
06008719,3,2,1,0,1,1,0,0,0
06009173,14,3,11,0,2,1,1,2,1
06009291,5,2,3,0,0,0,0,0,0
06009297,6,1,5,0,2,1,1,0,1
06009303,5,2,3,0,0,0,0,0,0
06009589,6,1,5,0,1,1,0,1,1
06009868,16,6,10,0,2,1,1,0,1
06009993,15,3,12,0,0,0,0,0,1
06009994,15,3,12,0,0,0,0,0,1
06009996,15,3,12,0,0,0,0,0,1
06009999,15,3,12,0,1,1,0,1,1
06010061,15,3,12,0,1,1,0,1,1
06010154,15,3,12,0,0,0,0,0,1
06010355,8,0,8,0,0,0,0,0,1
06010364,10,3,7,0,1,1,0,1,1
06010693,30,12,18,0,1,1,0,0,1
06010708,16,2,14,0,0,0,0,0,1
06010834,10,5,5,0,0,0,0,0,1
06011649,20,9,11,0,2,2,0,0,1
06011677,3,0,3,0,0,0,0,0,1
06011820,5,1,4,0,1,1,0,0,0
06011894,8,3,5,0,1,1,0,1,1
06011967,7,0,7,0,1,1,0,0,1
06012009,7,3,4,0,2,1,1,1,1
06012112,3,3,0,0,2,2,0,0,0
06012425,6,4,2,0,1,1,0,0,1
06012434,12,6,6,0,0,0,0,0,1
06012690,21,2,19,0,1,1,0,1,0
06012717,4,2,2,0,1,1,0,0,1
06012780,7,3,4,0,4,1,3,2,1
06012996,6,2,4,0,0,0,0,0,0
06013044,12,2,10,0,1,0,1,0,0
06013143,15,3,12,0,1,1,0,1,0
06013157,20,0,20,0,0,0,0,0,1
06013161,18,0,18,0,0,0,0,0,1
06013237,23,1,22,0,1,1,0,1,0
06013238,15,8,7,0,0,0,0,0,0
06013350,3,3,0,0,1,1,0,0,1
06013372,9,3,6,0,1,1,0,1,1
06013528,6,3,3,0,2,2,0,1,1
06013551,2,1,1,0,0,0,0,0,0
06013948,7,2,5,0,2,2,0,2,1
06013980,10,0,10,0,2,2,0,0,1
06014408,5,1,4,0,2,2,0,0,1
06014593,10,2,8,0,0,0,0,0,1
06014732,15,0,15,0,0,0,0,0,1
06014738,15,0,15,0,0,0,0,0,1
06014740,15,0,15,0,0,0,0,0,1
06014756,15,0,15,0,0,0,0,0,1
06014801,15,0,15,0,0,0,0,0,1
06014821,9,4,5,0,0,0,0,0,0
06014850,5,3,2,0,2,2,0,0,0
06014870,3,3,0,0,2,2,0,0,0
06015141,11,2,9,0,1,1,0,1,1
06015316,4,2,2,0,2,2,0,0,0
06015445,4,2,2,0,1,1,0,0,1
06015724,15,7,8,0,0,0,0,0,1
06015791,14,3,11,0,1,1,0,1,1
06015816,7,2,5,0,1,1,0,0,1
06015824,7,0,7,0,0,0,0,0,1
06015924,5,0,5,0,0,0,0,0,1
06016068,6,0,6,0,0,0,0,0,1
06016136,4,0,4,0,0,0,0,0,1
06016149,12,2,10,0,1,1,0,1,1
06016250,8,2,6,0,1,1,0,0,1
06016650,7,4,3,0,1,1,0,0,1
06017065,4,0,4,0,0,0,0,0,1
06017088,4,2,2,0,1,1,0,0,1
06017139,8,5,3,0,4,4,0,0,1
06017793,5,3,2,0,3,3,0,1,1
06018005,20,5,15,0,2,2,0,2,1
06018008,20,5,15,0,2,2,0,2,1
06018232,6,4,2,0,1,1,0,0,1
06018305,5,2,3,0,1,1,0,0,1
06018456,9,0,9,0,1,1,0,1,1
06018500,4,1,3,0,1,1,0,0,1
06018718,49,8,41,0,0,0,0,0,1
06018748,15,2,13,0,1,1,0,1,1
06018872,4,4,0,0,3,3,0,0,0
06018900,29,12,17,0,0,0,0,0,1
06018951,7,2,5,0,1,1,0,1,1
06018955,4,2,2,0,1,1,0,0,1
06019063,7,5,2,0,0,0,0,0,1
06019363,8,0,8,0,0,0,0,0,1
06019492,9,3,6,0,2,2,0,0,1
06019584,9,2,7,0,1,1,0,0,0
06019976,6,3,3,0,1,1,0,0,1
06020012,9,3,6,0,0,0,0,0,0
06020126,14,0,14,0,0,0,0,0,1
06020207,15,2,13,0,2,1,1,2,1
06020342,3,2,1,0,1,1,0,0,1
06020476,24,2,22,0,1,1,0,1,1
06020564,4,0,4,0,1,1,0,0,1
06021105,12,2,10,0,0,0,0,0,0
06021219,3,1,2,0,1,1,0,0,1
06021322,17,0,17,1,0,0,0,0,1
06021385,19,5,14,0,2,2,0,2,1
06021388,19,5,14,0,2,2,0,2,1
06021395,20,5,15,0,2,2,0,2,1
06021396,19,5,14,0,2,2,0,2,1
06021397,19,5,14,0,2,2,0,2,1
06021492,8,0,8,0,0,0,0,0,1
06021560,4,0,4,0,0,0,0,0,1
06022146,8,1,7,0,1,1,0,0,1
06022152,5,3,2,0,2,2,0,0,1
06022159,21,0,21,0,1,1,0,1,1
06022348,12,10,2,0,1,1,0,0,1
06022545,6,0,6,0,0,0,0,0,1
06022784,4,2,2,0,1,1,0,1,1
06023058,3,2,1,0,1,1,0,0,0
06023076,5,0,5,0,0,0,0,0,1
06023243,70,20,50,0,0,0,0,0,1
06023453,10,4,6,0,1,1,0,1,1
06023458,5,0,5,0,0,0,0,0,1
06023494,16,5,11,0,1,1,0,1,1
06023503,25,6,19,0,2,2,0,2,1
06023552,16,7,9,0,2,2,0,2,1
06023616,5,3,2,0,2,2,0,0,1
06023651,4,1,3,0,1,1,0,0,0
06023774,5,0,5,0,3,3,0,0,1
06023863,25,4,21,0,1,1,0,1,1
06023874,18,3,15,0,1,1,0,1,1
06023887,5,2,3,0,1,1,0,0,1
06023893,7,0,7,0,0,0,0,0,1
06023923,15,2,13,0,1,1,0,1,1
06024038,5,3,2,0,2,2,0,0,0
06024174,4,0,4,0,0,0,0,0,1
06024250,6,2,4,0,1,1,0,0,1
06024313,9,3,6,0,1,1,0,0,0
06024362,4,4,0,0,1,1,0,0,0
06024819,4,2,2,0,2,2,0,0,1
06025028,10,7,3,0,0,0,0,0,1
06025156,27,8,19,0,1,1,0,0,0
06025252,12,2,10,0,1,1,0,1,1
06025495,5,3,2,0,2,2,0,0,0
06025681,4,0,4,0,0,0,0,0,1
06025801,4,2,2,0,2,2,0,0,1
06025838,6,2,4,0,0,0,0,0,1
06025889,6,0,6,0,0,0,0,0,0
06026072,5,3,2,0,2,2,0,0,0
06026481,4,0,4,0,1,1,0,0,1
06027016,3,1,2,0,1,1,0,0,1
06027093,7,5,2,0,2,2,0,0,1
06027268,12,4,8,0,1,1,0,1,1
06027279,4,0,4,0,0,0,0,0,1
06027314,33,3,30,0,1,1,0,1,1
06027423,13,3,10,0,1,1,0,1,1
06027434,3,3,0,0,2,2,0,0,0
06027452,15,0,15,0,0,0,0,0,1
06027484,2,2,0,0,1,1,0,1,0
06027686,4,2,2,0,3,3,0,0,1
06028016,5,2,3,0,1,1,0,0,0
06028127,5,3,2,0,1,1,0,0,1
06028128,9,4,5,0,1,1,0,1,1
06028364,14,3,11,0,1,1,0,1,1
06028419,3,3,0,0,2,2,0,0,0
06028458,7,0,7,0,0,0,0,0,1
06028492,3,2,1,0,2,2,0,0,0
06028509,3,3,0,0,3,3,0,0,0
06028633,10,0,10,0,0,0,0,0,1
06028759,13,3,10,0,2,2,0,0,1
06028936,32,7,25,0,0,0,0,0,1
06028994,11,3,8,0,4,4,0,4,1
06029292,4,2,2,0,1,1,0,0,0
06029296,2,2,0,0,1,1,0,0,0
06029366,8,3,5,0,2,2,0,2,1
06029445,6,2,4,0,1,1,0,0,1
06029530,7,2,5,0,3,1,2,0,1
06029889,4,2,2,0,1,1,0,0,1
06029939,8,3,5,0,0,0,0,0,0
06029962,5,1,4,0,1,1,0,0,1
06029979,2,0,2,0,0,0,0,0,1
06030108,4,2,2,0,1,1,0,0,1
06030312,6,0,6,0,1,1,0,0,1
06030326,6,3,3,0,1,1,0,1,1
06030455,10,6,4,0,1,1,0,0,1
06030468,7,2,5,0,0,0,0,0,0
06030501,10,3,7,0,1,1,0,1,1
06030553,7,2,5,0,1,1,0,1,1
06030659,6,3,3,0,0,0,0,0,0
06030803,8,3,5,0,1,1,0,0,1
06030830,2,1,1,0,1,1,0,0,1
06030845,3,1,2,0,1,1,0,0,1
06030902,10,0,10,0,0,0,0,0,1
06031220,5,3,2,0,2,2,0,0,1
06031241,6,4,2,0,1,1,0,0,1
06031246,8,0,8,0,0,0,0,0,1
06031639,8,1,7,0,1,1,0,0,0
06031760,9,0,9,0,0,0,0,0,1
01130124,3,0,3,0,0,0,0,0,0
01130241,25,5,20,0,1,1,0,1,1
01130269,122,9,113,0,0,0,0,0,1
01130680,19,0,19,0,0,0,0,0,1
01130968,55,18,37,0,0,0,0,0,0
01131523,26,0,26,0,0,0,0,0,1
01132261,40,3,37,0,1,1,0,1,1
01132389,95,16,79,0,0,0,0,0,1
01132499,28,2,26,0,1,1,0,1,1
01132669,43,0,43,0,0,0,0,0,1
01132760,49,5,44,0,1,1,0,1,1
01132888,21,3,18,0,1,1,0,1,0
01133424,3,3,0,0,1,1,0,0,1
01133459,39,3,36,0,1,1,0,1,1
01133537,72,10,62,0,0,0,0,0,1
01133617,30,0,30,0,0,0,0,0,1
01133952,20,3,17,0,1,1,0,0,0
01134772,42,8,34,0,1,1,0,1,1
01134878,70,10,60,0,0,0,0,0,0
01134897,7,0,7,0,0,0,0,0,1
01135043,30,5,25,0,1,1,0,1,1
01135053,20,2,18,0,1,1,0,0,1
01135243,18,0,18,0,0,0,0,0,1
01135284,35,7,28,0,1,1,0,1,1
01135380,4,0,4,0,1,1,0,0,0
01135517,22,3,19,0,1,1,0,1,1
01135678,3,2,1,0,1,1,0,0,1
01135804,16,3,13,0,1,1,0,1,0
01135827,35,5,30,0,1,1,0,1,1
01136384,45,4,41,0,0,0,0,0,0
01136511,42,12,30,0,0,0,0,0,1
01136601,23,4,19,0,0,0,0,0,1
01136793,59,4,55,0,0,0,0,0,1
01136893,22,5,17,0,0,0,0,0,1
01136899,8,5,3,0,1,1,0,0,1
01137097,6,0,6,0,0,0,0,0,0
01137353,71,3,68,0,2,2,0,2,1
01137780,78,22,56,0,0,0,0,0,0
01138022,35,3,32,0,1,1,0,1,1
01138268,32,0,32,0,0,0,0,0,1
01138340,55,6,49,0,1,1,0,1,1
01138744,8,3,5,0,1,1,0,1,0
01138995,63,14,49,0,0,0,0,0,1
01139085,4,3,1,0,1,1,0,0,0
01139640,33,0,33,0,1,1,0,1,1
01139949,7,3,4,0,2,2,0,1,1
01140208,26,5,21,0,1,1,0,1,1
01140502,13,3,10,0,1,1,0,0,1
01140505,11,5,6,0,1,1,0,0,1
01140803,3,3,0,0,2,2,0,0,0
01141372,10,3,7,0,1,1,0,1,1
01141530,20,3,17,0,1,1,0,1,1
01141788,40,7,33,0,1,1,0,1,1
01142208,42,5,37,0,2,1,1,1,1
01142313,13,0,13,0,1,1,0,1,1
01142360,95,25,70,0,25,24,1,0,1
01142536,101,8,93,0,0,0,0,0,0
01142560,23,1,22,0,1,1,0,1,1
01142830,45,10,35,0,0,0,0,0,1
01143302,0,0,0,0,0,0,0,0,0
01143506,35,0,35,0,0,0,0,0,1
01143732,20,4,16,0,1,1,0,1,1
01143819,53,8,45,0,1,1,0,1,1
01143820,49,6,43,0,1,1,0,1,1
01144329,33,5,28,0,1,1,0,1,1
01144352,49,10,39,0,1,1,0,1,1
01145149,21,0,21,0,0,0,0,0,1
01145214,37,7,30,0,0,0,0,0,1
01145231,32,0,32,0,0,0,0,0,1
01145493,20,3,17,0,0,0,0,0,1
01145510,18,4,14,0,0,0,0,0,1
01145800,27,6,21,0,0,0,0,0,1
01145823,19,5,14,0,1,1,0,0,0
01145960,19,0,19,0,0,0,0,0,1
01146094,15,4,11,0,1,1,0,0,0
01146172,4,3,1,0,1,1,0,0,0
01146225,20,2,18,0,0,0,0,0,0
01146236,36,2,34,0,1,1,0,1,1
01146599,23,3,20,0,2,2,0,0,1
01146642,7,2,5,0,1,1,0,0,1
01146831,9,1,8,0,1,1,0,0,0
01146888,36,7,29,0,2,2,0,2,1
01147198,8,2,6,0,1,1,0,0,1
01147282,48,11,37,0,0,0,0,0,1
01147288,6,2,4,0,2,2,0,0,1
01147640,23,0,23,0,0,0,0,0,1
01147938,32,0,32,0,0,0,0,0,1
01147974,21,0,21,0,0,0,0,0,1
01148083,41,3,38,0,4,3,1,1,1
01148200,13,4,9,0,1,1,0,1,1
01148654,26,4,22,0,1,1,0,1,1
01148674,24,2,22,0,1,1,0,0,1
01148992,31,3,28,0,1,1,0,1,1
01149012,81,7,74,0,0,0,0,0,1
01149309,12,3,9,0,1,1,0,0,1
01149604,25,7,18,0,0,0,0,0,1
01149824,16,0,16,0,0,0,0,0,1
01150046,34,0,34,0,0,0,0,0,1
01150202,28,1,27,0,2,1,1,2,1
01150570,3,3,0,0,1,1,0,0,1
01151029,7,5,2,0,1,1,0,1,0
01151609,10,5,5,0,1,1,0,0,1
01151823,52,13,39,0,0,0,0,0,1
01152015,12,2,10,0,1,1,0,1,1
01152018,21,0,21,0,0,0,0,0,1
01152514,11,0,11,0,0,0,0,0,1
01152535,15,4,11,0,2,0,2,0,1
01153163,19,3,16,0,1,1,0,1,1
01153383,27,0,27,0,1,1,0,1,1
01153795,3,0,3,0,0,0,0,0,1
01153834,24,5,19,0,1,1,0,1,1
01154049,64,9,55,0,2,2,0,2,1
01154197,17,6,11,0,1,1,0,1,1
01154411,71,17,54,0,0,0,0,0,1
01154955,25,3,22,0,2,2,0,2,1
01155247,30,0,30,0,0,0,0,0,1
01155793,52,3,49,0,0,0,0,0,0
01155841,40,4,36,0,1,1,0,1,1
01156047,10,1,9,0,4,1,3,1,1
01156197,6,3,3,0,1,1,0,0,0
01156506,24,0,24,0,0,0,0,0,1
01156605,55,13,42,0,1,1,0,0,0
01156743,5,3,2,0,1,1,0,1,0
01157249,109,16,93,0,0,0,0,0,1
01157288,5,3,2,0,2,2,0,0,1
01157591,122,33,89,0,0,0,0,0,1
01157669,25,2,23,0,1,1,0,1,0
01157770,27,5,22,0,1,1,0,1,1
01157990,10,0,10,0,1,1,0,1,1
01158456,16,0,16,0,1,1,0,1,1
01158678,34,2,32,0,1,1,0,1,1
01158750,10,3,7,0,3,1,2,1,0
01158819,72,10,62,0,0,0,0,0,1
01158893,51,4,47,1,1,1,0,1,1
01158956,16,5,11,0,0,0,0,0,1
01159548,4,3,1,0,1,1,0,0,0
01160015,13,2,11,0,1,1,0,0,0
01160056,12,3,9,0,1,1,0,1,1
01160119,47,4,43,0,1,1,0,1,1
01160176,38,14,24,0,2,1,1,0,1
01160226,28,0,28,0,0,0,0,0,1
01160460,38,5,33,0,1,1,0,1,0
01161099,24,6,18,0,0,0,0,0,1
01161281,8,0,8,0,1,1,0,1,1
01161435,10,0,10,0,0,0,0,0,1
01161445,70,0,70,0,0,0,0,0,1
01161446,181,7,174,0,1,1,0,1,1
01161649,12,5,7,0,2,2,0,0,1
01161935,9,3,6,0,1,1,0,0,1
01162240,55,7,48,0,0,0,0,0,1
01162501,38,4,34,0,1,1,0,1,1
01162531,6,2,4,0,2,2,0,0,1
01162840,30,5,25,0,0,0,0,0,0
01162870,28,3,25,0,0,0,0,0,1
01163246,45,14,31,0,0,0,0,0,1
01163352,16,3,13,0,0,0,0,0,0
01163567,26,3,23,0,0,0,0,0,1
01163687,23,5,18,0,0,0,0,0,1
01163844,32,5,27,0,1,1,0,1,1
01163945,3,2,1,0,3,2,1,1,0
01164081,22,3,19,0,1,1,0,0,1
01164204,13,3,10,0,0,0,0,0,0
01164455,41,8,33,0,1,1,0,0,1
01164551,14,3,11,0,0,0,0,0,1
01164553,28,0,28,0,0,0,0,0,1
01164841,25,0,25,0,1,1,0,1,1
01164903,29,7,22,0,0,0,0,0,1
01164920,20,2,18,0,1,1,0,1,1
01165130,44,11,33,0,0,0,0,0,1
01165311,78,14,64,0,0,0,0,0,1
01165461,18,4,14,0,0,0,0,0,1
01165791,5,2,3,0,1,1,0,0,1
01166185,24,0,24,0,0,0,0,0,1
01166239,69,14,55,0,18,13,5,0,1
01166348,5,3,2,0,2,2,0,0,0
01166416,3,3,0,0,1,1,0,0,0
01167127,57,13,44,0,0,0,0,0,1
01167328,33,0,33,0,1,1,0,1,1
01168169,25,3,22,0,0,0,0,0,1
01168299,17,6,11,0,1,1,0,1,1
01168311,23,4,19,0,1,1,0,1,1
01168440,54,16,38,0,0,0,0,0,1
01168450,27,0,27,0,0,0,0,0,1
01168472,48,5,43,0,1,1,0,0,1
01168987,15,3,12,0,1,1,0,0,1
01169163,7,3,4,0,1,1,0,1,0
01170230,18,6,12,0,0,0,0,0,1
01170304,29,12,17,0,2,2,0,0,1
01170753,52,0,52,0,0,0,0,0,1
01170885,0,0,0,0,0,0,0,0,1
01170890,52,13,39,0,2,1,1,0,0
01171100,20,6,14,0,0,0,0,0,0
01171166,4,2,2,0,1,1,0,0,1
01171709,8,3,5,2,1,1,0,0,1
01171833,22,3,19,0,1,1,0,1,1
01171856,20,6,14,0,0,0,0,0,0
01171873,5,1,4,0,1,1,0,0,1
01172263,44,9,35,0,0,0,0,0,1
01172617,8,3,5,0,0,0,0,0,1
01172644,11,4,7,0,0,0,0,0,0
01172694,38,10,28,0,0,0,0,0,0
01172926,6,3,3,0,2,2,0,0,0
01173073,22,0,22,0,1,1,0,1,1
01173271,20,4,16,0,1,1,0,1,1
01173516,0,0,0,0,0,0,0,0,0
01173852,12,5,7,0,1,1,0,0,1
01173859,92,15,77,0,0,0,0,0,1
01174651,55,17,38,0,0,0,0,0,1
01174981,15,0,15,0,0,0,0,0,1
01175051,44,9,35,0,0,0,0,0,1
01175114,2,0,2,0,0,0,0,0,0
01175279,74,8,66,0,0,0,0,0,1
01175491,20,4,16,0,1,1,0,1,1
01175598,23,3,20,0,1,1,0,1,1
01175680,33,0,33,0,0,0,0,0,1
01175684,17,2,15,0,1,1,0,0,1
01175776,6,3,3,0,1,1,0,0,0
01175862,77,10,67,0,2,2,0,0,1
01175867,14,1,13,0,1,1,0,1,0
01176089,27,0,27,0,0,0,0,0,1
01176427,6,2,4,0,2,2,0,0,0
11700349,2,2,0,0,1,1,0,0,1
11700432,3,3,0,0,0,0,0,0,0
11700539,2,2,0,0,2,2,0,1,1
11700607,3,3,0,0,1,1,0,1,0
11701182,1,1,0,0,1,1,0,0,0
11701263,1,1,0,0,1,1,0,0,0
11701364,3,3,0,0,2,2,0,0,1
11701625,1,1,0,0,1,1,0,0,0
11702116,1,1,0,0,1,1,0,0,0
11702300,1,1,0,0,1,1,0,0,0
11702347,2,2,0,0,1,1,0,0,0
11702637,2,2,0,0,2,2,0,0,0
11702948,2,2,0,0,1,1,0,1,0
11703140,2,2,0,0,1,1,0,1,1
11703205,1,1,0,0,1,1,0,0,0
11703274,7,7,0,0,0,0,0,0,0
11703568,1,1,0,0,1,1,0,0,0
11703842,3,3,0,0,0,0,0,0,1
11704183,3,3,0,0,1,1,0,1,1
11704803,2,2,0,0,2,2,0,0,0
11704966,8,6,2,0,1,1,0,1,1
11704995,2,2,0,0,1,1,0,1,0
11705074,7,5,2,0,2,1,1,2,1
11705881,2,2,0,0,1,1,0,0,0
11705931,1,1,0,0,1,1,0,0,0
11706248,1,1,0,0,2,2,0,1,0
11706497,1,1,0,0,1,1,0,0,0
11706504,1,1,0,0,1,1,0,0,0
11706535,8,7,1,0,0,0,0,0,0
11706577,2,2,0,0,2,2,0,0,0
11706578,1,1,0,0,1,1,0,0,0
11706921,3,1,2,0,3,1,2,0,0
11707051,1,1,0,0,1,1,0,0,0
11708614,1,1,0,0,1,1,0,0,0
11708986,2,2,0,0,1,1,0,0,0
11709008,1,1,0,0,1,1,0,0,0
11709174,1,1,0,0,1,1,0,0,0
11709326,3,3,0,0,0,0,0,0,0
11709377,8,8,0,0,0,0,0,0,0
11709403,9,9,0,0,4,4,0,0,1
11709427,1,1,0,0,1,1,0,0,0
11709477,3,3,0,0,1,1,0,1,0
11709493,1,1,0,0,1,1,0,0,0
11709873,4,3,1,0,1,1,0,1,1
11710287,1,1,0,0,1,1,0,0,0
11710362,1,1,0,0,1,1,0,0,0
11710526,1,1,0,0,1,1,0,0,0
11710577,1,1,0,0,1,1,0,0,0
11710578,1,1,0,0,2,2,0,0,0
11710604,2,2,0,0,1,1,0,0,0
11710707,1,1,0,0,0,0,0,0,0
11710742,2,2,0,0,2,2,0,0,0
11710811,4,3,1,0,4,4,0,0,1
11711042,3,3,0,0,1,1,0,1,1
11711808,1,1,0,0,1,1,0,0,0
11712190,1,1,0,0,1,1,0,0,0
11712566,2,2,0,0,1,1,0,0,0
11712661,1,1,0,0,1,1,0,0,0
11713023,1,1,0,0,1,1,0,0,0
11713060,2,2,0,0,2,2,0,0,0
11713268,2,2,0,0,1,1,0,1,1
11713357,2,2,0,0,1,1,0,1,0
11713550,2,2,0,0,1,1,0,1,1
11713853,1,1,0,0,1,1,0,0,0
11714070,1,1,0,0,1,1,0,0,0
11715166,1,1,0,0,1,1,0,0,0
11715347,1,1,0,0,1,1,0,0,0
11715364,6,2,4,0,2,1,1,1,1
11715675,2,2,0,0,1,1,0,0,0
11715771,2,2,0,0,1,1,0,0,0
11716037,2,2,0,0,2,2,0,0,0
11716767,3,3,0,0,1,1,0,1,1
11717279,2,2,0,0,1,1,0,0,0
11717310,2,2,0,0,0,0,0,0,0
11717394,3,3,0,0,2,2,0,0,0
11717434,4,4,0,0,1,1,0,1,1
11717724,1,1,0,0,1,1,0,0,0
11717816,7,7,0,0,1,1,0,1,1
11717986,1,1,0,0,1,1,0,0,0
11718001,2,2,0,0,1,1,0,0,0
11718108,2,2,0,0,2,1,1,0,0
11718261,1,1,0,0,1,1,0,0,0
11718459,3,3,0,0,3,3,0,0,0
11718506,2,1,1,0,3,2,1,1,0
11718910,6,4,2,0,0,0,0,0,0
11718987,1,1,0,0,1,1,0,0,0
11719521,3,3,0,0,1,1,0,0,0
11719719,2,2,0,0,1,1,0,0,0
11719793,2,2,0,0,1,1,0,0,0
11720494,4,4,0,0,1,1,0,0,0
11721162,3,3,0,0,0,0,0,0,0
11721213,3,3,0,0,3,3,0,0,0
11721478,1,1,0,0,1,1,0,0,0
11721575,1,1,0,0,1,1,0,0,0
11721752,2,2,0,0,2,2,0,0,0
11721862,5,3,2,0,1,1,0,1,0
11722166,3,3,0,0,0,0,0,0,0
11722200,2,2,0,0,1,1,0,0,0
11722555,2,2,0,0,2,2,0,0,0
11722710,1,1,0,0,1,1,0,0,0
11722822,2,2,0,0,2,2,0,1,0
11723069,1,1,0,0,1,1,0,0,0
11723145,2,2,0,0,0,0,0,0,1
11723521,1,1,0,0,1,1,0,0,1
11723689,2,2,0,0,2,2,0,0,1
11723770,1,1,0,0,1,1,0,0,0
11723846,1,1,0,0,1,1,0,0,0
11723941,2,2,0,0,1,1,0,0,1
11724111,2,2,0,0,2,2,0,0,0
11724607,1,1,0,0,1,1,0,0,0
11724894,1,0,1,0,1,0,1,0,0
11725123,3,3,0,0,1,1,0,0,1
11725165,1,1,0,0,1,1,0,0,0
11725350,2,2,0,0,2,2,0,0,0
11725802,4,4,0,0,0,0,0,0,0
11726071,1,1,0,0,1,1,0,0,0
11726301,2,2,0,0,1,1,0,1,1
11726415,2,2,0,0,2,2,0,0,0
11726452,1,1,0,0,1,1,0,0,0
11726941,2,2,0,0,0,0,0,0,0
11727299,4,4,0,0,1,1,0,0,1
11727369,6,4,2,0,1,1,0,1,1
11727436,1,1,0,0,1,1,0,0,0
11727477,6,4,2,0,1,1,0,1,1
11727545,2,2,0,0,2,2,0,0,1
11727794,6,6,0,0,2,2,0,0,1
11727920,2,2,0,0,2,2,0,0,0
11728110,1,1,0,0,0,0,0,0,0
11728275,1,1,0,0,1,1,0,0,0
11728281,1,1,0,0,1,1,0,0,0
11728413,2,2,0,0,1,1,0,1,1
11728510,2,2,0,0,1,1,0,1,1
11728523,2,2,0,0,2,2,0,0,0
11728578,2,2,0,0,1,1,0,1,1
11728639,2,2,0,0,1,1,0,0,1
11728819,1,1,0,0,2,2,0,0,1
11729016,2,2,0,0,1,1,0,1,1
11729351,1,1,0,0,1,1,0,0,0
11729666,2,1,1,0,2,1,1,0,0
11729674,2,2,0,0,2,2,0,0,0
11729695,5,5,0,0,1,0,1,0,1
11729799,2,2,0,0,1,1,0,1,1
11729852,1,1,0,0,1,1,0,0,0
11730109,1,1,0,0,1,1,0,0,0
11730126,2,2,0,0,1,1,0,1,1
11731152,3,3,0,0,3,3,0,0,0
11731262,1,1,0,0,1,1,0,0,0
11731308,1,1,0,0,1,1,0,0,0
11731658,1,1,0,0,1,1,0,0,0
11732100,5,4,1,0,0,0,0,0,1
11732168,1,1,0,0,1,1,0,0,0
11732974,1,1,0,0,1,1,0,0,0
11733303,1,0,1,0,1,1,0,0,0
11733529,1,1,0,0,1,1,0,0,0
11734589,1,1,0,0,1,1,0,0,0
11734767,1,1,0,0,1,1,0,0,0
11734863,4,4,0,0,1,1,0,0,1
11735113,4,4,0,0,1,1,0,1,1
11735195,6,5,1,0,1,1,0,1,1
11735391,2,2,0,0,2,2,0,0,0
11735715,2,2,0,0,1,1,0,0,1
11736604,3,3,0,0,1,1,0,0,1
11736792,1,1,0,0,1,1,0,0,0
11737144,1,1,0,0,1,1,0,1,0
11737351,3,3,0,0,0,0,0,0,1
11737719,1,1,0,0,1,1,0,0,0
11737737,1,1,0,0,2,2,0,0,0
11737868,1,1,0,0,0,0,0,0,0
11738032,2,2,0,0,1,1,0,0,0
11738907,5,5,0,0,0,0,0,0,0
11739444,2,2,0,0,1,1,0,0,0
11740119,1,1,0,0,1,1,0,0,0
11740205,1,1,0,0,1,1,0,0,0
11740402,3,3,0,0,1,1,0,1,1
11741249,4,4,0,0,4,4,0,0,0
11742059,1,1,0,0,1,1,0,0,0
11742358,1,1,0,0,1,1,0,0,0
11742415,1,1,0,0,1,1,0,0,0
11743302,9,9,0,0,0,0,0,0,0
11743369,1,1,0,0,1,1,0,0,0
11743380,12,8,4,0,0,0,0,0,0
11743858,1,1,0,0,0,0,0,0,0
11744717,2,2,0,0,1,1,0,0,0
11745038,13,13,0,0,1,1,0,1,0
11745859,3,3,0,0,3,3,0,0,0
11745953,2,2,0,0,2,2,0,0,0
11746182,1,1,0,0,2,2,0,0,0
11746573,2,2,0,0,2,2,0,0,0
11746659,1,1,0,0,1,1,0,0,1
11747149,1,1,0,0,1,1,0,0,0
11747235,2,2,0,0,3,2,1,1,0
11747406,2,2,0,0,1,1,0,0,0
11747733,1,1,0,0,1,1,0,0,1
11748309,1,1,0,0,1,1,0,0,0
11748593,1,1,0,0,1,1,0,0,0
11748785,2,2,0,0,2,2,0,0,0
11749084,1,1,0,0,1,1,0,0,0
11749779,4,4,0,0,2,2,0,0,1
11749892,6,6,0,0,0,0,0,0,0
11750028,1,1,0,0,1,1,0,0,0
11750122,2,2,0,0,0,0,0,0,0
11750161,1,1,0,0,1,1,0,0,0
11750846,1,1,0,0,1,1,0,0,0
11751004,2,2,0,0,1,1,0,1,0
11751214,1,1,0,0,1,1,0,0,0
11751432,1,1,0,0,1,1,0,0,0
11751472,1,1,0,0,1,1,0,0,0
11751515,5,5,0,0,1,1,0,1,1
11751598,2,2,0,0,2,2,0,0,0
11751874,1,1,0,0,1,1,0,0,1
11752479,1,1,0,0,1,1,0,0,0
11752650,1,1,0,0,1,1,0,0,0
11752873,1,1,0,0,1,1,0,0,0
11753569,1,1,0,0,2,2,0,0,0
11753687,1,1,0,0,1,1,0,0,0
11753818,3,3,0,0,1,1,0,1,1
11754049,2,2,0,0,1,1,0,0,0
11754674,3,3,0,0,0,0,0,0,0
11755110,1,1,0,0,1,1,0,0,0
11755131,2,2,0,0,1,1,0,0,0
11755149,1,1,0,0,1,1,0,0,0
11755161,4,4,0,0,2,1,1,0,0
11755980,1,1,0,0,1,1,0,0,0
11756866,2,2,0,0,1,1,0,0,0
11757124,2,2,0,0,1,1,0,0,0
11757203,5,4,1,0,1,0,1,1,1
11757873,4,4,0,0,1,1,0,1,1
11757940,4,4,0,0,1,1,0,1,1
11758435,3,3,0,0,1,1,0,1,1
11758473,2,2,0,0,2,2,0,0,0
11758532,3,3,0,0,1,1,0,1,1
11758839,1,1,0,0,0,0,0,0,0
11758958,1,1,0,0,1,1,0,0,0
11759295,4,4,0,0,1,1,0,1,0
11759362,2,2,0,0,1,1,0,0,0
11759569,1,1,0,0,1,1,0,0,1
11759587,1,1,0,0,1,1,0,0,0
11759641,3,2,1,0,3,1,2,0,0
11759934,2,2,0,0,1,1,0,1,1
11760154,1,1,0,0,1,1,0,0,0
11760270,7,6,1,0,1,1,0,0,0
11760722,1,1,0,0,2,2,0,0,0
11760917,2,1,1,0,2,1,1,0,0
11761009,7,5,2,0,0,0,0,0,1
11761152,2,2,0,0,1,1,0,0,1
11761775,2,2,0,0,1,1,0,0,0
11762146,2,2,0,0,2,2,0,0,0
11762380,2,2,0,0,2,2,0,0,0
11762517,2,2,0,0,1,1,0,0,0
11762686,1,1,0,0,1,1,0,1,0
11762745,1,1,0,0,1,1,0,0,0
11762818,1,1,0,0,1,1,0,0,0
06220118,11,0,11,0,0,0,0,0,1
06220234,18,7,11,0,0,0,0,0,1
06220264,5,0,5,0,0,0,0,0,1
06220931,4,3,1,0,2,2,0,0,1
06221141,8,2,6,0,2,2,0,0,0
06221171,4,0,4,0,0,0,0,0,1
06221263,18,2,16,0,1,1,0,1,1
06221265,6,0,6,0,0,0,0,0,1
06221480,2,0,2,0,0,0,0,0,0
06221535,7,2,5,0,1,1,0,1,1
06221771,4,2,2,0,1,1,0,0,0
06221959,26,5,21,0,2,2,0,2,1
06221996,5,3,2,0,1,1,0,0,1
06222055,7,4,3,0,1,1,0,1,1
06222098,8,5,3,0,1,1,0,1,1
06222620,11,0,11,0,0,0,0,0,1
06222664,5,2,3,0,1,1,0,0,1
06222862,10,4,6,0,1,1,0,1,1
06223359,26,3,23,0,1,0,1,1,1
06223485,4,0,4,0,0,0,0,0,1
06223736,31,5,26,0,3,2,1,3,1
06223740,31,5,26,0,2,2,0,2,1
06223818,7,0,7,0,0,0,0,0,1
06224224,6,3,3,0,1,1,0,0,1
06224985,4,4,0,0,1,1,0,0,1
06225059,9,3,6,0,4,3,1,1,1
06225082,2,2,0,0,2,2,0,0,0
06225333,10,3,7,0,1,1,0,1,1
06225445,7,2,5,0,1,1,0,1,1
06225479,14,3,11,0,2,2,0,2,1
06225483,16,4,12,0,2,2,0,2,1
06225851,8,3,5,0,2,2,0,0,0
06225933,6,2,4,0,1,1,0,0,0
06226134,5,0,5,0,0,0,0,0,1
06226392,3,3,0,0,2,2,0,0,1
06226416,5,0,5,0,0,0,0,0,0
06226434,5,1,4,0,1,1,0,0,0
06226592,25,12,13,0,6,6,0,0,1
06226595,73,14,59,0,0,0,0,0,1
06226719,47,6,41,0,1,1,0,1,0
06226749,22,11,11,0,0,0,0,0,1
06226775,17,0,17,0,0,0,0,0,1
06226803,28,5,23,0,1,1,0,1,1
06226957,7,5,2,0,1,1,0,1,1
06227091,7,2,5,0,4,2,2,0,0
06227100,20,12,8,0,0,0,0,0,1
06227137,3,3,0,0,2,2,0,0,0
06227318,6,0,6,0,0,0,0,0,1
06227392,2,2,0,0,1,1,0,0,0
06227725,8,1,7,0,2,1,1,0,1
06228143,3,1,2,0,2,1,1,1,1
06228245,15,4,11,0,2,2,0,2,1
06228255,4,3,1,0,2,2,0,0,1
06228585,7,2,5,0,1,1,0,0,0
06228821,4,4,0,0,3,3,0,0,1
06228955,4,3,1,0,1,1,0,0,0
06229147,4,2,2,0,2,1,1,0,0
06229569,7,3,4,0,0,0,0,0,1
06229810,6,1,5,0,1,1,0,1,1
06230211,4,0,4,0,0,0,0,0,1
06230385,13,0,13,0,1,1,0,1,1
06230514,6,1,5,0,1,1,0,0,1
06230767,5,3,2,0,1,1,0,0,0
06231325,2,1,1,0,1,1,0,0,0
06231428,26,7,19,0,2,1,1,2,1
06231440,6,2,4,0,1,1,0,0,1
06231592,3,3,0,0,1,1,0,0,0
06231809,20,9,11,0,1,1,0,0,0
06232248,5,0,5,0,0,0,0,0,1
06232266,5,0,5,0,0,0,0,0,1
06232764,2,2,0,0,1,1,0,0,0
06232939,10,4,6,0,1,1,0,1,1
06233006,10,5,5,0,3,0,3,0,1
06233165,4,2,2,0,2,2,0,0,0
06233587,2,2,0,0,1,1,0,0,0
06233633,15,0,15,0,0,0,0,0,1
06234227,3,3,0,0,1,1,0,0,0
06234429,4,2,2,0,1,1,0,0,1
06234562,3,3,0,0,1,1,0,0,1
06234775,5,1,4,0,3,3,0,0,0
06234815,6,1,5,0,1,1,0,0,0
06234863,12,3,9,0,0,0,0,0,1
06235182,9,3,6,0,1,1,0,1,1
06235332,3,3,0,0,2,2,0,0,1
06236008,24,4,20,0,1,1,0,1,1
06236059,17,5,12,0,1,1,0,1,1
06236127,4,3,1,0,2,2,0,0,0
06236173,4,0,4,0,1,1,0,0,1
06236179,8,3,5,0,1,1,0,0,1
06236607,5,0,5,0,0,0,0,0,1
06236665,6,0,6,0,0,0,0,0,1
06236671,23,4,19,0,1,1,0,1,1
06236713,2,1,1,0,1,1,0,0,0
06237202,5,3,2,0,1,1,0,0,1
06237623,19,6,13,0,1,1,0,1,1
06237942,7,0,7,0,0,0,0,0,1
06237948,7,0,7,0,0,0,0,0,1
06237968,7,0,7,0,0,0,0,0,1
06238013,7,0,7,0,0,0,0,0,1
06238812,3,2,1,0,1,1,0,0,0
06238836,3,2,1,0,1,1,0,0,0
06239034,16,0,16,0,0,0,0,0,1
06239184,10,2,8,0,1,1,0,0,1
06239590,5,3,2,0,1,1,0,1,1
06239867,2,1,1,0,1,1,0,0,0
06240151,28,7,21,0,0,0,0,0,1
06240181,4,3,1,0,1,1,0,0,0
06240215,4,2,2,0,1,1,0,0,0
06240659,4,2,2,0,1,1,0,0,0
06241695,4,2,2,0,1,1,0,0,1
06241738,18,6,12,0,1,1,0,0,0
06241992,4,1,3,0,1,1,0,0,1
06242034,7,0,7,0,0,0,0,0,1
06242082,10,0,10,0,0,0,0,0,1
06242141,17,8,9,0,0,0,0,0,1
06242273,3,3,0,0,1,1,0,0,0
06242328,24,4,20,0,1,1,0,1,1
06242508,26,5,21,0,2,2,0,2,1
06242672,14,5,9,0,1,1,0,1,1
06242732,15,0,15,0,0,0,0,0,1
06242870,4,0,4,0,0,0,0,0,1
06242954,14,3,11,0,0,0,0,0,0
06243678,6,1,5,0,1,1,0,0,0
06243698,8,0,8,0,1,1,0,1,0
06243912,4,1,3,0,1,1,0,0,1
06244260,21,12,9,0,0,0,0,0,0
06244269,9,2,7,0,0,0,0,0,0
06244330,6,3,3,0,0,0,0,0,1
06244703,3,2,1,0,2,2,0,0,0
06244765,4,2,2,0,1,1,0,0,0
06245728,8,4,4,0,1,1,0,0,1
06245757,3,2,1,0,1,1,0,0,1
06245787,4,3,1,0,1,1,0,0,1
06245801,8,4,4,0,3,1,2,0,1
06246619,4,1,3,0,1,1,0,0,1
06246929,40,12,28,0,0,0,0,0,0
06247372,8,4,4,0,3,3,0,0,1
06247883,4,1,3,0,1,1,0,0,0
06247917,7,0,7,3,0,0,0,0,1
06247953,4,3,1,0,1,1,0,0,0
06247955,6,1,5,0,1,1,0,0,1
06248210,6,0,6,0,0,0,0,0,1
06248674,31,9,22,0,1,1,0,0,1
06249431,5,0,5,0,0,0,0,0,1
06249683,3,0,3,0,0,0,0,0,1
06249799,39,4,35,0,3,2,1,3,0
06249803,14,12,2,0,1,1,0,0,0
06249843,2,0,2,0,0,0,0,0,0
06249860,13,4,9,0,2,2,0,2,1
06250814,8,4,4,0,0,0,0,0,1
06251340,4,3,1,0,1,1,0,1,0
06251458,5,3,2,0,1,1,0,0,1
06251556,2,2,0,0,1,1,0,0,0
06251999,11,4,7,0,0,0,0,0,1
06252059,5,1,4,0,1,1,0,0,1
06252535,15,0,15,0,0,0,0,0,1
06252567,14,0,14,0,0,0,0,0,1
06252667,9,5,4,0,0,0,0,0,1
06252671,9,0,9,0,0,0,0,0,1
06252699,4,2,2,0,1,1,0,0,0
06252720,18,3,15,0,2,1,1,2,1
06252749,15,0,15,0,0,0,0,0,1
06252765,6,1,5,0,0,0,0,0,1
06252766,17,0,17,0,0,0,0,0,1
06252881,3,3,0,0,2,2,0,0,0
06253477,27,3,24,0,1,1,0,1,0
06253529,4,2,2,0,1,1,0,0,1
06253687,5,0,5,0,0,0,0,0,1
06253892,6,4,2,0,1,1,0,1,1
06254195,12,5,7,0,2,2,0,0,1
06254196,14,4,10,0,1,1,0,1,1
06254342,10,3,7,0,0,0,0,0,1
06254578,9,3,6,0,1,1,0,0,0
06254600,7,5,2,0,3,1,2,1,0
06254658,5,3,2,0,1,1,0,0,0
06254669,15,2,13,0,3,1,2,1,1
06254755,6,3,3,0,1,1,0,0,1
06254995,5,3,2,0,2,2,0,0,0
06255178,6,3,3,0,0,0,0,0,0
06255215,8,2,6,0,1,1,0,0,1
06255276,12,5,7,0,0,0,0,0,0
06255352,10,3,7,0,1,1,0,1,0
06255402,26,4,22,0,1,1,0,1,1
06255477,15,4,11,0,0,0,0,0,0
06255483,7,5,2,0,4,4,0,0,0
06255498,3,3,0,0,1,1,0,0,1
06255507,7,3,4,0,2,2,0,1,1
06255586,3,0,3,0,0,0,0,0,1
06255729,25,4,21,0,0,0,0,0,0
06255792,4,3,1,0,1,1,0,0,0
06255817,8,2,6,0,2,2,0,1,1
06255938,5,3,2,0,1,1,0,0,1
06255972,4,2,2,0,1,1,0,0,0
06256544,25,4,21,0,1,1,0,1,1
06256667,3,2,1,0,1,1,0,0,1
06256698,19,9,10,0,1,0,1,1,1
06256712,23,0,23,0,0,0,0,0,1
06256721,3,0,3,0,0,0,0,0,1
06256740,3,0,3,0,0,0,0,0,1
06256955,10,2,8,0,2,1,1,0,1
06256972,10,5,5,0,0,0,0,0,0
06257047,16,3,13,0,1,1,0,1,1
06257320,22,7,15,0,0,0,0,0,0
06257618,9,0,9,0,0,0,0,0,1
06257626,12,0,12,0,0,0,0,0,1
06257721,4,2,2,0,2,2,0,0,1
06257727,4,1,3,0,1,1,0,0,1
06257744,19,3,16,0,1,1,0,1,1
06258088,28,12,16,0,1,1,0,0,0
06258194,4,3,1,0,1,1,0,0,1
06258226,5,0,5,0,0,0,0,0,0
06258268,11,6,5,0,1,1,0,1,0
06258292,9,6,3,0,3,3,0,1,0
06258354,11,2,9,0,1,1,0,1,1
06258422,4,0,4,0,0,0,0,0,1
06258575,13,7,6,0,0,0,0,0,0
06259003,28,6,22,0,2,2,0,2,1
06259258,21,3,18,0,1,1,0,1,1
06259260,31,5,26,0,3,3,0,3,1
06259320,2,0,2,0,0,0,0,0,1
06259507,6,2,4,0,1,1,0,0,1
06259530,33,5,28,0,1,1,0,1,1
06259820,24,4,20,0,0,0,0,0,1
06259882,10,5,5,0,10,10,0,0,0
06260053,27,8,19,0,1,1,0,1,1
06260316,33,5,28,0,1,1,0,1,1
06260329,24,9,15,0,11,0,11,0,1
06260426,8,4,4,0,1,1,0,1,1
06260536,5,0,5,0,2,2,0,0,1
06260615,11,4,7,0,1,1,0,0,1
06260699,3,3,0,0,2,2,0,0,0
06261220,13,4,9,0,2,1,1,2,1
06261286,4,0,4,0,0,0,0,0,1
06261556,7,2,5,0,0,0,0,0,1
06261579,4,2,2,0,1,1,0,0,0
06261628,3,3,0,0,1,1,0,0,0
06261762,10,0,10,0,0,0,0,0,1
06261781,10,0,10,0,0,0,0,0,1
06261914,10,4,6,0,1,1,0,0,1
06262288,2,2,0,0,1,1,0,0,0
06262780,3,2,1,1,5,5,0,0,1
06263123,7,2,5,0,1,1,0,1,1
06263445,2,2,0,0,1,1,0,0,0
06263643,19,0,19,0,1,1,0,1,1
06263776,3,0,3,0,0,0,0,0,1
06263950,5,3,2,0,1,1,0,0,0
06264445,17,3,14,0,1,1,0,1,1
06264534,9,0,9,0,0,0,0,0,1
06264686,29,6,23,0,1,1,0,1,1
06264687,29,6,23,0,1,1,0,1,1
06264698,4,0,4,0,0,0,0,0,1
06264754,9,3,6,0,1,1,0,1,1
06265005,12,1,11,0,0,0,0,0,1
06265038,7,0,7,0,0,0,0,0,1
06265141,46,6,40,0,1,1,0,1,1
06265842,8,0,8,0,0,0,0,0,1
06266142,16,5,11,0,1,1,0,1,1
06266211,5,0,5,0,1,1,0,0,1
06266443,26,0,26,0,1,1,0,1,1
06266597,12,1,11,0,1,1,0,0,1
06266609,3,3,0,0,1,1,0,0,0
06266722,26,6,20,0,0,0,0,0,1
06266949,4,0,4,0,0,0,0,0,1
06266965,9,2,7,0,0,0,0,0,1
06266972,33,10,23,0,0,0,0,0,1
06266993,16,7,9,0,1,0,1,0,1
06267750,7,3,4,0,3,2,1,0,0
06267928,14,5,9,0,0,0,0,0,1
06268314,5,2,3,0,1,1,0,0,1
06268481,17,3,14,0,1,1,0,1,1
06268574,10,0,10,0,0,0,0,0,1
06268809,25,6,19,0,1,1,0,1,1
06269107,3,2,1,0,1,1,0,0,0
06269267,6,0,6,0,0,0,0,0,1
06269647,4,2,2,0,1,1,0,0,1
06269905,3,1,2,0,1,1,0,0,0
06270014,10,3,7,0,0,0,0,0,0
06270016,10,3,7,0,0,0,0,0,0
06270019,10,3,7,0,0,0,0,0,0
06270319,6,2,4,0,1,1,0,0,0
06270474,5,3,2,0,1,1,0,0,1
06270524,5,3,2,0,1,1,0,0,1
06270551,4,2,2,0,2,2,0,0,0
06270691,6,0,6,0,0,0,0,0,1
06270876,38,11,27,0,0,0,0,0,1
06271087,4,3,1,0,2,2,0,0,1
06271315,14,7,7,0,1,1,0,0,0
06271341,16,4,12,0,1,1,0,1,1
06271489,7,5,2,0,1,1,0,1,0
06271588,5,0,5,0,0,0,0,0,1
06271823,20,0,20,0,0,0,0,0,1
06271873,4,2,2,0,1,1,0,0,0
06271891,5,2,3,0,0,0,0,0,1
06271938,5,0,5,0,0,0,0,0,1
06272151,16,7,9,0,1,1,0,1,1
06272178,20,8,12,0,1,1,0,0,0
06272263,6,5,1,0,0,0,0,0,0
06272503,2,0,2,0,1,1,0,0,0
06272946,7,2,5,0,0,0,0,0,1
06273004,10,0,10,0,2,2,0,0,1
06273397,5,4,1,0,0,0,0,0,1
06273603,5,3,2,0,2,2,0,0,1
06273721,7,4,3,0,1,1,0,1,0
06273974,4,1,3,0,3,1,2,0,0
06274876,6,2,4,0,3,3,0,0,1
06275379,7,4,3,0,1,1,0,1,0
06275664,5,2,3,0,1,1,0,0,1
06276194,2,2,0,0,1,1,0,0,1
06276474,7,1,6,0,2,1,1,0,0
06276624,42,13,29,0,1,1,0,0,1
06276887,29,5,24,0,1,1,0,0,1
06276965,6,4,2,0,2,2,0,0,1
06277078,16,3,13,0,2,2,0,1,1
06277161,8,3,5,0,1,1,0,1,1
06277406,8,3,5,0,0,0,0,0,1
06278017,15,4,11,0,1,1,0,1,1
06278181,3,3,0,0,2,2,0,0,0
06279786,17,8,9,0,0,0,0,0,0
06279811,7,5,2,0,1,1,0,1,0
06279861,11,0,11,0,0,0,0,0,1
06280020,6,0,6,0,1,1,0,1,1
06280108,26,8,18,0,0,0,0,0,1
06280136,6,0,6,0,1,1,0,0,0
06280656,5,2,3,0,1,1,0,0,1
06280761,5,3,2,0,1,1,0,0,1
06280792,5,1,4,0,2,1,1,0,1
06280856,4,1,3,0,1,1,0,0,0
06280860,4,1,3,0,1,1,0,1,0
06281088,4,2,2,0,1,1,0,0,0
06281347,16,9,7,0,0,0,0,0,1
06281589,4,0,4,0,0,0,0,0,1
06281707,8,5,3,0,1,1,0,1,1
06281817,21,0,21,0,1,1,0,1,1
06282020,4,3,1,0,1,1,0,0,1
06282370,2,1,1,0,1,1,0,0,1
CE012020,0,0,0,0,0,0,0,0,0
CE012021,0,0,0,0,0,0,0,0,0
CE012033,0,0,0,0,0,0,0,0,0
CE012052,0,0,0,0,0,0,0,0,0
CE012064,0,0,0,0,0,0,0,0,0
CE012087,0,0,0,0,0,0,0,0,0
CE012104,0,0,0,0,0,0,0,0,0
CE012110,0,0,0,0,0,0,0,0,0
CE012120,0,0,0,0,0,0,0,0,0
CE012121,0,0,0,0,0,0,0,0,0
CE012148,0,0,0,0,0,0,0,0,0
CE012183,0,0,0,0,0,0,0,0,0
CE012188,0,0,0,0,0,0,0,0,0
CE012231,0,0,0,0,0,0,0,0,0
CE012242,0,0,0,0,0,0,0,0,0
CE012252,0,0,0,0,0,0,0,0,0
CE012255,0,0,0,0,0,0,0,0,0
CE012257,0,0,0,0,0,0,0,0,0
CE012276,0,0,0,0,0,0,0,0,0
CE012308,0,0,0,0,0,0,0,0,0
CE012315,0,0,0,0,0,0,0,0,0
CE012337,0,0,0,0,0,0,0,0,0
CE012391,0,0,0,0,0,0,0,0,0
CE012404,0,0,0,0,0,0,0,0,0
CE012479,0,0,0,0,0,0,0,0,0
CE012507,0,0,0,0,0,0,0,0,0
CE012515,0,0,0,0,0,0,0,0,0
CE012598,0,0,0,0,0,0,0,0,0
CE012672,0,0,0,0,0,0,0,0,0
CE012719,0,0,0,0,0,0,0,0,0
CE012739,0,0,0,0,0,0,0,0,0
CE012759,0,0,0,0,0,0,0,0,0
CE012821,0,0,0,0,0,0,0,0,0
CE012828,0,0,0,0,0,0,0,0,0
CE012844,0,0,0,0,0,0,0,0,0
CE012870,0,0,0,0,0,0,0,0,0
CE012885,0,0,0,0,0,0,0,0,0
CE012893,0,0,0,0,0,0,0,0,0
CE012904,0,0,0,0,0,0,0,0,0
CE012940,0,0,0,0,0,0,0,0,0
CE012958,0,0,0,0,0,0,0,0,0
CE013072,0,0,0,0,0,0,0,0,0
CE013080,0,0,0,0,0,0,0,0,0
CE013113,0,0,0,0,0,0,0,0,0
CE013153,0,0,0,0,0,0,0,0,0
CE013177,0,0,0,0,0,0,0,0,0
CE013194,0,0,0,0,0,0,0,0,0
CE013220,0,0,0,0,0,0,0,0,0
CE013240,0,0,0,0,0,0,0,0,0
CE013260,0,0,0,0,0,0,0,0,0
CE013261,0,0,0,0,0,0,0,0,0
CE013280,0,0,0,0,0,0,0,0,0
CE013317,0,0,0,0,0,0,0,0,0
CE013320,0,0,0,0,0,0,0,0,0
CE013359,0,0,0,0,0,0,0,0,0
CE013468,0,0,0,0,0,0,0,0,0
CE013523,0,0,0,0,0,0,0,0,0
CE013524,0,0,0,0,0,0,0,0,0
CE013577,0,0,0,0,0,0,0,0,0
CE013614,0,0,0,0,0,0,0,0,0
CE013637,0,0,0,0,0,0,0,0,0
CE013638,0,0,0,0,0,0,0,0,0
CE013670,0,0,0,0,0,0,0,0,0
CE013688,0,0,0,0,0,0,0,0,0
CE013695,0,0,0,0,0,0,0,0,0
CE013722,0,0,0,0,0,0,0,0,0
CE013739,0,0,0,0,0,0,0,0,0
CE013797,0,0,0,0,0,0,0,0,0
CE013810,0,0,0,0,0,0,0,0,0
CE013855,0,0,0,0,0,0,0,0,0
CE013874,0,0,0,0,0,0,0,0,0
CE013888,0,0,0,0,0,0,0,0,0
CE013893,0,0,0,0,0,0,0,0,0
CE013897,0,0,0,0,0,0,0,0,0
CE013910,0,0,0,0,0,0,0,0,0
CE013919,0,0,0,0,0,0,0,0,0
CE013942,0,0,0,0,0,0,0,0,0
CE013945,0,0,0,0,0,0,0,0,0
CE013978,0,0,0,0,0,0,0,0,0
CE013989,0,0,0,0,0,0,0,0,0
CE014055,0,0,0,0,0,0,0,0,0
CE014065,0,0,0,0,0,0,0,0,0
CE014071,0,0,0,0,0,0,0,0,0
CE014095,0,0,0,0,0,0,0,0,0
CE014124,0,0,0,0,0,0,0,0,0
CE014144,0,0,0,0,0,0,0,0,0
CE014178,0,0,0,0,0,0,0,0,0
CE014208,0,0,0,0,0,0,0,0,0
CE014218,0,0,0,0,0,0,0,0,0
CE014222,0,0,0,0,0,0,0,0,0
CE014256,0,0,0,0,0,0,0,0,0
CE014297,0,0,0,0,0,0,0,0,0
CE014301,0,0,0,0,0,0,0,0,0
CE014324,0,0,0,0,0,0,0,0,0
CE014327,0,0,0,0,0,0,0,0,0
CE014329,0,0,0,0,0,0,0,0,0
CE014336,0,0,0,0,0,0,0,0,0
CE014394,0,0,0,0,0,0,0,0,0
CE014396,0,0,0,0,0,0,0,0,0
CE014410,0,0,0,0,0,0,0,0,0
CE014433,0,0,0,0,0,0,0,0,0
CE014435,0,0,0,0,0,0,0,0,0
CE014463,0,0,0,0,0,0,0,0,0
CE014481,0,0,0,0,0,0,0,0,0
CE014503,0,0,0,0,0,0,0,0,0
CE014515,0,0,0,0,0,0,0,0,0
CE014522,0,0,0,0,0,0,0,0,0
CE014549,0,0,0,0,0,0,0,0,0
CE014551,0,0,0,0,0,0,0,0,0
CE014559,0,0,0,0,0,0,0,0,0
CE014593,0,0,0,0,0,0,0,0,0
CE014598,0,0,0,0,0,0,0,0,0
CE014608,0,0,0,0,0,0,0,0,0
CE014612,0,0,0,0,0,0,0,0,0
CE014625,0,0,0,0,0,0,0,0,0
CE014656,0,0,0,0,0,0,0,0,0
CE014667,0,0,0,0,0,0,0,0,0
CE014672,0,0,0,0,0,0,0,0,0
CE014682,0,0,0,0,0,0,0,0,0
CE014731,0,0,0,0,0,0,0,0,0
CE014767,0,0,0,0,0,0,0,0,0
CE014769,0,0,0,0,0,0,0,0,0
CE014823,0,0,0,0,0,0,0,0,0
CE014835,0,0,0,0,0,0,0,0,0
CE014868,0,0,0,0,0,0,0,0,0
CE014882,0,0,0,0,0,0,0,0,0
CE014894,0,0,0,0,0,0,0,0,0
CE014900,0,0,0,0,0,0,0,0,0
CE014903,0,0,0,0,0,0,0,0,0
CE014909,0,0,0,0,0,0,0,0,0
CE014946,0,0,0,0,0,0,0,0,0
CE014974,0,0,0,0,0,0,0,0,0
CE014989,0,0,0,0,0,0,0,0,0
CE014993,0,0,0,0,0,0,0,0,0
CE014995,0,0,0,0,0,0,0,0,0
CE014996,0,0,0,0,0,0,0,0,0
CE015008,0,0,0,0,0,0,0,0,0
CE015026,0,0,0,0,0,0,0,0,0
CE015027,0,0,0,0,0,0,0,0,0
CE015046,0,0,0,0,0,0,0,0,0
CE015052,0,0,0,0,0,0,0,0,0
CE015053,0,0,0,0,0,0,0,0,0
CE015103,0,0,0,0,0,0,0,0,0
CE015105,0,0,0,0,0,0,0,0,0
CE015112,0,0,0,0,0,0,0,0,0
CE015119,0,0,0,0,0,0,0,0,0
CE015136,0,0,0,0,0,0,0,0,0
CE015174,0,0,0,0,0,0,0,0,0
CE015193,0,0,0,0,0,0,0,0,0
CE015194,0,0,0,0,0,0,0,0,0
CE015196,0,0,0,0,0,0,0,0,0
CE015245,0,0,0,0,0,0,0,0,0
CE015259,0,0,0,0,0,0,0,0,0
CE015304,0,0,0,0,0,0,0,0,0
CE015322,0,0,0,0,0,0,0,0,0
CE015337,0,0,0,0,0,0,0,0,0
CE015342,0,0,0,0,0,0,0,0,0
CE015372,0,0,0,0,0,0,0,0,0
CE015394,0,0,0,0,0,0,0,0,0
CE015405,0,0,0,0,0,0,0,0,0
CE015407,0,0,0,0,0,0,0,0,0
CE015473,0,0,0,0,0,0,0,0,0
CE015478,0,0,0,0,0,0,0,0,0
CE015480,0,0,0,0,0,0,0,0,0
CE015515,0,0,0,0,0,0,0,0,0
CE015523,0,0,0,0,0,0,0,0,0
CE015539,0,0,0,0,0,0,0,0,0
CE015606,0,0,0,0,0,0,0,0,0
CE015630,0,0,0,0,0,0,0,0,0
CE015672,0,0,0,0,0,0,0,0,0
CE015696,0,0,0,0,0,0,0,0,0
CE015715,0,0,0,0,0,0,0,0,0
CE015783,0,0,0,0,0,0,0,0,0
CE015800,0,0,0,0,0,0,0,0,0
CE015803,0,0,0,0,0,0,0,0,0
CE015821,0,0,0,0,0,0,0,0,0
CE015834,0,0,0,0,0,0,0,0,0
CE015836,0,0,0,0,0,0,0,0,0
CE015837,0,0,0,0,0,0,0,0,0
CE015880,0,0,0,0,0,0,0,0,0
CE015910,0,0,0,0,0,0,0,0,0
CE015920,0,0,0,0,0,0,0,0,0
CE015921,0,0,0,0,0,0,0,0,0
CE015932,0,0,0,0,0,0,0,0,0
CE015935,0,0,0,0,0,0,0,0,0
CE015937,0,0,0,0,0,0,0,0,0
CE015944,0,0,0,0,0,0,0,0,0
CE015968,0,0,0,0,0,0,0,0,0
CE015983,0,0,0,0,0,0,0,0,0
CE015994,0,0,0,0,0,0,0,0,0
CE016013,0,0,0,0,0,0,0,0,0
CE016019,0,0,0,0,0,0,0,0,0
CE016058,0,0,0,0,0,0,0,0,0
CE016111,0,0,0,0,0,0,0,0,0
CE016126,0,0,0,0,0,0,0,0,0
CE016136,0,0,0,0,0,0,0,0,0
CE016138,0,0,0,0,0,0,0,0,0
CE016147,0,0,0,0,0,0,0,0,0
CE016157,0,0,0,0,0,0,0,0,0
CE016162,0,0,0,0,0,0,0,0,0
CE016167,0,0,0,0,0,0,0,0,0
CE016178,0,0,0,0,0,0,0,0,0
CE016209,0,0,0,0,0,0,0,0,0
CE016217,0,0,0,0,0,0,0,0,0
CE016232,0,0,0,0,0,0,0,0,0
CE016306,0,0,0,0,0,0,0,0,0
CE016332,0,0,0,0,0,0,0,0,0
CE016333,0,0,0,0,0,0,0,0,0
CE016359,0,0,0,0,0,0,0,0,0
CE016380,0,0,0,0,0,0,0,0,0
CE016426,0,0,0,0,0,0,0,0,0
CE016441,0,0,0,0,0,0,0,0,0
CE016451,0,0,0,0,0,0,0,0,0
CE016456,0,0,0,0,0,0,0,0,0
CE016458,0,0,0,0,0,0,0,0,0
CE016490,0,0,0,0,0,0,0,0,0
CE016500,0,0,0,0,0,0,0,0,0
CE016512,0,0,0,0,0,0,0,0,0
CE016536,0,0,0,0,0,0,0,0,0
CE016546,0,0,0,0,0,0,0,0,0
CE016641,0,0,0,0,0,0,0,0,0
CE016654,0,0,0,0,0,0,0,0,0
CE016680,0,0,0,0,0,0,0,0,0
CE016698,0,0,0,0,0,0,0,0,0
00380054,26,3,23,0,1,1,0,1,1
00380433,7,3,4,0,1,1,0,0,1
00380825,37,3,34,0,2,1,1,2,1
00381124,13,6,7,0,2,2,0,2,1
00381159,33,3,30,0,1,1,0,1,1
00381622,15,3,12,0,0,0,0,0,0
00381716,10,0,10,0,0,0,0,0,1
00381770,7,0,7,0,0,0,0,0,1
00382452,48,11,37,0,0,0,0,0,1
00382564,48,4,44,0,1,1,0,1,1
00382593,50,2,48,0,0,0,0,0,0
00382600,61,4,57,0,0,0,0,0,0
00382678,34,4,30,0,1,1,0,1,1
00382817,61,8,53,0,1,1,0,1,1
00383032,66,7,59,0,1,1,0,1,1
00383378,5,3,2,0,0,0,0,0,1
00383994,59,0,59,0,1,1,0,1,1
00384406,11,3,8,0,1,1,0,1,1
00384974,6,4,2,0,1,1,0,0,0
00385052,16,4,12,0,1,1,0,1,1
00385188,11,2,9,0,0,0,0,0,1
00385397,4,3,1,0,0,0,0,0,1
00385659,14,4,10,0,1,1,0,1,1
00385755,22,0,22,0,0,0,0,0,1
00386161,17,5,12,0,1,1,0,0,1
00387076,11,3,8,0,1,1,0,1,1
00387185,4,0,4,0,1,1,0,1,1
00387291,5,0,5,0,0,0,0,0,1
00387741,6,3,3,0,3,3,0,1,1
00387888,9,3,6,0,1,1,0,1,1
00388123,13,3,10,0,1,1,0,0,1
00388135,35,3,32,0,1,1,0,1,1
00388147,6,3,3,0,1,1,0,0,1
00388182,34,0,34,0,1,1,0,1,1
00388220,16,3,13,0,2,1,1,0,0
00388497,13,2,11,0,1,1,0,1,1
00388611,16,2,14,0,1,1,0,1,0
00388895,95,24,71,0,2,1,1,0,1
00389062,242,25,217,0,0,0,0,0,1
00389499,10,3,7,0,1,1,0,1,1
00389550,2,2,0,0,0,0,0,0,0
00389567,30,0,30,0,0,0,0,0,1
00389627,10,3,7,0,1,1,0,1,1
00390328,54,4,50,0,1,1,0,1,1
00390413,113,9,104,0,0,0,0,0,0
00390501,29,3,26,0,0,0,0,0,1
00390837,31,3,28,0,2,1,1,2,1
00391027,14,3,11,0,1,1,0,1,1
00391618,20,4,16,0,1,1,0,1,1
00391717,10,4,6,0,2,1,1,1,1
00391848,12,5,7,0,2,2,0,0,1
00391886,137,14,123,0,17,0,17,1,1
00391957,75,9,66,0,8,8,0,0,1
00392067,26,5,21,0,2,2,0,0,1
00392186,40,9,31,0,0,0,0,0,0
00392242,11,0,11,0,0,0,0,0,1
00392424,7,4,3,0,2,2,0,0,1
00392619,30,5,25,0,1,1,0,1,1
00392872,43,3,40,0,1,1,0,1,1
00392902,38,2,36,0,1,1,0,1,1
00392978,69,10,59,0,12,0,12,0,1
00393066,44,11,33,0,0,0,0,0,0
00393087,35,5,30,0,1,1,0,1,1
00393104,32,7,25,0,1,1,0,1,1
00394221,125,13,112,0,0,0,0,0,1
00394222,19,9,10,0,0,0,0,0,1
00394466,25,0,25,0,0,0,0,0,1
00394504,29,5,24,0,1,1,0,1,1
00394532,58,2,56,0,1,1,0,1,1
00394688,28,4,24,0,2,1,1,2,1
00395322,19,3,16,0,2,2,0,2,1
00395618,23,3,20,0,1,1,0,1,1
00396309,58,9,49,0,0,0,0,0,1
00396362,14,4,10,0,1,1,0,1,1
00396904,9,3,6,0,1,1,0,0,0
00397132,34,3,31,0,0,0,0,0,1
00397156,149,3,146,0,1,1,0,1,1
00397759,14,3,11,0,1,1,0,1,1
00398409,6,2,4,0,1,1,0,1,1
00398426,60,7,53,0,1,1,0,1,1
00398543,8,3,5,0,1,1,0,0,1
00398604,83,13,70,0,0,0,0,0,1
00398875,40,7,33,0,0,0,0,0,1
00398916,22,0,22,0,2,1,1,2,1
00399575,26,0,26,0,0,0,0,0,1
00400313,18,3,15,0,1,1,0,1,1
00400458,29,1,28,0,1,1,0,0,1
00400695,40,16,24,0,0,0,0,0,1
00401589,51,4,47,0,1,1,0,1,1
00401821,49,0,49,0,0,0,0,0,1
00402421,59,15,44,0,2,1,1,0,0
00402684,36,5,31,0,1,1,0,1,1
00402685,17,0,17,0,0,0,0,0,1
00402716,0,0,0,0,0,0,0,0,0
00402748,90,15,75,0,0,0,0,0,1
00402766,0,0,0,0,0,0,0,0,0
00403095,15,0,15,0,0,0,0,0,1
00403200,32,4,28,0,1,1,0,1,1
00403450,23,0,23,0,0,0,0,0,1
00404370,51,2,49,0,1,1,0,1,1
00404467,11,1,10,0,1,1,0,1,1
00404951,38,3,35,0,1,1,0,1,1
00405180,78,8,70,0,0,0,0,0,1
00405267,18,2,16,0,1,1,0,1,1
00405393,11,5,6,0,1,1,0,1,1
00405667,25,4,21,0,0,0,0,0,1
00405720,167,8,159,0,0,0,0,0,1
00406322,11,2,9,0,1,1,0,0,0
00406595,8,0,8,0,0,0,0,0,1
00406711,50,9,41,0,0,0,0,0,1
00406809,61,13,48,0,1,1,0,1,1
00406869,30,0,30,0,0,0,0,0,1
00407127,50,3,47,0,1,1,0,1,1
00407144,3,3,0,0,0,0,0,0,0
00407234,51,6,45,0,1,1,0,1,1
00407270,68,10,58,0,0,0,0,0,1
00407403,21,4,17,0,0,0,0,0,1
00407630,114,22,92,0,12,0,12,0,1
00408017,31,3,28,0,0,0,0,0,1
00408030,1,1,0,0,0,0,0,0,1
00408301,85,0,85,0,0,0,0,0,1
00408422,27,0,27,0,0,0,0,0,1
00409295,33,4,29,0,0,0,0,0,1
00409599,10,4,6,0,4,4,0,1,1
00409726,110,9,101,0,0,0,0,0,1
00409738,19,8,11,0,4,0,4,0,1
00409752,15,5,10,0,2,2,0,0,1
00409867,36,0,36,0,0,0,0,0,1
00410018,12,8,4,0,5,1,4,0,1
00410065,21,3,18,0,2,1,1,2,1
00410594,35,0,35,0,0,0,0,0,1
00411322,22,3,19,0,1,1,0,1,1
00411331,10,2,8,0,1,1,0,0,1
00411351,5,0,5,0,0,0,0,0,0
00411609,12,3,9,0,1,1,0,1,1
00411970,20,3,17,0,0,0,0,0,1
00412198,27,7,20,0,1,1,0,1,1
00412259,6,4,2,0,0,0,0,0,1
00412621,151,22,129,0,0,0,0,0,1
00412742,34,4,30,0,0,0,0,0,0
00412783,17,4,13,0,1,1,0,1,1
00412913,45,13,32,0,4,4,0,4,0
00413214,53,9,44,0,0,0,0,0,1
00413369,7,3,4,0,2,2,0,0,0
00413948,12,1,11,0,1,1,0,1,1
00414245,19,3,16,0,0,0,0,0,1
00414684,9,3,6,0,2,1,1,1,0
00415216,9,0,9,0,0,0,0,0,1
00415497,28,3,25,0,1,1,0,1,1
00415498,13,3,10,0,1,1,0,1,1
00415853,42,1,41,0,1,1,0,1,1
00416147,27,1,26,0,1,1,0,1,1
00416173,3,3,0,0,1,1,0,0,0
00416507,13,3,10,0,1,1,0,1,1
00416671,42,3,39,0,1,1,0,1,1
00416787,44,5,39,0,1,1,0,1,1
00417021,23,4,19,0,7,5,2,1,1
00417183,35,0,35,0,0,0,0,0,1
00417484,33,8,25,0,1,1,0,1,1
00418006,9,2,7,0,0,0,0,0,1
00418311,65,13,52,0,0,0,0,0,1
00418328,45,0,45,0,1,1,0,1,1
00418500,28,0,28,0,0,0,0,0,1
00419256,69,11,58,0,0,0,0,0,1
00419368,14,3,11,0,1,1,0,0,1
00419814,22,2,20,0,1,1,0,1,1
00420158,42,3,39,0,1,1,0,1,1
00420247,15,5,10,0,1,1,0,1,1
00420431,26,3,23,0,0,0,0,0,1
00420575,50,4,46,0,1,1,0,1,1
00420867,41,11,30,0,0,0,0,0,0
00421037,0,0,0,0,0,0,0,0,1
00421479,23,8,15,0,0,0,0,0,1
00422160,30,12,18,0,0,0,0,0,0
00422330,28,4,24,0,2,1,1,0,1
00422837,34,6,28,0,1,1,0,1,1
00422897,29,0,29,0,1,1,0,1,1
00422898,8,1,7,0,1,1,0,0,0
00423149,19,3,16,0,1,1,0,1,1
00423318,4,4,0,0,1,1,0,0,0
00423372,39,4,35,0,1,1,0,0,1
00424114,26,3,23,0,0,0,0,0,1
00424215,28,4,24,0,1,1,0,1,1
00424348,154,17,137,0,0,0,0,0,1
00424360,11,1,10,0,1,1,0,1,1
00424442,103,16,87,0,0,0,0,0,0
00424510,11,5,6,0,0,0,0,0,0
00425188,21,9,12,0,0,0,0,0,1
00425829,30,0,30,0,1,1,0,1,1
00426402,52,3,49,0,1,1,0,1,1
00426414,26,0,26,0,0,0,0,0,1
00426792,79,13,66,0,0,0,0,0,1
00426887,27,0,27,0,0,0,0,0,1
00426965,14,0,14,0,0,0,0,0,1
00427272,56,4,52,0,1,1,0,1,1
00427533,30,0,30,0,0,0,0,0,1
00427542,7,7,0,0,2,2,0,0,0
00427900,8,1,7,1,1,1,0,0,1
00427972,3,3,0,0,1,1,0,0,0
00428261,14,5,9,0,1,1,0,1,1
00428628,19,3,16,0,0,0,0,0,1
00428870,26,6,20,0,1,1,0,1,1
00429046,11,3,8,0,1,1,0,1,1
00429091,10,0,10,0,0,0,0,0,1
00429215,16,3,13,0,1,1,0,1,1
00429298,117,23,94,0,0,0,0,0,1
00429315,48,4,44,0,2,2,0,1,1
00429714,22,3,19,0,1,1,0,1,1
00431210,6,3,3,0,2,2,0,0,0
00431476,38,3,35,0,0,0,0,0,1
00431633,30,4,26,0,1,1,0,1,1
00431900,15,7,8,0,0,0,0,0,1
00432014,31,5,26,0,1,1,0,1,1
00432447,8,4,4,0,3,3,0,0,0
00432511,62,13,49,0,0,0,0,0,1
00432769,10,6,4,0,2,1,1,0,0
00432989,43,11,32,0,0,0,0,0,1
00433078,5,4,1,0,0,0,0,0,1
00433300,10,3,7,0,1,1,0,1,0
00433411,18,5,13,0,0,0,0,0,0
00433732,22,0,22,0,0,0,0,0,1
00433790,33,1,32,0,0,0,0,0,1
00434487,42,4,38,0,1,1,0,1,1
00435899,115,10,105,0,0,0,0,0,0
00435947,11,4,7,0,0,0,0,0,0
00436088,46,0,46,0,1,1,0,1,1
00436376,11,0,11,0,0,0,0,0,1
00436868,19,2,17,0,1,1,0,1,1
00437009,36,3,33,0,1,1,0,1,0
00437300,5,0,5,0,0,0,0,0,1
00437688,9,2,7,0,1,1,0,0,1
00438111,36,5,31,0,1,1,0,1,1
00438302,11,3,8,0,1,1,0,1,1
00438563,10,3,7,0,0,0,0,0,0
00438838,14,3,11,0,1,1,0,1,1
00439055,10,0,10,0,0,0,0,0,0
00439142,9,8,1,0,0,0,0,0,1
00439430,5,2,3,0,2,2,0,0,0
00440436,59,15,44,0,0,0,0,0,1
00440452,35,0,35,0,0,0,0,0,1
00440463,12,6,6,0,4,3,1,0,1
00440736,3,0,3,0,0,0,0,0,1
00441186,62,11,51,0,0,0,0,0,1
00441187,60,11,49,0,0,0,0,0,1
00441284,187,11,176,0,0,0,0,0,1
00441484,37,5,32,0,1,1,0,1,1
00441712,40,5,35,0,1,1,0,1,0
00441975,219,2,217,0,0,0,0,0,1
00442709,40,5,35,0,2,1,1,0,0
00442770,15,4,11,0,1,1,0,1,1
00443219,29,2,27,0,1,1,0,1,1
00444351,79,13,66,0,2,0,2,0,1
00444627,10,4,6,0,6,3,3,0,1
00445178,8,2,6,0,1,1,0,0,0
00445790,63,14,49,0,0,0,0,0,1
00445884,12,6,6,0,2,1,1,2,1
00446083,83,15,68,0,1,1,0,0,1
00446119,8,4,4,0,1,1,0,1,1
00446132,15,4,11,0,1,1,0,1,1
00447002,10,0,10,0,0,0,0,0,1
00448278,59,8,51,0,1,1,0,1,1
00448282,30,5,25,0,2,1,1,2,1
00448911,31,7,24,0,2,1,1,2,1
00448920,44,7,37,0,7,0,7,0,0
00449060,30,8,22,0,0,0,0,0,0
00449077,7,3,4,0,1,1,0,0,1
00449431,3,2,1,0,1,1,0,0,0
00450147,13,0,13,0,0,0,0,0,1
00450379,17,6,11,0,1,1,0,0,0
00450650,35,4,31,0,1,1,0,1,1
00450929,51,14,37,0,1,0,1,0,0
00451065,28,7,21,0,2,2,0,1,1
00451326,21,0,21,0,0,0,0,0,1
00451359,27,0,27,0,0,0,0,0,1
00452026,2,2,0,0,0,0,0,0,1
00452053,12,3,9,0,1,1,0,1,1
00452716,11,3,8,0,0,0,0,0,1
00453180,11,0,11,0,1,1,0,1,1
00453225,33,0,33,0,1,1,0,1,1
00453294,30,7,23,0,1,1,0,0,0
00453569,39,3,36,0,1,1,0,1,0
00453594,189,86,103,0,1,1,0,1,1
00453632,106,25,81,0,3,3,0,3,1
00453782,9,4,5,0,3,3,0,0,1
00454017,12,0,12,0,0,0,0,0,1
00454134,118,10,108,0,0,0,0,0,1
00454169,139,15,124,0,0,0,0,0,1
00454297,75,9,66,0,1,1,0,0,1
00454327,17,3,14,0,1,1,0,1,1
00454398,48,3,45,0,1,1,0,1,1
00454826,43,5,38,0,1,1,0,1,1
00455013,48,2,46,0,0,0,0,0,1
00455050,83,11,72,0,0,0,0,0,1
00455358,0,0,0,0,0,0,0,0,1
00456426,0,0,0,0,0,0,0,0,1
00456573,89,14,75,0,0,0,0,0,1
00456587,35,10,25,0,0,0,0,0,1
00457162,18,2,16,0,1,1,0,1,1
00457188,144,18,126,0,1,1,0,0,1
00457895,37,0,37,0,0,0,0,0,1
00458117,38,0,38,0,0,0,0,0,1
00458191,91,12,79,0,1,1,0,0,0
00458787,44,13,31,0,2,1,1,0,0
00458949,35,3,32,0,1,1,0,1,1
00459420,35,0,35,0,0,0,0,0,1
00459577,12,3,9,0,1,1,0,1,1
00459637,30,5,25,0,1,1,0,1,1
00460129,23,8,15,0,0,0,0,0,1
00460259,18,4,14,0,1,1,0,1,1
00460851,14,4,10,0,1,1,0,1,1
00461588,203,7,196,0,0,0,0,0,1
00461611,32,4,28,0,1,1,0,1,1
00461764,12,0,12,0,1,1,0,1,1
00461916,5,3,2,0,4,4,0,1,1
00462157,83,11,72,0,0,0,0,0,1
00462261,12,4,8,0,3,1,2,1,1
00462411,12,5,7,0,1,1,0,1,1
00462868,19,6,13,0,0,0,0,0,0
00462984,61,0,61,0,0,0,0,0,0
00463493,61,4,57,0,0,0,0,0,0
00463572,25,3,22,0,0,0,0,0,1
00463885,203,7,196,0,0,0,0,0,1
00464317,81,10,71,0,0,0,0,0,0
00464785,16,5,11,0,1,1,0,1,1
00464822,82,0,82,0,0,0,0,0,1
00464880,43,4,39,0,1,1,0,1,1
00465012,31,5,26,0,1,1,0,1,1
00465355,36,5,31,0,0,0,0,0,1
00465476,3,3,0,0,1,1,0,0,1
00465603,44,2,42,0,2,1,1,1,1
00465899,27,8,19,0,1,1,0,0,0
00465901,9,5,4,0,1,1,0,1,1
00465975,108,17,91,0,0,0,0,0,1
00466069,38,4,34,0,1,1,0,1,1
00466676,6,2,4,0,3,2,1,0,1
00467254,87,13,74,0,0,0,0,0,1
00467514,60,12,48,0,0,0,0,0,1
00467924,3,0,3,0,0,0,0,0,1
00467945,47,14,33,0,0,0,0,0,1
00468245,26,0,26,0,0,0,0,0,1
00468425,25,12,13,0,0,0,0,0,0
00469098,121,9,112,0,0,0,0,0,1
00469144,15,6,9,0,2,2,0,0,0
00469605,66,3,63,0,1,1,0,1,1
00469655,14,6,8,0,0,0,0,0,1
00469788,27,0,27,0,0,0,0,0,1
00469940,27,2,25,0,1,1,0,1,1
00470155,10,3,7,0,3,3,0,1,1
00470721,25,5,20,0,2,1,1,0,0
00471252,26,3,23,0,1,1,0,1,1
00471498,11,2,9,0,1,1,0,1,1
00471864,51,4,47,0,1,1,0,1,1
00472142,23,0,23,0,0,0,0,0,1
00472253,34,5,29,0,1,1,0,1,1
00472336,3,3,0,0,1,1,0,0,0
00472388,36,2,34,0,2,1,1,1,1
00472391,28,7,21,0,1,1,0,1,1
00473025,29,4,25,0,2,2,0,2,1
00473089,36,3,33,0,1,1,0,1,1
00473513,16,0,16,0,1,1,0,1,1
00473785,12,3,9,0,1,1,0,1,1
00474514,64,3,61,0,0,0,0,0,0
00474560,5,5,0,0,0,0,0,0,1
00475212,39,4,35,0,1,1,0,1,1
00475960,15,4,11,0,2,2,0,2,1
00476245,21,0,21,0,0,0,0,0,1
00476440,25,3,22,0,1,1,0,1,1
00476633,13,4,9,0,1,1,0,1,1
00476928,13,0,13,0,1,1,0,1,1
00476995,25,4,21,0,1,1,0,1,1
00477128,23,3,20,0,1,1,0,1,0
00477312,78,8,70,0,2,2,0,2,1
00477404,13,6,7,0,1,1,0,0,1
00477584,7,3,4,0,1,1,0,0,1
00477695,55,10,45,0,1,1,0,1,1
00477815,7,5,2,0,1,1,0,1,0
00478089,8,5,3,0,1,1,0,0,1
00478127,61,7,54,0,1,1,0,1,1
00478575,32,3,29,0,1,1,0,1,1
00478666,36,0,36,0,0,0,0,0,1
00478671,14,4,10,0,0,0,0,0,1
00478765,8,2,6,0,2,2,0,0,0
00479101,6,3,3,0,0,0,0,0,1
00479529,33,3,30,0,1,1,0,1,1
00479884,11,4,7,0,2,2,0,0,0
10451275,1,1,0,0,1,1,0,0,0
10451429,1,1,0,0,1,1,0,0,0
10451432,8,7,1,0,0,0,0,0,0
10451754,11,8,3,0,1,1,0,1,1
10452026,2,0,2,0,1,1,0,0,0
10452300,1,1,0,0,2,1,1,0,0
10452886,2,2,0,0,1,1,0,0,1
10453299,2,2,0,0,2,2,0,0,1
10453437,1,1,0,0,1,1,0,0,0
10453568,2,2,0,0,1,1,0,0,0
10453654,2,2,0,0,1,1,0,0,0
10453822,3,3,0,0,1,1,0,1,1
10454078,1,1,0,0,1,1,0,0,0
10454376,3,3,0,0,1,1,0,0,0
10455139,1,0,1,0,1,1,0,0,0
10455346,1,0,1,0,1,1,0,0,0
10455406,17,12,5,0,0,0,0,0,0
10455754,2,2,0,0,2,2,0,0,1
10455955,2,0,2,0,1,1,0,0,0
10456014,2,1,1,0,0,0,0,0,0
10456162,5,5,0,0,2,1,1,1,1
10456431,3,3,0,0,1,1,0,0,0
10456440,2,1,1,0,2,1,1,0,0
10456663,3,3,0,0,2,2,0,0,0
10456768,2,2,0,0,2,2,0,0,0
10456868,2,2,0,0,1,1,0,0,1
10456996,1,1,0,0,0,0,0,0,0
10457764,2,1,1,0,2,1,1,0,0
10457781,5,5,0,0,3,3,0,0,0
10458184,2,1,1,0,2,1,1,0,0
10458211,3,1,2,0,1,1,0,1,1
10458233,1,0,1,0,1,1,0,0,0
10458300,2,2,0,0,3,3,0,0,0
10458639,2,2,0,0,1,1,0,0,0
10458858,2,2,0,0,2,2,0,0,0
10458979,4,4,0,0,1,1,0,1,1
10459023,2,2,0,0,2,2,0,0,0
10460146,2,0,2,0,1,1,0,0,0
10460902,2,2,0,0,1,1,0,0,0
10461100,1,1,0,0,1,1,0,0,0
10461270,2,2,0,0,0,0,0,0,1
10461875,10,9,1,0,0,0,0,0,1
10461990,4,1,3,0,0,0,0,0,1
10462031,1,0,1,0,1,1,0,0,0
10462035,4,2,2,0,7,1,6,0,0
10462061,2,2,0,0,2,2,0,0,0
10462487,2,0,2,0,1,1,0,0,0
10462505,2,1,1,0,2,1,1,1,0
10462602,2,0,2,0,2,1,1,1,0
10462675,2,1,1,0,2,1,1,1,0
10462702,2,1,1,0,2,1,1,0,0
10462850,2,0,2,0,1,1,0,0,1
10462903,1,1,0,0,1,1,0,0,0
10463143,3,2,1,0,4,2,2,0,1
10463352,2,2,0,0,1,1,0,0,1
10463376,7,6,1,0,2,2,0,0,1
10463452,2,1,1,0,2,1,1,0,0
10463849,2,0,2,0,1,1,0,0,0
10463889,1,1,0,0,1,1,0,0,0
10464333,1,1,0,0,1,1,0,0,0
10464979,1,1,0,0,1,1,0,0,0
10465246,1,1,0,0,1,1,0,0,0
10465411,2,2,0,0,1,1,0,1,1
10465563,1,1,0,0,1,1,0,0,0
10465596,2,0,2,0,2,2,0,0,0
10465731,10,2,8,0,4,1,3,3,1
10466804,2,0,2,0,1,1,0,0,0
10467076,2,1,1,0,1,1,0,0,0
10467174,2,0,2,0,1,1,0,0,0
10467271,1,0,1,0,1,1,0,0,0
10467567,1,0,1,0,1,1,0,0,0
10467905,4,4,0,0,1,1,0,1,0
10468203,2,1,1,0,1,0,1,0,0
10468698,2,2,0,0,0,0,0,0,0
10468997,3,0,3,0,3,3,0,0,0
10469145,7,4,3,0,0,0,0,0,1
10469960,1,1,0,0,1,1,0,0,0
10470014,5,3,2,0,2,0,2,0,1
10470030,12,3,9,0,8,3,5,0,0
10470335,2,2,0,0,1,1,0,0,0
10470550,2,2,0,0,2,2,0,0,0
10470804,4,3,1,0,1,1,0,0,1
10471180,2,0,2,0,2,2,0,0,0
10471341,1,1,0,0,1,1,0,0,0
10471525,1,0,1,0,2,2,0,0,0
10471722,3,3,0,0,3,3,0,0,0
10471973,1,1,0,0,2,1,1,0,1
10472138,1,1,0,0,0,0,0,0,0
10472227,1,0,1,0,1,1,0,0,0
10472306,1,1,0,0,0,0,0,0,0
10472796,1,1,0,0,1,1,0,0,0
10473317,6,5,1,0,0,0,0,0,1
10473447,1,1,0,0,1,1,0,0,0
10473490,8,4,4,0,2,1,1,0,0
10473966,1,0,1,0,1,1,0,0,0
10474049,4,4,0,0,2,2,0,0,0
10474514,1,1,0,0,2,2,0,0,0
10474640,1,1,0,0,1,1,0,0,0
10474647,2,2,0,0,1,1,0,0,1
10474784,2,2,0,0,0,0,0,0,1
10474801,3,3,0,0,3,3,0,0,1
10474852,1,0,1,0,1,1,0,0,0
10474926,4,4,0,0,0,0,0,0,1
10474989,1,1,0,0,1,1,0,0,0
10475143,2,2,0,0,1,1,0,0,0
10475225,3,3,0,0,1,1,0,1,1
10475265,5,1,4,0,1,0,1,0,0
10475430,1,0,1,0,1,1,0,0,0
10475561,2,1,1,0,1,1,0,0,1
10476084,2,1,1,0,1,1,0,0,0
10476950,2,2,0,0,2,2,0,0,0
10476994,2,2,0,0,0,0,0,0,0
10477112,9,8,1,0,0,0,0,0,0
10478425,2,2,0,0,2,2,0,0,0
10478623,1,1,0,0,1,1,0,0,0
10478679,5,2,3,0,2,1,1,2,1
10478762,1,1,0,0,1,1,0,0,0
10478849,2,2,0,0,2,2,0,0,0
10478925,6,0,6,0,0,0,0,0,1
10479022,2,2,0,0,2,2,0,0,1
10479189,6,0,6,0,0,0,0,0,1
10479453,6,0,6,0,0,0,0,0,1
10479457,3,3,0,0,2,2,0,2,1
10479548,6,0,6,0,0,0,0,0,1
10479694,2,2,0,0,2,2,0,0,0
10479762,3,3,0,0,1,1,0,1,1
10480081,6,0,6,0,5,5,0,0,1
10480721,5,1,4,0,0,0,0,0,0
10480786,2,2,0,0,1,1,0,0,1
10480929,1,1,0,0,1,1,0,0,0
10481051,2,1,1,0,2,1,1,0,0
10481052,2,1,1,0,2,1,1,0,0
10481103,2,2,0,0,2,2,0,0,1
10481338,2,2,0,0,1,1,0,0,1
10481364,2,1,1,0,0,0,0,0,0
10481474,2,2,0,0,2,2,0,0,0
10481602,5,5,0,0,4,4,0,0,0
10481621,2,1,1,0,1,1,0,1,0
10482003,9,7,2,0,0,0,0,0,0
10482004,1,1,0,0,1,1,0,0,1
10482294,2,0,2,0,1,1,0,0,0
10482443,1,1,0,0,1,1,0,0,0
10482633,2,0,2,0,1,1,0,0,0
10482924,3,2,1,0,2,1,1,1,0
10483397,1,0,1,0,1,1,0,0,0
10484396,3,3,0,0,0,0,0,0,1
10484450,3,2,1,0,1,1,0,0,0
10485013,1,0,1,0,1,1,0,0,0
10485060,1,0,1,0,1,1,0,0,0
10485345,2,2,0,0,1,1,0,0,1
10486633,1,1,0,0,1,1,0,0,0
10486754,5,3,2,0,1,1,0,1,1
10486893,2,1,1,0,2,1,1,0,0
10487441,2,2,0,0,1,1,0,0,0
10487522,2,2,0,0,2,2,0,0,0
10487779,2,2,0,0,2,1,1,1,1
10487834,1,1,0,0,1,1,0,0,0
10488340,2,2,0,0,0,0,0,0,0
10488905,1,1,0,0,1,1,0,0,0
10489230,3,3,0,0,1,1,0,1,0
10489234,2,2,0,0,1,1,0,0,0
10489476,2,0,2,0,2,2,0,0,0
10489510,1,0,1,0,0,0,0,0,0
10489698,1,0,1,0,1,1,0,0,0
10490043,4,0,4,0,0,0,0,0,0
10490695,15,8,7,0,2,1,1,2,1
10490699,3,2,1,0,2,1,1,0,0
10490998,3,3,0,0,2,2,0,0,1
10491000,2,1,1,0,2,1,1,0,0
10491091,2,2,0,0,2,2,0,0,0
10491402,1,1,0,0,1,1,0,0,0
10491602,1,0,1,0,0,0,0,0,0
10491716,1,1,0,0,0,0,0,0,0
10491883,1,1,0,0,1,1,0,0,0
10492084,3,3,0,0,3,3,0,0,0
10492187,2,0,2,0,2,2,0,0,1
10492224,3,3,0,0,1,1,0,0,0
10492555,2,1,1,0,1,0,1,0,0
10492612,1,1,0,0,1,1,0,0,1
10492770,2,0,2,0,1,1,0,0,1
10492903,1,0,1,0,1,1,0,0,0
10493058,1,1,0,0,1,1,0,0,0
10493321,1,1,0,0,1,1,0,0,0
10493429,1,1,0,0,1,1,0,0,0
10493489,33,19,14,0,0,0,0,0,1
10493699,2,2,0,0,2,2,0,0,1
10494441,4,4,0,0,1,1,0,1,1
10494536,2,2,0,0,1,1,0,0,0
10494774,6,3,3,0,1,1,0,1,1
10494989,7,5,2,0,1,1,0,1,1
10495095,7,5,2,0,1,1,0,1,1
10495200,3,3,0,0,2,1,1,1,1
10495676,15,13,2,0,1,1,0,1,1
10495701,2,2,0,0,2,2,0,0,0
10496128,2,2,0,0,2,2,0,0,0
10496308,1,1,0,0,1,1,0,0,0
10496689,1,1,0,0,1,1,0,1,0
10496892,2,2,0,0,2,2,0,0,0
10496963,2,2,0,0,2,2,0,0,0
10497020,1,1,0,0,1,1,0,0,0
10497099,1,1,0,0,1,1,0,0,0
10497270,2,2,0,0,2,2,0,0,0
10497511,2,1,1,0,2,1,1,1,0
10497546,1,1,0,0,1,1,0,0,0
10497600,6,4,2,0,2,0,2,0,1
10497681,2,2,0,0,2,2,0,0,0
10497790,1,1,0,0,1,1,0,0,0
10497895,1,0,1,0,1,1,0,0,0
10498473,1,1,0,0,1,1,0,0,0
10498553,2,0,2,0,1,1,0,0,0
10498620,2,0,2,0,2,2,0,0,1
10498672,5,5,0,0,5,2,3,3,1
10499174,25,9,16,0,0,0,0,0,0
10499509,2,2,0,0,1,1,0,1,1
10499597,2,1,1,0,2,1,1,0,0
10499695,2,2,0,0,2,2,0,0,0
10500031,5,5,0,0,3,3,0,0,1
10500207,17,15,2,0,0,0,0,0,1
10500425,8,8,0,0,1,1,0,1,1
10500550,6,5,1,0,0,0,0,0,1
10500613,2,2,0,0,2,2,0,0,0
10500758,1,1,0,0,1,1,0,0,0
10500784,1,1,0,0,2,2,0,0,1
10500846,2,2,0,0,3,2,1,2,0
10500850,1,1,0,0,1,1,0,0,0
10501504,3,1,2,0,3,1,2,0,0
10501576,2,2,0,0,3,1,2,1,0
10501584,3,2,1,0,3,1,2,0,0
10501633,3,3,0,0,2,2,0,0,0
10501720,4,3,1,0,1,1,0,0,1
10501845,3,2,1,0,3,1,2,0,0
10501900,1,1,0,0,1,1,0,0,0
10501995,2,0,2,0,1,1,0,0,0
10502450,3,2,1,0,2,2,0,0,1
10502560,1,0,1,0,1,1,0,0,0
10502931,2,2,0,0,1,1,0,0,0
10503186,4,4,0,0,4,4,0,0,0
10503361,3,3,0,0,1,1,0,1,1
10503839,10,6,4,1,3,1,2,3,1
10503846,2,0,2,0,2,2,0,0,0
10503866,2,2,0,0,2,2,0,0,0
10504072,4,3,1,0,1,1,0,1,1
10504152,4,3,1,0,1,1,0,1,1
10504429,3,3,0,0,1,1,0,0,1
10505215,2,2,0,0,2,2,0,0,0
10505221,3,2,1,0,2,1,1,0,0
10505273,1,0,1,0,1,1,0,0,0
10505434,2,2,0,0,3,1,2,1,0
10505471,2,2,0,0,2,2,0,0,0
10505508,4,3,1,0,3,2,1,0,1
10505734,2,1,1,0,1,1,0,0,0
10505782,5,4,1,0,2,2,0,0,1
10505804,2,2,0,0,3,1,2,1,0
10505844,2,2,0,0,3,1,2,1,0
10506725,10,7,3,0,3,2,1,0,0
10506749,7,7,0,0,3,0,3,0,0
10506945,4,4,0,0,0,0,0,0,1
10507320,3,2,1,0,1,1,0,1,1
10507519,7,5,2,0,2,1,1,1,1
10507628,2,2,0,0,1,1,0,0,1
10507791,1,1,0,0,1,1,0,0,0
10507896,1,1,0,0,1,1,0,0,0
10508021,9,5,4,0,4,3,1,2,1
10508560,2,2,0,0,3,1,2,1,0
10508626,4,2,2,0,5,2,3,1,0
10508633,2,2,0,0,1,1,0,0,1
10508683,2,2,0,0,3,1,2,1,0
10508740,3,2,1,0,1,1,0,0,1
10508782,3,2,1,0,2,1,1,0,0
10508919,2,2,0,0,2,2,0,0,1
10509817,5,4,1,0,1,1,0,1,1
10510024,2,0,2,0,2,2,0,0,0
10510261,2,2,0,0,1,1,0,0,0
10510283,2,1,1,0,1,1,0,0,1
10510602,1,1,0,0,1,1,0,0,0
10510770,2,2,0,0,2,2,0,0,0
10511136,7,6,1,0,1,1,0,1,1
10511170,1,1,0,0,1,1,0,0,0
10511451,2,1,1,0,1,1,0,0,0
10511590,1,1,0,0,1,1,0,0,0
10511759,2,2,0,0,2,2,0,0,0
10512218,1,1,0,0,1,1,0,0,0
10512241,1,1,0,0,1,1,0,0,0
10512627,1,1,0,0,1,1,0,0,0
10512650,2,2,0,0,2,2,0,0,0
10512768,3,3,0,0,2,2,0,0,0
10512820,2,2,0,0,3,1,2,1,0
10513073,5,2,3,0,2,1,1,0,0
10513217,7,7,0,0,2,1,1,0,1
10513730,2,0,2,0,1,1,0,0,0
10513838,4,0,4,0,1,1,0,0,0
10514017,7,6,1,0,1,1,0,1,1
10514124,1,1,0,0,1,1,0,0,0
10514188,2,0,2,0,2,2,0,0,0
10514214,1,1,0,0,1,1,0,0,1
10514267,3,3,0,0,1,1,0,0,1
10515035,2,1,1,0,1,1,0,0,0
10515771,2,0,2,0,1,1,0,1,0
10516195,3,2,1,0,2,2,0,0,0
10516284,4,3,1,0,1,1,0,1,0
10516504,1,1,0,0,1,1,0,0,0
10516607,1,1,0,0,1,1,0,0,0
10516934,3,3,0,0,2,2,0,2,1
10517577,2,2,0,0,1,1,0,0,0
10517582,1,1,0,0,0,0,0,0,0
10517761,1,0,1,0,0,0,0,0,0
10517817,3,3,0,0,3,3,0,0,0
10518002,1,1,0,0,1,1,0,0,0
10518331,1,1,0,0,1,1,0,0,0
10518507,4,4,0,0,2,2,0,0,1
10518581,2,1,1,0,2,2,0,0,0
10518991,1,1,0,0,1,1,0,0,0
10519545,2,1,1,0,2,1,1,0,0
10519984,1,0,1,0,1,1,0,0,0
10520047,2,2,0,0,1,1,0,0,0
10520111,8,6,2,0,2,0,2,0,1
10520175,2,2,0,0,2,2,0,0,0
10520298,9,5,4,0,3,1,2,0,0
10520370,6,6,0,0,1,1,0,1,1
10520458,2,2,0,0,3,1,2,2,0
10520475,1,1,0,0,1,1,0,0,0
10520795,6,6,0,0,1,1,0,1,1
10520896,2,1,1,0,2,1,1,0,0
10520904,6,6,0,0,1,1,0,1,1
10521104,4,3,1,0,5,2,3,2,1
10521120,3,2,1,0,2,2,0,0,1
10521736,5,4,1,0,1,1,0,1,1
10521819,2,1,1,0,2,1,1,0,0
10521946,1,1,0,0,1,1,0,0,0
10522303,4,4,0,0,4,0,4,0,1
10522625,1,0,1,0,0,0,0,0,1
10522669,1,0,1,0,0,0,0,0,1
10522743,4,3,1,0,2,2,0,0,1
10522854,2,2,0,0,2,2,0,0,1
10523014,2,1,1,0,0,0,0,0,0
10523055,1,1,0,0,0,0,0,0,0
10523080,1,1,0,0,1,1,0,0,0
10523385,2,1,1,0,3,2,1,0,0
10523637,2,2,0,0,2,2,0,0,0
10523659,1,0,1,0,1,1,0,0,0
10523663,10,5,5,0,2,1,1,2,1
10523749,10,4,6,0,3,2,1,3,1
10524306,5,5,0,0,0,0,0,0,0
10524452,2,2,0,0,1,1,0,0,0
10524612,2,2,0,0,2,2,0,0,0
10525093,1,1,0,0,1,1,0,0,0
10525216,5,3,2,0,3,3,0,3,0
10525425,1,1,0,0,1,1,0,0,0
10525474,5,3,2,0,5,5,0,1,1
10525525,1,1,0,0,1,1,0,0,0
10525574,4,3,1,0,1,1,0,1,1
10525582,1,1,0,0,1,1,0,0,0
10525715,1,1,0,0,1,1,0,0,0
10526433,6,5,1,0,3,1,2,1,1
10526564,2,2,0,0,3,3,0,2,0
10527177,1,0,1,0,0,0,0,0,0
10527651,1,0,1,0,1,1,0,0,0
10528559,4,4,0,0,1,0,1,1,1
10529272,4,3,1,0,1,1,0,1,1
10530331,2,1,1,0,1,1,0,0,1
10530608,4,4,0,0,5,1,4,1,1
10530719,2,1,1,0,2,1,1,2,0
10530819,2,2,0,0,1,1,0,0,0
10531416,1,0,1,0,0,0,0,0,0
10531717,3,2,1,0,1,1,0,1,0
10531924,2,0,2,0,0,0,0,0,1
10532155,5,4,1,0,1,1,0,1,1
10532444,6,0,6,0,2,2,0,0,1
10532618,1,1,0,0,1,1,0,0,0
10532884,2,0,2,0,2,2,0,0,1
10533697,11,9,2,0,0,0,0,0,1
10533762,2,2,0,0,1,1,0,0,1
10533975,4,3,1,0,2,0,2,1,1
10534166,2,2,0,0,0,0,0,0,0
10534644,3,2,1,0,2,2,0,0,1
10534694,7,6,1,0,3,2,1,1,1
10534768,2,2,0,0,2,2,0,0,1
10534787,3,3,0,0,2,2,0,0,0
10534826,2,2,0,0,2,2,0,0,1
10534921,3,2,1,0,2,1,1,0,1
09360397,6,5,1,0,1,1,0,1,1
09360484,1,1,0,0,1,1,0,0,0
09360503,2,1,1,0,1,1,0,0,1
09360511,3,1,2,0,1,1,0,0,0
09360768,2,2,0,0,1,1,0,0,0
09360857,2,2,0,0,1,1,0,0,0
09361066,6,4,2,0,3,2,1,1,0
09361189,3,3,0,0,1,1,0,0,1
09361616,6,4,2,0,1,1,0,1,1
09361952,1,0,1,0,0,0,0,0,0
09362333,1,1,0,0,1,1,0,0,0
09362379,3,0,3,0,0,0,0,0,1
09362642,3,3,0,0,1,1,0,0,1
09362801,23,15,8,0,0,0,0,0,0
09362846,1,1,0,0,1,1,0,0,0
09363041,3,1,2,0,1,1,0,0,0
09363053,2,2,0,0,1,1,0,0,0
09363235,2,1,1,0,1,1,0,0,0
09364067,3,0,3,0,0,0,0,0,1
09364227,2,1,1,0,1,1,0,0,1
09364524,2,2,0,0,0,0,0,0,0
09364652,2,2,0,0,1,1,0,0,0
09364687,6,5,1,0,3,3,0,0,0
09364857,1,1,0,0,1,1,0,0,0
09364884,5,3,2,0,1,1,0,1,1
09365162,1,1,0,0,1,1,0,0,0
09365231,2,0,2,0,2,2,0,0,0
09366143,6,4,2,0,3,1,2,3,1
09366876,2,2,0,0,2,2,0,0,0
09366909,2,0,2,0,0,0,0,0,1
09367129,2,2,0,0,2,2,0,0,0
09367132,2,2,0,0,2,2,0,0,1
09367667,2,0,2,0,2,2,0,0,1
09368049,3,0,3,0,1,1,0,0,0
09368112,3,3,0,0,2,2,0,0,1
09368429,2,0,2,0,1,1,0,0,1
09368430,1,0,1,0,0,0,0,0,0
09368800,1,1,0,0,1,1,0,0,0
09369220,2,1,1,0,1,1,0,0,0
09369248,2,1,1,0,4,3,1,0,1
09369712,7,0,7,0,1,1,0,1,1
09369830,2,0,2,0,0,0,0,0,1
09370441,2,2,0,0,1,1,0,0,0
09370569,2,2,0,0,1,1,0,0,0
09370759,9,6,3,0,3,3,0,0,0
09370874,4,0,4,0,0,0,0,0,0
09371131,2,2,0,0,2,2,0,0,0
09372339,1,1,0,0,1,1,0,0,0
09373395,1,1,0,0,1,1,0,0,0
09373398,5,0,5,0,0,0,0,0,1
09373611,8,3,5,0,2,2,0,0,1
09373828,2,0,2,0,0,0,0,0,1
09374060,7,3,4,0,2,2,0,2,1
09374816,1,1,0,0,1,1,0,0,0
09375159,2,2,0,0,2,2,0,0,1
09375711,2,1,1,0,1,1,0,0,0
09375867,1,0,1,0,1,1,0,0,0
09375908,2,0,2,0,0,0,0,0,0
09375993,1,0,1,0,1,1,0,0,0
09376017,1,1,0,0,1,1,0,0,0
09376072,1,0,1,0,1,1,0,0,0
09376234,1,1,0,0,1,1,0,0,0
09376581,2,1,1,0,4,2,2,1,1
09376585,6,5,1,0,1,1,0,0,0
09376628,10,7,3,0,2,1,1,2,1
09376852,1,1,0,0,0,0,0,0,0
09376943,5,5,0,0,1,1,0,1,1
09377567,6,1,5,0,2,2,0,0,0
09377700,2,2,0,0,1,1,0,0,1
09377830,14,7,7,0,2,2,0,2,0
09377847,5,4,1,0,1,1,0,1,0
09377977,7,5,2,0,1,1,0,0,1
09378380,3,1,2,0,1,1,0,0,0
09378558,2,2,0,0,2,2,0,0,1
09379253,11,4,7,0,0,0,0,0,1
09379555,5,5,0,0,1,1,0,1,0
09379734,5,5,0,0,1,1,0,1,0
09379878,2,2,0,0,2,2,0,0,0
09380428,29,11,18,0,0,0,0,0,0
09380656,4,0,4,0,0,0,0,0,1
09380670,3,0,3,0,0,0,0,0,0
09381349,3,0,3,0,0,0,0,0,0
09381772,2,2,0,0,2,2,0,0,0
09381828,2,2,0,0,1,1,0,0,0
09382018,7,3,4,0,1,1,0,1,1
09382052,2,2,0,0,2,2,0,0,0
09382373,6,6,0,0,1,1,0,1,1
09382385,2,1,1,0,1,1,0,0,1
09382499,4,0,4,0,1,1,0,1,0
09382531,1,1,0,0,1,1,0,0,1
09383203,4,3,1,0,3,2,1,1,1
09383522,1,1,0,0,1,1,0,0,0
09383658,7,0,7,0,0,0,0,0,1
09384120,3,3,0,0,1,1,0,0,0
09384722,4,1,3,0,1,1,0,0,1
09384770,2,2,0,0,1,1,0,1,0
09384918,3,0,3,0,2,2,0,0,0
09385533,1,0,1,0,0,0,0,0,1
09385577,7,0,7,0,0,0,0,0,1
09385628,7,3,4,0,2,2,0,2,1
09386563,3,0,3,0,0,0,0,0,1
09386646,15,5,10,0,1,1,0,1,1
09386912,2,2,0,0,1,1,0,0,0
09386981,19,8,11,0,0,0,0,0,0
09387239,10,3,7,0,0,0,0,0,1
09387457,2,0,2,0,1,1,0,0,0
09387625,1,1,0,0,2,2,0,0,0
09387689,3,2,1,0,1,1,0,1,1
09387818,2,0,2,0,2,2,0,1,1
09387866,2,2,0,0,1,1,0,0,0
09387880,6,2,4,0,1,1,0,0,0
09388657,5,5,0,0,3,0,3,0,0
09388861,1,0,1,0,0,0,0,0,0
09388902,2,2,0,0,2,2,0,0,1
09388941,14,7,7,0,0,0,0,0,1
09388994,1,1,0,0,2,2,0,0,0
09389068,13,7,6,0,1,1,0,1,1
09389150,13,7,6,0,1,1,0,1,1
09389199,3,2,1,0,1,1,0,1,1
09389223,1,0,1,0,1,1,0,0,0
09389231,2,0,2,0,0,0,0,0,1
09389304,3,2,1,0,1,1,0,1,1
09389771,1,1,0,0,1,1,0,0,0
09389838,1,1,0,0,1,1,0,0,0
09389891,7,6,1,0,0,0,0,0,0
09389892,3,2,1,0,1,1,0,0,1
09389985,5,2,3,0,1,1,0,0,0
09390078,9,4,5,0,2,1,1,1,1
09390569,3,0,3,0,1,1,0,0,1
09390585,3,3,0,0,4,2,2,1,0
09390637,5,0,5,0,0,0,0,0,1
09390639,1,0,1,0,1,1,0,0,1
09390669,2,0,2,0,0,0,0,0,1
09390696,8,0,8,0,0,0,0,0,0
09390757,1,1,0,0,1,1,0,0,0
09390914,1,1,0,0,1,1,0,0,0
09391123,1,1,0,0,1,1,0,0,0
09391316,3,3,0,0,1,1,0,0,0
09391901,2,0,2,0,1,1,0,0,0
09392863,4,0,4,0,0,0,0,0,0
09392876,2,2,0,0,1,1,0,1,1
09393586,3,3,0,0,0,0,0,0,1
09395168,8,5,3,0,3,2,1,3,1
09395314,2,1,1,0,1,1,0,0,0
09395456,4,3,1,0,1,1,0,1,1
09395902,2,1,1,0,1,1,0,0,0
09396267,2,2,0,0,1,1,0,0,0
09396431,8,3,5,0,0,0,0,0,1
09396636,2,2,0,0,2,2,0,0,0
09396662,1,0,1,0,1,1,0,0,1
09397320,5,0,5,0,1,1,0,1,1
09397665,2,2,0,0,2,2,0,0,0
09398299,4,2,2,0,2,2,0,0,0
09398570,5,4,1,0,2,2,0,0,1
09398578,7,3,4,0,0,0,0,0,0
09399078,1,0,1,0,0,0,0,0,0
09399752,1,1,0,0,1,1,0,0,0
09399764,4,4,0,0,1,1,0,0,0
09399896,3,3,0,0,1,1,0,0,1
09399987,3,3,0,0,2,2,0,0,0
09400037,8,5,3,0,1,1,0,0,1
09400086,1,1,0,0,1,1,0,0,0
09400127,2,1,1,0,1,1,0,0,0
09400310,7,3,4,0,1,1,0,1,0
09400340,2,0,2,0,1,1,0,0,0
09400375,8,3,5,0,4,3,1,0,0
09400573,2,1,1,0,2,1,1,0,1
09400692,2,0,2,0,1,1,0,0,0
09400886,2,0,2,0,1,1,0,1,1
09400917,2,0,2,0,0,0,0,0,0
09401157,3,1,2,0,1,1,0,0,1
09401240,2,1,1,0,2,2,0,0,0
09401357,19,13,6,0,0,0,0,0,1
09401541,2,1,1,0,1,1,0,0,0
09401556,1,1,0,0,1,1,0,0,1
09401740,3,3,0,0,1,1,0,0,0
09402053,4,3,1,0,3,3,0,0,0
09402145,1,1,0,0,1,1,0,0,0
09402152,2,2,0,0,2,2,0,0,0
09402690,2,0,2,0,0,0,0,0,1
09402726,4,2,2,0,2,2,0,0,0
09403073,1,0,1,0,0,0,0,0,0
09403110,3,0,3,0,2,2,0,0,0
09403611,6,3,3,0,2,1,1,2,1
09403614,6,3,3,0,2,1,1,2,1
09403656,5,2,3,0,2,1,1,2,1
09403678,2,2,0,0,2,2,0,0,0
09403833,4,4,0,0,3,3,0,0,1
09404021,10,9,1,0,0,0,0,0,1
09404082,5,2,3,0,1,1,0,1,1
09404106,5,2,3,0,1,1,0,1,1
09404196,6,4,2,0,0,0,0,0,0
09404343,6,5,1,0,0,0,0,0,1
09404925,2,1,1,0,1,1,0,0,0
09404973,1,1,0,0,1,1,0,0,0
09405060,2,2,0,0,2,2,0,0,0
09405081,1,0,1,0,1,1,0,0,0
09405995,1,0,1,0,1,1,0,0,0
09406018,1,1,0,0,2,2,0,0,1
09406081,2,1,1,0,2,1,1,0,0
09406304,3,1,2,0,3,1,2,0,1
09406507,3,3,0,0,1,1,0,0,0
09406669,2,2,0,0,2,2,0,0,0
09406851,8,4,4,0,1,1,0,1,1
09407861,2,0,2,0,1,1,0,1,1
09408585,1,1,0,0,1,1,0,0,1
09409081,5,2,3,0,1,1,0,0,0
09409086,1,0,1,0,1,1,0,0,0
09409123,4,2,2,0,1,1,0,1,0
09409160,2,2,0,0,1,1,0,0,0
09409327,3,3,0,0,3,2,1,0,0
09410083,1,1,0,0,2,1,1,0,1
09410382,5,2,3,0,1,1,0,0,1
09410798,3,2,1,0,1,1,0,0,0
09411327,7,3,4,0,1,1,0,1,1
09411389,2,0,2,0,1,1,0,1,1
09411602,2,0,2,0,1,1,0,1,1
09411616,2,0,2,0,2,2,0,0,1
09411714,1,1,0,0,1,1,0,0,1
09411804,2,0,2,0,2,2,0,0,1
09412065,1,1,0,0,1,1,0,0,0
09412383,8,5,3,0,1,1,0,0,1
09412853,2,0,2,0,0,0,0,0,1
09412858,4,3,1,0,1,1,0,1,1
09413087,5,2,3,0,0,0,0,0,0
09413319,2,0,2,0,0,0,0,0,1
09413544,5,3,2,0,0,0,0,0,0
09413609,2,0,2,0,0,0,0,0,0
09413632,10,2,8,0,3,1,2,1,0
09413757,7,6,1,1,0,0,0,0,1
09414038,3,2,1,0,1,1,0,1,1
09414135,2,0,2,0,1,1,0,0,1
09414229,1,1,0,0,1,1,0,0,0
09414352,13,6,7,0,0,0,0,0,1
09414462,4,0,4,0,2,2,0,0,1
09415167,10,6,4,0,0,0,0,0,1
09415744,1,1,0,0,1,1,0,0,0
09415768,1,1,0,0,2,2,0,0,0
09415958,9,3,6,0,3,1,2,3,0
08270063,6,5,1,0,0,0,0,0,1
08270065,1,1,0,0,3,1,2,2,0
08270105,2,0,2,0,0,0,0,0,1
08270359,2,2,0,0,1,1,0,0,0
08271021,16,0,16,0,0,0,0,0,1
08271124,2,2,0,0,0,0,0,0,1
08271384,18,8,10,0,1,1,0,0,1
08271665,1,1,0,0,1,1,0,0,0
08271892,3,1,2,0,1,1,0,0,0
08271985,21,3,18,0,2,1,1,2,1
08272167,6,4,2,0,1,1,0,1,1
08272181,4,0,4,0,2,2,0,0,1
08272183,16,3,13,0,1,1,0,1,1
08272211,4,3,1,0,2,2,0,0,1
08272234,9,6,3,0,0,0,0,0,0
08272250,14,6,8,0,1,1,0,1,1
08272295,20,5,15,0,2,1,1,2,1
08272354,13,2,11,0,1,1,0,1,1
08272480,16,6,10,0,0,0,0,0,1
08272676,4,4,0,0,1,1,0,1,1
08272943,1,0,1,0,1,1,0,0,0
08273143,2,2,0,0,2,2,0,0,0
08273195,11,2,9,0,1,1,0,1,1
08273219,2,2,0,0,2,2,0,0,1
08273372,1,1,0,0,1,1,0,0,1
08273616,17,7,10,0,2,2,0,2,1
08273688,3,0,3,0,0,0,0,0,1
08274281,1,0,1,0,0,0,0,0,0
08274442,6,2,4,0,1,1,0,0,0
08274478,1,0,1,0,0,0,0,0,0
08274527,3,0,3,0,1,1,0,0,0
08274655,2,0,2,0,1,1,0,0,0
08274789,2,1,1,0,1,1,0,0,1
08274799,6,2,4,0,1,1,0,0,1
08275287,23,9,14,0,0,0,0,0,1
08275341,2,0,2,0,0,0,0,0,1
08275408,1,1,0,0,1,1,0,0,0
08276438,2,0,2,0,1,1,0,0,1
08276472,5,1,4,0,1,1,0,0,0
08276620,1,1,0,0,1,1,0,0,0
08276824,2,2,0,0,2,2,0,0,0
08277096,17,7,10,0,4,3,1,1,1
08277340,5,4,1,0,0,0,0,0,1
08277551,1,1,0,0,1,1,0,0,0
08277819,1,1,0,0,1,1,0,0,0
08277977,4,0,4,0,1,1,0,1,1
08278697,2,2,0,0,2,2,0,0,1
08278739,5,3,2,0,2,2,0,0,1
08278766,16,8,8,0,1,0,1,0,0
08278932,2,2,0,0,1,1,0,0,1
08279190,2,1,1,0,2,1,1,0,0
08279395,6,3,3,0,2,1,1,1,1
08279560,10,5,5,0,3,3,0,0,1
08279598,2,0,2,0,1,1,0,0,0
08280636,2,2,0,0,2,2,0,0,0
08280942,7,5,2,0,1,1,0,0,0
08281046,25,0,25,0,0,0,0,0,0
08281100,11,2,9,0,1,1,0,1,1
08281426,4,0,4,0,0,0,0,0,1
08281481,2,2,0,0,1,1,0,0,0
08281949,4,0,4,0,0,0,0,0,1
08282623,4,2,2,0,1,1,0,0,0
08282645,4,3,1,0,2,2,0,0,1
08282659,4,4,0,0,1,1,0,0,1
08282867,19,8,11,0,6,3,3,0,1
08282914,6,0,6,0,0,0,0,0,1
08282931,3,2,1,0,1,1,0,0,1
08283033,7,1,6,0,0,0,0,0,1
08283042,2,2,0,0,3,3,0,0,0
08283060,7,5,2,0,1,1,0,1,1
08283131,11,4,7,0,1,0,1,1,1
08283583,2,0,2,0,0,0,0,0,1
08283672,2,1,1,0,1,1,0,0,0
08283695,2,1,1,0,1,1,0,0,0
08283891,1,0,1,0,0,0,0,0,1
08283968,1,1,0,0,1,1,0,0,1
08284220,40,21,19,0,0,0,0,0,1
08284274,7,6,1,0,0,0,0,0,0
08284280,2,2,0,0,1,1,0,0,0
08284349,8,2,6,0,1,1,0,1,1
08284371,24,6,18,0,3,0,3,0,0
08284648,9,3,6,0,1,1,0,1,1
08284677,3,1,2,0,1,1,0,0,0
08284692,10,4,6,0,1,1,0,1,1
08284840,3,2,1,0,0,0,0,0,1
08284860,5,3,2,0,3,3,0,0,1
08285383,1,0,1,0,0,0,0,0,0
08285853,7,1,6,0,0,0,0,0,1
08285898,1,0,1,0,1,1,0,0,0
08285984,1,1,0,0,1,1,0,0,0
08286257,1,0,1,0,0,0,0,0,0
08286295,33,15,18,0,4,3,1,0,0
08286418,20,0,20,0,3,3,0,0,1
08286493,5,0,5,0,1,1,0,1,0
08286865,15,5,10,0,1,1,0,1,1
08286926,6,2,4,0,1,1,0,0,0
08287047,7,6,1,0,2,0,2,0,1
08287687,11,3,8,0,0,0,0,0,0
08287691,3,2,1,0,1,1,0,0,0
08287905,1,0,1,0,1,1,0,0,0
08287910,9,5,4,0,1,1,0,1,1
08288023,1,1,0,0,1,1,0,0,0
08288061,15,5,10,0,1,1,0,1,1
08288126,1,0,1,0,1,1,0,0,0
08288176,30,13,17,0,0,0,0,0,1
08288548,3,1,2,0,4,3,1,0,0
08288600,1,1,0,0,2,2,0,0,0
08288992,2,0,2,0,1,1,0,0,1
08289534,28,14,14,0,3,3,0,3,1
08289583,19,0,19,0,3,3,0,0,1
08289900,1,1,0,0,1,1,0,0,0
08290086,3,2,1,0,1,1,0,1,1
08290405,7,3,4,0,0,0,0,0,1
08290423,14,6,8,0,0,0,0,0,0
08290455,8,6,2,0,2,1,1,1,0
08290937,3,2,1,0,1,1,0,0,0
08291377,1,1,0,0,1,1,0,0,1
08291429,19,7,12,0,0,0,0,0,1
08291492,28,0,28,0,0,0,0,0,0
08291498,3,0,3,0,0,0,0,0,1
08291601,31,13,18,0,0,0,0,0,1
08291841,2,2,0,0,1,1,0,0,0
08291862,2,1,1,0,1,1,0,0,0
08291888,3,3,0,0,3,3,0,0,0
08291966,2,0,2,0,0,0,0,0,1
08292030,3,3,0,0,1,1,0,0,1
08292131,9,3,6,0,1,1,0,0,1
08292380,26,10,16,0,3,3,0,0,1
08293063,1,0,1,0,0,0,0,0,1
08293360,4,3,1,0,1,1,0,0,0
08293776,13,2,11,0,0,0,0,0,1
08294054,1,0,1,0,0,0,0,0,0
08294076,1,1,0,0,1,1,0,0,1
08294117,8,6,2,0,0,0,0,0,1
08294615,2,2,0,0,2,2,0,0,0
08294659,11,7,4,0,1,1,0,0,1
08294942,3,3,0,0,1,1,0,1,0
08295042,1,1,0,0,0,0,0,0,1
08295181,2,1,1,0,0,0,0,0,1
08295286,1,1,0,0,1,1,0,0,0
08295307,3,2,1,0,2,2,0,0,0
08295662,1,1,0,0,1,1,0,0,0
08295748,3,2,1,0,1,1,0,0,0
08295828,1,1,0,0,1,1,0,0,0
08295830,19,12,7,0,0,0,0,0,1
08296453,2,2,0,0,1,1,0,0,0
08296556,14,0,14,0,0,0,0,0,1
08296831,6,4,2,0,1,1,0,0,1
08297069,7,3,4,0,1,1,0,1,1
08297343,6,0,6,0,0,0,0,0,1
08297470,2,2,0,0,1,1,0,0,1
08297960,3,3,0,0,2,2,0,0,0
08298272,1,1,0,0,1,1,0,0,0
08298279,6,0,6,0,0,0,0,0,1
08298550,2,2,0,0,1,1,0,0,0
08298751,10,6,4,0,2,2,0,0,0
08298936,3,3,0,0,1,1,0,1,1
08298940,10,6,4,0,0,0,0,0,0
08299166,25,11,14,0,0,0,0,0,0
08299496,4,0,4,0,0,0,0,0,1
08300427,3,2,1,0,0,0,0,0,0
08300587,4,0,4,0,0,0,0,0,1
08301004,11,2,9,0,1,1,0,1,1
08301065,3,0,3,0,0,0,0,0,1
08301082,1,0,1,0,0,0,0,0,1
08301150,2,1,1,0,1,1,0,0,0
08301205,2,2,0,0,1,1,0,0,0
08301275,2,2,0,0,1,1,0,0,0
08301922,10,2,8,0,1,1,0,1,1
08301945,12,2,10,0,6,1,5,5,1
08302008,8,2,6,0,1,1,0,1,1
08302042,5,4,1,0,0,0,0,0,1
08302065,2,2,0,0,1,1,0,0,0
08302077,2,2,0,0,2,2,0,0,0
08302302,3,1,2,0,3,2,1,0,1
08302670,2,0,2,0,0,0,0,0,0
08302822,8,4,4,0,0,0,0,0,1
08302875,2,2,0,0,1,1,0,0,0
08302907,1,1,0,0,1,1,0,0,0
08303039,2,2,0,0,1,1,0,0,0
08303133,2,2,0,0,1,1,0,0,1
08303263,5,2,3,0,1,1,0,1,1
08303532,22,13,9,0,0,0,0,0,1
08303629,1,0,1,0,0,0,0,0,1
08303773,35,9,26,0,7,0,7,0,0
08303893,12,0,12,0,1,1,0,1,0
08304258,9,3,6,0,2,1,1,1,1
08304350,2,2,0,0,2,2,0,0,1
08304388,18,8,10,0,0,0,0,0,1
08304396,1,1,0,0,1,1,0,0,0
08304492,3,1,2,0,1,1,0,0,0
08304538,8,5,3,0,0,0,0,0,0
08305281,6,3,3,0,1,1,0,1,1
08305417,4,4,0,0,1,1,0,0,0
08305570,3,2,1,0,3,3,0,3,1
08305764,17,9,8,0,0,0,0,0,0
08305945,3,0,3,0,0,0,0,0,1
08306048,7,4,3,0,1,1,0,1,1
08306060,4,3,1,0,1,0,1,1,1
08307176,2,2,0,0,1,1,0,0,1
08307265,3,2,1,0,1,1,0,0,0
08307400,3,3,0,0,1,1,0,0,0
08307678,4,2,2,0,2,2,0,0,1
08307685,3,0,3,0,2,1,1,0,0
08308068,2,1,1,0,1,1,0,0,0
08308180,4,2,2,0,2,2,0,0,1
08308944,6,1,5,0,1,1,0,0,1
08309137,7,3,4,0,1,1,0,1,1
08309247,7,3,4,0,1,1,0,1,1
08309254,4,2,2,0,1,1,0,1,1
08309279,4,2,2,0,1,1,0,1,1
08309377,4,1,3,0,1,1,0,0,1
08309457,11,6,5,0,6,6,0,5,1
08309478,1,1,0,0,2,2,0,0,0
08309493,2,1,1,0,2,1,1,0,0
08309497,2,2,0,0,2,2,0,0,1
08309659,2,0,2,0,1,1,0,0,0
08309693,2,1,1,0,1,1,0,0,0
08309747,15,8,7,0,0,0,0,0,0
08309879,2,1,1,0,2,1,1,0,0
08309897,16,5,11,0,0,0,0,0,1
08309928,2,2,0,0,1,1,0,0,0
08309969,7,3,4,0,4,3,1,0,0
08310097,2,2,0,0,1,1,0,0,1
08310166,7,3,4,0,3,1,2,3,1
08310762,2,2,0,0,1,1,0,0,0
08310813,5,4,1,0,1,0,1,1,1
08310843,14,0,14,0,0,0,0,0,1
08311050,3,3,0,0,1,1,0,1,1
08311200,18,8,10,0,0,0,0,0,0
08311229,5,3,2,0,1,1,0,1,1
08311864,5,0,5,0,0,0,0,0,0
08311909,8,3,5,0,1,0,1,0,1
08312124,5,4,1,0,0,0,0,0,0
08312311,1,1,0,0,1,1,0,0,0
08312420,4,3,1,0,1,1,0,0,0
08312487,7,4,3,0,1,0,1,1,1
08312853,3,2,1,0,2,2,0,0,1
08313285,1,1,0,0,1,1,0,0,1
08313364,11,5,6,0,0,0,0,0,1
08313593,1,1,0,0,1,1,0,0,0
08313724,12,3,9,0,4,1,3,1,1
08314083,20,9,11,0,0,0,0,0,1
08314226,3,3,0,0,2,2,0,0,0
08314448,17,0,17,0,0,0,0,0,1
08314540,3,0,3,0,0,0,0,0,0
08314653,4,3,1,0,1,1,0,0,1
08314967,6,5,1,0,0,0,0,0,0
08315377,1,1,0,0,1,1,0,0,1
08315446,1,1,0,0,1,1,0,0,0
08315879,1,0,1,0,0,0,0,0,0
08315897,5,3,2,0,0,0,0,0,1
08316291,5,4,1,0,2,2,0,0,1
08316380,1,1,0,0,0,0,0,0,1
08316486,12,4,8,0,2,2,0,2,1
08317210,20,3,17,0,2,1,1,2,1
08317541,14,2,12,0,1,1,0,1,1
08317605,3,3,0,0,1,1,0,0,0
08317745,1,0,1,0,0,0,0,0,0
08318067,40,12,28,0,0,0,0,0,1
08318110,1,1,0,0,0,0,0,0,0
08318132,1,1,0,0,1,1,0,0,0
08318168,12,2,10,0,1,1,0,1,1
08318207,1,0,1,0,1,1,0,0,0
08318520,3,0,3,0,1,1,0,0,0
08318568,2,0,2,0,0,0,0,0,1
08318726,1,1,0,0,1,1,0,0,1
08318939,1,1,0,0,0,0,0,0,0
08318962,12,0,12,0,2,2,0,0,1
08318970,6,2,4,0,0,0,0,0,0
08319049,2,2,0,0,1,1,0,0,0
08319063,1,1,0,0,0,0,0,0,0
08319610,1,0,1,0,0,0,0,0,0
08319660,4,4,0,0,1,1,0,1,1
08319768,2,0,2,0,0,0,0,0,1
08319962,11,4,7,0,0,0,0,0,0
08319999,14,8,6,0,0,0,0,0,0
08320013,8,4,4,0,1,1,0,1,1
08320266,9,2,7,0,0,0,0,0,1
08320569,37,9,28,0,0,0,0,0,1
08321020,3,2,1,0,0,0,0,0,1
08321170,4,0,4,0,0,0,0,0,0
08321254,7,4,3,0,4,4,0,0,1
08321446,1,0,1,0,0,0,0,0,1
08321586,9,3,6,0,2,1,1,2,1
08321649,1,0,1,0,0,0,0,0,0
08321771,2,0,2,0,0,0,0,0,1
08321778,2,0,2,0,0,0,0,0,1
08321856,5,4,1,0,2,2,0,0,1
08321994,2,2,0,0,2,2,0,0,0
08321995,5,4,1,0,2,2,0,2,1
08322132,1,1,0,0,1,1,0,1,0
08322209,5,3,2,0,1,1,0,1,0
08322220,2,0,2,0,0,0,0,0,1
08322443,6,3,3,0,0,0,0,0,1
08322622,11,7,4,0,0,0,0,0,0
08322715,12,3,9,0,1,1,0,1,1
08322748,3,2,1,0,2,1,1,0,0
08322972,2,2,0,0,2,2,0,0,0
08323206,3,2,1,0,1,1,0,0,0
08323528,3,1,2,0,1,1,0,0,0
08324472,1,1,0,0,1,1,0,0,0
08324842,7,0,7,0,0,0,0,0,0
08324912,2,2,0,0,1,1,0,0,0
08324934,2,1,1,0,3,1,2,0,0
08324940,12,6,6,1,1,1,0,1,1
08326163,2,2,0,0,1,1,0,0,0
08326256,1,1,0,0,1,1,0,0,0
08326327,17,5,12,0,2,2,0,0,1
08327366,3,3,0,0,1,1,0,0,1
08327422,22,0,22,0,0,0,0,0,1
08327435,2,2,0,0,1,1,0,0,0
08327500,2,2,0,0,2,2,0,0,0
08327872,2,2,0,0,1,1,0,0,1
08328145,3,2,1,0,2,2,0,0,0
08328488,1,0,1,0,0,0,0,0,1
08328490,8,6,2,0,0,0,0,0,0
08328547,12,6,6,0,0,0,0,0,0
08329110,9,5,4,0,1,1,0,1,1
08329317,3,2,1,0,1,1,0,0,0
08329563,7,4,3,0,3,3,0,3,1
08329993,23,5,18,0,0,0,0,0,1
10780217,13,10,3,0,0,0,0,0,0
10780225,3,3,0,0,0,0,0,0,1
10780732,1,0,1,0,1,1,0,0,0
10780795,13,8,5,0,0,0,0,0,1
10781169,1,1,0,0,2,1,1,0,1
10781199,1,0,1,0,1,1,0,0,0
10781253,2,2,0,0,1,1,0,0,0
10781289,2,0,2,0,2,2,0,0,0
10781433,2,2,0,0,0,0,0,0,0
10781470,6,6,0,0,2,2,0,0,0
10781896,3,1,2,0,3,1,2,0,0
10782017,1,0,1,0,1,1,0,0,0
10782066,4,3,1,0,1,1,0,1,1
10782475,3,0,3,0,2,2,0,0,0
10782624,2,2,0,0,1,1,0,0,1
10782698,2,1,1,0,2,1,1,0,0
10783342,2,1,1,0,1,1,0,0,0
10783393,2,2,0,0,2,2,0,0,0
10783566,13,10,3,0,0,0,0,0,0
10783778,2,2,0,0,2,2,0,0,1
10784084,4,3,1,0,1,1,0,1,1
10784576,2,2,0,0,0,0,0,0,1
10784689,3,3,0,0,2,2,0,0,0
10784744,4,3,1,0,1,1,0,1,1
10784845,1,0,1,0,1,1,0,0,0
10784908,1,1,0,0,1,1,0,0,0
10785215,1,1,0,0,3,3,0,2,0
10785264,4,3,1,0,1,1,0,1,1
10785531,1,1,0,0,1,1,0,0,1
10785898,1,1,0,0,1,1,0,0,0
10785992,5,4,1,0,2,2,0,2,1
10786166,1,1,0,0,1,1,0,0,0
10786323,2,2,0,0,2,2,0,0,0
10786456,5,4,1,0,0,0,0,0,0
10786521,1,1,0,0,1,1,0,0,0
10786620,1,1,0,0,1,1,0,0,0
10786622,2,2,0,0,2,2,0,0,0
10787361,1,1,0,0,1,1,0,0,0
10787694,7,6,1,0,1,1,0,0,1
10787790,1,0,1,0,1,1,0,0,0
10788082,3,0,3,0,2,1,1,0,0
10788151,4,3,1,0,1,1,0,1,1
10788421,2,0,2,0,1,1,0,0,0
10788580,1,0,1,0,1,1,0,0,0
10789182,1,1,0,0,1,1,0,1,0
10789899,7,6,1,0,3,2,1,0,0
10790098,5,5,0,0,2,2,0,1,1
10790388,3,2,1,0,3,2,1,0,1
10790395,5,0,5,0,1,1,0,1,1
10790488,4,4,0,0,10,7,3,7,1
10790652,7,5,2,0,0,0,0,0,1
10791038,1,1,0,0,1,1,0,0,0
10791120,2,2,0,0,2,2,0,0,0
10791551,4,0,4,0,2,1,1,2,1
10791694,3,3,0,0,3,3,0,0,0
10792715,7,7,0,0,2,2,0,1,1
10792843,3,3,0,0,1,1,0,0,1
10793104,1,1,0,0,1,1,0,0,0
10793423,1,1,0,0,1,1,0,0,0
10793454,1,0,1,0,1,1,0,0,0
10793583,3,3,0,0,2,2,0,0,1
10794319,3,1,2,0,2,1,1,0,0
10794518,1,1,0,0,1,1,0,0,0
10794874,2,2,0,0,1,1,0,1,0
10795183,1,1,0,0,1,1,0,0,0
10795295,1,1,0,0,1,1,0,0,0
10795378,2,2,0,0,2,2,0,0,0
10795421,2,1,1,0,2,1,1,0,0
10796006,7,5,2,2,3,1,2,1,0
10796030,4,3,1,0,1,1,0,1,0
10796222,5,3,2,0,0,0,0,0,1
10796424,8,8,0,0,1,1,0,1,1
10796487,2,2,0,0,2,1,1,1,0
10796595,3,3,0,0,3,3,0,0,0
10796596,2,2,0,0,2,1,1,1,0
10796605,1,1,0,0,1,1,0,1,0
10796713,1,0,1,0,1,1,0,0,0
10797225,1,1,0,0,1,1,0,0,0
10797700,1,1,0,0,1,1,0,1,0
10797843,1,1,0,0,1,1,0,0,0
10797892,2,2,0,0,1,1,0,1,1
10797933,2,2,0,0,0,0,0,0,0
10798023,2,2,0,0,2,2,0,0,0
10798031,1,1,0,0,1,1,0,0,0
10798234,1,1,0,0,1,1,0,0,0
10798488,4,4,0,0,0,0,0,0,0
10798758,2,2,0,0,2,2,0,0,1
10799072,3,3,0,0,1,1,0,1,0
10799094,3,3,0,0,0,0,0,0,0
10799097,3,3,0,0,1,1,0,1,0
10799113,6,3,3,0,2,1,1,2,1
10799250,3,3,0,0,1,1,0,1,0
10799256,2,0,2,0,2,1,1,0,0
10799393,1,0,1,0,1,1,0,0,0
10799427,2,2,0,0,1,1,0,0,0
10799854,6,6,0,0,1,0,1,0,1
10799902,1,1,0,0,1,1,0,0,0
10800084,3,3,0,0,2,1,1,2,1
10800214,2,0,2,0,1,1,0,0,0
10800225,2,1,1,0,1,1,0,0,0
10800352,2,0,2,0,2,2,0,0,0
10800391,2,1,1,0,1,1,0,0,0
10800601,2,2,0,0,2,2,0,0,0
10800931,1,1,0,0,1,1,0,0,0
10801113,9,3,6,0,0,0,0,0,1
10801154,2,2,0,0,0,0,0,0,0
10801351,5,4,1,0,1,1,0,0,1
10801839,1,1,0,0,1,1,0,0,1
10801845,1,1,0,0,2,2,0,0,0
10802219,3,2,1,0,1,1,0,1,0
10802458,2,1,1,0,2,1,1,0,0
10802510,1,1,0,0,1,1,0,0,0
10802541,1,1,0,0,1,1,0,0,0
10802734,3,3,0,0,3,3,0,0,1
10802858,2,1,1,0,2,1,1,0,0
10803088,1,1,0,0,1,1,0,0,0
10803852,6,6,0,0,3,2,1,2,1
10804475,2,2,0,0,2,2,0,0,1
10804678,4,4,0,0,0,0,0,0,0
10805544,2,1,1,0,2,1,1,0,0
10805645,3,3,0,0,1,1,0,0,0
10805715,3,3,0,0,1,1,0,0,0
10805719,3,3,0,0,1,1,0,0,0
10806387,1,1,0,0,2,2,0,1,0
10807353,1,1,0,0,1,1,0,0,0
10807743,1,1,0,0,1,1,0,0,0
10807815,5,4,1,2,3,1,2,1,0
10808417,5,1,4,0,1,1,0,1,0
10808611,5,4,1,0,2,0,2,0,1
10808853,3,3,0,0,1,1,0,1,1
10809155,1,0,1,0,1,1,0,0,1
10809231,1,1,0,0,2,2,0,0,0
10809260,2,2,0,0,2,1,1,0,1
10809267,1,1,0,0,1,1,0,0,0
10809290,1,1,0,0,1,1,0,0,0
10809348,3,3,0,0,2,2,0,2,1
10809493,4,2,2,0,2,2,0,0,0
10809783,2,2,0,0,2,2,0,0,1
10809850,1,0,1,0,1,1,0,0,0
10809900,2,2,0,0,1,1,0,0,0
10809969,4,4,0,0,3,2,1,2,1
10810086,4,2,2,0,2,2,0,0,0
10810143,9,6,3,0,1,1,0,1,1
10810516,3,3,0,0,3,3,0,0,0
10810569,2,2,0,0,1,1,0,0,0
10811158,2,2,0,0,2,2,0,0,0
10811358,2,2,0,0,2,2,0,0,1
10811528,1,1,0,0,1,1,0,0,0
10811779,2,1,1,0,2,1,1,0,0
10811903,2,0,2,0,1,1,0,0,0
10812124,4,4,0,0,4,2,2,2,1
10812192,2,2,0,0,2,2,0,0,0
10812320,14,6,8,0,0,0,0,0,1
10812354,1,1,0,0,1,1,0,0,0
10812904,2,1,1,0,2,1,1,0,0
10813531,5,5,0,0,1,1,0,1,1
10813899,1,1,0,0,1,1,0,0,0
10814022,10,6,4,0,1,0,1,1,1
10814248,4,3,1,0,1,1,0,1,1
10814309,1,1,0,0,1,1,0,0,0
10814603,8,8,0,0,1,1,0,0,1
10815438,2,2,0,0,1,0,1,0,0
10815928,2,2,0,0,1,1,0,0,1
10815957,1,0,1,0,1,1,0,0,0
10815972,2,2,0,0,1,1,0,0,0
10816042,2,2,0,0,2,2,0,0,0
10816130,4,3,1,0,1,1,0,1,1
10816474,2,2,0,0,1,1,0,0,0
10816630,2,2,0,0,1,1,0,0,0
10816750,2,2,0,0,0,0,0,0,0
10817198,2,2,0,0,2,2,0,0,0
10817253,1,1,0,0,0,0,0,0,0
10817594,2,2,0,0,0,0,0,0,0
10817605,1,1,0,0,1,1,0,0,0
10817734,8,4,4,0,1,0,1,0,0
10817744,2,2,0,0,1,1,0,0,0
10817777,8,5,3,0,1,0,1,1,1
10817792,1,0,1,0,1,1,0,0,0
10817801,2,2,0,0,1,1,0,0,0
10817978,1,1,0,0,0,0,0,0,1
10817984,5,3,2,0,1,0,1,0,0
10818756,1,1,0,0,1,1,0,0,0
10818836,2,2,0,0,2,2,0,0,1
10818888,4,4,0,0,2,2,0,0,1
10819037,3,2,1,0,2,1,1,0,0
10819075,6,5,1,0,3,3,0,0,0
10819513,1,0,1,0,1,1,0,0,0
10820072,1,1,0,0,1,1,0,0,1
10820087,1,1,0,0,1,1,0,0,1
10820170,4,4,0,0,1,1,0,0,1
10820776,4,4,0,0,0,0,0,0,0
10820875,1,0,1,0,1,1,0,0,0
10820893,1,0,1,0,1,1,0,0,0
10821223,15,11,4,0,0,0,0,0,0
10821460,4,4,0,0,1,1,0,0,0
10821753,1,1,0,0,1,1,0,0,0
10821889,2,2,0,0,2,2,0,0,0
10821922,1,0,1,0,1,1,0,0,0
10822013,1,1,0,0,1,1,0,0,0
10823193,1,1,0,0,1,1,0,0,1
10823574,3,0,3,0,0,0,0,0,1
10823586,1,1,0,0,1,1,0,0,0
10823953,1,1,0,0,1,1,0,0,0
10824165,10,4,6,0,3,1,2,3,1
10824350,2,2,0,0,0,0,0,0,0
10824468,1,1,0,0,1,1,0,0,0
10824626,1,1,0,0,1,1,0,0,0
10824673,2,1,1,0,2,1,1,0,0
10824799,2,0,2,0,2,2,0,1,1
10825014,4,3,1,0,0,0,0,0,1
10825018,1,1,0,0,1,1,0,0,0
10825203,5,5,0,0,1,1,0,1,1
10825215,5,5,0,0,1,1,0,1,1
10825361,5,5,0,0,1,1,0,1,1
10825487,1,1,0,0,1,1,0,0,1
10825500,2,2,0,0,2,2,0,0,1
10825563,1,1,0,0,1,1,0,0,1
10825590,6,6,0,0,4,2,2,1,1
10825949,8,7,1,0,2,2,0,2,1
10826207,6,6,0,0,0,0,0,0,0
10826280,7,7,0,0,4,1,3,1,1
10826410,2,2,0,0,1,1,0,0,0
10826471,3,3,0,0,1,1,0,0,1
10826649,1,1,0,0,2,2,0,0,0
10826741,1,1,0,0,1,1,0,0,0
10826783,7,6,1,0,1,1,0,1,1
10826907,2,2,0,0,1,1,0,0,0
10827002,1,1,0,0,2,1,1,1,0
10827082,1,1,0,0,1,1,0,1,0
10827102,1,1,0,0,1,1,0,0,0
10827198,2,0,2,0,1,1,0,0,0
10827225,3,3,0,0,2,2,0,0,0
10827306,1,1,0,0,1,1,0,0,0
10827877,2,0,2,0,1,1,0,0,0
10828006,6,5,1,0,1,1,0,1,1
10828226,4,4,0,0,3,3,0,0,1
10828635,4,3,1,0,3,2,1,1,1
10828734,2,0,2,0,2,2,0,0,0
10828869,2,2,0,0,2,2,0,0,0
10829031,6,4,2,0,0,0,0,0,0
10829236,1,1,0,0,1,1,0,0,0
10830076,1,0,1,0,1,1,0,0,0
10830119,1,1,0,0,1,1,0,0,0
10830394,1,0,1,0,1,1,0,0,0
10830991,1,0,1,0,0,0,0,0,0
10831136,2,2,0,0,1,1,0,1,0
10831331,3,3,0,0,3,3,0,0,1
10831398,4,4,0,0,0,0,0,0,1
10831430,11,7,4,0,3,2,1,3,1
10831787,2,1,1,0,2,1,1,0,0
10832018,5,5,0,0,0,0,0,0,0
10832049,1,1,0,0,1,1,0,0,0
10832211,1,1,0,0,1,1,0,0,0
10832317,2,0,2,0,1,1,0,0,1
10832724,8,3,5,0,4,1,3,0,0
10832845,3,3,0,0,1,1,0,0,0
10833174,2,1,1,0,1,1,0,0,0
10833367,3,3,0,0,2,2,0,0,0
10833385,3,3,0,0,3,0,3,0,0
10833573,1,1,0,0,1,1,0,0,0
10834061,2,1,1,0,2,1,1,0,0
10834118,3,2,1,0,1,1,0,0,0
10834144,2,2,0,0,1,1,0,0,0
10834733,6,5,1,0,1,1,0,0,0
10834745,1,0,1,0,1,1,0,0,0
10834844,3,3,0,0,2,1,1,2,0
10834887,1,0,1,0,1,1,0,0,0
10835284,2,2,0,0,1,1,0,0,0
10835302,1,0,1,0,1,1,0,0,0
10835506,2,2,0,0,2,2,0,0,0
10836161,2,2,0,0,2,2,0,0,0
10836686,2,2,0,0,2,2,0,0,0
10836987,1,1,0,0,1,1,0,0,0
10837163,2,2,0,0,2,2,0,0,0
10837224,4,2,2,0,4,2,2,2,0
10837603,3,1,2,0,3,2,1,0,1
10837642,1,0,1,0,1,1,0,0,0
10837716,2,2,0,0,1,1,0,0,0
10838557,1,1,0,0,1,1,0,0,0
10838797,1,0,1,0,1,1,0,0,0
10838893,1,0,1,0,1,1,0,0,0
10839281,2,2,0,0,1,1,0,0,0
10839308,5,3,2,0,1,0,1,0,1
10839397,2,1,1,0,1,1,0,0,0
10839561,3,3,0,0,0,0,0,0,0
10839709,1,1,0,0,1,1,0,0,0
10839781,3,3,0,0,3,3,0,1,0
10839792,5,3,2,0,3,2,1,1,1
10839801,2,2,0,0,2,2,0,0,0
10839931,3,3,0,0,1,1,0,1,0
10839943,2,2,0,0,2,2,0,0,0
10839976,3,3,0,0,1,1,0,1,0
10840098,2,0,2,0,1,1,0,0,0
10840230,1,1,0,0,0,0,0,0,0
10840356,12,4,8,0,2,1,1,2,1
10840617,1,1,0,0,0,0,0,0,0
10840690,12,4,8,0,2,1,1,2,1
10840958,1,0,1,0,1,1,0,0,0
10841154,6,5,1,2,3,1,2,1,0
10841350,1,1,0,0,1,1,0,0,0
10841517,2,1,1,0,2,1,1,0,0
10841722,1,1,0,0,1,1,0,0,0
10842115,2,1,1,0,2,1,1,0,0
10842116,7,1,6,0,1,1,0,0,0
10842166,3,3,0,0,1,1,0,1,0
10842264,2,2,0,0,2,2,0,0,1
10842321,1,1,0,0,1,1,0,0,0
10842387,1,1,0,0,1,1,0,0,0
10842656,4,2,2,0,0,0,0,0,1
10842777,4,4,0,0,2,2,0,1,1
10842813,2,2,0,0,0,0,0,0,1
09030063,3,2,1,0,0,0,0,0,1
09030133,11,3,8,0,2,2,0,2,1
09030597,8,0,8,0,0,0,0,0,1
09030943,1,1,0,0,1,1,0,0,0
09031838,2,2,0,0,2,2,0,0,0
09032018,2,2,0,0,1,1,0,0,0
09032235,4,0,4,0,1,1,0,0,1
09032987,1,1,0,0,1,1,0,0,0
09033083,5,0,5,0,0,0,0,0,1
09033182,1,1,0,0,1,1,0,0,0
09033317,2,0,2,0,0,0,0,0,1
09033367,3,2,1,0,4,1,3,3,1
09033569,1,1,0,0,1,1,0,0,0
09033635,2,2,0,0,2,2,0,0,1
09033925,2,2,0,0,2,2,0,0,0
09034299,9,1,8,0,1,1,0,0,0
09034615,2,0,2,0,2,2,0,0,1
09035396,1,1,0,0,1,1,0,0,0
09035654,3,3,0,0,2,2,0,0,0
09035693,5,1,4,0,1,1,0,0,1
09035886,5,3,2,0,2,2,0,1,1
09036204,6,2,4,0,1,1,0,1,1
09036393,2,0,2,0,0,0,0,0,0
09036856,5,3,2,0,1,1,0,0,1
09037039,9,5,4,0,2,1,1,2,1
09037156,4,2,2,0,1,1,0,1,1
09037187,5,4,1,0,1,1,0,0,0
09037208,4,1,3,0,1,1,0,0,0
09037291,4,0,4,0,1,1,0,1,1
09038024,3,1,2,0,0,0,0,0,1
09038082,15,6,9,0,2,1,1,1,1
09038191,3,2,1,0,3,2,1,0,1
09038211,2,0,2,0,0,0,0,0,1
09038216,2,0,2,0,0,0,0,0,1
09038217,2,0,2,0,0,0,0,0,1
09038218,2,0,2,0,0,0,0,0,1
09038219,2,0,2,0,0,0,0,0,1
09038285,2,0,2,0,0,0,0,0,1
09038364,2,2,0,0,1,1,0,0,0
09038912,6,5,1,0,1,1,0,1,0
09039188,2,0,2,0,2,2,0,0,0
09039532,4,0,4,0,0,0,0,0,0
09039592,2,1,1,0,1,1,0,0,0
09039827,8,8,0,2,2,1,1,2,0
09040017,4,2,2,0,2,2,0,0,1
09040043,2,2,0,0,1,1,0,0,0
09040137,3,0,3,0,0,0,0,0,1
09040176,12,5,7,0,0,0,0,0,1
09040461,2,0,2,0,1,1,0,0,0
09040500,3,1,2,0,1,1,0,0,1
09042108,2,2,0,0,2,2,0,0,0
09042300,3,2,1,0,2,1,1,1,0
09042698,2,2,0,0,2,2,0,0,0
09042859,3,2,1,0,1,1,0,0,0
09042903,6,4,2,0,3,2,1,0,0
09043277,2,2,0,0,3,3,0,1,1
09043334,3,3,0,0,1,1,0,1,0
09043596,2,0,2,0,0,0,0,0,0
09044253,1,1,0,0,1,1,0,0,0
09044287,4,3,1,0,0,0,0,0,1
09044389,2,2,0,0,2,2,0,0,0
09044416,6,5,1,0,2,2,0,0,1
09044431,6,5,1,0,2,2,0,0,1
09044503,6,5,1,0,2,2,0,0,1
09044542,6,5,1,0,2,2,0,0,1
09044548,6,5,1,0,2,2,0,0,1
09044556,8,5,3,0,2,2,0,0,1
09044570,6,5,1,0,2,2,0,0,1
09044609,6,5,1,0,2,2,0,0,1
09044611,6,5,1,0,2,2,0,0,1
09044618,6,5,1,0,2,2,0,0,1
09044645,6,0,6,0,0,0,0,0,1
09044654,5,1,4,0,1,1,0,0,1
09044774,15,9,6,0,0,0,0,0,1
09044843,3,0,3,0,0,0,0,0,1
09044983,8,3,5,0,0,0,0,0,0
09044995,2,2,0,0,2,2,0,1,0
09045021,2,0,2,0,1,1,0,0,0
09045182,2,0,2,0,2,2,0,0,1
09045319,1,0,1,0,0,0,0,0,1
09045587,16,16,0,0,0,0,0,0,1
09045712,2,2,0,0,2,2,0,0,1
09046288,1,1,0,0,2,1,1,0,0
09046471,2,1,1,0,1,0,1,0,1
09046599,8,4,4,0,2,2,0,2,1
09046721,8,0,8,0,2,1,1,0,1
09046908,2,0,2,0,1,1,0,0,0
09047007,4,4,0,0,3,3,0,0,1
09047281,10,2,8,0,1,1,0,1,0
09047988,2,2,0,0,1,1,0,0,1
09048017,3,3,0,0,3,3,0,0,1
09048039,1,1,0,0,1,1,0,0,0
09048455,1,0,1,0,0,0,0,0,0
09049226,3,2,1,0,1,1,0,0,0
09049251,2,2,0,0,1,1,0,0,0
09049732,2,2,0,0,1,1,0,1,0
09049843,1,1,0,0,1,1,0,0,0
09049966,2,0,2,0,2,2,0,0,0
09050036,20,8,12,0,0,0,0,0,1
09050150,1,1,0,0,1,1,0,0,1
09050186,1,1,0,0,1,1,0,0,1
09050428,3,3,0,0,1,1,0,0,0
09050507,1,1,0,0,1,1,0,0,0
09050761,2,2,0,0,2,2,0,0,0
09051026,2,2,0,0,2,2,0,0,0
09051067,5,3,2,0,1,1,0,0,1
09051215,1,0,1,0,0,0,0,0,0
09051358,2,2,0,0,1,1,0,0,0
09051475,4,0,4,0,0,0,0,0,1
09051545,4,3,1,0,1,1,0,0,0
09051615,2,2,0,0,3,3,0,0,0
09051693,1,1,0,0,1,1,0,0,1
09051783,1,1,0,0,1,1,0,0,1
09052116,2,0,2,0,0,0,0,0,0
09052181,4,2,2,0,2,1,1,1,1
09052234,4,2,2,0,1,1,0,0,1
09052305,3,2,1,0,3,2,1,0,0
09052429,1,0,1,0,0,0,0,0,0
09052571,3,2,1,0,0,0,0,0,0
09052720,1,0,1,0,1,1,0,0,0
09052865,2,0,2,0,0,0,0,0,1
09052933,2,1,1,0,1,1,0,0,0
09053025,1,1,0,0,1,1,0,0,0
09053469,10,6,4,0,3,3,0,0,0
09053488,9,4,5,0,2,1,1,1,1
09053748,5,0,5,0,2,1,1,0,0
09054038,1,1,0,0,1,1,0,0,0
09054086,2,2,0,0,1,1,0,0,0
09054223,2,2,0,0,1,1,0,0,0
09054335,1,0,1,0,0,0,0,0,0
09054519,3,0,3,0,0,0,0,0,0
09055440,6,1,5,0,3,1,2,0,0
09055766,1,1,0,0,1,1,0,0,0
09056114,2,2,0,0,1,1,0,0,0
09056201,1,1,0,0,1,1,0,0,0
09056208,2,0,2,0,0,0,0,0,0
09056217,1,1,0,0,1,1,0,0,1
09056288,1,1,0,0,1,1,0,0,0
09056402,2,2,0,0,2,2,0,0,0
09056764,1,1,0,0,1,1,0,0,0
09056915,1,0,1,0,0,0,0,0,0
09057429,1,1,0,0,1,1,0,0,0
09057600,1,1,0,0,1,1,0,0,0
09057935,7,0,7,0,0,0,0,0,1
09058072,1,0,1,0,0,0,0,0,0
09058403,5,4,1,0,3,3,0,0,0
09058625,19,7,12,0,0,0,0,0,1
09058786,1,1,0,0,1,1,0,0,0
09058868,7,3,4,0,1,1,0,1,1
09058943,1,1,0,0,1,1,0,0,0
09060274,3,0,3,0,0,0,0,0,1
09060396,3,2,1,0,1,1,0,1,1
09060445,5,5,0,0,2,2,0,2,1
09061036,4,4,0,0,0,0,0,0,1
09061147,1,1,0,0,1,1,0,0,0
09061230,2,2,0,0,2,2,0,0,0
09061325,2,2,0,0,1,1,0,0,0
09061410,2,2,0,0,2,2,0,0,0
09061583,2,0,2,0,0,0,0,0,1
09062267,1,1,0,0,1,1,0,0,0
09062447,7,4,3,0,1,1,0,1,0
09062553,7,3,4,0,1,1,0,1,1
09062749,5,0,5,0,0,0,0,0,1
09062801,10,0,10,0,2,1,1,0,0
09062808,1,1,0,0,2,1,1,0,0
09062889,2,2,0,0,1,1,0,0,0
09063015,20,13,7,0,11,9,2,0,1
09063482,3,0,3,0,0,0,0,0,1
09063520,4,0,4,0,1,1,0,1,0
09063593,1,1,0,0,2,2,0,0,0
09063613,4,0,4,0,0,0,0,0,1
09063616,1,1,0,0,1,1,0,0,0
09063669,4,0,4,0,2,2,0,0,1
09063792,5,0,5,0,0,0,0,0,1
09063867,1,0,1,0,0,0,0,0,0
09064021,2,1,1,0,1,1,0,0,0
09064099,3,0,3,0,1,1,0,0,0
09064473,13,0,13,1,0,0,0,0,1
09064598,10,5,5,0,3,3,0,0,1
09064610,4,0,4,0,2,2,0,0,1
09064621,4,3,1,0,3,3,0,0,1
09064659,5,3,2,0,1,1,0,0,1
09064671,2,2,0,0,2,2,0,0,0
09065002,3,0,3,0,0,0,0,0,1
09065183,3,0,3,0,0,0,0,0,1
09065220,9,3,6,0,0,0,0,0,0
09065234,6,1,5,0,2,1,1,0,0
09065280,3,0,3,0,0,0,0,0,1
09065309,3,0,3,0,0,0,0,0,1
09065310,3,0,3,0,0,0,0,0,1
09065340,3,0,3,0,0,0,0,0,1
09065346,7,5,2,0,1,1,0,0,1
09065375,3,0,3,0,0,0,0,0,1
09065448,3,0,3,0,0,0,0,0,1
09065561,9,8,1,0,0,0,0,0,1
09066775,1,1,0,0,1,1,0,0,1
09066937,2,0,2,0,0,0,0,0,1
09066967,2,0,2,0,0,0,0,0,1
09067032,2,0,2,0,0,0,0,0,1
09067690,6,1,5,0,3,1,2,0,0
09067733,6,3,3,0,2,2,0,1,1
09067925,11,7,4,0,1,1,0,0,1
09067946,8,0,8,0,0,0,0,0,1
09068058,4,3,1,0,1,1,0,0,0
09068330,1,0,1,0,0,0,0,0,0
09068707,1,0,1,0,0,0,0,0,1
09069089,4,0,4,0,0,0,0,0,1
09069122,13,7,6,0,0,0,0,0,0
09069151,4,0,4,0,2,2,0,0,1
09069182,12,5,7,0,2,1,1,2,1
09069327,4,0,4,0,0,0,0,0,1
09069531,9,8,1,0,0,0,0,0,1
09069626,10,1,9,0,5,1,4,0,0
09069844,2,0,2,0,0,0,0,0,0
09069877,8,0,8,0,5,1,4,0,0
09070554,2,0,2,0,0,0,0,0,0
09070789,1,0,1,0,1,1,0,0,0
09070987,2,2,0,0,2,2,0,0,0
09071077,1,1,0,0,1,1,0,0,0
09071291,3,3,0,0,1,1,0,0,0
09071340,3,0,3,0,0,0,0,0,1
09071491,2,1,1,0,2,2,0,0,0
09071662,3,1,2,0,1,1,0,0,1
09071932,4,3,1,0,1,1,0,1,1
09072206,4,2,2,0,1,1,0,0,0
09072310,1,0,1,0,1,1,0,1,1
09073121,8,5,3,0,2,2,0,0,1
09073411,2,2,0,0,2,2,0,0,0
09073571,2,2,0,0,2,2,0,0,0
09074161,2,2,0,0,2,2,0,0,0
09074960,17,12,5,0,1,1,0,1,1
09075089,4,0,4,0,0,0,0,0,0
09075167,8,4,4,0,2,1,1,2,1
09075201,21,10,11,0,1,1,0,1,1
09075225,9,4,5,0,0,0,0,0,1
09075229,5,5,0,0,1,1,0,0,1
09075232,3,1,2,0,1,1,0,0,0
09075361,2,0,2,0,0,0,0,0,1
09075560,12,5,7,0,2,2,0,0,1
09075593,9,7,2,0,1,1,0,1,1
09075658,11,7,4,0,0,0,0,0,0
09075865,1,0,1,0,0,0,0,0,1
09075950,4,0,4,0,0,0,0,0,1
09076466,2,0,2,0,0,0,0,0,0
09077120,8,6,2,1,1,1,0,1,0
09077373,2,1,1,0,1,1,0,0,1
09077495,11,5,6,0,2,2,0,2,1
09077880,1,0,1,0,0,0,0,0,1
09077893,11,4,7,0,1,1,0,1,0
09078032,3,3,0,0,1,1,0,0,1
09078071,4,1,3,0,1,1,0,0,0
09078653,1,1,0,0,1,1,0,0,0
09079122,5,4,1,0,0,0,0,0,1
09079834,3,1,2,0,1,1,0,0,0
09079901,3,2,1,0,2,2,0,0,0
09080057,2,0,2,0,1,1,0,0,0
09080154,10,6,4,0,1,1,0,1,1
09080180,10,5,5,0,1,1,0,1,1
09080182,7,3,4,0,0,0,0,0,1
09080184,10,6,4,0,1,1,0,1,1
09080222,7,3,4,0,1,1,0,1,1
09080463,2,2,0,0,2,2,0,0,0
09080530,1,1,0,0,1,1,0,0,1
09080593,3,3,0,0,2,2,0,0,0
09080819,8,2,6,0,0,0,0,0,0
09080879,1,0,1,0,1,1,0,0,0
09081018,2,0,2,0,0,0,0,0,1
09081098,2,0,2,0,0,0,0,0,0
09081101,4,2,2,0,2,2,0,0,0
09081161,3,2,1,0,3,3,0,0,0
09081304,1,0,1,0,0,0,0,0,1
09082055,8,5,3,0,4,4,0,0,1
09082232,3,2,1,0,3,1,2,3,0
09082310,8,4,4,0,1,1,0,1,1
09082338,10,6,4,0,1,1,0,1,1
09082983,1,0,1,0,1,1,0,0,0
09083046,5,0,5,0,0,0,0,0,1
09083624,1,0,1,0,1,1,0,0,0
09083820,4,2,2,0,2,2,0,0,0
09083870,8,2,6,0,1,1,0,1,1
09083904,5,5,0,0,0,0,0,0,0
09084066,18,10,8,0,0,0,0,0,1
09084684,1,1,0,0,1,1,0,0,0
09084699,8,3,5,0,0,0,0,0,1
09085696,3,2,1,0,1,1,0,0,1
09085732,13,9,4,0,0,0,0,0,0
09086461,3,2,1,0,2,1,1,0,1
09086506,3,3,0,0,4,3,1,1,1
09086509,3,0,3,0,0,0,0,0,1
09086535,4,2,2,0,5,1,4,2,1
09086536,3,3,0,0,2,2,0,0,0
09086547,3,3,0,0,4,3,1,1,1
09086555,8,0,8,0,6,1,5,3,1
09086757,23,15,8,0,0,0,0,0,0
09086796,1,1,0,0,1,1,0,0,0
09086882,3,2,1,0,2,2,0,0,0
09086908,3,3,0,0,2,2,0,0,0
09086979,8,5,3,0,1,1,0,1,1
09087514,4,3,1,0,1,1,0,0,1
09087900,1,1,0,0,1,1,0,0,0
09088446,7,3,4,0,1,1,0,1,0
09089089,6,4,2,0,1,1,0,1,1
09089216,4,1,3,0,1,1,0,0,1
09089235,4,1,3,0,1,1,0,0,1
09089663,1,1,0,0,0,0,0,0,0
09089701,3,0,3,0,0,0,0,0,0
09089915,5,3,2,0,0,0,0,0,1
09089946,5,3,2,0,0,0,0,0,1
06473013,4,0,4,0,0,0,0,0,1
06473216,7,1,6,0,2,1,1,0,1
06473312,9,2,7,0,0,0,0,0,1
06473519,8,3,5,0,1,1,0,1,1
06473522,13,3,10,0,2,2,0,2,1
06473524,8,0,8,0,1,1,0,1,1
06473574,4,2,2,0,2,2,0,0,1
06473724,3,3,0,0,2,2,0,0,0
06473920,11,4,7,0,1,1,0,0,1
06473995,7,0,7,0,2,1,1,0,1
06474301,4,2,2,0,1,1,0,0,1
06474320,5,2,3,0,1,1,0,0,1
06474597,24,6,18,0,0,0,0,0,1
06474740,15,0,15,0,0,0,0,0,1
06474876,4,0,4,0,1,1,0,0,1
06474914,10,3,7,0,1,1,0,1,1
06475099,5,3,2,0,3,3,0,0,1
06475283,19,4,15,0,2,2,0,2,1
06475334,2,2,0,0,1,1,0,0,0
06475372,6,0,6,0,0,0,0,0,1
06475373,10,0,10,0,0,0,0,0,1
06475379,15,5,10,0,2,1,1,2,1
06476320,11,3,8,0,1,1,0,1,1
06476328,6,0,6,0,0,0,0,0,1
06476402,16,0,16,0,0,0,0,0,1
06476488,4,3,1,0,1,1,0,0,0
06476597,6,0,6,0,0,0,0,0,1
06476820,5,2,3,0,1,1,0,0,1
06476843,4,2,2,0,1,1,0,0,1
06476890,5,2,3,0,1,1,0,0,1
06476929,5,3,2,0,1,1,0,0,1
06477262,24,12,12,0,0,0,0,0,1
06477509,7,2,5,0,1,1,0,0,1
06477520,5,3,2,0,1,1,0,0,0
06477521,15,5,10,0,0,0,0,0,1
06477545,12,0,12,0,0,0,0,0,1
06477561,15,0,15,0,0,0,0,0,1
06477617,9,3,6,0,0,0,0,0,0
06477767,9,4,5,0,1,1,0,1,1
06478170,26,10,16,0,0,0,0,0,0
06478545,11,6,5,0,1,1,0,1,1
06478603,5,3,2,0,2,2,0,0,1
06478896,13,3,10,0,1,1,0,1,1
06479084,4,2,2,0,2,2,0,0,1
06479314,10,5,5,0,2,1,1,2,1
06479462,4,0,4,0,0,0,0,0,1
06479506,14,3,11,0,1,1,0,1,1
06479557,5,2,3,0,2,2,0,0,1
06479712,5,3,2,0,2,2,0,0,1
06479959,2,2,0,0,1,1,0,0,1
06480044,18,15,3,0,1,0,1,1,1
06480254,6,2,4,0,1,1,0,1,1
06480375,25,5,20,0,1,1,0,1,1
06480383,5,2,3,0,1,1,0,0,1
06480726,35,9,26,0,0,0,0,0,1
06480936,13,5,8,0,1,1,0,0,1
06481044,11,2,9,0,3,1,2,1,1
06481209,2,2,0,0,2,2,0,0,1
06481401,13,5,8,0,3,2,1,2,1
06481490,6,2,4,0,0,0,0,0,1
06481575,8,3,5,0,1,1,0,0,1
06482013,9,2,7,0,2,2,0,0,1
06482027,6,3,3,0,1,1,0,0,0
06482035,4,1,3,0,1,1,0,0,1
06482037,4,2,2,0,1,1,0,0,1
06482735,4,3,1,0,2,2,0,0,0
06482951,5,3,2,0,2,2,0,0,1
06483117,17,3,14,0,0,0,0,0,1
06483429,6,3,3,0,2,2,0,0,0
06483462,7,0,7,0,0,0,0,0,1
06483768,8,3,5,0,0,0,0,0,1
06483835,12,6,6,0,0,0,0,0,1
06483893,5,0,5,0,0,0,0,0,0
06484099,9,5,4,0,0,0,0,0,1
06484114,2,0,2,0,1,1,0,0,1
06484132,20,4,16,0,2,2,0,2,1
06484256,2,0,2,0,0,0,0,0,1
06484279,43,10,33,0,0,0,0,0,1
06484329,3,3,0,0,1,1,0,0,0
06484468,2,2,0,0,2,2,0,0,0
06484545,5,2,3,0,1,1,0,0,0
06484809,5,3,2,0,2,2,0,0,0
06484936,5,2,3,0,1,1,0,1,1
06484965,36,0,36,0,0,0,0,0,0
06484983,26,9,17,0,0,0,0,0,0
06485008,4,3,1,0,1,1,0,0,1
06485658,6,1,5,0,4,1,3,1,0
06486224,5,2,3,0,1,1,0,0,1
06486255,57,17,40,0,0,0,0,0,1
06486606,7,5,2,0,0,0,0,0,1
06486618,7,5,2,0,2,2,0,0,1
06486660,15,2,13,0,1,1,0,1,1
06486792,2,2,0,0,1,1,0,0,0
06486872,3,3,0,0,1,1,0,0,0
06487376,7,0,7,0,0,0,0,0,1
06487402,6,4,2,0,3,3,0,0,1
06487629,5,2,3,0,1,1,0,0,0
06487663,16,3,13,0,1,1,0,1,1
06487777,16,5,11,0,1,1,0,1,1
06487855,8,2,6,0,1,1,0,0,1
06488655,11,4,7,1,0,0,0,0,1
06488805,21,4,17,0,2,2,0,2,1
06488944,4,2,2,0,1,1,0,0,1
06488965,6,1,5,0,1,1,0,1,1
06488992,11,0,11,0,0,0,0,0,1
06489299,3,1,2,0,1,1,0,0,0
06489429,26,5,21,0,1,1,0,1,1
06489498,4,2,2,0,1,1,0,0,1
06489551,2,2,0,0,1,1,0,0,1
06489599,4,0,4,0,0,0,0,0,1
06489617,4,2,2,0,1,1,0,0,0
06489703,7,0,7,0,0,0,0,0,1
06489928,13,8,5,0,1,1,0,0,0
06490185,4,2,2,0,1,1,0,0,1
06490313,23,0,23,0,1,1,0,1,1
06490323,30,5,25,0,0,0,0,0,1
06490331,23,0,23,0,1,1,0,1,1
06490501,4,0,4,0,0,0,0,0,1
06490908,4,0,4,0,0,0,0,0,1
06491322,9,5,4,0,1,1,0,1,1
06491384,11,7,4,0,1,1,0,1,1
06492016,3,3,0,0,1,1,0,0,0
06492022,4,1,3,0,1,1,0,0,0
06492606,25,10,15,0,0,0,0,0,1
06492665,5,3,2,0,1,1,0,0,1
06492672,3,0,3,0,0,0,0,0,1
06492758,5,3,2,0,0,0,0,0,0
06492895,3,0,3,0,0,0,0,0,1
06492937,14,6,8,0,0,0,0,0,1
06493667,4,0,4,0,0,0,0,0,1
06493711,24,7,17,0,0,0,0,0,1
06493784,15,0,15,0,0,0,0,0,1
06493959,5,0,5,0,0,0,0,0,1
06494177,5,2,3,0,2,1,1,1,0
06494543,12,4,8,0,1,1,0,1,1
06494599,7,0,7,0,0,0,0,0,1
06495027,6,2,4,0,1,1,0,0,1
06495115,33,11,22,0,1,1,0,0,0
06495129,6,2,4,0,3,2,1,1,1
06495411,2,1,1,0,1,1,0,0,0
06495568,9,0,9,0,0,0,0,0,1
06495626,3,3,0,0,2,2,0,0,0
06496203,4,2,2,0,2,2,0,0,0
06496329,3,3,0,0,2,2,0,0,0
06496739,15,0,15,0,0,0,0,0,1
06497030,6,5,1,0,1,1,0,0,0
06497366,2,0,2,0,0,0,0,0,0
06497412,6,3,3,0,2,1,1,0,0
06497660,17,5,12,0,1,1,0,0,1
06498073,12,4,8,0,1,1,0,1,1
06498124,2,2,0,0,1,1,0,0,0
06498164,14,4,10,0,2,2,0,2,1
06498413,3,2,1,0,2,2,0,0,0
06498846,14,1,13,0,1,1,0,1,1
06498906,5,3,2,0,1,1,0,0,1
06498940,6,0,6,0,0,0,0,0,1
06499168,5,0,5,0,0,0,0,0,1
06499726,4,0,4,0,1,1,0,0,1
06500123,6,1,5,0,2,1,1,0,0
06500347,19,0,19,0,0,0,0,0,1
06500428,7,2,5,0,3,2,1,0,0
06500486,52,17,35,0,0,0,0,0,1
06500853,5,3,2,0,1,1,0,0,1
06500892,6,4,2,0,1,1,0,1,1
06500894,11,3,8,0,1,1,0,1,1
06501622,5,2,3,0,1,1,0,0,0
06501672,11,2,9,0,1,1,0,1,1
06501809,4,1,3,0,1,1,0,0,1
06501816,4,0,4,0,0,0,0,0,1
06501958,18,3,15,0,1,1,0,1,1
06502442,10,0,10,0,3,1,2,1,1
06502496,13,3,10,0,2,2,0,2,1
06502878,19,6,13,0,0,0,0,0,0
06503031,19,9,10,0,0,0,0,0,1
06503335,10,4,6,0,1,1,0,1,1
06503435,14,5,9,0,1,1,0,0,1
06503580,4,0,4,0,0,0,0,0,1
06503967,18,4,14,0,0,0,0,0,1
06504203,3,0,3,0,0,0,0,0,0
06504362,9,0,9,0,0,0,0,0,1
06504497,17,3,14,0,0,0,0,0,1
06504755,5,3,2,0,2,2,0,0,1
06504809,4,0,4,0,0,0,0,0,1
06504920,19,2,17,0,4,4,0,0,1
06504934,5,2,3,0,2,2,0,1,1
06504999,5,1,4,0,1,1,0,0,0
06505391,5,0,5,0,0,0,0,0,1
06505567,8,0,8,0,0,0,0,0,1
06505615,2,0,2,0,0,0,0,0,0
06505633,3,3,0,0,1,1,0,0,0
06505656,6,0,6,0,0,0,0,0,1
06505871,12,3,9,1,3,1,2,1,1
06505960,5,2,3,0,1,1,0,0,0
06506015,8,3,5,0,1,1,0,1,1
06506028,6,3,3,0,1,1,0,0,0
06506410,8,6,2,0,0,0,0,0,0
06506445,2,2,0,0,1,1,0,0,0
06507182,4,3,1,0,1,1,0,0,0
06507313,17,3,14,0,1,1,0,1,1
06507693,6,0,6,0,0,0,0,0,1
06507696,7,5,2,0,1,1,0,0,1
06507766,12,5,7,0,1,1,0,1,1
06507837,22,7,15,0,1,0,1,0,0
06508034,16,8,8,0,0,0,0,0,0
06508320,7,0,7,0,2,2,0,0,0
06508639,14,3,11,0,0,0,0,0,0
06509341,5,0,5,0,0,0,0,0,1
06510421,6,2,4,0,1,1,0,1,1
06510429,4,4,0,0,1,1,0,0,1
06510558,7,0,7,0,0,0,0,0,0
06510589,3,3,0,0,2,2,0,0,0
06510709,22,7,15,0,0,0,0,0,1
06511046,36,13,23,0,0,0,0,0,1
06511365,19,0,19,0,1,1,0,1,1
06511545,2,2,0,0,1,1,0,0,1
06511551,7,2,5,0,2,2,0,0,1
06511639,4,1,3,0,1,1,0,0,0
06512404,13,0,13,0,0,0,0,0,1
06512836,6,5,1,0,3,1,2,1,1
06512910,11,6,5,0,2,1,1,1,1
06514313,14,1,13,0,1,1,0,1,1
06514391,13,4,9,0,1,1,0,1,1
06514428,2,1,1,0,1,1,0,0,0
06514525,6,0,6,0,1,1,0,0,1
06514568,5,3,2,0,1,1,0,0,0
06514776,11,4,7,0,1,1,0,0,1
06514819,9,1,8,0,1,1,0,0,1
06514913,10,3,7,0,5,3,2,0,1
06515107,2,1,1,0,1,1,0,0,0
06515116,9,2,7,1,0,0,0,0,1
06515387,2,2,0,0,1,1,0,0,0
06515735,18,4,14,0,1,1,0,1,1
06515741,5,3,2,0,2,2,0,0,0
06515760,2,2,0,0,2,2,0,0,0
06515809,5,3,2,0,2,2,0,0,0
06515999,8,0,8,0,1,1,0,1,0
01869239,29,0,29,0,1,1,0,1,1
01869365,6,0,6,0,2,2,0,0,1
01869518,22,4,18,0,0,0,0,0,0
01869543,37,5,32,0,0,0,0,0,1
01869637,25,0,25,0,0,0,0,0,1
01869671,2,2,0,0,1,1,0,0,1
01869807,12,0,12,0,0,0,0,0,0
01870209,5,2,3,0,0,0,0,0,0
01870468,8,3,5,0,1,1,0,0,1
01870925,62,16,46,0,0,0,0,0,1
01871029,24,0,24,0,1,1,0,1,1
01871480,6,0,6,0,1,1,0,1,1
01871628,36,3,33,0,3,2,1,3,1
01871630,23,3,20,0,0,0,0,0,1
01871639,0,0,0,0,0,0,0,0,0
01871827,21,0,21,0,0,0,0,0,1
01871953,9,0,9,0,1,1,0,0,0
01872070,62,6,56,0,1,1,0,1,1
01872071,62,4,58,0,1,1,0,1,1
01872153,11,4,7,0,1,1,0,0,1
01872218,415,9,406,0,0,0,0,0,1
01872574,86,9,77,0,0,0,0,0,1
01872665,7,4,3,0,2,1,1,1,1
01872938,22,0,22,0,0,0,0,0,1
01873148,152,2,150,1,0,0,0,0,1
01873214,19,1,18,0,2,1,1,0,1
01873263,10,3,7,0,0,0,0,0,1
01873409,26,0,26,0,0,0,0,0,1
01873570,10,5,5,0,2,2,0,0,0
01873931,13,4,9,1,0,0,0,0,1
01874486,0,0,0,0,0,0,0,0,1
01874667,155,14,141,0,0,0,0,0,1
01874680,10,3,7,0,3,1,2,0,0
01874810,6,2,4,0,0,0,0,0,0
01874868,58,13,45,0,0,0,0,0,1
01874886,86,10,76,0,0,0,0,0,1
01875000,26,0,26,0,0,0,0,0,1
01875292,20,1,19,0,1,1,0,0,1
01875468,10,0,10,0,0,0,0,0,1
01876180,34,3,31,0,2,2,0,0,0
01876856,4,2,2,0,2,2,0,0,1
01876968,59,8,51,0,0,0,0,0,1
01877366,8,3,5,0,2,1,1,1,0
01877695,23,4,19,0,2,1,1,2,1
01878022,14,4,10,0,1,1,0,1,1
01878365,4,2,2,0,1,1,0,0,1
01878501,6,0,6,0,1,1,0,0,1
01878675,6,3,3,0,0,0,0,0,1
01878754,25,3,22,0,2,2,0,0,0
01878772,8,2,6,0,1,1,0,0,0
01878835,58,4,54,0,1,1,0,1,1
01878842,37,14,23,0,1,1,0,1,1
01878843,48,0,48,0,1,1,0,1,1
01878902,48,2,46,0,2,1,1,2,1
01878927,9,6,3,0,1,1,0,0,1
01879212,16,1,15,0,1,1,0,1,1
01879752,15,4,11,0,0,0,0,0,1
01880187,15,3,12,0,1,1,0,1,1
01880505,29,3,26,0,1,1,0,1,1
01880682,32,5,27,0,0,0,0,0,1
01880734,27,9,18,0,0,0,0,0,1
01880741,23,2,21,0,3,3,0,1,1
01880755,40,9,31,0,0,0,0,0,1
01880800,60,7,53,0,0,0,0,0,1
01881038,1,0,1,0,0,0,0,0,1
01881236,0,0,0,0,0,0,0,0,0
01881578,6,1,5,0,1,1,0,1,1
01881630,40,4,36,0,3,3,0,3,1
01881634,44,4,40,0,1,1,0,1,1
01881683,23,2,21,0,1,1,0,1,1
01882196,15,4,11,0,1,1,0,1,1
01882207,6,1,5,0,1,1,0,0,1
01882286,15,5,10,0,0,0,0,0,1
01882407,88,10,78,0,0,0,0,0,0
01882537,5,3,2,0,1,1,0,0,1
01882767,33,5,28,0,1,1,0,0,1
01883182,29,2,27,0,1,1,0,1,1
01883383,49,3,46,0,1,1,0,1,1
01883550,15,7,8,0,1,1,0,1,1
01883900,26,2,24,0,1,1,0,1,1
01884123,17,5,12,0,0,0,0,0,0
01884198,6,0,6,0,4,3,1,0,1
01884217,12,0,12,0,0,0,0,0,1
01884230,39,5,34,0,1,0,1,1,1
01884629,3,0,3,0,1,1,0,0,1
01884654,9,0,9,0,0,0,0,0,1
01885001,18,0,18,0,0,0,0,0,1
01885586,64,8,56,0,1,1,0,1,1
01885666,14,3,11,0,1,1,0,1,1
01885688,32,0,32,0,0,0,0,0,1
01886104,12,5,7,0,5,5,0,1,1
01886368,29,0,29,0,1,1,0,1,1
01886448,24,2,22,0,1,1,0,1,1
01886586,14,3,11,0,2,1,1,1,1
01886794,8,3,5,0,2,2,0,0,0
01886866,36,13,23,0,0,0,0,0,1
01887129,16,3,13,0,3,1,2,3,1
01887741,16,3,13,0,1,1,0,1,1
01887852,35,9,26,0,1,1,0,1,0
01888040,38,0,38,0,1,1,0,1,1
01889142,4,2,2,0,1,1,0,0,0
01889626,136,16,120,0,0,0,0,0,1
01889922,8,0,8,0,0,0,0,0,0
01889929,25,5,20,0,1,1,0,0,0
01890117,17,5,12,0,0,0,0,0,1
01890135,22,7,15,0,3,1,2,2,1
01890283,8,3,5,0,1,1,0,0,1
01890646,17,0,17,0,0,0,0,0,0
01890650,20,0,20,0,1,1,0,1,1
01890935,7,3,4,0,1,1,0,0,1
01891274,46,3,43,0,1,1,0,1,1
01891463,91,11,80,0,0,0,0,0,1
01891934,24,9,15,0,0,0,0,0,0
01892278,5,1,4,0,1,1,0,0,1
01892410,3,2,1,0,1,1,0,0,0
01893192,19,5,14,0,1,1,0,1,1
01893781,36,3,33,0,1,1,0,1,1
01893979,35,10,25,0,2,2,0,0,1
01894004,7,4,3,0,3,3,0,0,1
01894256,35,4,31,0,1,1,0,1,1
01894340,50,12,38,0,1,1,0,0,1
01894682,21,3,18,0,1,1,0,1,1
01895361,18,5,13,0,1,1,0,1,1
01895689,38,6,32,0,1,1,0,1,1
01895708,3,3,0,0,1,1,0,0,0
01895770,33,4,29,0,0,0,0,0,1
01896128,35,4,31,0,1,1,0,1,1
01896255,10,5,5,0,1,1,0,0,0
01896592,79,8,71,0,4,3,1,0,1
01896879,4,2,2,0,2,2,0,0,1
01897065,6,3,3,0,2,2,0,0,1
01897176,31,8,23,0,0,0,0,0,0
01897331,3,0,3,0,2,2,0,0,0
01897816,36,7,29,0,0,0,0,0,1
01898192,57,6,51,0,0,0,0,0,1
01898355,45,0,45,0,0,0,0,0,1
01900010,23,2,21,0,1,1,0,1,1
01900170,27,0,27,0,0,0,0,0,1
01900374,26,2,24,0,1,1,0,1,1
01900511,107,17,90,0,0,0,0,0,1
01900518,7,2,5,0,1,1,0,0,0
01900673,4,2,2,0,1,1,0,0,0
01900907,69,6,63,0,2,2,0,2,1
01900914,12,6,6,0,0,0,0,0,1
01900915,39,3,36,0,1,1,0,1,1
01901413,16,0,16,0,1,1,0,1,1
01901414,104,8,96,0,1,1,0,1,1
01901415,16,6,10,0,1,1,0,1,1
01901478,37,3,34,0,1,1,0,1,1
01901744,28,3,25,0,1,1,0,1,1
01901923,29,0,29,0,0,0,0,0,1
01902303,22,5,17,0,0,0,0,0,1
01902466,29,0,29,0,0,0,0,0,1
01902475,18,2,16,0,1,1,0,1,1
01902478,8,5,3,0,2,2,0,0,0
01902503,40,5,35,0,0,0,0,0,1
01902919,25,4,21,0,0,0,0,0,1
01902981,12,3,9,0,2,2,0,0,1
01903106,8,4,4,0,1,1,0,0,0
01903236,8,4,4,0,4,1,3,1,0
01903405,113,17,96,0,0,0,0,0,1
01903635,24,4,20,0,1,1,0,0,0
01903918,275,164,111,0,0,0,0,0,1
01904813,3,3,0,0,2,2,0,0,0
01904873,47,13,34,0,0,0,0,0,1
01905465,17,2,15,0,0,0,0,0,1
01905696,15,3,12,0,0,0,0,0,1
01905752,3,2,1,0,1,1,0,0,1
01905807,21,4,17,0,1,1,0,1,1
01905896,7,6,1,0,2,2,0,0,1
01906197,35,0,35,0,0,0,0,0,1
01906857,10,0,10,0,0,0,0,0,1
01907815,13,0,13,0,0,0,0,0,1
01907841,27,4,23,0,2,2,0,2,1
01908212,21,0,21,0,1,1,0,1,1
01908432,36,8,28,0,1,1,0,0,0
01908967,58,3,55,0,1,1,0,1,1
01908981,5,1,4,0,3,2,1,0,0
01909056,2,2,0,0,0,0,0,0,0
01909111,73,5,68,0,2,2,0,2,1
01909643,7,2,5,0,1,1,0,1,0
01909746,26,0,26,0,0,0,0,0,1
01910004,22,2,20,0,1,1,0,1,1
01910243,26,2,24,0,1,1,0,1,1
01910458,0,0,0,0,0,0,0,0,1
01910477,39,0,39,0,0,0,0,0,0
01910502,8,3,5,0,3,2,1,0,1
01910511,27,3,24,0,1,1,0,1,1
01910539,28,4,24,0,1,1,0,1,1
01910692,13,3,10,0,0,0,0,0,1
01910866,16,3,13,0,1,1,0,1,1
01910938,2,1,1,0,1,1,0,0,0
01911114,3,2,1,0,1,1,0,0,1
01911185,5,2,3,0,1,1,0,0,0
01911651,77,13,64,0,0,0,0,0,1
01911815,13,6,7,0,0,0,0,0,1
01911827,5,2,3,0,1,1,0,0,1
01912075,21,7,14,0,1,1,0,0,0
01912248,8,2,6,0,1,1,0,0,1
01912705,43,3,40,0,0,0,0,0,1
01913344,30,4,26,0,1,1,0,1,1
01913362,37,4,33,0,1,1,0,1,1
01913411,44,3,41,0,1,1,0,1,1
01913555,116,9,107,0,0,0,0,0,1
01913794,78,10,68,0,1,1,0,1,1
01914199,37,4,33,0,1,1,0,1,1
01914411,43,12,31,0,1,1,0,1,1
01914417,48,15,33,0,1,1,0,1,1
01914651,4,1,3,0,2,2,0,0,0
01914838,44,0,44,0,0,0,0,0,1
01914886,10,0,10,0,0,0,0,0,1
01915607,36,0,36,0,0,0,0,0,1
01915688,16,0,16,0,0,0,0,0,1
01915691,23,5,18,0,0,0,0,0,1
01915763,38,3,35,0,2,1,1,2,1
01915767,43,5,38,0,1,1,0,1,1
01915771,42,4,38,0,1,1,0,1,1
01915866,35,6,29,0,2,1,1,0,1
01915995,60,7,53,0,8,8,0,0,0
01916698,91,7,84,0,0,0,0,0,1
01917120,16,4,12,1,2,0,2,2,1
01917148,4,0,4,0,2,2,0,0,0
01917322,17,0,17,0,0,0,0,0,1
01918378,16,4,12,0,1,1,0,1,1
01918522,26,3,23,0,3,1,2,3,1
01918664,22,2,20,0,1,1,0,1,1
01919512,30,0,30,0,1,1,0,1,1
01919620,12,0,12,0,0,0,0,0,1
01919765,22,4,18,0,0,0,0,0,1
01919823,62,14,48,0,0,0,0,0,1
01919920,4,4,0,0,1,1,0,0,1
01920623,93,10,83,0,1,1,0,1,1
01921082,37,3,34,0,1,1,0,1,1
01921087,52,11,41,0,0,0,0,0,1
01921432,13,4,9,0,0,0,0,0,1
01921487,24,4,20,0,1,1,0,1,1
01921508,29,7,22,0,1,1,0,0,1
01921513,80,11,69,0,0,0,0,0,1
01921570,14,0,14,0,0,0,0,0,1
01922589,42,6,36,1,0,0,0,0,1
01922826,67,9,58,0,0,0,0,0,1
01922846,40,0,40,0,0,0,0,0,1
01923125,4,2,2,0,1,1,0,0,1
01923357,30,3,27,0,2,1,1,2,1
01923684,22,3,19,0,0,0,0,0,1
01923689,21,2,19,0,0,0,0,0,0
01923974,20,3,17,0,1,0,1,0,1
01923988,15,2,13,0,0,0,0,0,0
01925502,5,3,2,0,1,1,0,0,0
01925614,17,0,17,0,0,0,0,0,1
01925762,19,5,14,0,0,0,0,0,1
01925802,30,2,28,0,2,2,0,2,1
01925803,10,5,5,0,4,4,0,0,0
01925807,16,4,12,0,1,1,0,0,1
01925878,44,0,44,0,0,0,0,0,1
01926395,67,14,53,1,0,0,0,0,1
01926828,70,15,55,0,0,0,0,0,1
01926842,33,4,29,0,0,0,0,0,1
01926939,85,12,73,0,0,0,0,0,1
01927344,20,0,20,0,0,0,0,0,1
01927370,10,2,8,0,1,1,0,1,1
01927634,21,1,20,0,1,1,0,1,1
01927639,13,4,9,0,1,1,0,1,1
01927640,23,9,14,0,0,0,0,0,1
01927658,37,2,35,0,1,1,0,1,1
01927672,17,3,14,1,1,1,0,1,1
01927761,0,0,0,0,0,0,0,0,1
01927774,3,2,1,0,1,1,0,0,1
01927946,7,2,5,0,1,1,0,0,1
01927968,31,6,25,0,1,1,0,1,1
01928009,10,3,7,0,0,0,0,0,1
01928109,25,3,22,0,0,0,0,0,1
01928168,4,1,3,0,1,1,0,0,0
01928337,7,3,4,0,1,1,0,0,1
01928498,19,0,19,0,0,0,0,0,1
01928529,17,0,17,0,0,0,0,0,1
01928541,89,18,71,0,0,0,0,0,1
01929144,10,0,10,0,0,0,0,0,1
01929173,15,0,15,0,0,0,0,0,1
01929270,13,3,10,0,2,2,0,0,1
01929349,3,3,0,0,1,1,0,0,0
01929464,20,5,15,0,1,1,0,1,1
01929512,49,4,45,0,1,1,0,1,1
01929724,61,4,57,0,1,1,0,1,1
01929778,14,1,13,0,1,1,0,0,0
01929933,4,3,1,0,2,2,0,0,1
01930196,76,10,66,0,0,0,0,0,1
01930446,46,0,46,0,0,0,0,0,1
01930699,62,9,53,0,6,3,3,0,1
01930741,22,10,12,0,0,0,0,0,1
01930792,15,0,15,0,0,0,0,0,1
01931184,43,3,40,0,1,1,0,1,1
01931452,27,4,23,0,0,0,0,0,1
01931522,15,0,15,0,0,0,0,0,1
01931551,35,0,35,0,0,0,0,0,1
01931797,23,4,19,0,1,1,0,1,1
01932254,40,0,40,0,0,0,0,0,1
01932622,6,2,4,0,1,1,0,0,1
01932882,25,10,15,0,0,0,0,0,1
01932947,29,12,17,0,0,0,0,0,1
01933064,26,5,21,0,3,2,1,0,0
01933367,30,3,27,0,4,4,0,0,1
01933411,5,5,0,0,2,2,0,0,1
01933427,17,4,13,0,1,1,0,1,1
01933461,62,3,59,0,1,1,0,1,1
01933625,44,5,39,0,0,0,0,0,1
01933897,59,8,51,0,4,4,0,0,0
01934214,9,2,7,0,3,2,1,0,0
01934366,36,0,36,0,0,0,0,0,1
01934416,7,5,2,0,3,3,0,0,0
01934617,43,3,40,0,1,1,0,1,1
01934644,75,9,66,0,1,1,0,1,1
01934690,31,0,31,0,1,1,0,1,1
01934811,41,3,38,0,1,1,0,1,1
01935025,54,4,50,0,1,1,0,1,1
01935936,44,4,40,0,0,0,0,0,1
01936021,13,0,13,0,0,0,0,0,1
01936687,5,3,2,0,3,3,0,0,1
01937096,107,5,102,0,3,1,2,0,0
11400117,2,2,0,0,2,2,0,0,0
11400422,9,7,2,0,2,1,1,2,1
11400812,1,1,0,0,1,1,0,0,0
11401199,2,2,0,0,2,2,0,0,1
11401317,1,1,0,0,1,1,0,0,0
11401560,1,1,0,0,1,1,0,0,0
11401690,1,1,0,0,1,1,0,0,0
11401691,1,1,0,0,1,1,0,0,0
11402009,1,1,0,0,1,1,0,0,0
11402359,2,2,0,0,1,1,0,0,0
11403068,2,2,0,0,1,1,0,1,1
11403166,1,1,0,0,1,1,0,0,0
11403223,1,1,0,0,1,1,0,0,1
11403677,2,2,0,0,2,2,0,0,0
11404216,1,1,0,0,1,1,0,0,0
11404242,2,2,0,0,1,1,0,0,0
11404578,11,9,2,0,0,0,0,0,0
11404934,2,2,0,0,2,2,0,0,1
11405457,1,1,0,0,0,0,0,0,0
11405600,1,1,0,0,1,1,0,0,0
11405721,1,1,0,0,1,1,0,0,0
11405760,1,1,0,0,1,1,0,0,0
11405934,1,1,0,0,1,1,0,0,0
11406674,1,1,0,0,1,1,0,0,0
11406955,1,1,0,0,1,1,0,0,0
11407208,1,1,0,0,1,1,0,0,0
11407233,2,2,0,0,2,2,0,0,0
11407372,2,2,0,0,1,1,0,0,1
11407454,1,1,0,0,1,1,0,0,0
11407750,5,2,3,0,3,2,1,1,1
11407810,1,1,0,0,1,1,0,0,0
11408588,3,3,0,0,1,1,0,0,1
11409394,5,5,0,0,0,0,0,0,1
11409733,2,2,0,0,1,1,0,0,0
11409818,2,2,0,0,1,1,0,1,1
11409978,1,1,0,0,1,1,0,0,0
11410594,5,3,2,0,0,0,0,0,1
11410648,5,4,1,0,2,2,0,1,1
11410729,1,1,0,0,1,1,0,0,1
11410766,1,1,0,0,1,1,0,0,0
11410911,2,2,0,0,1,1,0,0,0
11410963,1,1,0,0,1,1,0,0,0
11411403,3,3,0,0,1,1,0,0,0
11411505,2,2,0,0,1,1,0,0,0
11411662,2,2,0,0,2,2,0,2,0
11411694,1,1,0,0,1,1,0,0,0
11411759,2,2,0,0,1,1,0,0,0
11412083,2,2,0,0,2,2,0,0,0
11412536,3,3,0,0,2,2,0,2,1
11412737,2,2,0,0,1,1,0,0,0
11412914,2,2,0,0,1,1,0,0,1
11412925,2,2,0,0,2,1,1,1,1
11413207,5,5,0,0,0,0,0,0,1
11413301,3,3,0,0,3,3,0,0,0
11413797,2,2,0,0,1,1,0,0,0
11414052,2,1,1,0,1,1,0,0,0
11414097,7,7,0,0,0,0,0,0,0
11414204,2,2,0,0,2,2,0,0,0
11414353,3,3,0,0,0,0,0,0,0
11414512,1,1,0,0,0,0,0,0,0
11415260,1,1,0,0,1,1,0,0,0
11415382,1,1,0,0,1,1,0,0,0
11416775,1,1,0,0,1,1,0,0,0
11417126,1,0,1,0,1,1,0,0,0
11417689,14,14,0,0,3,2,1,0,0
11417754,1,1,0,0,1,1,0,0,0
11418489,4,4,0,1,1,1,0,1,1
11418552,3,3,0,0,0,0,0,0,0
11418587,1,1,0,0,0,0,0,0,0
11419409,2,2,0,0,1,1,0,0,0
11419655,4,4,0,1,1,1,0,1,1
11419676,2,2,0,0,1,1,0,0,0
11419697,2,2,0,0,2,2,0,0,0
11419930,1,1,0,0,1,1,0,0,0
11420157,1,1,0,0,0,0,0,0,0
11420286,4,4,0,1,1,1,0,1,1
11420375,1,1,0,0,2,2,0,0,1
11420589,2,2,0,0,1,1,0,0,1
11420650,1,1,0,0,1,1,0,0,0
11420928,1,1,0,0,1,1,0,0,1
11421068,4,4,0,0,3,1,2,2,1
11421497,6,3,3,0,1,0,1,0,0
11421855,2,2,0,0,0,0,0,0,0
11422130,1,1,0,0,1,1,0,0,0
11422184,4,4,0,0,1,1,0,1,1
11422259,1,1,0,0,1,1,0,0,0
11422269,2,2,0,0,2,2,0,0,1
11422276,1,1,0,0,1,1,0,0,1
11422496,4,4,0,0,1,1,0,1,1
11422583,1,1,0,0,1,1,0,0,0
11422694,2,2,0,0,1,1,0,0,0
11422963,2,2,0,0,1,1,0,1,0
11423161,1,1,0,0,2,2,0,2,0
11423668,2,2,0,0,2,2,0,0,0
11423736,1,1,0,0,1,1,0,0,0
11424098,3,1,2,0,2,1,1,0,0
11424527,2,2,0,0,2,2,0,0,0
11424822,1,1,0,0,1,1,0,0,0
11425152,4,4,0,0,2,2,0,0,1
11425290,1,1,0,0,1,1,0,0,0
11425572,1,1,0,0,1,1,0,0,0
11425653,2,2,0,0,0,0,0,0,0
11426040,5,2,3,0,3,1,2,2,0
11426304,2,2,0,0,1,1,0,1,0
11426308,1,1,0,0,1,1,0,0,0
11427190,1,1,0,0,1,1,0,0,0
11427496,1,1,0,0,2,1,1,1,0
11427676,2,2,0,0,1,1,0,0,0
11427693,6,6,0,0,0,0,0,0,0
11427971,1,1,0,0,1,1,0,0,0
11428078,1,1,0,0,1,1,0,0,0
11428513,2,2,0,0,1,1,0,0,0
11428719,1,1,0,0,1,1,0,0,0
11429054,3,3,0,0,3,3,0,0,0
11429126,1,1,0,0,1,1,0,0,0
11429389,4,3,1,0,0,0,0,0,0
11429395,4,4,0,1,1,1,0,1,1
11429964,1,1,0,0,1,1,0,0,0
11430021,1,1,0,0,1,1,0,0,0
11430333,2,2,0,0,2,2,0,0,0
11430802,1,1,0,0,1,1,0,0,0
11430864,4,4,0,0,0,0,0,0,0
11431596,2,2,0,0,2,2,0,0,0
11431642,5,3,2,0,2,1,1,2,1
11431889,1,1,0,0,1,1,0,0,1
11431989,2,2,0,0,2,2,0,0,0
11432522,2,2,0,0,1,1,0,0,0
11432604,1,1,0,0,1,1,0,0,0
11432797,1,1,0,0,1,1,0,0,0
11432864,2,2,0,0,2,2,0,0,0
11433413,1,1,0,0,1,1,0,0,0
11433798,7,6,1,0,1,1,0,1,1
11434187,4,4,0,0,1,1,0,1,1
11434349,2,2,0,0,1,1,0,0,1
11434871,4,2,2,0,2,1,1,0,0
11435515,2,2,0,0,2,2,0,0,1
11435560,2,2,0,0,2,2,0,0,0
11435847,5,5,0,0,0,0,0,0,0
11436237,1,1,0,0,1,1,0,0,0
11436275,1,1,0,0,1,1,0,0,0
11436657,2,2,0,0,2,2,0,0,0
11436805,1,1,0,0,1,1,0,1,0
11436899,6,6,0,0,0,0,0,0,0
11436974,2,1,1,0,1,1,0,0,0
11437125,1,1,0,0,1,1,0,0,0
11437206,1,1,0,0,1,1,0,0,0
11437731,1,1,0,0,1,1,0,0,0
11438009,1,1,0,0,1,1,0,0,0
11438098,1,1,0,0,1,1,0,0,0
11438671,1,1,0,0,1,1,0,0,0
11438677,1,1,0,0,1,1,0,0,0
11439047,2,2,0,0,1,1,0,0,0
11439167,5,3,2,0,2,1,1,2,0
11439554,4,4,0,0,2,2,0,2,1
11439564,4,3,1,0,0,0,0,0,1
11439794,7,4,3,0,2,2,0,0,1
11439948,1,1,0,0,1,1,0,0,0
11440237,2,2,0,0,2,2,0,0,0
11440423,1,1,0,0,2,2,0,0,0
11440516,2,2,0,0,2,2,0,0,0
11440728,1,1,0,0,1,1,0,0,0
11440763,2,2,0,0,1,1,0,0,0
11440798,2,2,0,0,0,0,0,0,0
11440966,2,2,0,0,1,1,0,0,0
11441691,1,1,0,0,1,1,0,0,0
11441842,2,2,0,0,2,2,0,0,1
11442010,5,2,3,0,3,2,1,1,1
11442110,1,1,0,0,1,1,0,0,0
11442912,2,2,0,0,2,2,0,0,0
11443294,2,2,0,0,2,2,0,0,0
11443528,2,2,0,0,1,1,0,0,1
11443678,1,1,0,0,1,1,0,0,0
11444009,3,3,0,0,3,3,0,0,0
11444061,2,2,0,0,2,2,0,0,0
11444070,2,2,0,0,2,2,0,0,0
11444169,1,0,1,0,1,1,0,0,0
11444235,2,2,0,0,1,1,0,0,1
11444730,1,1,0,0,1,1,0,0,0
11445381,1,1,0,0,1,1,0,0,0
11445644,2,2,0,0,1,1,0,1,0
11445732,6,6,0,0,1,1,0,1,1
11445737,3,3,0,0,2,2,0,0,1
11445838,6,6,0,0,1,1,0,1,1
11446068,5,4,1,0,1,1,0,1,1
11447115,2,2,0,0,2,2,0,0,0
11447451,1,1,0,0,1,1,0,0,0
11447587,1,1,0,0,1,1,0,0,0
11447787,4,4,0,0,1,1,0,1,1
11447818,1,1,0,0,1,1,0,0,0
11447910,2,2,0,0,1,1,0,1,0
11447948,2,2,0,0,3,3,0,0,1
11447966,1,1,0,0,0,0,0,0,0
11448376,2,2,0,0,1,1,0,0,0
11448892,1,1,0,0,1,1,0,0,0
11449025,3,3,0,0,0,0,0,0,1
11449165,1,1,0,0,0,0,0,0,0
11449209,1,1,0,0,1,1,0,0,0
11449720,1,1,0,0,1,1,0,0,0
11449913,7,5,2,0,2,1,1,2,1
11449990,2,2,0,0,1,1,0,0,0
11450169,2,2,0,0,2,2,0,0,1
11450251,2,2,0,0,1,1,0,1,1
11450290,2,2,0,0,1,1,0,1,1
11450364,2,2,0,0,1,1,0,1,1
11450557,1,1,0,0,1,1,0,0,0
11450756,4,3,1,0,3,2,1,0,0
11451340,4,3,1,0,1,1,0,1,0
11451449,6,4,2,0,2,1,1,1,0
11451885,1,1,0,0,1,1,0,0,0
11452344,1,1,0,0,1,1,0,0,0
11452379,1,0,1,0,1,1,0,0,0
11452397,1,1,0,0,1,1,0,0,0
11452696,2,2,0,0,2,2,0,0,0
11452963,2,2,0,0,1,1,0,0,0
11453178,2,1,1,0,2,1,1,0,0
11453654,1,1,0,0,1,1,0,0,0
11453691,11,10,1,0,0,0,0,0,0
11453908,2,2,0,0,1,1,0,1,0
11453961,4,4,0,0,2,2,0,0,0
11454086,1,1,0,0,2,2,0,0,0
11454093,2,2,0,0,1,1,0,0,1
11454295,2,0,2,0,1,1,0,0,0
11454909,3,3,0,0,1,1,0,1,0
11454980,1,1,0,0,1,1,0,0,0
11455227,1,1,0,0,1,1,0,0,0
11455414,1,1,0,0,1,1,0,0,0
11455588,1,1,0,0,1,1,0,0,0
11455628,1,1,0,0,1,1,0,0,0
11456441,2,2,0,0,2,2,0,0,0
11456636,7,4,3,0,1,1,0,1,1
11456750,1,1,0,0,1,1,0,0,0
11456829,4,4,0,0,0,0,0,0,0
11457044,1,1,0,0,1,1,0,0,0
11457151,2,2,0,0,2,2,0,0,0
11457333,1,1,0,0,0,0,0,0,0
11457465,2,2,0,0,1,1,0,0,0
11457507,2,2,0,0,2,2,0,0,0
11457997,1,1,0,0,1,1,0,0,0
11458114,1,1,0,0,1,1,0,0,0
11458291,2,2,0,1,1,1,0,1,0
11458781,3,3,0,0,2,2,0,0,0
11459499,1,1,0,0,1,1,0,0,0
11459516,2,2,0,0,1,1,0,0,1
11459652,1,1,0,0,1,1,0,0,0
11459757,2,2,0,0,0,0,0,0,0
11459821,7,5,2,0,2,1,1,2,1
11460062,1,1,0,0,1,1,0,1,0
11460148,3,3,0,0,1,1,0,1,1
11460275,1,1,0,0,1,1,0,0,0
11460334,4,3,1,0,3,2,1,1,1
11460518,3,2,1,0,1,1,0,1,1
11460707,2,2,0,0,1,1,0,0,1
11461196,3,2,1,0,1,1,0,1,1
11461286,4,3,1,0,1,1,0,1,0
11461317,1,1,0,0,1,1,0,0,0
11461397,1,1,0,0,1,1,0,0,0
11461450,4,3,1,0,4,3,1,0,0
11461484,4,3,1,0,1,1,0,1,0
11461544,1,1,0,0,1,1,0,0,0
11461588,1,1,0,0,1,1,0,0,0
11461629,2,2,0,0,1,1,0,0,1
11461647,3,3,0,0,1,1,0,1,0
11462637,1,1,0,0,0,0,0,0,0
11462691,5,4,1,0,2,1,1,2,1
11462943,2,1,1,0,1,1,0,1,0
11463178,1,1,0,0,1,1,0,0,0
11463408,9,8,1,0,0,0,0,0,0
11463470,1,1,0,0,1,1,0,1,0
11463703,8,7,1,0,0,0,0,0,0
11463930,1,0,1,0,0,0,0,0,1
11464098,1,1,0,0,1,1,0,0,0
11464353,2,1,1,0,2,1,1,0,0
11464442,2,1,1,0,2,1,1,0,0
11464594,1,1,0,0,2,2,0,0,0
11464804,1,1,0,0,1,1,0,0,0
11464821,3,3,0,0,2,2,0,0,0
11465740,1,1,0,0,1,1,0,0,1
11466619,2,2,0,0,1,1,0,0,0
11466950,2,2,0,0,2,2,0,0,0
11467498,2,1,1,0,2,1,1,0,0
11467530,2,1,1,0,1,1,0,0,0
11467538,3,3,0,0,2,2,0,0,1
11467587,7,6,1,0,2,1,1,2,1
11467616,3,2,1,0,1,1,0,1,0
11467694,1,1,0,0,1,1,0,0,0
11467714,1,1,0,0,1,1,0,0,0
11467736,2,2,0,0,0,0,0,0,0
11467854,4,4,0,0,0,0,0,0,1
11467897,1,1,0,0,1,1,0,0,0
11468018,2,2,0,0,2,2,0,0,0
11468409,3,3,0,0,2,2,0,0,1
11468486,1,1,0,0,1,1,0,0,0
11468667,2,2,0,0,1,1,0,0,0
11469231,4,4,0,0,0,0,0,0,0
11470060,1,1,0,0,1,1,0,0,0
11470309,3,3,0,0,0,0,0,0,0
11470622,1,1,0,0,1,1,0,0,0
11471117,3,3,0,0,1,1,0,0,0
11471170,4,4,0,0,3,3,0,0,0
11471500,1,1,0,0,1,1,0,0,0
11471757,2,2,0,0,1,1,0,0,0
11472161,1,1,0,0,1,1,0,0,0
11472441,2,2,0,0,1,1,0,0,1
11472792,1,1,0,0,1,1,0,0,0
11472914,1,1,0,0,1,1,0,0,0
11472950,1,1,0,0,1,1,0,0,0
11473535,1,1,0,0,1,1,0,0,0
11473735,6,5,1,0,2,1,1,2,1
11473898,1,1,0,0,0,0,0,0,0
11474052,4,0,4,0,4,3,1,0,0
11474597,1,1,0,0,0,0,0,0,0
11474746,2,2,0,0,1,1,0,0,0
11475190,3,3,0,0,2,2,0,0,1
11475428,6,5,1,0,3,2,1,1,1
11475457,3,3,0,0,1,1,0,0,0
11475497,3,2,1,0,1,1,0,1,1
11475903,1,1,0,0,1,1,0,0,0
11476051,1,1,0,0,1,1,0,0,0
11476240,2,1,1,0,1,0,1,0,0
11476303,1,1,0,0,1,1,0,0,0
11477218,1,1,0,0,1,1,0,0,0
07490243,2,1,1,0,1,1,0,0,1
07490403,11,4,7,0,0,0,0,0,1
07490490,15,5,10,0,0,0,0,0,1
07490626,15,0,15,0,2,1,1,2,1
07490786,6,3,3,0,0,0,0,0,0
07490873,1,1,0,0,1,1,0,0,0
07490951,2,1,1,0,0,0,0,0,0
07491059,2,1,1,0,1,1,0,0,1
07491219,8,4,4,0,2,1,1,1,0
07491422,2,2,0,0,2,2,0,0,0
07491735,3,1,2,0,1,1,0,0,0
07491847,3,0,3,0,0,0,0,0,1
07492092,4,0,4,0,2,2,0,0,1
07492102,11,0,11,0,0,0,0,0,0
07492131,11,5,6,0,1,1,0,1,1
07492198,47,22,25,0,0,0,0,0,1
07493169,2,1,1,0,1,1,0,1,1
07493343,2,2,0,0,2,2,0,0,0
07493432,10,5,5,0,1,1,0,0,1
07493534,6,5,1,0,0,0,0,0,0
07493575,8,2,6,0,0,0,0,0,0
07494298,1,1,0,0,2,2,0,0,0
07494620,31,10,21,0,0,0,0,0,1
07494637,2,0,2,0,0,0,0,0,0
07495535,5,2,3,0,2,2,0,0,0
07495558,13,0,13,0,0,0,0,0,0
07495819,2,2,0,0,1,1,0,0,0
07496026,5,3,2,0,2,2,0,0,0
07496237,2,1,1,0,1,1,0,0,0
07496346,1,1,0,0,1,1,0,0,0
07496355,3,2,1,0,2,2,0,0,0
07496745,9,2,7,0,3,1,2,3,0
07496752,18,2,16,0,2,2,0,2,1
07496754,18,2,16,0,2,2,0,2,1
07496756,22,9,13,0,1,1,0,1,1
07496765,18,2,16,0,2,2,0,2,1
07497113,6,2,4,0,1,1,0,1,1
07497198,14,4,10,1,5,1,4,3,1
07498115,2,0,2,0,0,0,0,0,1
07498701,3,3,0,0,2,2,0,0,1
07498765,14,4,10,0,4,3,1,2,1
07498923,23,13,10,0,3,0,3,0,0
07499397,22,0,22,0,0,0,0,0,1
07499475,4,2,2,0,1,1,0,0,1
07499948,6,0,6,0,0,0,0,0,1
07500506,2,1,1,0,1,1,0,0,1
07500520,2,0,2,0,0,0,0,0,1
07500738,5,5,0,0,1,1,0,0,0
07501272,8,2,6,0,1,1,0,1,1
07501313,6,5,1,0,1,1,0,1,1
07501671,3,2,1,0,1,1,0,0,0
07501883,2,2,0,0,2,2,0,0,0
07502034,2,2,0,0,2,2,0,0,1
07502485,1,0,1,0,1,1,0,0,0
07503123,2,0,2,0,0,0,0,0,1
07503203,11,2,9,0,2,1,1,1,1
07503259,3,2,1,0,3,2,1,0,1
07503691,1,1,0,0,1,1,0,0,0
07503862,7,2,5,1,0,0,0,0,1
07503926,16,5,11,1,2,1,1,2,1
07503992,9,4,5,0,0,0,0,0,0
07503993,13,0,13,0,0,0,0,0,1
07504022,5,4,1,0,1,1,0,0,0
07504041,3,1,2,0,1,1,0,0,0
07504048,3,2,1,0,2,2,0,0,1
07504101,2,1,1,0,1,1,0,0,1
07504387,8,3,5,0,2,2,0,0,1
07504810,3,2,1,0,1,1,0,0,1
07504860,4,3,1,0,1,1,0,0,0
07504867,6,2,4,0,1,1,0,0,0
07504878,5,3,2,0,2,2,0,0,0
07504913,6,4,2,0,1,1,0,1,0
07505595,3,2,1,0,2,2,0,0,0
07506313,7,4,3,0,1,1,0,0,1
07506340,2,2,0,0,2,2,0,0,0
07506360,5,2,3,0,4,1,3,1,1
07506598,48,12,36,0,0,0,0,0,1
07506956,3,3,0,0,1,1,0,0,0
07507035,3,0,3,0,0,0,0,0,0
07507368,2,1,1,0,1,1,0,0,0
07507718,6,0,6,0,0,0,0,0,0
07507958,1,1,0,0,1,1,0,0,0
07508272,2,0,2,0,1,1,0,0,1
07508891,12,8,4,0,1,1,0,0,0
07509102,3,0,3,0,0,0,0,0,1
07509171,9,5,4,2,4,1,3,1,0
07509364,1,0,1,0,0,0,0,0,0
07509409,27,13,14,0,1,1,0,0,0
07509415,2,2,0,0,1,1,0,0,0
07509464,12,6,6,0,0,0,0,0,0
07509480,4,2,2,0,1,1,0,0,0
07509556,17,6,11,0,0,0,0,0,0
07509675,1,0,1,0,0,0,0,0,0
07509879,16,5,11,0,7,5,2,0,0
07510176,2,1,1,0,1,1,0,0,0
07510328,5,2,3,0,1,1,0,1,0
07510349,3,3,0,0,1,1,0,0,0
07510578,25,7,18,0,3,3,0,2,1
07510595,1,1,0,0,1,1,0,0,0
07510802,3,1,2,0,1,1,0,0,0
07510835,2,2,0,0,2,2,0,0,0
07511345,4,4,0,0,1,1,0,0,0
07511393,5,2,3,0,5,4,1,1,1
07511467,5,2,3,0,1,1,0,0,0
07511594,15,6,9,0,1,1,0,1,0
07511811,2,2,0,0,1,1,0,0,0
07511976,8,3,5,0,0,0,0,0,1
07512798,1,1,0,0,1,1,0,0,1
07512950,5,0,5,0,0,0,0,0,1
07513111,6,0,6,0,0,0,0,0,1
07513112,11,7,4,0,0,0,0,0,0
07513309,37,7,30,0,0,0,0,0,0
07513369,2,2,0,0,1,1,0,0,0
07513680,2,0,2,0,0,0,0,0,1
07513742,2,0,2,0,0,0,0,0,0
07514454,2,1,1,0,0,0,0,0,0
07514466,4,2,2,0,1,1,0,1,1
07514469,11,6,5,0,0,0,0,0,1
07514641,1,1,0,0,1,1,0,0,1
07515032,2,2,0,0,1,1,0,0,1
07515070,11,2,9,0,1,1,0,1,1
07515165,1,1,0,0,1,1,0,0,0
07515653,20,9,11,0,0,0,0,0,1
07515728,10,4,6,0,0,0,0,0,0
07516050,9,2,7,1,0,0,0,0,1
07516176,17,5,12,0,0,0,0,0,1
07516277,32,5,27,0,1,1,0,1,1
07516355,5,0,5,0,0,0,0,0,0
07516386,3,0,3,0,0,0,0,0,1
07516429,3,0,3,0,0,0,0,0,1
07516867,12,7,5,0,1,1,0,1,1
07517144,5,5,0,0,0,0,0,0,1
07517182,8,0,8,0,2,2,0,0,1
07517189,2,1,1,0,2,2,0,0,1
07517434,2,1,1,0,1,1,0,1,0
07517752,2,0,2,0,0,0,0,0,1
07517968,7,6,1,0,0,0,0,0,0
07518085,3,1,2,0,1,1,0,0,0
07518120,2,1,1,0,1,1,0,0,0
07518420,2,1,1,0,1,1,0,0,1
07519888,42,10,32,0,0,0,0,0,0
07519927,23,10,13,0,0,0,0,0,0
07520033,12,5,7,0,0,0,0,0,1
07520152,11,7,4,0,0,0,0,0,0
07520681,2,0,2,0,1,1,0,0,0
07520697,9,5,4,0,1,1,0,1,1
07520791,2,1,1,0,1,1,0,0,1
07520900,9,4,5,0,1,1,0,1,1
07520943,2,0,2,0,0,0,0,0,1
07520980,4,3,1,0,1,1,0,0,0
07520989,9,6,3,0,1,1,0,1,1
07521614,2,0,2,0,0,0,0,0,0
07521716,20,7,13,0,3,2,1,3,0
07521736,3,3,0,0,1,1,0,0,0
07521823,3,3,0,0,1,1,0,0,0
07521873,9,4,5,0,2,1,1,2,1
07521907,9,4,5,0,2,1,1,2,1
07522675,3,0,3,0,0,0,0,0,1
07523179,19,8,11,0,0,0,0,0,0
07523241,20,7,13,0,1,1,0,1,0
07523406,4,4,0,0,0,0,0,0,0
07523436,38,9,29,0,0,0,0,0,0
07523592,2,2,0,0,2,2,0,0,0
07523689,2,1,1,0,1,1,0,0,0
07523854,3,3,0,0,1,1,0,0,0
07523925,4,0,4,0,0,0,0,0,0
07524634,4,0,4,0,0,0,0,0,0
07525114,61,21,40,0,0,0,0,0,1
07525294,1,0,1,0,0,0,0,0,0
07525887,9,5,4,0,5,4,1,0,0
07526612,14,3,11,0,1,1,0,1,1
07526615,2,2,0,0,2,2,0,0,0
07527517,1,1,0,0,1,1,0,0,0
07527595,2,1,1,0,2,2,0,0,1
07527781,1,0,1,0,0,0,0,0,0
07528013,3,0,3,0,0,0,0,0,1
07528497,6,4,2,0,2,1,1,0,0
07528584,4,0,4,0,0,0,0,0,1
07528634,3,0,3,0,2,2,0,0,1
07529195,1,1,0,0,1,1,0,0,0
07529200,4,3,1,0,2,2,0,0,0
07529430,4,3,1,0,3,3,0,0,0
07529665,10,2,8,0,2,1,1,2,0
07530104,5,2,3,1,1,1,0,0,1
07530670,4,2,2,0,0,0,0,0,1
07530682,2,2,0,0,1,1,0,0,0
07531066,2,0,2,0,0,0,0,0,1
07531203,1,1,0,0,1,1,0,1,1
07531648,2,2,0,0,1,1,0,0,0
07531684,3,2,1,0,1,1,0,1,1
07531908,2,2,0,0,2,2,0,0,0
07532046,9,0,9,0,1,1,0,1,1
07532122,9,0,9,0,1,1,0,1,1
07532189,2,0,2,0,0,0,0,0,0
07532846,3,0,3,0,0,0,0,0,1
07533854,2,0,2,0,1,1,0,0,1
07533870,1,1,0,0,1,1,0,0,0
07533905,2,2,0,0,1,1,0,0,0
07534011,3,3,0,0,3,3,0,0,1
07534028,6,0,6,0,0,0,0,0,1
07534096,13,6,7,0,0,0,0,0,1
07534313,1,0,1,0,0,0,0,0,0
07534492,2,2,0,0,1,1,0,0,0
07534535,3,1,2,0,1,1,0,0,0
07534655,1,1,0,0,3,1,2,0,1
07534860,3,0,3,0,0,0,0,0,0
07535127,5,3,2,0,2,2,0,0,1
07535174,3,0,3,0,4,4,0,0,0
07535196,4,3,1,0,1,1,0,1,1
07535227,10,3,7,0,1,1,0,1,1
07535550,7,2,5,0,1,1,0,1,1
07535672,2,2,0,0,2,2,0,0,1
07536991,3,0,3,0,0,0,0,0,0
07537246,12,6,6,0,0,0,0,0,0
07537261,2,0,2,0,1,1,0,0,1
07537279,6,0,6,0,4,4,0,0,0
07537636,15,8,7,0,0,0,0,0,1
07538160,6,3,3,0,2,2,0,0,1
07538265,33,13,20,0,0,0,0,0,1
07538278,5,0,5,0,0,0,0,0,0
07538328,3,0,3,0,0,0,0,0,1
07538347,2,1,1,0,1,1,0,0,1
07538467,48,12,36,0,0,0,0,0,1
07538645,1,0,1,0,1,1,0,0,0
07538730,56,17,39,0,0,0,0,0,1
07539284,14,3,11,0,0,0,0,0,1
07539853,8,5,3,0,1,1,0,1,1
07539908,7,0,7,0,0,0,0,0,0
07539932,8,3,5,0,1,1,0,1,1
07540273,3,0,3,0,2,2,0,0,1
07540334,1,1,0,0,1,1,0,0,1
07540343,2,1,1,0,1,1,0,0,0
07540370,2,2,0,0,1,1,0,0,0
07540423,2,1,1,0,1,1,0,0,0
07541015,4,2,2,0,1,1,0,0,0
07541017,15,3,12,0,2,1,1,2,1
07541035,2,1,1,0,2,1,1,0,0
07541108,3,0,3,0,0,0,0,0,1
07541692,4,2,2,0,1,1,0,0,1
07541787,13,4,9,0,2,2,0,2,1
07542396,6,2,4,0,1,1,0,0,0
07542427,4,2,2,0,2,2,0,0,1
07542444,5,5,0,0,0,0,0,0,1
07542445,1,0,1,0,0,0,0,0,0
07542762,3,0,3,0,0,0,0,0,1
07542996,5,3,2,0,0,0,0,0,0
07543095,10,3,7,0,0,0,0,0,0
07543121,5,3,2,0,2,1,1,1,1
07543177,11,2,9,0,2,1,1,2,0
07543193,8,0,8,0,0,0,0,0,1
07543197,5,2,3,0,1,1,0,1,1
07543200,5,0,5,0,0,0,0,0,1
07543293,2,2,0,0,1,1,0,0,0
07543585,15,3,12,0,1,1,0,1,1
07543834,30,14,16,0,0,0,0,0,1
07544057,3,2,1,0,1,1,0,0,0
07544158,4,3,1,0,1,1,0,0,0
07544227,3,3,0,0,2,2,0,0,1
07544338,10,4,6,0,2,1,1,1,0
07544348,10,4,6,0,2,1,1,1,0
07544471,3,1,2,0,2,1,1,0,1
07544673,4,0,4,0,1,1,0,0,1
07544724,9,6,3,0,2,1,1,1,1
07544904,1,0,1,0,0,0,0,0,1
07545060,28,6,22,0,0,0,0,0,0
07545147,4,2,2,0,1,1,0,1,0
07545536,36,18,18,0,0,0,0,0,1
07545585,2,2,0,0,2,2,0,0,0
07545698,20,3,17,0,1,1,0,1,0
07546316,2,0,2,0,0,0,0,0,1
07547039,18,11,7,0,9,5,4,0,0
07547773,5,4,1,0,3,3,0,0,0
07548058,2,2,0,0,1,1,0,0,0
07548073,1,1,0,0,1,1,0,0,0
07548308,5,0,5,0,2,2,0,0,1
07548506,4,0,4,0,0,0,0,0,0
07548631,3,1,2,0,1,1,0,0,1
07549058,2,2,0,0,1,1,0,0,0
07549117,19,4,15,0,1,1,0,1,1
07549242,9,5,4,0,1,1,0,0,0
07549484,15,9,6,0,0,0,0,0,1
07549600,29,9,20,0,2,2,0,2,1
07549866,3,2,1,0,1,1,0,0,0
07549890,16,9,7,0,0,0,0,0,1
07549973,2,1,1,0,1,1,0,0,0
07550317,2,2,0,0,2,2,0,0,1
07550900,3,2,1,0,1,1,0,0,0
07551425,1,1,0,0,1,1,0,0,0
07551601,2,0,2,0,0,0,0,0,1
07552219,2,1,1,0,1,1,0,0,1
07552481,23,11,12,0,0,0,0,0,0
07552522,1,0,1,0,0,0,0,0,1
07552535,42,9,33,0,0,0,0,0,1
07552957,6,3,3,0,0,0,0,0,1
07553344,5,3,2,0,3,2,1,0,0
07553526,2,1,1,0,1,1,0,0,0
07553554,34,2,32,0,0,0,0,0,1
07553793,16,2,14,0,3,1,2,1,1
07553970,1,0,1,0,1,1,0,0,0
07554085,42,18,24,0,0,0,0,0,0
07554135,1,1,0,0,1,1,0,0,0
07554154,10,0,10,0,2,2,0,0,1
07554557,10,5,5,0,0,0,0,0,1
07554775,1,1,0,0,1,1,0,0,0
07554910,3,3,0,0,1,1,0,1,1
07555128,3,3,0,0,1,1,0,0,0
07555205,11,5,6,0,2,1,1,2,1
07555379,1,0,1,0,0,0,0,0,1
07555513,5,2,3,0,2,1,1,0,1
07555641,4,2,2,0,1,1,0,0,0
07556042,1,0,1,0,0,0,0,0,0
07556159,42,17,25,0,0,0,0,0,0
07556227,10,5,5,0,0,0,0,0,1
07556481,23,6,17,0,4,1,3,4,1
07556491,20,5,15,0,1,1,0,1,1
07556501,20,5,15,0,1,1,0,1,1
07556511,3,0,3,0,0,0,0,0,1
07556525,20,5,15,0,1,1,0,1,1
07556544,13,0,13,0,0,0,0,0,0
07556579,3,3,0,0,1,1,0,0,1
07556595,28,3,25,0,1,1,0,1,1
07556665,9,0,9,0,0,0,0,0,1
07556770,20,9,11,0,1,1,0,1,1
07557079,2,1,1,0,1,1,0,0,0
07557396,3,2,1,0,2,2,0,0,0
07557531,8,0,8,0,0,0,0,0,0
07557674,18,4,14,0,7,0,7,0,1
07557741,5,3,2,0,1,1,0,0,1
07557831,46,10,36,0,0,0,0,0,0
07557846,8,5,3,0,0,0,0,0,0
07557971,10,6,4,0,0,0,0,0,0
07557989,4,3,1,0,2,2,0,0,1
07558274,2,2,0,0,1,1,0,0,0
07558492,6,0,6,0,0,0,0,0,1
07558609,5,2,3,0,3,3,0,0,1
07558729,3,3,0,0,2,2,0,1,0
07558889,2,2,0,0,1,1,0,0,0
07559238,29,0,29,0,0,0,0,0,0
07559293,37,9,28,0,0,0,0,0,1
07559439,40,9,31,0,4,4,0,0,1
07559718,1,1,0,0,1,1,0,0,1
07559722,13,7,6,0,0,0,0,0,1
07559753,6,3,3,0,2,1,1,2,0
07559977,2,1,1,0,1,1,0,0,0
07560343,1,0,1,0,0,0,0,0,0
07560518,2,2,0,0,2,2,0,0,1
07561173,19,5,14,0,1,1,0,0,0
07561541,26,13,13,0,1,1,0,1,1
07561570,1,1,0,0,1,1,0,0,0
07561609,29,9,20,0,0,0,0,0,1
07562205,7,5,2,0,3,2,1,0,0
07562293,3,1,2,0,0,0,0,0,1
07562444,2,2,0,0,2,2,0,0,0
07562490,21,11,10,0,0,0,0,0,0
07562845,1,1,0,0,1,1,0,0,1
07563096,8,2,6,0,1,1,0,1,1
07564775,1,1,0,0,1,1,0,0,0
07564983,1,1,0,0,1,1,0,0,0
07565015,3,2,1,0,1,1,0,1,1
07565213,4,1,3,0,2,1,1,0,0
07565373,5,5,0,0,0,0,0,0,1
07566145,2,2,0,0,2,2,0,0,0
07566231,3,0,3,0,0,0,0,0,1
07566245,8,3,5,0,1,1,0,1,1
07566738,15,6,9,0,1,1,0,1,1
07566772,12,2,10,0,1,1,0,0,0
07566864,13,7,6,0,1,1,0,0,1
07566876,20,8,12,0,0,0,0,0,0
07566903,6,3,3,0,1,1,0,1,1
07566986,43,14,29,0,0,0,0,0,1
07567668,4,0,4,0,0,0,0,0,1
07567881,15,12,3,0,0,0,0,0,1
07568335,1,0,1,0,1,1,0,0,1
07568647,4,0,4,0,0,0,0,0,0
07568957,26,13,13,0,0,0,0,0,1
07569691,6,2,4,0,1,1,0,1,1
07569729,7,5,2,0,1,1,0,1,1
07569743,41,6,35,0,0,0,0,0,0
07569800,9,0,9,0,2,2,0,0,1
07569897,4,2,2,0,1,1,0,0,0
07569921,1,1,0,0,1,1,0,0,0
08000032,2,2,0,0,2,2,0,0,0
08000038,5,0,5,0,0,0,0,0,0
08000047,2,0,2,0,0,0,0,0,0
08000080,6,2,4,0,1,1,0,1,0
08000087,4,0,4,0,2,1,1,0,0
08000094,17,9,8,0,6,5,1,0,0
08000160,7,0,7,0,0,0,0,0,0
08000189,3,0,3,0,0,0,0,0,0
08000434,4,2,2,0,2,2,0,0,0
08000756,3,2,1,0,1,1,0,1,1
08000761,3,2,1,0,1,1,0,1,1
08000807,26,10,16,0,0,0,0,0,1
08001035,6,1,5,0,1,1,0,0,1
08001121,8,1,7,0,1,1,0,0,0
08002160,3,3,0,0,1,1,0,1,0
08002172,4,4,0,0,3,3,0,0,0
08002190,4,0,4,0,0,0,0,0,0
08002817,1,0,1,0,0,0,0,0,1
08002863,2,2,0,0,2,2,0,0,0
08003038,6,3,3,0,1,1,0,1,1
08003086,2,2,0,0,2,2,0,0,0
08003349,2,0,2,0,0,0,0,0,0
08003383,1,1,0,0,2,2,0,0,0
08003843,1,1,0,0,1,1,0,0,0
08003975,2,0,2,0,0,0,0,0,1
08004006,1,1,0,0,1,1,0,0,0
08004124,5,4,1,0,1,1,0,1,0
08004196,3,2,1,0,1,1,0,0,1
08004383,3,2,1,0,1,1,0,0,0
08004757,4,3,1,0,2,2,0,0,0
08004760,8,5,3,0,4,4,0,0,0
08004783,2,0,2,0,0,0,0,0,1
08004790,2,0,2,0,0,0,0,0,1
08004985,3,1,2,0,1,1,0,0,1
08005249,4,4,0,0,5,2,3,1,1
08005292,2,2,0,0,1,1,0,0,0
08005512,20,6,14,0,0,0,0,0,0
08005798,19,11,8,0,1,1,0,1,1
08005814,2,2,0,0,2,2,0,0,1
08006007,2,2,0,0,0,0,0,0,1
08006103,6,3,3,0,1,1,0,0,1
08006148,2,0,2,0,2,2,0,0,0
08006377,4,0,4,0,3,3,0,0,0
08006463,2,1,1,0,1,1,0,0,0
08006468,13,6,7,0,0,0,0,0,0
08006705,3,3,0,0,3,3,0,0,0
08007058,6,0,6,0,0,0,0,0,1
08007139,1,0,1,0,1,1,0,0,0
08007385,2,2,0,0,2,2,0,0,1
08007540,3,0,3,0,0,0,0,0,0
08007897,2,2,0,0,1,1,0,0,0
08008175,10,8,2,0,1,0,1,0,1
08008214,1,1,0,0,1,1,0,0,0
08008820,9,4,5,0,3,3,0,3,1
08008913,3,3,0,0,2,2,0,0,1
08008915,9,1,8,0,1,1,0,0,0
08008967,2,2,0,0,2,2,0,0,0
08009055,4,0,4,0,0,0,0,0,1
08009089,9,3,6,0,1,1,0,0,1
08009593,17,4,13,0,2,1,1,2,0
08009988,3,1,2,0,1,1,0,0,0
08010153,2,2,0,0,2,2,0,0,1
08010328,3,1,2,0,1,1,0,0,0
08010537,3,0,3,0,0,0,0,0,1
08010561,16,7,9,0,1,1,0,1,0
08010646,1,1,0,0,1,1,0,0,0
08010849,1,1,0,0,1,1,0,0,0
08010992,2,2,0,0,2,2,0,0,0
08010999,2,0,2,0,0,0,0,0,1
08011029,3,3,0,0,2,2,0,0,0
08011086,2,2,0,0,2,2,0,0,1
08011541,11,4,7,0,0,0,0,0,0
08011855,3,0,3,0,0,0,0,0,0
08011888,3,0,3,0,0,0,0,0,1
08011922,12,2,10,0,0,0,0,0,1
08012038,4,4,0,0,1,1,0,1,1
08012043,4,4,0,0,1,1,0,1,1
08012161,3,0,3,0,0,0,0,0,1
08012365,8,5,3,0,0,0,0,0,1
08012443,7,4,3,0,3,3,0,0,1
08012928,4,0,4,0,0,0,0,0,0
08013043,28,12,16,0,0,0,0,0,0
08013276,1,1,0,0,1,1,0,1,0
08013479,3,2,1,0,2,2,0,0,1
08013831,12,0,12,0,0,0,0,0,1
08013837,1,1,0,0,1,1,0,0,1
08013854,1,0,1,0,1,1,0,0,1
08013982,3,2,1,0,2,2,0,0,0
08015004,1,1,0,0,1,1,0,0,0
08015679,2,2,0,0,1,1,0,0,0
08015844,4,0,4,0,0,0,0,0,1
08015875,2,2,0,0,2,2,0,0,0
08015899,1,1,0,0,1,1,0,0,1
08016187,2,0,2,0,0,0,0,0,1
08016269,3,3,0,0,2,2,0,0,0
08017068,4,1,3,0,1,1,0,0,0
08017096,1,1,0,0,0,0,0,0,1
08017395,1,0,1,0,1,1,0,0,0
08017402,4,2,2,0,1,1,0,1,0
08017699,1,1,0,0,2,2,0,0,0
08018013,4,3,1,0,2,2,0,0,0
08018144,5,0,5,0,0,0,0,0,1
08018173,6,2,4,0,3,3,0,1,1
08018418,8,4,4,0,1,1,0,1,1
08018487,4,1,3,0,2,2,0,0,0
08018676,2,2,0,0,2,2,0,0,0
08018728,4,3,1,0,0,0,0,0,1
08018942,21,13,8,0,0,0,0,0,1
08019010,5,1,4,0,4,3,1,1,1
08019240,6,0,6,0,0,0,0,0,1
08019272,1,1,0,0,1,1,0,0,0
08019528,2,2,0,0,1,1,0,0,0
08020066,2,0,2,0,1,1,0,0,1
08020409,1,1,0,0,1,1,0,0,1
08020526,9,0,9,1,0,0,0,0,1
08020558,2,0,2,0,2,2,0,0,0
08021091,2,0,2,0,0,0,0,0,0
08021195,10,2,8,0,1,1,0,0,1
08021638,2,2,0,0,2,2,0,0,1
08021824,1,1,0,0,1,1,0,0,0
08022028,1,1,0,0,1,1,0,0,0
08023015,1,0,1,0,0,0,0,0,0
08023182,2,1,1,0,1,1,0,0,0
08023346,4,3,1,0,3,3,0,0,0
08023637,3,2,1,0,3,1,2,1,0
08023894,14,0,14,0,0,0,0,0,0
08024061,8,3,5,0,1,1,0,1,1
08024332,5,0,5,0,0,0,0,0,1
08024489,13,6,7,0,0,0,0,0,1
08024554,2,0,2,0,0,0,0,0,1
08024577,3,3,0,0,2,2,0,0,0
08024861,2,0,2,0,2,2,0,0,1
08024867,5,0,5,0,0,0,0,0,1
08025222,2,1,1,0,1,1,0,0,0
08025794,4,0,4,0,0,0,0,0,1
08026888,15,5,10,0,0,0,0,0,1
08026919,3,0,3,0,0,0,0,0,1
08027064,3,2,1,0,1,1,0,0,0
08027475,1,0,1,0,0,0,0,0,1
08027845,22,10,12,0,1,1,0,0,0
08028325,2,2,0,0,1,1,0,0,1
08028495,2,0,2,0,0,0,0,0,1
08028523,2,0,2,0,0,0,0,0,0
08028576,5,3,2,0,1,1,0,0,0
08028717,1,0,1,0,0,0,0,0,0
08028789,34,14,20,0,3,3,0,0,0
08029254,5,5,0,0,4,4,0,0,0
08029399,6,2,4,0,0,0,0,0,1
08029715,15,6,9,0,0,0,0,0,0
08029920,1,0,1,0,0,0,0,0,0
08030128,4,4,0,0,0,0,0,0,0
08030181,5,3,2,0,3,1,2,1,1
08030247,2,1,1,0,1,1,0,0,1
08030879,2,2,0,0,1,1,0,0,0
08030927,2,0,2,0,0,0,0,0,0
08031016,4,3,1,0,2,1,1,0,1
08031272,13,4,9,0,0,0,0,0,1
08032098,1,0,1,0,0,0,0,0,0
08032425,1,1,0,0,1,1,0,0,0
08032777,3,1,2,0,3,1,2,0,0
08032803,3,1,2,0,1,1,0,0,1
08033480,1,1,0,0,1,1,0,0,0
08033539,3,2,1,0,1,1,0,1,0
08033728,3,2,1,0,1,1,0,1,0
08034036,1,1,0,0,1,1,0,0,1
08034511,4,2,2,0,1,1,0,0,0
08034553,8,4,4,0,1,1,0,1,1
08034643,1,0,1,0,0,0,0,0,1
08034651,6,3,3,0,5,4,1,0,1
08034734,2,1,1,0,1,1,0,0,0
08035139,5,0,5,0,0,0,0,0,1
08035368,2,2,0,0,1,1,0,0,0
08035468,5,2,3,0,1,1,0,1,1
08035507,5,2,3,0,1,1,0,1,1
08035787,1,1,0,0,1,1,0,0,0
08036065,4,4,0,0,2,2,0,0,1
08036258,3,0,3,0,0,0,0,0,1
08036506,18,4,14,0,1,1,0,1,1
08036666,12,5,7,0,0,0,0,0,1
08036733,10,5,5,0,0,0,0,0,1
08037191,3,2,1,0,2,2,0,0,1
08037243,2,0,2,0,0,0,0,0,1
08037357,1,1,0,0,1,1,0,0,0
08037541,1,1,0,0,1,1,0,0,0
08037967,2,2,0,0,1,1,0,0,1
08038438,12,6,6,0,0,0,0,0,1
08039061,2,0,2,0,0,0,0,0,1
08039148,5,2,3,0,2,1,1,0,0
08039675,16,9,7,0,3,3,0,3,1
08039739,7,0,7,0,0,0,0,0,1
08039743,2,0,2,0,1,1,0,0,0
08039802,2,2,0,0,1,1,0,0,0
08040954,2,2,0,0,2,2,0,0,1
08041070,7,4,3,0,1,1,0,0,0
08041426,1,1,0,0,1,1,0,0,0
08041878,5,2,3,0,2,1,1,0,1
08041887,14,10,4,0,0,0,0,0,1
08041891,10,5,5,0,4,0,4,0,0
08041954,4,2,2,0,2,2,0,0,0
08042021,9,5,4,0,2,2,0,0,1
08042040,8,4,4,0,2,2,0,0,1
08042066,10,5,5,0,2,2,0,0,1
08042089,9,5,4,0,2,2,0,0,1
08042664,2,1,1,0,1,1,0,0,0
08042841,2,2,0,0,1,1,0,0,0
08043098,1,1,0,0,1,1,0,0,1
08043144,2,0,2,0,0,0,0,0,1
08043155,3,3,0,0,1,1,0,0,0
08043198,1,1,0,0,1,1,0,0,0
08043511,8,2,6,0,1,1,0,1,1
08043633,4,4,0,0,1,1,0,0,0
08043731,7,3,4,0,0,0,0,0,0
08043853,2,1,1,0,1,1,0,0,0
08043945,2,1,1,0,1,1,0,0,0
08044108,4,4,0,0,3,2,1,0,1
08044110,21,12,9,0,0,0,0,0,0
08044644,2,2,0,0,2,2,0,0,0
08045239,28,6,22,0,0,0,0,0,0
08045327,2,2,0,0,2,2,0,0,0
08045627,1,1,0,0,1,1,0,0,0
08046092,3,0,3,0,0,0,0,0,1
08046334,1,0,1,0,0,0,0,0,0
08046381,7,0,7,0,0,0,0,0,1
08046558,4,0,4,0,0,0,0,0,1
08046787,2,2,0,0,2,2,0,0,0
08047329,9,0,9,0,0,0,0,0,0
08047395,2,2,0,0,1,1,0,0,0
08047602,3,2,1,0,2,2,0,0,0
08047635,3,2,1,0,2,2,0,0,1
08047670,11,5,6,0,0,0,0,0,1
08047769,2,0,2,0,0,0,0,0,1
08048025,11,3,8,0,1,1,0,1,1
08049051,20,6,14,0,1,1,0,1,1
08049569,7,6,1,0,5,5,0,0,0
08049696,1,1,0,0,1,1,0,0,0
08049839,2,2,0,0,2,2,0,0,0
08049871,1,1,0,0,1,1,0,0,0
08050365,5,0,5,0,0,0,0,0,1
08051015,3,3,0,0,1,1,0,0,0
08051155,2,2,0,0,2,2,0,0,0
08051177,4,0,4,0,0,0,0,0,1
08051184,3,3,0,0,0,0,0,0,0
08052008,6,4,2,0,0,0,0,0,1
08052030,14,2,12,0,1,1,0,1,1
08052114,2,2,0,0,1,1,0,1,1
08052233,3,1,2,0,1,1,0,0,0
08052370,13,0,13,0,0,0,0,0,1
08052689,1,0,1,0,1,1,0,0,0
08053211,2,2,0,0,2,2,0,0,0
08053233,2,1,1,0,1,1,0,0,0
08053268,5,3,2,0,1,1,0,1,1
08053808,2,1,1,0,2,1,1,0,0
08053918,2,2,0,0,1,1,0,0,1
08054354,3,2,1,0,2,1,1,0,0
08054645,5,4,1,0,1,1,0,0,1
08055250,2,2,0,0,0,0,0,0,1
08055280,5,3,2,0,1,1,0,0,1
08055400,4,3,1,0,1,1,0,0,1
08055593,3,0,3,0,0,0,0,0,1
08055628,1,1,0,0,1,1,0,0,0
08056190,2,0,2,0,0,0,0,0,0
08056712,4,0,4,0,0,0,0,0,0
08057302,2,0,2,0,0,0,0,0,1
08057308,16,13,3,0,1,1,0,0,1
08057425,14,6,8,0,2,2,0,2,1
08057542,4,1,3,0,1,1,0,0,0
08057639,2,2,0,0,2,2,0,0,1
08057815,3,3,0,0,1,1,0,0,1
08058001,13,2,11,0,1,1,0,1,1
08058035,2,2,0,0,3,2,1,1,0
08058318,8,0,8,0,0,0,0,0,1
08058658,6,2,4,0,0,0,0,0,1
08058803,1,1,0,0,1,1,0,0,0
08058861,3,1,2,0,1,1,0,0,0
08058926,1,1,0,0,1,1,0,0,0
08059499,3,0,3,0,0,0,0,0,1
08059762,3,0,3,0,1,1,0,0,0
08059813,3,1,2,0,1,1,0,0,0
08060482,1,1,0,0,1,1,0,0,0
08060937,1,1,0,0,1,1,0,0,0
08061518,1,0,1,0,0,0,0,0,1
08061734,3,3,0,0,2,2,0,0,1
08061789,2,0,2,0,0,0,0,0,0
08062225,6,0,6,0,0,0,0,0,1
08062234,7,5,2,0,1,1,0,0,1
08062438,2,0,2,0,0,0,0,0,1
08062575,2,2,0,0,2,2,0,0,0
08062928,2,1,1,0,1,1,0,0,0
08063160,10,4,6,0,4,4,0,0,0
08063192,4,4,0,0,1,1,0,0,0
08064130,3,2,1,0,2,2,0,0,1
08064573,2,0,2,0,0,0,0,0,1
08064590,5,0,5,0,0,0,0,0,1
08064696,5,2,3,0,2,1,1,0,0
08064796,52,10,42,0,0,0,0,0,1
08064823,2,0,2,0,0,0,0,0,1
08064835,18,3,15,0,1,1,0,0,1
08064934,1,0,1,0,0,0,0,0,1
06960112,6,3,3,0,1,1,0,0,1
06960313,12,9,3,0,0,0,0,0,1
06960329,22,9,13,0,0,0,0,0,0
06960390,4,2,2,0,2,2,0,0,1
06960646,13,8,5,0,0,0,0,0,1
06960891,2,0,2,0,0,0,0,0,0
06960923,4,3,1,0,1,1,0,0,0
06961614,3,0,3,0,0,0,0,0,0
06963023,3,0,3,0,0,0,0,0,1
06963114,2,0,2,0,1,1,0,0,0
06963774,4,3,1,0,2,2,0,0,0
06964509,7,4,3,0,3,1,2,1,0
06964668,8,4,4,0,1,1,0,1,1
06964782,6,3,3,0,0,0,0,0,1
06964889,7,0,7,0,1,1,0,0,1
06964924,2,1,1,0,1,1,0,0,1
06965148,2,1,1,0,2,2,0,0,0
06966605,11,2,9,0,1,1,0,0,1
06966733,19,6,13,0,0,0,0,0,1
06967016,16,4,12,0,1,1,0,1,1
06967120,3,1,2,0,1,1,0,0,1
06967248,18,11,7,0,0,0,0,0,1
06967255,4,3,1,0,4,2,2,1,0
06967285,6,4,2,0,4,1,3,1,0
06967542,8,0,8,0,0,0,0,0,1
06967610,2,2,0,0,2,1,1,0,1
06967743,1,1,0,0,1,1,0,0,0
06967812,6,5,1,0,0,0,0,0,1
06967903,8,4,4,0,1,1,0,0,1
06968171,9,5,4,0,3,1,2,1,1
06968373,30,6,24,0,1,1,0,1,1
06968511,8,1,7,0,1,1,0,1,0
06968956,4,4,0,0,3,3,0,0,1
06969333,3,0,3,0,0,0,0,0,1
06969470,5,1,4,0,1,1,0,0,1
06969547,12,2,10,0,1,1,0,1,1
06969780,8,3,5,0,3,3,0,0,1
06969999,5,3,2,0,2,2,0,0,0
06970490,2,0,2,0,0,0,0,0,1
06970796,4,2,2,0,1,1,0,0,1
06971442,4,2,2,0,1,1,0,0,1
06971618,1,0,1,0,0,0,0,0,0
06971712,9,4,5,0,1,1,0,0,1
06971791,4,3,1,0,1,1,0,0,1
06972206,4,1,3,0,2,1,1,0,1
06973546,6,0,6,0,0,0,0,0,1
06973562,2,1,1,0,1,1,0,0,1
06973738,7,3,4,0,1,1,0,1,1
06973804,2,2,0,0,2,2,0,0,1
06973812,14,6,8,0,1,1,0,1,1
06973880,10,1,9,0,1,1,0,0,1
06974087,1,0,1,0,1,1,0,0,0
06974126,1,1,0,0,1,1,0,0,1
06974294,8,0,8,0,0,0,0,0,1
06974539,1,1,0,0,1,1,0,0,0
06974749,4,0,4,0,0,0,0,0,1
06975033,7,6,1,0,2,2,0,1,1
06975073,6,4,2,0,3,3,0,0,0
06975228,6,3,3,0,1,1,0,1,0
06975636,3,1,2,0,1,1,0,0,1
06975786,4,1,3,0,1,1,0,0,1
06975790,20,9,11,1,1,1,0,1,1
06975921,20,4,16,0,2,1,1,2,1
06975925,3,2,1,0,1,1,0,0,1
06975962,10,2,8,0,3,1,2,3,0
06976903,1,1,0,0,0,0,0,0,0
06977361,2,0,2,0,1,1,0,0,1
06977427,2,1,1,0,1,1,0,0,0
06977495,4,0,4,0,1,1,0,0,1
06977701,16,6,10,0,0,0,0,0,1
06977707,5,3,2,0,2,2,0,0,1
06977842,5,0,5,0,0,0,0,0,1
06977908,3,2,1,0,1,1,0,0,0
06977942,11,2,9,0,1,1,0,1,1
06978074,14,5,9,0,2,2,0,0,0
06978161,16,6,10,0,0,0,0,0,0
06978433,5,1,4,0,1,1,0,1,1
06978506,5,0,5,0,3,3,0,0,1
06978714,3,2,1,0,2,1,1,0,0
06978720,21,10,11,0,0,0,0,0,1
06978971,20,9,11,0,0,0,0,0,1
06979480,7,0,7,0,0,0,0,0,1
06979548,1,1,0,0,1,1,0,0,0
06979925,4,2,2,0,1,1,0,0,0
06980222,1,0,1,0,1,1,0,0,0
06980618,3,1,2,0,2,1,1,0,1
06980632,4,1,3,0,0,0,0,0,1
06980885,3,2,1,0,1,1,0,0,0
06981129,1,1,0,0,1,1,0,0,1
06981337,7,0,7,0,0,0,0,0,1
06981850,19,3,16,0,1,1,0,0,1
06981874,29,6,23,0,1,1,0,0,1
06982196,1,0,1,0,1,1,0,0,1
06982785,2,1,1,0,1,1,0,0,1
06982795,3,1,2,0,1,1,0,0,0
06982933,3,3,0,0,2,2,0,0,0
06983042,28,8,20,0,1,0,1,0,1
06983710,11,0,11,1,0,0,0,0,1
06983748,6,2,4,0,0,0,0,0,1
06984083,4,0,4,0,0,0,0,0,1
06984217,6,0,6,0,0,0,0,0,1
06984258,7,3,4,0,1,1,0,0,0
06984879,8,1,7,0,1,1,0,0,1
06985004,2,0,2,0,0,0,0,0,1
06985031,1,1,0,0,1,1,0,0,1
06985236,5,3,2,0,2,2,0,0,0
06985367,22,5,17,0,0,0,0,0,1
06985637,3,1,2,0,1,1,0,0,0
06985895,2,0,2,0,0,0,0,0,1
06986368,2,2,0,0,1,1,0,0,0
06987477,6,5,1,0,4,4,0,0,1
06987519,7,0,7,0,0,0,0,0,1
06987720,19,4,15,0,2,2,0,2,1
06988472,12,7,5,0,0,0,0,0,1
06988832,3,3,0,0,1,1,0,0,1
06988944,5,5,0,0,2,2,0,0,1
06989069,14,7,7,0,0,0,0,0,1
06989109,10,4,6,0,1,0,1,0,1
06989136,13,4,9,0,4,0,4,0,1
06989162,13,3,10,0,2,0,2,0,1
06989372,7,0,7,0,0,0,0,0,1
06989380,4,0,4,0,2,2,0,0,1
06989403,7,0,7,0,0,0,0,0,1
06989688,4,3,1,0,2,2,0,0,0
06990086,6,0,6,0,0,0,0,0,1
06990221,4,3,1,0,1,1,0,0,1
06990256,19,7,12,0,1,1,0,1,1
06990301,3,0,3,0,0,0,0,0,0
06990371,2,1,1,0,1,1,0,1,1
06990593,7,3,4,0,4,1,3,1,1
06990762,5,3,2,0,1,1,0,1,1
06991044,11,0,11,0,0,0,0,0,1
06991161,6,0,6,0,2,2,0,0,1
06991314,20,7,13,0,2,2,0,0,0
06991560,22,5,17,0,2,1,1,2,1
06991987,5,0,5,0,0,0,0,0,1
06992513,15,5,10,0,1,1,0,1,1
06993206,7,0,7,0,0,0,0,0,1
06993562,8,2,6,0,1,1,0,1,1
06993738,13,3,10,0,1,1,0,1,1
06994007,10,0,10,1,1,1,0,0,1
06994491,12,0,12,1,1,1,0,0,1
06994618,10,0,10,1,1,1,0,0,1
06995381,10,2,8,0,3,1,2,3,0
06995661,9,4,5,0,0,0,0,0,1
06995665,10,6,4,0,8,7,1,0,1
06995955,3,2,1,0,2,1,1,1,1
06996678,72,23,49,0,0,0,0,0,1
06996819,10,0,10,0,1,1,0,0,1
06996828,24,0,24,0,1,1,0,0,1
06996857,4,0,4,0,1,1,0,0,1
06996953,4,0,4,0,0,0,0,0,1
06996987,6,4,2,0,1,1,0,0,0
06997187,2,1,1,0,2,2,0,1,0
06997799,4,0,4,0,0,0,0,0,1
06997861,1,1,0,0,1,1,0,0,0
06997931,32,8,24,0,0,0,0,0,0
06997994,17,9,8,0,2,1,1,0,1
06998003,4,3,1,0,1,1,0,0,0
06998176,2,1,1,0,2,2,0,0,0
06998292,2,0,2,0,0,0,0,0,1
06999022,5,3,2,0,1,1,0,1,1
06999441,2,2,0,0,1,1,0,0,0
06999691,5,4,1,0,1,1,0,1,0
06999901,3,3,0,0,1,1,0,0,0
06999996,3,2,1,0,1,1,0,0,0
07000311,16,3,13,0,1,1,0,1,1
07000336,16,4,12,0,1,1,0,1,1
07000338,11,4,7,0,6,3,3,0,1
07000342,11,3,8,0,0,0,0,0,1
07000430,2,2,0,0,2,2,0,0,0
07000556,12,0,12,0,0,0,0,0,1
07000558,4,1,3,0,1,1,0,0,1
07001473,15,10,5,0,1,1,0,0,1
07001636,12,0,12,0,0,0,0,0,1
07002111,2,1,1,0,1,1,0,0,0
07002289,1,1,0,0,1,1,0,0,1
07002340,11,3,8,0,3,1,2,0,0
07003050,5,2,3,0,1,1,0,0,0
07003077,5,3,2,0,2,2,0,0,0
07003162,6,2,4,0,3,2,1,0,0
07003472,24,8,16,0,5,0,5,0,1
07003774,16,4,12,0,1,1,0,1,1
07003896,6,4,2,0,2,2,0,0,1
07004014,8,4,4,0,0,0,0,0,1
07004082,4,4,0,0,1,1,0,0,1
07004086,17,6,11,0,0,0,0,0,1
07004534,5,0,5,0,2,2,0,2,1
07004848,2,1,1,0,1,1,0,0,0
07006005,3,3,0,0,1,1,0,0,1
07006334,2,2,0,0,1,1,0,0,0
07006819,4,0,4,0,0,0,0,0,1
07007099,8,4,4,0,2,2,0,0,0
07007117,2,2,0,0,1,1,0,0,0
07007118,13,0,13,0,0,0,0,0,1
07007543,10,0,10,0,0,0,0,0,1
07007649,4,2,2,0,2,2,0,0,0
07008003,21,8,13,0,0,0,0,0,1
07008134,11,4,7,0,0,0,0,0,0
07008398,2,2,0,0,1,1,0,0,0
07008608,6,3,3,0,3,2,1,1,1
07009482,4,4,0,0,0,0,0,0,0
07009960,10,4,6,0,0,0,0,0,0
07010316,3,1,2,0,2,2,0,0,0
07010975,3,0,3,0,0,0,0,0,1
07011226,11,0,11,0,0,0,0,0,1
07011352,3,3,0,0,2,2,0,0,1
07011726,2,0,2,0,0,0,0,0,0
07012678,11,5,6,0,0,0,0,0,1
07012843,3,2,1,0,1,1,0,0,0
07012945,2,1,1,0,1,1,0,0,1
07013775,10,5,5,0,7,5,2,4,1
07014292,10,5,5,0,1,1,0,1,1
07014984,2,2,0,0,1,1,0,0,0
07015240,22,4,18,0,0,0,0,0,1
07015773,37,12,25,0,0,0,0,0,1
07015791,2,1,1,0,2,2,0,0,1
07015892,1,0,1,0,0,0,0,0,0
07015948,1,1,0,0,1,1,0,0,0
07016529,4,2,2,0,1,1,0,0,1
07016586,4,0,4,0,0,0,0,0,0
07016710,3,1,2,0,1,1,0,0,0
07016879,4,3,1,0,4,4,0,0,0
07017267,38,7,31,0,1,1,0,1,1
07017410,30,5,25,0,1,1,0,1,1
07017618,30,5,25,0,1,1,0,1,1
07017619,13,2,11,0,0,0,0,0,1
07018004,11,7,4,0,1,1,0,0,1
07018193,3,1,2,0,1,1,0,0,1
07018881,8,0,8,0,0,0,0,0,1
07018892,12,5,7,0,1,1,0,1,1
07018896,13,4,9,0,1,1,0,1,1
07019414,5,0,5,0,1,1,0,1,1
07019444,13,8,5,0,1,1,0,1,1
07019482,4,0,4,0,2,2,0,0,1
07019796,2,2,0,0,2,1,1,1,0
07019871,9,6,3,0,0,0,0,0,0
07020268,2,2,0,0,2,2,0,0,1
07020334,3,2,1,0,2,2,0,0,0
07020378,4,1,3,0,2,2,0,0,0
07020484,1,1,0,0,1,1,0,0,0
07020487,3,2,1,0,2,2,0,0,1
07020571,11,4,7,0,1,1,0,1,1
07020718,2,2,0,0,2,2,0,0,1
07021060,14,6,8,0,2,1,1,1,1
07021334,13,6,7,0,1,1,0,1,1
07021597,5,0,5,0,1,1,0,0,1
07022278,3,0,3,0,1,1,0,0,0
08530173,2,0,2,0,0,0,0,0,1
08530228,2,2,0,0,1,1,0,0,1
08530444,4,2,2,0,2,2,0,0,0
08530572,1,0,1,0,0,0,0,0,1
08530613,9,0,9,0,0,0,0,0,1
08530782,4,0,4,0,0,0,0,0,0
08531034,2,0,2,0,0,0,0,0,0
08531171,1,1,0,0,1,1,0,0,0
08531748,1,0,1,0,0,0,0,0,1
08531992,1,1,0,0,1,1,0,0,1
08532302,2,2,0,0,1,1,0,0,0
08532329,12,4,8,0,0,0,0,0,1
08532343,1,0,1,0,1,1,0,0,0
08532566,4,3,1,0,2,2,0,0,0
08532600,13,5,8,0,0,0,0,0,0
08532694,15,7,8,0,0,0,0,0,1
08533325,3,0,3,0,0,0,0,0,1
08533908,3,1,2,0,4,1,3,1,0
08534115,2,0,2,0,0,0,0,0,1
08534122,3,2,1,0,1,1,0,0,1
08534249,7,3,4,0,3,1,2,3,1
08534281,7,3,4,0,3,1,2,3,1
08534302,7,3,4,0,3,1,2,3,1
08534328,2,0,2,0,0,0,0,0,1
08534345,7,4,3,0,1,1,0,1,1
08534379,2,0,2,0,0,0,0,0,1
08534441,6,1,5,0,1,1,0,1,1
08534514,2,1,1,0,1,1,0,0,0
08534602,1,1,0,0,1,1,0,0,1
08534643,14,10,4,0,3,0,3,0,1
08535056,1,1,0,0,1,1,0,0,0
08535116,13,6,7,0,0,0,0,0,1
08535265,3,2,1,0,1,1,0,0,1
08535612,1,1,0,0,1,1,0,0,0
08535984,2,2,0,0,1,1,0,0,0
08536380,1,0,1,0,0,0,0,0,1
08536408,2,2,0,0,0,0,0,0,1
08536722,2,2,0,0,2,2,0,0,1
08536915,4,2,2,0,0,0,0,0,0
08536916,4,0,4,3,0,0,0,0,1
08536970,2,2,0,0,2,2,0,0,0
08537181,7,3,4,0,3,3,0,0,1
08537226,4,2,2,0,1,1,0,0,0
08537342,6,4,2,2,3,1,2,1,0
08537452,2,2,0,0,1,1,0,0,0
08537688,4,4,0,0,0,0,0,0,1
08538574,1,1,0,0,1,1,0,0,1
08538716,10,2,8,0,1,1,0,1,1
08538726,10,2,8,0,1,1,0,1,1
08538728,13,5,8,0,0,0,0,0,0
08538747,4,2,2,0,2,1,1,1,1
08538748,9,6,3,0,1,1,0,1,1
08538786,2,2,0,0,2,2,0,0,1
08538791,2,2,0,0,2,2,0,0,1
08539189,2,0,2,0,1,1,0,0,0
08539257,2,1,1,0,1,1,0,0,0
08539526,2,0,2,0,1,1,0,0,0
08540353,1,0,1,0,1,1,0,0,0
08540597,27,12,15,0,3,2,1,3,1
08540623,6,0,6,0,0,0,0,0,0
08540631,7,0,7,0,1,1,0,1,1
08540718,3,0,3,0,0,0,0,0,1
08540834,11,8,3,0,0,0,0,0,1
08540952,2,1,1,0,2,1,1,0,0
08541284,4,2,2,0,1,1,0,0,0
08541395,1,1,0,0,1,1,0,0,0
08541827,6,0,6,0,0,0,0,0,1
08541833,3,3,0,0,1,1,0,0,1
08541849,3,2,1,0,1,1,0,0,1
08542357,1,1,0,0,1,1,0,0,0
08542379,2,1,1,0,2,1,1,0,1
08542489,2,2,0,0,2,2,0,0,0
08542533,9,2,7,0,3,1,2,1,1
08542591,3,3,0,0,3,3,0,0,0
08543305,1,1,0,0,1,1,0,0,0
08543436,2,2,0,0,1,1,0,0,0
08543468,1,1,0,0,1,1,0,0,0
08543742,2,2,0,0,1,1,0,1,0
08543919,8,2,6,0,1,1,0,1,1
08544007,4,3,1,0,1,1,0,0,1
08544111,2,2,0,0,2,2,0,0,0
08544197,4,2,2,0,0,0,0,0,0
08544526,1,1,0,0,1,1,0,0,0
08544842,3,0,3,0,0,0,0,0,1
08545067,1,0,1,0,1,1,0,0,0
08545079,2,2,0,0,2,2,0,0,0
08545091,4,2,2,0,1,1,0,0,1
08545360,2,2,0,0,1,1,0,0,0
08545536,1,0,1,0,0,0,0,0,1
08545833,4,2,2,0,2,1,1,0,0
08546426,2,2,0,0,1,1,0,0,0
08546884,1,0,1,0,0,0,0,0,1
08547260,4,3,1,0,1,1,0,1,1
08547377,2,0,2,0,0,0,0,0,1
08547438,1,1,0,0,0,0,0,0,1
08547596,5,0,5,0,1,1,0,1,1
08547786,15,13,2,0,0,0,0,0,0
08548079,1,0,1,0,1,1,0,0,0
08548118,6,3,3,0,3,3,0,0,1
08548165,6,3,3,0,3,3,0,0,1
08548166,1,1,0,0,1,1,0,0,0
08548178,6,3,3,0,3,3,0,0,1
08548196,6,3,3,0,3,3,0,0,1
08548278,6,0,6,0,0,0,0,0,1
08548511,4,2,2,0,0,0,0,0,1
08548526,16,8,8,0,0,0,0,0,0
08548975,1,0,1,0,0,0,0,0,0
08549657,1,0,1,0,0,0,0,0,0
08549781,1,1,0,0,1,1,0,0,0
08549807,24,13,11,0,4,3,1,0,0
08549841,3,1,2,0,2,2,0,0,1
08550122,7,3,4,0,1,1,0,1,1
08550268,15,10,5,0,1,0,1,0,0
08550744,3,3,0,0,1,1,0,1,1
08551063,1,0,1,0,1,1,0,0,0
08551069,7,5,2,0,3,1,2,1,1
08551474,7,3,4,0,1,1,0,1,1
08551599,9,4,5,0,2,1,1,2,1
08551602,1,0,1,0,1,1,0,0,0
08551604,5,0,5,0,2,2,0,2,1
08551665,3,0,3,0,1,1,0,0,0
08551883,3,2,1,0,1,1,0,0,1
08552054,2,0,2,0,0,0,0,0,0
08552282,4,0,4,0,2,1,1,0,1
08552573,12,7,5,0,2,1,1,0,0
08552689,6,2,4,0,1,1,0,0,1
08553020,1,1,0,0,1,1,0,0,0
08553895,2,2,0,0,1,1,0,0,0
08554157,11,6,5,0,1,1,0,0,1
08554750,1,1,0,0,1,1,0,0,0
08554976,4,3,1,0,1,1,0,0,0
08555588,21,9,12,0,0,0,0,0,1
08555709,2,1,1,0,1,1,0,0,0
08556024,5,0,5,0,0,0,0,0,1
08556127,10,10,0,0,0,0,0,0,1
08556153,4,4,0,0,0,0,0,0,0
08556183,1,1,0,0,1,1,0,0,0
08556186,14,4,10,0,1,1,0,1,1
08557171,2,2,0,0,3,3,0,1,1
08557607,1,0,1,0,0,0,0,0,1
08557665,22,14,8,0,0,0,0,0,1
08557832,3,2,1,0,1,1,0,0,0
08558124,2,0,2,0,0,0,0,0,0
08558176,1,1,0,0,1,1,0,0,0
08558246,15,4,11,1,1,1,0,1,0
08558417,1,0,1,0,0,0,0,0,1
08558746,1,1,0,0,1,1,0,0,1
08559027,1,1,0,0,1,1,0,0,0
08559247,1,1,0,0,1,1,0,0,0
08559442,10,8,2,0,1,1,0,1,1
08559468,8,0,8,0,0,0,0,0,1
08559517,3,1,2,0,1,0,1,1,0
08559745,1,0,1,0,0,0,0,0,0
08559925,2,0,2,0,0,0,0,0,0
08560313,2,2,0,0,2,1,1,0,0
08561222,22,12,10,0,1,1,0,0,1
08561412,4,0,4,0,0,0,0,0,0
08561558,9,3,6,0,3,1,2,3,1
08561574,5,0,5,0,1,1,0,0,0
08561835,4,3,1,0,0,0,0,0,1
08562196,2,0,2,0,2,2,0,0,0
08562370,4,0,4,0,0,0,0,0,1
08562374,4,0,4,0,0,0,0,0,1
08562451,16,7,9,0,1,1,0,1,1
08562534,1,1,0,0,1,1,0,0,0
08562679,1,1,0,0,1,1,0,0,1
08562837,10,4,6,0,0,0,0,0,1
08562901,1,0,1,0,0,0,0,0,0
08563079,1,1,0,0,1,1,0,0,0
08563252,2,0,2,0,0,0,0,0,0
08563366,11,5,6,0,2,2,0,2,1
08563483,6,4,2,0,2,2,0,2,1
08563495,2,1,1,0,1,1,0,0,0
08564030,2,0,2,0,0,0,0,0,1
08564101,2,2,0,0,1,1,0,0,0
08564318,2,0,2,0,0,0,0,0,0
08565148,10,6,4,0,0,0,0,0,1
08565195,2,2,0,0,1,1,0,0,0
08565323,2,1,1,0,1,1,0,0,0
08565402,3,2,1,0,0,0,0,0,0
08565408,3,2,1,0,1,1,0,0,1
08565835,5,0,5,0,0,0,0,0,0
08565850,1,1,0,0,1,1,0,0,0
08566185,27,10,17,0,0,0,0,0,1
08566403,5,3,2,0,3,3,0,0,0
08566429,2,2,0,0,2,2,0,0,0
08566758,2,2,0,0,1,1,0,0,0
08566839,3,0,3,0,0,0,0,0,1
08566895,1,1,0,0,1,1,0,0,0
08566922,5,3,2,0,2,2,0,0,0
08567391,2,2,0,0,2,2,0,0,0
08567573,2,2,0,0,2,2,0,0,0
08567659,1,0,1,0,0,0,0,0,0
08568158,2,0,2,0,0,0,0,0,0
08568295,10,5,5,0,1,1,0,1,1
08568533,11,4,7,0,1,1,0,1,1
08568552,10,5,5,0,1,1,0,1,1
08568596,3,2,1,0,1,1,0,0,0
08568649,12,0,12,0,0,0,0,0,1
08568880,8,4,4,0,7,7,0,0,1
08569113,2,2,0,0,2,2,0,0,0
08569173,3,2,1,0,1,1,0,0,0
08569773,4,2,2,0,1,1,0,0,0
08570561,18,7,11,0,1,1,0,1,1
08571108,4,3,1,0,1,1,0,1,1
08571134,2,2,0,0,2,2,0,0,1
08571148,4,3,1,0,1,1,0,1,1
08571678,1,0,1,0,0,0,0,0,1
08571797,3,0,3,0,1,1,0,0,0
08572328,3,0,3,0,0,0,0,0,0
08572894,5,3,2,0,1,1,0,1,0
08572954,4,2,2,0,1,1,0,0,0
08573614,2,0,2,0,0,0,0,0,1
08573867,2,1,1,0,1,1,0,0,0
08573912,2,2,0,0,0,0,0,0,0
08574667,7,3,4,0,1,1,0,1,1
08574792,2,0,2,0,0,0,0,0,1
08574849,1,0,1,0,0,0,0,0,1
08575477,2,2,0,0,2,2,0,0,1
08575689,8,4,4,0,0,0,0,0,0
08576084,1,0,1,0,0,0,0,0,1
08576228,2,2,0,0,3,3,0,0,0
08576301,1,1,0,0,1,1,0,0,0
08576358,16,9,7,0,0,0,0,0,1
08576415,2,2,0,0,3,3,0,1,0
08576475,2,2,0,0,0,0,0,0,0
08576499,32,7,25,0,0,0,0,0,1
08576824,2,2,0,0,2,2,0,0,0
08577062,6,6,0,0,1,1,0,1,1
08577086,1,0,1,0,0,0,0,0,0
08577133,2,0,2,0,0,0,0,0,0
08577555,2,2,0,0,2,2,0,0,0
08578057,4,3,1,0,1,1,0,0,0
08578176,7,0,7,0,0,0,0,0,1
08578328,6,0,6,0,0,0,0,0,0
08578438,13,7,6,0,0,0,0,0,1
08578451,7,4,3,0,1,1,0,1,1
08578576,11,8,3,0,1,1,0,1,1
08578613,2,0,2,0,0,0,0,0,0
08578659,2,0,2,0,0,0,0,0,1
08578699,2,0,2,0,0,0,0,0,1
08578954,7,2,5,0,2,2,0,0,0
08579378,1,0,1,0,0,0,0,0,0
08579692,2,1,1,0,1,1,0,0,0
08580215,4,3,1,0,1,1,0,0,0
08580428,4,2,2,0,1,1,0,0,0
08580497,2,2,0,0,1,1,0,0,0
08580828,14,4,10,0,1,1,0,1,1
08581988,2,2,0,0,1,1,0,0,0
08582114,1,1,0,0,1,1,0,0,0
08582655,1,1,0,0,1,1,0,0,0
08583692,4,4,0,0,1,1,0,0,0
08583874,6,0,6,0,1,1,0,0,0
08583892,4,2,2,0,0,0,0,0,1
08584442,1,1,0,0,2,2,0,0,0
08585232,6,3,3,0,0,0,0,0,1
08585368,1,1,0,0,1,1,0,0,0
08585484,2,2,0,0,1,1,0,0,0
08585568,3,2,1,0,1,1,0,0,1
08585775,2,2,0,0,1,1,0,0,0
08586146,5,3,2,0,1,1,0,0,1
08586785,1,0,1,0,0,0,0,0,0
08586858,3,1,2,0,1,1,0,1,0
08586985,4,3,1,0,2,2,0,0,0
08587641,5,3,2,0,0,0,0,0,1
08587682,1,0,1,0,0,0,0,0,1
08587707,3,2,1,0,1,1,0,1,1
08588142,5,2,3,0,0,0,0,0,0
08588212,9,3,6,0,1,1,0,1,1
08588297,3,3,0,0,2,2,0,0,0
08588811,2,2,0,0,2,2,0,0,0
08588840,1,1,0,0,2,2,0,0,1
08588872,1,0,1,0,1,1,0,0,0
08588963,3,1,2,0,1,1,0,0,0
08589241,9,2,7,0,1,1,0,1,1
08589377,6,4,2,0,1,0,1,0,1
08589427,12,9,3,0,1,1,0,1,1
08589484,15,6,9,1,1,1,0,1,1
08589522,2,2,0,0,1,1,0,0,1
08589638,2,1,1,0,1,1,0,0,0
08589646,9,2,7,0,1,1,0,1,1
08590001,1,0,1,0,0,0,0,0,1
08590449,7,7,0,0,1,1,0,0,0
08590560,3,1,2,0,3,1,2,0,0
08591067,5,3,2,0,3,1,2,1,1
08591887,2,2,0,0,2,2,0,0,0
08592117,1,1,0,0,1,1,0,0,0
08592599,9,4,5,0,1,1,0,1,1
08593063,7,5,2,0,0,0,0,0,1
08593656,2,2,0,0,1,1,0,0,0
08593860,6,3,3,0,2,2,0,0,1
08593983,1,0,1,0,0,0,0,0,0
08594325,2,0,2,0,0,0,0,0,0
08594745,2,0,2,0,0,0,0,0,0
08595012,3,2,1,0,2,2,0,0,0
08595203,2,2,0,0,1,1,0,0,0
08595563,4,4,0,0,1,1,0,0,1
08595855,2,2,0,0,0,0,0,0,0
08596527,3,0,3,0,0,0,0,0,0
08596592,3,2,1,0,1,1,0,0,0
08596836,8,5,3,0,2,2,0,0,1
08596857,1,1,0,0,1,1,0,0,0
08597161,4,3,1,0,3,1,2,0,1
08597174,2,2,0,0,1,1,0,0,0
08597304,3,0,3,0,0,0,0,0,0
08597569,2,2,0,0,2,2,0,0,1
08597738,8,5,3,0,1,0,1,0,1
08597784,17,10,7,0,0,0,0,0,0
08597833,1,1,0,0,1,1,0,0,0
08597911,14,1,13,0,0,0,0,0,1
08597912,14,1,13,0,0,0,0,0,1
08598500,8,7,1,2,3,1,2,1,0
08598635,1,1,0,0,1,1,0,0,0
08598706,15,7,8,0,3,2,1,1,1
08599160,2,2,0,0,2,2,0,0,0
08599305,1,1,0,0,1,1,0,0,0
08599501,5,0,5,0,0,0,0,0,1
08599535,1,1,0,0,1,1,0,0,0
08599721,10,4,6,0,0,0,0,0,1
08599890,2,2,0,0,1,1,0,1,1
08599991,1,1,0,0,0,0,0,0,0
08600335,1,1,0,0,1,1,0,0,0
08600373,1,1,0,0,1,1,0,0,0
08600723,2,2,0,0,1,1,0,0,0
08601291,12,4,8,0,0,0,0,0,0
08601336,14,0,14,0,0,0,0,0,1
08601368,2,0,2,0,2,2,0,0,0
08601507,1,1,0,0,1,1,0,1,1
08601814,15,9,6,0,1,1,0,0,0
08601852,8,8,0,0,2,0,2,0,0
08602271,2,0,2,0,0,0,0,0,1
08602388,2,2,0,0,1,1,0,0,0
08602524,2,0,2,0,0,0,0,0,1
08602927,2,0,2,0,0,0,0,0,1
10080199,2,2,0,0,2,2,0,0,0
10080222,1,0,1,0,1,1,0,0,0
10080286,1,1,0,0,1,1,0,0,0
10080673,1,1,0,0,1,1,0,0,0
10080695,2,2,0,0,2,2,0,0,1
10080955,1,1,0,0,2,1,1,1,0
10081708,1,1,0,0,1,1,0,1,0
10081847,6,4,2,0,3,3,0,0,1
10081902,3,0,3,0,1,1,0,0,0
10082315,2,0,2,0,1,1,0,0,0
10082394,3,3,0,0,1,1,0,0,0
10083358,1,1,0,0,1,1,0,0,0
10083547,2,2,0,0,1,1,0,0,1
10083627,2,2,0,0,2,2,0,0,0
10084105,9,2,7,0,2,1,1,2,1
10084542,4,0,4,0,1,1,0,0,1
10084743,14,9,5,0,0,0,0,0,1
10084777,2,2,0,0,1,1,0,0,1
10084867,1,0,1,0,0,0,0,0,0
10085024,6,3,3,0,2,2,0,0,0
10085206,4,0,4,0,2,0,2,0,0
10085236,4,4,0,0,0,0,0,0,0
10085513,1,1,0,0,1,1,0,0,0
10085547,5,3,2,0,1,1,0,1,0
10085828,1,0,1,0,1,1,0,0,0
10086102,4,3,1,0,2,1,1,0,0
10086814,1,0,1,0,1,1,0,0,0
10087258,2,0,2,0,0,0,0,0,0
10087524,2,0,2,0,1,1,0,0,0
10087857,1,1,0,0,1,1,0,0,1
10088172,3,3,0,0,1,1,0,1,1
10088293,3,0,3,0,0,0,0,0,0
10089108,6,5,1,0,3,3,0,0,1
10089313,1,1,0,0,1,1,0,0,1
10089417,2,1,1,0,1,1,0,0,0
10089741,5,5,0,0,2,2,0,0,1
10089963,2,2,0,0,2,2,0,0,0
10090271,3,3,0,0,2,2,0,0,0
10090746,2,2,0,0,2,2,0,0,0
10091367,3,2,1,0,1,1,0,1,1
10091909,2,0,2,0,1,1,0,0,0
10092604,1,1,0,0,1,1,0,0,0
10093017,4,4,0,0,2,2,0,0,0
10093395,1,0,1,0,0,0,0,0,1
10094137,7,6,1,0,0,0,0,0,0
10094455,2,1,1,0,2,2,0,0,0
10094630,2,1,1,0,3,2,1,0,0
10094722,1,0,1,0,0,0,0,0,0
10095147,2,2,0,0,1,1,0,0,1
10095214,3,0,3,0,0,0,0,0,1
10095275,1,1,0,0,1,1,0,0,0
10095412,4,3,1,0,3,3,0,0,0
10095431,4,3,1,0,3,2,1,0,0
10095467,1,1,0,0,1,1,0,0,0
10095593,7,3,4,0,1,1,0,1,1
10096025,1,1,0,0,1,1,0,0,0
10096379,2,2,0,0,1,1,0,1,1
10096767,5,3,2,0,4,1,3,2,1
10096873,1,1,0,0,1,1,0,0,0
10097156,1,0,1,0,1,1,0,0,0
10097239,1,0,1,0,1,1,0,0,1
10097300,3,1,2,0,1,1,0,0,1
10097366,1,1,0,0,3,3,0,0,0
10097564,1,1,0,0,1,1,0,0,0
10097579,1,1,0,0,1,1,0,0,0
10098284,1,1,0,0,1,1,0,0,0
10098396,2,2,0,0,0,0,0,0,0
10098613,6,3,3,0,0,0,0,0,1
10098890,8,6,2,0,0,0,0,0,0
10098892,3,1,2,0,1,1,0,0,0
10098911,4,1,3,0,4,2,2,1,0
10099103,3,3,0,0,0,0,0,0,0
10099128,2,1,1,0,1,1,0,0,0
10099130,2,1,1,0,1,1,0,0,0
10099405,2,1,1,0,2,2,0,0,0
10099407,2,1,1,0,1,1,0,0,0
10099419,2,1,1,0,1,1,0,0,0
10099585,2,0,2,0,0,0,0,0,0
10099680,7,1,6,0,4,1,3,0,0
10099905,1,1,0,0,1,1,0,0,0
10100129,2,2,0,0,2,2,0,0,0
10100378,1,1,0,0,1,1,0,0,0
10100420,2,2,0,0,1,1,0,0,0
10100697,3,3,0,0,3,3,0,0,1
10101220,4,4,0,0,1,1,0,0,1
10101278,3,1,2,0,1,1,0,0,0
10102086,1,1,0,0,1,1,0,0,0
10102835,1,1,0,0,1,1,0,0,0
10103325,2,2,0,0,2,2,0,0,0
10103398,4,3,1,0,2,1,1,0,1
10103822,5,4,1,0,1,1,0,0,0
10104345,3,2,1,0,1,1,0,0,1
10104945,1,1,0,0,1,1,0,0,0
10105281,2,2,0,0,1,1,0,1,1
10105352,1,1,0,0,1,1,0,0,0
10105411,4,4,0,0,1,1,0,0,0
10105496,2,2,0,0,1,1,0,0,0
10106138,1,1,0,0,1,1,0,0,0
10106212,2,2,0,0,2,2,0,0,0
10106651,1,0,1,0,1,1,0,0,0
10107134,1,1,0,0,1,1,0,0,0
10107165,1,1,0,0,1,1,0,0,0
10107354,1,1,0,0,1,1,0,0,1
10107606,4,3,1,0,3,2,1,0,0
10107764,2,2,0,0,2,2,0,0,1
10108981,1,0,1,0,1,1,0,0,0
10109290,1,1,0,0,1,1,0,0,0
10109694,3,2,1,0,0,0,0,0,1
10109790,3,0,3,0,1,1,0,0,0
10109829,3,2,1,0,0,0,0,0,1
10109912,2,2,0,0,2,2,0,0,0
10110723,4,2,2,0,0,0,0,0,0
10111387,2,2,0,0,1,1,0,0,0
10111497,2,1,1,0,2,1,1,0,0
10111586,3,3,0,0,1,1,0,0,0
10112351,7,3,4,0,2,1,1,2,1
10112471,1,0,1,0,1,1,0,0,1
10112554,2,0,2,0,2,2,0,0,0
10112950,1,0,1,0,1,1,0,0,0
10113036,18,10,8,0,0,0,0,0,0
10113364,2,2,0,0,3,2,1,0,1
10113564,3,3,0,0,1,1,0,0,1
10113701,1,1,0,0,1,1,0,0,0
10114004,2,2,0,0,2,2,0,0,0
10114006,2,2,0,0,2,2,0,0,0
10114060,2,2,0,0,2,2,0,0,0
10114449,2,0,2,0,0,0,0,0,1
10114537,2,2,0,0,2,2,0,2,1
10114585,3,2,1,0,1,1,0,0,0
10115829,2,2,0,0,1,1,0,0,0
10116012,1,1,0,0,1,1,0,0,1
10116200,2,2,0,0,1,1,0,0,0
10116452,2,2,0,0,2,2,0,0,0
10117916,6,0,6,0,3,1,2,0,0
10118088,5,0,5,0,1,1,0,0,0
10118104,3,0,3,0,2,1,1,0,0
10118348,4,0,4,0,2,1,1,0,0
10119096,2,0,2,0,1,1,0,0,0
10119219,2,2,0,0,1,1,0,0,1
10119396,1,1,0,0,1,1,0,0,0
10119841,1,1,0,0,1,1,0,0,0
10119861,1,1,0,0,1,1,0,0,0
10120942,7,6,1,0,3,1,2,3,1
10120977,1,1,0,0,1,1,0,0,0
10121289,5,3,2,0,3,3,0,0,0
10121515,3,3,0,0,3,3,0,0,0
10121534,1,1,0,0,1,1,0,0,0
10122055,1,1,0,0,1,1,0,0,0
10122083,1,0,1,0,0,0,0,0,1
10122164,5,5,0,0,0,0,0,0,1
10122367,2,2,0,0,1,1,0,0,0
10122587,1,0,1,0,1,1,0,0,0
10123059,1,1,0,0,1,1,0,0,0
10123424,2,0,2,0,0,0,0,0,0
10123607,13,10,3,0,9,0,9,1,1
10123650,2,0,2,0,1,1,0,0,0
10123785,1,0,1,0,0,0,0,0,1
10124076,2,1,1,0,1,1,0,0,0
10124124,2,1,1,0,1,1,0,0,0
10124448,3,3,0,0,1,1,0,0,0
10124762,6,2,4,0,1,1,0,1,1
10124871,1,1,0,0,1,1,0,0,0
10125069,2,0,2,0,2,2,0,0,0
10125597,1,1,0,0,1,1,0,0,0
10125599,3,3,0,0,2,2,0,0,0
10125682,2,2,0,0,2,2,0,0,0
10125777,2,2,0,0,1,1,0,0,0
10126038,6,1,5,0,6,1,5,0,0
10126271,1,1,0,0,2,2,0,0,0
10127154,1,1,0,0,1,1,0,0,0
10127234,12,0,12,0,0,0,0,0,0
10127574,2,2,0,0,2,2,0,0,0
10127627,1,1,0,0,2,2,0,0,1
10128575,1,0,1,0,1,1,0,0,0
10128711,2,2,0,0,1,1,0,0,1
10128722,2,1,1,0,1,1,0,0,0
10129133,4,1,3,0,1,1,0,1,0
10129606,4,2,2,0,1,1,0,0,1
10129720,1,0,1,0,1,1,0,0,0
10129905,2,1,1,0,2,2,0,1,1
10129984,1,1,0,0,1,1,0,0,0
10130282,2,1,1,0,1,1,0,0,0
10130327,2,2,0,0,1,1,0,0,1
10130493,2,2,0,0,2,2,0,0,1
10130503,2,2,0,0,2,2,0,0,0
10130642,1,1,0,0,1,1,0,0,1
10131418,3,3,0,0,2,2,0,0,0
10131918,1,1,0,0,1,1,0,0,0
10132596,5,0,5,0,0,0,0,0,0
10132677,1,0,1,0,0,0,0,0,0
10133076,1,0,1,0,0,0,0,0,0
10133641,3,2,1,0,2,1,1,1,0
10133872,1,1,0,0,1,1,0,0,0
10133978,1,1,0,0,1,1,0,0,0
10134271,9,4,5,0,2,1,1,2,0
10134859,1,1,0,0,1,1,0,0,1
10135092,2,2,0,0,0,0,0,0,1
10135597,9,4,5,0,2,2,0,2,1
10135796,2,1,1,0,2,1,1,0,0
10135900,2,2,0,0,2,2,0,0,1
10136091,2,1,1,0,2,2,0,0,0
10136505,3,3,0,0,1,1,0,0,1
10136519,2,1,1,0,2,1,1,0,0
10137796,3,3,0,0,2,2,0,0,0
10138561,8,3,5,0,0,0,0,0,0
10139184,2,1,1,0,0,0,0,0,0
10139387,1,1,0,0,1,1,0,0,0
10139433,4,3,1,0,1,1,0,1,0
10139455,1,1,0,0,1,1,0,0,0
10140255,1,0,1,0,1,1,0,0,0
10140325,5,4,1,0,2,2,0,0,1
10140355,1,0,1,0,0,0,0,0,0
10140378,1,0,1,0,0,0,0,0,0
10142224,26,17,9,0,2,2,0,2,1
10142333,2,2,0,0,2,2,0,0,0
10142738,17,8,9,0,0,0,0,0,1
10143044,1,0,1,0,1,1,0,0,0
10143080,3,3,0,0,1,1,0,0,1
10143485,2,2,0,0,2,2,0,0,0
10143792,9,6,3,0,3,2,1,0,1
10144062,3,3,0,0,3,3,0,0,0
10144153,1,1,0,0,1,1,0,0,0
10144302,2,1,1,0,2,2,0,0,1
10144347,4,4,0,0,3,3,0,0,0
10144465,4,4,0,0,1,1,0,0,1
10144850,1,1,0,0,1,1,0,0,1
10144885,2,2,0,0,1,1,0,0,1
10145066,1,1,0,0,1,1,0,0,0
10145379,3,2,1,0,1,1,0,0,0
10145977,5,4,1,0,0,0,0,0,1
10146092,1,1,0,0,1,1,0,0,0
10146210,2,2,0,0,2,2,0,0,0
10147034,2,2,0,0,1,1,0,0,0
10147080,2,1,1,0,1,1,0,0,0
10147433,1,1,0,0,1,1,0,0,0
10147542,3,3,0,0,3,3,0,0,1
10147782,2,1,1,0,2,1,1,0,0
10148088,2,0,2,0,1,1,0,0,0
10148416,1,0,1,0,0,0,0,0,0
10148516,1,0,1,0,1,1,0,0,0
10148761,4,0,4,0,0,0,0,0,0
10149487,2,0,2,0,1,1,0,0,1
10149917,2,0,2,0,1,1,0,0,0
10149951,4,3,1,0,4,4,0,1,1
10150300,4,4,0,0,1,1,0,0,1
10150497,8,8,0,0,0,0,0,0,1
10150573,1,1,0,0,1,1,0,0,0
10150975,2,2,0,0,2,2,0,0,0
10151329,1,1,0,0,1,1,0,0,1
10151905,1,0,1,0,0,0,0,0,0
10152324,4,3,1,0,1,1,0,1,0
10152692,1,1,0,0,1,1,0,0,0
10153017,2,2,0,0,2,2,0,0,0
10153359,3,1,2,0,2,1,1,0,1
10153535,4,4,0,0,1,1,0,0,1
10153657,6,6,0,0,0,0,0,0,1
10153708,2,2,0,0,0,0,0,0,0
10153879,2,2,0,0,2,2,0,0,1
10155123,4,4,0,0,0,0,0,0,0
10155507,2,2,0,0,1,1,0,1,0
10155567,2,0,2,0,1,1,0,0,0
10156049,4,0,4,0,0,0,0,0,0
10156911,10,8,2,0,1,1,0,1,1
10156992,1,1,0,0,1,1,0,0,0
10157325,5,0,5,0,0,0,0,0,0
10157448,1,1,0,0,1,1,0,0,0
10157452,1,1,0,0,1,1,0,0,0
10157724,5,3,2,0,4,2,2,0,0
10157976,6,5,1,0,1,1,0,1,0
10158066,17,13,4,0,0,0,0,0,0
10158073,1,1,0,0,1,1,0,1,0
10159036,1,1,0,0,1,1,0,0,0
10159516,1,1,0,0,1,1,0,0,0
10159825,12,7,5,0,1,1,0,0,0
10159898,6,2,4,0,2,2,0,0,0
10160066,2,0,2,0,0,0,0,0,0
10160413,2,1,1,0,1,1,0,0,1
10160484,3,0,3,0,1,1,0,0,1
10161298,2,2,0,0,2,2,0,0,0
10161663,2,2,0,0,2,2,0,0,1
10161780,1,1,0,0,1,1,0,0,1
10161817,4,4,0,0,0,0,0,0,0
10161990,1,0,1,0,1,1,0,0,0
10162225,10,6,4,0,1,1,0,1,1
10162279,2,1,1,0,1,1,0,0,0
10162282,1,0,1,0,1,1,0,0,0
10162369,11,3,8,0,4,1,3,2,1
10162441,7,3,4,0,1,1,0,1,1
10162605,7,3,4,0,1,1,0,1,1
10162652,1,1,0,0,2,1,1,0,0
10162656,1,1,0,0,1,1,0,0,0
10162781,5,0,5,0,1,1,0,1,0
10163400,2,2,0,0,2,2,0,0,0
10163520,1,0,1,0,1,1,0,0,0
10163623,3,3,0,0,1,1,0,1,1
10163642,1,0,1,0,0,0,0,0,0
10164103,3,3,0,0,1,1,0,1,1
10164130,1,1,0,0,1,1,0,0,0
10164566,2,1,1,0,1,1,0,0,0
10164668,9,9,0,0,1,1,0,1,1
10164867,1,0,1,0,1,1,0,0,0
10165063,1,1,0,0,1,1,0,0,0
10165504,1,0,1,0,0,0,0,0,0
10166046,4,2,2,0,2,1,1,0,1
10166116,4,2,2,0,2,1,1,0,1
10166528,2,2,0,0,1,1,0,0,1
10166570,3,2,1,0,3,2,1,0,1
10166937,3,2,1,0,2,2,0,0,0
10167001,6,5,1,2,3,1,2,1,0
10167191,6,5,1,0,1,1,0,1,1
10167291,2,2,0,0,2,2,0,0,0
10167471,1,1,0,0,1,1,0,0,0
10168195,1,1,0,0,1,1,0,0,0
10168304,2,2,0,0,2,2,0,0,0
10168436,3,3,0,0,2,0,2,0,1
10168480,1,1,0,0,1,1,0,0,0
10168908,2,0,2,0,0,0,0,0,0
10169698,4,2,2,0,2,1,1,1,1
10169702,2,2,0,0,1,1,0,0,0
10169820,6,3,3,0,1,1,0,1,1
10169939,1,0,1,0,1,1,0,0,0
10170629,1,1,0,0,1,1,0,0,0
10171409,2,2,0,0,2,2,0,0,1
10171532,1,0,1,0,2,2,0,0,0
10171572,2,2,0,0,2,2,0,0,0
10171923,1,1,0,0,1,1,0,0,0
10172098,3,3,0,0,2,2,0,0,0
10172167,3,0,3,0,1,1,0,0,0
10172314,3,1,2,0,1,1,0,0,0
10172715,9,3,6,0,1,1,0,1,0
10173340,1,1,0,0,1,1,0,0,0
10173830,1,1,0,0,1,1,0,0,0
10173980,3,0,3,0,0,0,0,0,0
10174186,2,2,0,0,1,1,0,0,0
10174740,6,2,4,1,1,1,0,1,1
10175021,15,3,12,0,0,0,0,0,0
10175551,1,0,1,0,1,1,0,0,0
10175902,6,4,2,0,0,0,0,0,1
10176057,2,1,1,0,1,1,0,0,0
10176264,7,5,2,0,0,0,0,0,0
10176302,2,0,2,0,2,2,0,0,1
10176819,2,0,2,0,1,1,0,0,0
10177057,5,4,1,0,2,2,0,2,1
10177130,3,2,1,0,3,2,1,0,1
10177205,3,3,0,0,3,3,0,0,0
10177334,5,4,1,0,1,1,0,1,0
10177384,5,4,1,0,1,1,0,1,0
10177593,4,3,1,0,1,1,0,0,0
10178051,2,1,1,0,1,1,0,0,0
10178512,8,3,5,0,1,1,0,1,0
10178572,1,1,0,0,1,1,0,0,0
10179202,5,3,2,0,1,1,0,1,1
10179232,1,1,0,0,1,1,0,0,0
10179239,5,5,0,0,1,1,0,0,0
10179278,5,0,5,0,0,0,0,0,1
10179381,3,3,0,0,2,2,0,0,0
10179600,1,1,0,0,1,1,0,1,0
10179944,1,1,0,0,1,1,0,0,0
04494290,5,2,3,0,1,1,0,0,0
04494323,18,5,13,0,1,1,0,1,1
04494410,12,3,9,0,1,1,0,1,0
04494415,17,3,14,0,1,1,0,0,1
04494571,5,3,2,0,1,1,0,0,1
04495024,11,4,7,0,1,1,0,0,1
04495360,28,2,26,0,2,1,1,2,1
04495361,15,6,9,0,1,1,0,1,1
04495560,37,13,24,0,2,1,1,0,1
04496084,5,2,3,0,2,1,1,0,0
04496300,5,3,2,0,2,2,0,0,1
04496563,9,0,9,0,1,1,0,1,1
04496566,23,5,18,0,1,1,0,1,1
04496572,9,0,9,0,1,1,0,1,1
04496573,24,5,19,0,1,1,0,1,1
04496744,6,3,3,0,2,2,0,0,0
04496748,5,1,4,0,2,1,1,0,0
04496750,43,4,39,0,1,1,0,1,1
04496754,55,11,44,0,0,0,0,0,1
04497013,22,7,15,0,0,0,0,0,1
04497042,24,0,24,0,0,0,0,0,1
04497290,25,8,17,0,1,1,0,1,1
04497500,11,2,9,0,0,0,0,0,0
04497758,39,13,26,0,1,1,0,1,1
04497812,6,2,4,0,4,4,0,0,1
04498043,4,0,4,0,2,2,0,0,1
04498304,6,2,4,0,1,1,0,0,0
04498478,11,3,8,0,3,2,1,0,1
04498630,28,7,21,0,0,0,0,0,1
04498683,66,16,50,0,0,0,0,0,1
04498795,5,3,2,0,2,2,0,0,0
04498846,5,3,2,0,2,2,0,0,0
04498901,13,4,9,0,0,0,0,0,1
04498921,32,0,32,0,0,0,0,0,1
04499128,5,0,5,0,0,0,0,0,0
04499150,4,0,4,0,2,2,0,0,1
04499274,8,2,6,0,2,2,0,0,0
04499296,5,3,2,0,1,1,0,0,1
04499386,4,2,2,0,1,1,0,0,0
04499433,11,4,7,0,1,1,0,1,1
04500088,44,0,44,0,0,0,0,0,1
04500781,8,6,2,0,2,2,0,0,1
04500926,17,3,14,0,1,1,0,1,1
04501026,14,6,8,0,5,5,0,0,1
04501363,5,3,2,0,1,1,0,0,0
04501396,6,3,3,0,3,3,0,0,0
04502128,2,0,2,0,1,1,0,0,0
04502146,4,0,4,0,2,2,0,0,1
04502436,18,3,15,0,2,1,1,2,1
04502652,5,3,2,0,1,1,0,0,0
04502723,13,6,7,0,1,1,0,1,0
04502778,7,2,5,0,1,1,0,0,0
04502839,5,3,2,0,1,1,0,0,1
04502851,28,6,22,0,0,0,0,0,1
04503061,8,4,4,0,3,3,0,0,1
04503118,4,0,4,0,0,0,0,0,1
04503174,5,3,2,0,2,2,0,0,1
04503235,13,9,4,0,1,0,1,0,1
04503297,4,2,2,0,1,1,0,0,1
04503426,4,2,2,0,1,1,0,0,1
04503510,5,3,2,0,2,2,0,0,0
04503512,18,0,18,0,0,0,0,0,1
04503573,3,3,0,0,1,1,0,0,0
04503681,5,2,3,0,1,1,0,0,0
04503712,13,5,8,0,0,0,0,0,1
04503860,4,0,4,0,2,2,0,0,0
04503923,8,2,6,0,1,1,0,0,1
04504051,25,11,14,0,0,0,0,0,1
04504085,41,15,26,0,0,0,0,0,1
04504128,56,10,46,0,0,0,0,0,1
04504137,5,2,3,0,1,1,0,0,1
04504156,5,3,2,0,1,1,0,0,1
04504293,5,3,2,0,1,1,0,0,0
04504358,8,4,4,0,1,1,0,1,0
04504417,9,0,9,0,0,0,0,0,1
04505411,7,5,2,0,3,2,1,0,0
04505429,10,4,6,0,0,0,0,0,1
04505613,9,0,9,0,0,0,0,0,1
04505636,5,3,2,0,2,2,0,0,0
04505768,21,3,18,0,0,0,0,0,1
04506286,4,2,2,0,1,1,0,0,1
04506345,5,3,2,0,2,2,0,0,0
04506542,6,0,6,0,2,2,0,0,0
04506589,12,0,12,0,1,1,0,1,1
04506956,4,2,2,0,1,1,0,0,0
04506987,11,6,5,0,2,1,1,1,1
04507108,5,1,4,0,2,1,1,0,0
04507114,5,3,2,0,2,1,1,0,1
04507227,4,3,1,0,1,1,0,1,0
04507287,79,18,61,0,1,0,1,0,1
04507310,4,2,2,0,1,1,0,0,0
04507411,4,2,2,0,1,1,0,0,1
04507654,6,1,5,0,1,1,0,0,0
04507679,12,2,10,0,1,1,0,0,1
04508129,5,1,4,0,1,1,0,0,0
04508171,4,2,2,0,1,1,0,0,1
04508640,11,3,8,0,2,1,1,1,0
04508773,31,5,26,0,1,1,0,1,1
04508871,13,2,11,0,1,1,0,0,0
04508881,14,6,8,0,1,1,0,1,1
04508947,46,6,40,0,1,1,0,1,1
04508948,46,6,40,0,1,1,0,1,1
04509032,6,4,2,0,1,1,0,0,0
04509293,37,10,27,0,0,0,0,0,1
04509332,5,3,2,0,1,1,0,1,1
04509398,6,1,5,0,2,2,0,0,1
04509441,37,0,37,0,0,0,0,0,1
04509534,5,3,2,0,1,1,0,0,0
04509552,5,3,2,0,2,2,0,0,1
04509666,5,1,4,0,1,1,0,0,0
04509675,7,3,4,0,2,2,0,0,1
04509705,9,4,5,0,1,1,0,1,1
04509936,37,14,23,0,0,0,0,0,1
04510043,5,3,2,0,2,2,0,0,1
04510061,5,3,2,0,2,2,0,0,1
04510105,6,2,4,0,2,2,0,0,1
04510382,10,0,10,0,0,0,0,0,1
04510529,17,0,17,0,0,0,0,0,1
04510695,9,0,9,0,0,0,0,0,1
04510759,5,4,1,0,3,3,0,0,0
04510808,6,1,5,0,2,2,0,0,0
04510839,10,3,7,0,2,2,0,0,0
04511081,9,2,7,0,0,0,0,0,0
04511196,15,2,13,0,0,0,0,0,1
04511368,8,2,6,0,1,1,0,0,1
04511936,15,4,11,2,3,3,0,0,1
04511972,6,2,4,0,1,1,0,0,1
04512301,22,3,19,0,1,1,0,1,1
04512317,10,0,10,0,1,1,0,1,1
04512575,9,6,3,0,4,4,0,1,1
04512803,5,0,5,0,1,1,0,0,1
04512833,8,2,6,0,2,2,0,0,1
04512889,5,2,3,0,2,1,1,0,0
04513042,4,2,2,0,1,1,0,0,1
04513093,7,0,7,0,0,0,0,0,1
04513175,5,0,5,0,0,0,0,0,1
04513189,4,0,4,0,0,0,0,0,1
04513193,11,0,11,0,0,0,0,0,1
04513499,15,7,8,0,8,4,4,2,1
04513766,45,12,33,0,0,0,0,0,1
04513830,5,0,5,0,0,0,0,0,1
04513834,5,0,5,0,0,0,0,0,1
04513838,5,0,5,0,0,0,0,0,1
04514005,13,3,10,0,1,1,0,0,1
04514386,25,0,25,0,0,0,0,0,1
04514396,23,0,23,0,0,0,0,0,1
04514676,37,6,31,0,0,0,0,0,1
04514727,6,0,6,0,0,0,0,0,1
04515001,7,4,3,0,1,1,0,1,1
04515167,26,0,26,0,0,0,0,0,1
04515375,24,9,15,0,1,1,0,0,1
04515420,5,0,5,0,1,1,0,1,1
04515549,5,4,1,0,1,1,0,1,1
04515645,5,2,3,0,2,2,0,1,1
04516079,31,3,28,0,1,1,0,1,1
04516140,27,13,14,0,1,1,0,0,1
04516192,11,0,11,0,0,0,0,0,1
04516482,17,5,12,0,0,0,0,0,1
04516550,7,4,3,1,2,2,0,2,0
04517149,13,8,5,0,1,1,0,1,1
04517171,4,1,3,0,1,1,0,0,0
04517172,4,0,4,0,3,2,1,0,1
04517407,16,8,8,0,0,0,0,0,1
04517532,7,1,6,0,1,1,0,0,0
04517544,43,9,34,0,0,0,0,0,1
04517620,25,0,25,0,0,0,0,0,1
04517621,12,4,8,0,2,1,1,1,1
04517669,9,2,7,0,1,1,0,0,1
04517730,12,2,10,0,2,1,1,2,1
04517785,4,2,2,0,1,1,0,0,0
04518138,31,5,26,0,0,0,0,0,1
04518346,10,3,7,0,3,3,0,0,0
04518568,13,0,13,0,0,0,0,0,1
04518684,5,3,2,0,2,2,0,0,0
04518865,7,3,4,0,1,1,0,1,1
04518868,9,3,6,0,1,1,0,0,1
04518938,12,3,9,0,2,2,0,0,1
04518957,8,1,7,0,1,1,0,0,1
04519702,16,5,11,0,3,2,1,1,1
04519733,5,2,3,0,1,1,0,0,0
04519788,11,3,8,0,0,0,0,0,1
04519977,20,3,17,0,0,0,0,0,1
04520425,4,2,2,0,2,2,0,0,0
04520518,5,0,5,0,0,0,0,0,0
04520748,4,2,2,0,1,1,0,0,1
04521150,10,3,7,0,1,1,0,1,1
04521257,56,11,45,0,1,1,0,1,1
04521284,80,18,62,0,0,0,0,0,1
04521394,7,2,5,0,1,1,0,0,1
04521764,35,12,23,0,0,0,0,0,0
04521774,16,4,12,0,1,1,0,0,1
04522122,11,0,11,0,0,0,0,0,1
04522200,36,9,27,0,0,0,0,0,0
04522263,5,3,2,0,2,2,0,0,0
04522269,6,3,3,0,1,1,0,1,1
04522274,5,2,3,0,1,1,0,1,1
04522302,5,3,2,0,2,2,0,0,0
04522545,9,3,6,0,1,1,0,0,1
04522594,5,2,3,0,1,1,0,0,0
04522700,23,11,12,0,1,1,0,0,0
04522772,7,2,5,0,0,0,0,0,1
04523013,24,8,16,0,0,0,0,0,1
04523016,31,12,19,0,0,0,0,0,1
04523052,35,10,25,0,1,1,0,1,1
04523201,31,3,28,0,0,0,0,0,0
04523300,5,3,2,0,2,2,0,0,0
04523503,8,4,4,0,1,1,0,0,0
04523523,6,2,4,0,1,1,0,0,1
04523781,4,3,1,0,2,2,0,0,0
04523999,5,3,2,0,2,2,0,0,1
04524120,150,36,114,0,0,0,0,0,1
04524288,14,7,7,0,3,1,2,1,0
04524365,4,1,3,0,1,1,0,0,0
04524414,5,2,3,0,2,2,0,0,1
04524464,19,3,16,0,0,0,0,0,1
04524532,5,3,2,0,2,2,0,0,0
04524563,5,3,2,0,2,2,0,0,0
04524723,15,7,8,0,2,1,1,1,1
04524780,8,0,8,0,0,0,0,0,1
04525469,3,0,3,0,0,0,0,0,1
04525773,24,5,19,0,1,1,0,1,1
04525981,7,3,4,0,2,2,0,0,1
04526470,6,0,6,0,0,0,0,0,1
04526590,5,3,2,0,2,2,0,0,1
04526671,31,5,26,0,0,0,0,0,0
04526940,34,6,28,0,0,0,0,0,1
04528118,4,2,2,0,1,1,0,0,1
04528405,40,7,33,0,4,3,1,4,1
04528418,40,7,33,0,1,1,0,1,1
04528780,7,0,7,0,0,0,0,0,1
04528822,4,2,2,0,1,1,0,0,0
04528834,10,3,7,0,0,0,0,0,0
04528846,31,4,27,0,1,1,0,1,1
04528911,5,0,5,0,1,1,0,0,0
04529069,4,0,4,0,0,0,0,0,0
04529121,4,1,3,0,1,1,0,0,0
04529552,5,2,3,0,1,1,0,0,1
04529663,23,3,20,0,4,4,0,1,1
04529664,8,2,6,0,1,1,0,1,0
04530029,27,6,21,0,1,1,0,1,1
04530518,5,0,5,0,0,0,0,0,1
04530800,8,3,5,0,1,1,0,0,1
04530897,4,3,1,0,1,1,0,0,0
04530979,47,15,32,0,0,0,0,0,1
04530986,16,0,16,0,0,0,0,0,1
04530991,4,2,2,0,1,1,0,0,0
04531024,38,0,38,0,0,0,0,0,0
04531062,8,4,4,0,1,1,0,1,0
04531095,9,0,9,0,0,0,0,0,1
04531108,9,0,9,0,0,0,0,0,1
04531109,9,0,9,0,0,0,0,0,1
04531239,4,2,2,0,1,1,0,0,1
04531382,7,4,3,0,2,2,0,0,1
04531736,4,0,4,0,0,0,0,0,0
04531787,17,2,15,0,1,1,0,1,1
04531941,4,2,2,0,1,1,0,0,0
04240147,28,2,26,0,1,1,0,1,1
04240246,10,0,10,0,0,0,0,0,1
04240392,15,4,11,0,4,1,3,1,1
04240988,22,12,10,0,0,0,0,0,0
04241013,6,5,1,0,3,3,0,0,1
04241081,11,4,7,0,1,1,0,1,0
04241362,43,6,37,0,0,0,0,0,1
04241397,39,8,31,0,0,0,0,0,1
04241401,5,3,2,0,1,1,0,1,0
04241430,48,7,41,0,1,1,0,0,1
04241498,12,5,7,0,1,1,0,1,1
04241766,16,1,15,0,0,0,0,0,1
04241870,10,0,10,0,0,0,0,0,0
04241894,9,0,9,0,1,1,0,1,1
04241912,10,0,10,0,0,0,0,0,1
04242371,29,4,25,0,1,1,0,0,1
04242434,7,3,4,0,1,1,0,1,1
04242478,15,0,15,0,0,0,0,0,1
04242911,5,2,3,0,2,2,0,0,0
04242937,33,9,24,0,0,0,0,0,1
04242945,12,1,11,0,1,0,1,0,1
04242955,20,0,20,0,0,0,0,0,1
04243138,8,0,8,0,0,0,0,0,0
04243198,26,8,18,0,0,0,0,0,1
04243510,41,14,27,0,0,0,0,0,1
04243660,39,6,33,0,0,0,0,0,1
04243893,51,9,42,0,0,0,0,0,0
04244127,38,3,35,0,0,0,0,0,1
04244765,6,2,4,0,1,1,0,0,0
04244823,7,0,7,0,0,0,0,0,1
04244834,16,5,11,0,0,0,0,0,1
04244912,23,0,23,0,0,0,0,0,1
04244947,39,11,28,0,0,0,0,0,0
04244997,5,3,2,0,2,2,0,0,1
04245203,5,3,2,0,1,1,0,0,1
04245429,6,4,2,0,1,1,0,0,0
04245464,4,2,2,0,3,1,2,0,1
04245581,14,3,11,0,1,1,0,1,1
04245686,8,3,5,0,1,1,0,0,0
04245701,23,0,23,0,0,0,0,0,1
04246049,29,11,18,1,0,0,0,0,1
04246641,23,5,18,0,1,1,0,1,1
04246721,9,2,7,0,2,2,0,0,0
04246723,11,5,6,0,1,1,0,1,1
04246740,23,0,23,0,0,0,0,0,1
04246750,15,5,10,0,2,0,2,0,0
04246831,21,9,12,0,0,0,0,0,1
04247088,8,2,6,0,1,0,1,1,1
04247815,18,0,18,0,0,0,0,0,1
04248692,19,14,5,0,3,3,0,0,1
04248844,7,0,7,0,1,1,0,0,1
04249178,14,3,11,0,1,1,0,1,1
04249339,27,2,25,0,1,1,0,1,1
04249440,11,0,11,0,1,1,0,0,1
04249771,6,2,4,0,2,1,1,0,1
04250142,9,0,9,0,0,0,0,0,0
04250182,4,4,0,0,1,1,0,0,1
04250231,8,6,2,0,2,2,0,0,0
04250304,8,3,5,0,2,2,0,0,1
04250351,5,2,3,0,2,2,0,0,0
04250417,8,0,8,0,0,0,0,0,1
04250740,20,3,17,0,1,1,0,1,1
04250744,21,3,18,0,1,1,0,1,1
04250833,29,5,24,0,1,1,0,1,1
04250906,28,5,23,0,1,1,0,1,1
04251018,33,3,30,0,2,2,0,2,1
04251045,4,2,2,0,1,1,0,0,1
04251064,8,0,8,0,0,0,0,0,1
04251277,31,0,31,0,0,0,0,0,1
04251503,29,10,19,0,1,1,0,0,1
04251505,40,4,36,0,6,4,2,0,1
04251613,5,2,3,0,2,2,0,0,1
04251786,5,3,2,0,0,0,0,0,0
04252184,21,3,18,0,1,1,0,1,1
04252277,8,6,2,0,0,0,0,0,1
04252606,7,1,6,0,1,1,0,0,1
04252718,11,4,7,0,1,1,0,0,0
04253059,65,21,44,0,0,0,0,0,1
04253215,21,8,13,0,0,0,0,0,1
04253279,10,6,4,0,3,1,2,0,1
04253429,6,0,6,0,0,0,0,0,1
04253752,33,5,28,0,0,0,0,0,0
04253889,9,4,5,0,1,1,0,1,1
04253905,11,4,7,0,1,1,0,1,1
04253977,15,0,15,0,0,0,0,0,1
04254284,5,3,2,0,2,2,0,0,1
04254466,5,0,5,0,0,0,0,0,1
04254627,21,1,20,0,0,0,0,0,1
04254865,12,5,7,0,0,0,0,0,1
04254992,6,3,3,0,2,2,0,0,1
04255034,4,2,2,0,2,2,0,0,1
04255100,6,2,4,0,1,1,0,0,1
04255112,14,2,12,0,1,1,0,1,1
04255405,8,4,4,0,1,1,0,1,0
04255473,27,8,19,0,2,2,0,2,1
04255496,5,3,2,0,2,2,0,0,1
04255811,16,2,14,0,1,1,0,1,1
04255878,24,8,16,0,2,1,1,1,1
04255882,11,6,5,0,6,5,1,0,0
04255893,16,6,10,0,0,0,0,0,1
04256079,8,2,6,0,1,1,0,1,1
04256283,16,0,16,0,0,0,0,0,1
04256310,32,4,28,0,2,2,0,2,1
04256886,58,10,48,0,0,0,0,0,1
04257130,6,2,4,0,1,1,0,0,1
04257176,17,6,11,0,0,0,0,0,0
04257292,20,4,16,0,1,1,0,1,1
04257385,8,1,7,0,1,1,0,1,1
04257544,14,0,14,0,0,0,0,0,1
04257548,14,0,14,0,0,0,0,0,1
04257717,23,0,23,0,1,1,0,1,1
04257766,27,4,23,0,1,1,0,1,1
04257993,9,3,6,0,2,2,0,0,1
04258089,7,6,1,0,2,2,0,0,0
04258284,37,7,30,0,1,1,0,1,0
04258318,7,0,7,0,0,0,0,0,1
04258658,6,0,6,0,1,1,0,1,1
04258666,36,12,24,0,2,1,1,0,1
04258777,9,4,5,0,2,2,0,1,1
04258838,9,0,9,0,0,0,0,0,0
04259118,5,3,2,0,2,2,0,0,1
04259132,6,4,2,0,3,3,0,0,0
04259517,17,0,17,0,0,0,0,0,1
04259750,17,5,12,0,1,1,0,1,1
04259776,17,5,12,0,1,1,0,1,1
04260104,4,3,1,0,2,2,0,0,0
04260112,6,0,6,0,0,0,0,0,1
04260314,6,2,4,0,1,1,0,0,0
04260537,55,15,40,0,0,0,0,0,1
04260616,5,2,3,0,1,1,0,0,0
04260880,7,0,7,0,0,0,0,0,1
04261059,4,1,3,0,1,1,0,0,1
04261234,5,1,4,0,1,1,0,0,0
04261261,25,3,22,0,1,1,0,1,1
04261312,21,3,18,0,1,1,0,1,1
04261326,20,3,17,0,1,1,0,1,1
04261437,8,3,5,0,0,0,0,0,0
04261649,10,3,7,0,1,1,0,0,1
04261677,43,10,33,0,0,0,0,0,1
04261686,6,0,6,0,0,0,0,0,1
04261698,19,6,13,0,1,1,0,0,0
04261716,27,10,17,0,0,0,0,0,1
04261785,5,2,3,0,2,2,0,0,1
04262016,14,2,12,0,1,1,0,1,1
04262379,5,0,5,0,1,1,0,0,0
04262651,8,4,4,0,3,3,0,0,1
04262934,11,0,11,0,0,0,0,0,1
04263073,6,2,4,0,1,1,0,0,1
04263175,28,9,19,0,1,1,0,1,1
04263206,22,3,19,0,1,1,0,1,1
04263452,17,0,17,0,0,0,0,0,1
04263502,25,5,20,0,3,1,2,3,1
04263835,12,0,12,0,0,0,0,0,1
04263902,4,0,4,0,0,0,0,0,1
04263976,6,3,3,0,2,2,0,0,1
04264089,14,3,11,0,0,0,0,0,0
04264565,12,0,12,0,0,0,0,0,1
04264918,12,3,9,0,1,1,0,1,1
04265483,19,2,17,0,1,1,0,1,1
04265494,8,3,5,0,1,1,0,0,1
04265661,32,11,21,0,0,0,0,0,1
04265799,35,13,22,0,0,0,0,0,1
04265815,17,0,17,0,0,0,0,0,1
04266171,14,6,8,0,1,1,0,1,1
04266500,17,4,13,0,0,0,0,0,1
04267046,7,1,6,0,1,1,0,0,0
04267217,13,2,11,0,1,1,0,0,0
04267347,8,1,7,0,1,1,0,0,0
04267454,19,9,10,0,0,0,0,0,1
04267457,30,9,21,0,1,0,1,0,1
04267525,9,3,6,0,1,1,0,0,0
04267527,16,4,12,0,1,1,0,1,1
04267576,34,11,23,0,0,0,0,0,1
04267815,9,4,5,0,1,1,0,1,0
04267819,16,0,16,0,1,1,0,1,1
04268208,55,13,42,0,0,0,0,0,1
04268340,9,2,7,0,2,2,0,0,0
04268378,6,3,3,0,1,1,0,1,1
04268539,8,3,5,0,1,1,0,0,1
04268590,29,4,25,0,0,0,0,0,1
04268723,34,5,29,0,0,0,0,0,1
04268766,9,4,5,0,0,0,0,0,0
04269010,23,3,20,0,1,1,0,0,1
04269099,4,2,2,0,1,1,0,0,0
04269133,14,3,11,0,0,0,0,0,1
04269439,23,3,20,0,0,0,0,0,1
04269509,7,4,3,0,2,2,0,0,0
04269561,5,0,5,0,0,0,0,0,1
04269699,6,1,5,0,0,0,0,0,1
04269891,4,2,2,0,1,1,0,0,0
04269905,18,2,16,0,0,0,0,0,1
04270390,5,0,5,0,1,1,0,0,1
04270446,26,4,22,0,1,1,0,1,0
04270732,7,3,4,0,2,2,0,0,1
04271085,22,3,19,0,0,0,0,0,1
04271508,11,0,11,0,0,0,0,0,1
04272431,12,4,8,0,1,1,0,1,1
04273102,23,0,23,0,0,0,0,0,1
04273183,4,0,4,0,2,2,0,0,1
04273247,12,0,12,0,0,0,0,0,1
04274033,36,6,30,0,1,1,0,1,1
04274510,25,4,21,0,1,1,0,1,1
04274623,7,5,2,0,1,1,0,0,1
04275222,12,0,12,0,0,0,0,0,1
04275312,15,5,10,0,1,1,0,0,1
04275753,20,7,13,0,0,0,0,0,1
04275798,21,6,15,0,0,0,0,0,1
04275950,10,2,8,0,1,1,0,0,1
04276053,15,5,10,0,1,1,0,1,1
04276060,17,0,17,0,1,1,0,0,1
04276186,8,4,4,0,2,1,1,2,1
04276267,5,0,5,0,0,0,0,0,1
04276286,14,4,10,0,1,1,0,0,1
04276292,9,3,6,0,3,1,2,1,1
04276319,4,2,2,0,2,2,0,0,0
04276323,32,8,24,0,0,0,0,0,0
04276590,50,6,44,0,2,2,0,2,1
04276602,14,3,11,0,1,1,0,1,0
04276612,51,6,45,0,2,2,0,2,1
04276631,50,6,44,0,3,1,2,3,1
04276642,50,6,44,0,2,2,0,2,1
04276882,14,4,10,0,1,1,0,1,1
04276910,44,10,34,0,1,0,1,0,0
04277678,12,3,9,0,1,1,0,0,1
04277888,5,0,5,0,0,0,0,0,1
04277899,11,0,11,0,2,2,0,0,1
04277937,10,4,6,0,1,1,0,1,1
04277945,5,3,2,0,2,2,0,0,0
04870059,7,4,3,0,2,2,0,0,0
04870305,3,1,2,0,1,1,0,0,0
04870372,11,0,11,0,0,0,0,0,1
04870508,4,0,4,0,2,1,1,0,1
04870568,17,0,17,0,0,0,0,0,1
04870941,15,4,11,0,3,3,0,0,1
04871485,13,3,10,0,0,0,0,0,1
04871620,10,3,7,0,0,0,0,0,1
04871849,17,7,10,0,1,1,0,0,0
04872112,13,0,13,0,0,0,0,0,1
04872115,15,0,15,0,0,0,0,0,1
04872138,4,0,4,0,0,0,0,0,0
04872163,9,0,9,0,0,0,0,0,1
04872266,3,1,2,0,1,1,0,0,1
04872475,5,2,3,0,1,1,0,0,1
04872512,11,6,5,0,0,0,0,0,1
04872590,25,8,17,0,0,0,0,0,1
04873206,17,5,12,0,0,0,0,0,1
04873646,6,0,6,0,1,1,0,1,1
04873718,37,13,24,0,0,0,0,0,1
04873909,11,3,8,0,1,1,0,1,1
04874206,10,1,9,0,1,0,1,0,0
04874282,9,0,9,0,1,1,0,0,1
04874423,6,3,3,0,1,1,0,0,1
04874540,11,4,7,0,1,1,0,1,1
04875174,3,3,0,0,1,1,0,0,0
04875312,26,4,22,0,0,0,0,0,0
04875384,9,5,4,0,3,1,2,1,0
04876069,8,3,5,0,1,1,0,0,1
04876913,12,4,8,0,1,1,0,1,1
04876990,37,9,28,0,1,0,1,0,0
04877387,4,2,2,0,2,2,0,0,0
04877434,4,2,2,0,2,2,0,0,0
04877870,2,0,2,0,0,0,0,0,1
04877942,19,3,16,0,4,3,1,1,1
04878101,15,3,12,0,0,0,0,0,1
04878184,7,4,3,0,1,1,0,0,1
04878290,16,3,13,0,1,1,0,1,1
04878364,42,9,33,0,0,0,0,0,1
04878749,7,5,2,0,2,2,0,0,0
04879272,6,0,6,0,0,0,0,0,1
04879295,10,2,8,0,0,0,0,0,0
04879343,4,2,2,0,1,1,0,0,0
04879535,4,0,4,0,1,1,0,0,1
04879643,34,5,29,0,0,0,0,0,0
04879937,4,2,2,0,1,1,0,0,1
04879982,12,6,6,0,0,0,0,0,1
04880130,6,3,3,0,0,0,0,0,1
04880738,10,0,10,0,0,0,0,0,1
04880836,6,3,3,0,2,2,0,0,0
04880870,7,1,6,0,2,2,0,0,0
04881124,18,3,15,0,1,1,0,1,1
04881312,9,2,7,0,0,0,0,0,1
04881343,12,3,9,0,1,1,0,0,1
04881403,7,3,4,0,1,1,0,0,1
04881462,4,3,1,0,1,1,0,0,1
04881714,5,3,2,0,2,2,0,0,0
04882071,38,0,38,0,0,0,0,0,1
04882125,3,1,2,0,1,1,0,0,1
04882254,4,0,4,0,0,0,0,0,1
04882271,9,4,5,0,0,0,0,0,0
04882988,19,2,17,0,2,2,0,2,0
04883031,9,0,9,0,0,0,0,0,1
04883229,10,1,9,0,1,1,0,1,1
04883231,8,1,7,0,1,1,0,1,1
04883589,33,8,25,0,1,1,0,1,1
04883675,20,7,13,0,2,2,0,1,1
04884328,29,6,23,0,0,0,0,0,1
04884502,26,6,20,0,0,0,0,0,0
04884532,11,4,7,0,1,1,0,0,1
04884548,51,18,33,0,0,0,0,0,1
04884654,21,2,19,0,0,0,0,0,1
04884748,4,0,4,0,0,0,0,0,1
04884915,19,0,19,0,0,0,0,0,1
04885191,26,5,21,0,3,1,2,3,1
04885636,9,3,6,0,1,1,0,1,1
04885756,5,3,2,0,2,2,0,0,0
04885793,18,3,15,0,0,0,0,0,1
04886061,5,3,2,0,2,2,0,0,0
04886072,30,14,16,0,0,0,0,0,1
04886955,5,2,3,0,1,1,0,0,0
04886966,5,3,2,0,1,1,0,0,1
04887748,5,2,3,0,0,0,0,0,1
04888075,3,0,3,0,1,1,0,0,0
04888102,9,2,7,0,0,0,0,0,1
04888476,9,0,9,0,0,0,0,0,1
04888760,25,10,15,0,0,0,0,0,1
04889149,41,4,37,0,2,1,1,2,1
04889235,10,2,8,0,1,1,0,0,1
04889408,6,2,4,0,3,2,1,0,0
04889672,4,3,1,0,0,0,0,0,0
04889780,4,2,2,0,1,1,0,0,1
04890066,13,6,7,0,0,0,0,0,1
04890300,5,2,3,0,2,2,0,0,0
04890315,19,6,13,0,2,1,1,0,0
04890757,17,1,16,0,1,1,0,1,1
04891164,15,4,11,0,0,0,0,0,1
04891468,4,2,2,0,1,1,0,0,0
04891484,8,0,8,0,0,0,0,0,1
04891517,4,2,2,0,1,1,0,0,0
04891744,5,2,3,0,1,1,0,0,1
04891748,18,2,16,0,1,1,0,1,1
04892000,7,4,3,0,0,0,0,0,1
04892956,3,3,0,0,1,1,0,0,0
04893395,4,2,2,0,1,1,0,0,0
04894031,7,2,5,0,1,1,0,0,0
04894211,13,5,8,0,1,1,0,1,1
04894658,13,0,13,0,0,0,0,0,1
04894714,4,3,1,0,2,2,0,0,1
04894769,18,3,15,0,1,1,0,1,1
04894975,26,7,19,0,0,0,0,0,1
04896062,11,0,11,0,0,0,0,0,1
04896332,16,2,14,0,1,1,0,0,1
04896430,14,4,10,0,1,1,0,1,1
04896447,20,7,13,0,1,1,0,1,1
04897182,5,0,5,0,0,0,0,0,1
04897239,15,3,12,0,2,1,1,2,1
04897291,27,4,23,0,1,1,0,1,1
04897295,43,6,37,0,6,5,1,0,1
04897440,4,1,3,0,1,1,0,0,0
04898174,6,1,5,0,1,1,0,0,1
04898216,36,5,31,0,2,2,0,2,1
04898230,36,5,31,0,1,1,0,1,1
04898272,4,0,4,0,0,0,0,0,0
04898352,7,0,7,0,0,0,0,0,0
04898368,12,0,12,0,0,0,0,0,1
04898906,5,3,2,0,4,4,0,0,1
04898931,10,3,7,0,1,1,0,0,0
04898936,5,2,3,0,1,1,0,0,1
04899014,11,5,6,0,0,0,0,0,0
04899037,24,0,24,0,3,3,0,0,0
04899075,65,8,57,0,0,0,0,0,0
04899183,10,2,8,0,2,1,1,0,0
04899310,4,0,4,0,0,0,0,0,1
04899457,16,5,11,0,1,1,0,1,1
04899958,23,6,17,0,1,0,1,1,1
04900491,13,4,9,0,1,1,0,0,0
04900537,5,3,2,0,1,1,0,0,1
04900789,5,3,2,0,2,2,0,0,0
04900954,2,0,2,0,0,0,0,0,1
04901380,14,5,9,0,1,1,0,1,1
04901418,31,4,27,0,1,1,0,1,1
04901444,18,3,15,0,0,0,0,0,1
04901516,4,2,2,0,1,1,0,0,1
04901789,6,4,2,0,2,2,0,0,0
04902101,4,0,4,0,1,1,0,1,1
04902237,11,9,2,0,8,8,0,0,0
04902681,0,0,0,0,0,0,0,0,0
04902768,14,0,14,0,1,1,0,1,1
04902807,12,2,10,0,1,1,0,1,0
04903102,10,4,6,0,1,1,0,0,1
04903379,8,3,5,0,1,1,0,0,0
04903619,11,0,11,0,0,0,0,0,1
04903627,18,0,18,0,0,0,0,0,1
04903631,11,0,11,0,0,0,0,0,1
04903865,5,2,3,0,1,1,0,0,0
04903959,9,1,8,0,1,1,0,0,1
04904169,7,0,7,0,0,0,0,0,1
04904322,12,0,12,0,0,0,0,0,1
04904325,24,5,19,0,1,1,0,1,1
04904501,3,0,3,0,0,0,0,0,1
04904558,6,1,5,0,0,0,0,0,0
04904686,18,3,15,0,1,1,0,1,1
04905343,5,1,4,0,1,1,0,0,1
04905379,5,1,4,0,1,1,0,0,1
04905380,6,1,5,0,1,1,0,0,1
04905488,22,0,22,0,1,1,0,1,1
04905751,8,3,5,0,1,1,0,0,0
04905870,3,0,3,0,0,0,0,0,1
04906026,10,4,6,0,1,1,0,1,1
04906053,17,0,17,0,0,0,0,0,0
04906257,5,3,2,0,2,2,0,0,1
04906768,14,0,14,0,1,1,0,0,0
04906812,4,2,2,0,1,1,0,0,1
04906879,32,3,29,0,0,0,0,0,1
04907011,6,4,2,0,3,3,0,0,0
04907293,6,4,2,0,1,1,0,0,0
04907649,14,0,14,0,0,0,0,0,1
04908908,64,5,59,0,0,0,0,0,0
04908949,50,18,32,0,0,0,0,0,1
04909593,8,3,5,0,0,0,0,0,1
04910275,12,2,10,0,1,1,0,1,1
04910761,4,0,4,0,0,0,0,0,1
04910816,20,3,17,0,1,1,0,1,1
04910818,6,3,3,0,2,2,0,0,0
04910892,5,2,3,0,1,1,0,0,0
04911145,12,2,10,0,1,1,0,0,1
04911159,22,3,19,0,1,1,0,1,0
04911267,7,2,5,0,2,2,0,0,0
04913442,5,4,1,0,1,1,0,0,1
04913632,9,4,5,0,1,1,0,1,1
04913696,5,3,2,0,4,2,2,0,1
04913846,64,18,46,0,0,0,0,0,1
04914493,9,4,5,0,1,1,0,1,1
04914713,12,0,12,0,0,0,0,0,1
04914798,4,1,3,0,2,2,0,0,0
04914878,7,3,4,0,3,1,2,3,1
04915002,11,0,11,0,0,0,0,0,1
04915024,14,4,10,0,0,0,0,0,0
04915301,5,0,5,0,0,0,0,0,1
04915544,4,0,4,0,0,0,0,0,1
04915707,11,3,8,0,4,1,3,2,1
04915732,11,3,8,0,4,1,3,2,1
04915734,13,5,8,0,4,1,3,2,1
04915792,13,1,12,0,1,1,0,1,1
04915842,7,0,7,0,0,0,0,0,1
04916153,20,5,15,0,1,1,0,1,1
04916156,27,4,23,0,1,1,0,1,1
04916157,24,0,24,1,0,0,0,0,1
04916158,28,4,24,0,1,1,0,1,1
04916159,28,4,24,0,1,1,0,1,1
04916295,20,0,20,0,0,0,0,0,1
04916299,7,2,5,0,1,1,0,1,1
04916482,6,2,4,0,1,1,0,0,1
04916483,6,2,4,0,1,1,0,0,0
04916697,4,0,4,0,0,0,0,0,1
04916713,6,3,3,0,1,1,0,1,1
04916917,12,4,8,0,4,3,1,0,1
04916919,41,8,33,0,2,2,0,0,1
04917164,3,0,3,0,1,1,0,0,1
04917372,14,6,8,0,1,1,0,0,0
04917461,17,8,9,0,2,2,0,2,1
04917884,15,0,15,0,0,0,0,0,1
04917927,6,4,2,0,3,3,0,0,0
04918311,5,3,2,0,1,1,0,0,1
04918396,14,2,12,0,0,0,0,0,1
04918408,12,2,10,0,1,1,0,1,1
04918638,16,3,13,0,1,1,0,1,1
04918673,6,2,4,0,1,1,0,1,1
04918763,33,0,33,0,0,0,0,0,1
04918777,6,2,4,0,1,1,0,1,1
04918781,5,3,2,0,2,2,0,0,1
04918787,5,0,5,0,0,0,0,0,0
04918987,3,3,0,0,2,2,0,0,0
04919039,16,5,11,0,0,0,0,0,1
04919190,6,3,3,0,1,1,0,0,1
04919536,5,3,2,0,2,2,0,0,0
04919665,4,0,4,0,1,1,0,0,0
04919868,5,2,3,0,1,1,0,0,0
04920166,20,0,20,0,0,0,0,0,1
04920223,5,1,4,0,1,1,0,0,0
04920318,4,2,2,0,1,1,0,0,0
04920552,7,2,5,0,2,2,0,0,1
04920825,9,1,8,0,1,1,0,0,1
04920976,7,0,7,0,0,0,0,0,1
04921900,12,5,7,0,0,0,0,0,1
04921952,6,0,6,0,0,0,0,0,1
04921955,36,6,30,0,0,0,0,0,0
04922288,24,7,17,2,0,0,0,0,1
04922653,6,0,6,0,0,0,0,0,1
04923003,18,3,15,0,1,1,0,0,0
04923011,5,3,2,0,0,0,0,0,1
04923356,2,2,0,0,2,2,0,0,0
04923385,5,3,2,0,2,2,0,0,0
04923602,9,3,6,0,0,0,0,0,0
04923710,9,6,3,0,0,0,0,0,1
04924415,25,4,21,0,0,0,0,0,1
04924715,4,2,2,0,2,1,1,0,0
04925262,39,10,29,0,0,0,0,0,1
04925273,37,10,27,0,0,0,0,0,1
04925632,23,8,15,1,1,1,0,1,1
04925633,12,5,7,0,3,1,2,3,1
04925636,13,3,10,0,1,1,0,1,1
04925640,10,0,10,0,1,1,0,1,1
04925854,11,4,7,0,1,1,0,1,1
11250049,1,1,0,0,1,1,0,0,0
11250102,2,2,0,0,1,1,0,1,0
11250469,2,1,1,0,1,1,0,0,0
11250773,1,1,0,0,1,1,0,0,0
11250787,1,1,0,0,1,1,0,0,0
11250928,2,1,1,0,1,1,0,0,0
11251042,1,1,0,0,1,1,0,0,0
11251165,1,1,0,0,1,1,0,0,1
11251276,2,1,1,0,2,2,0,0,0
11251495,2,2,0,0,0,0,0,0,1
11252315,2,2,0,0,1,1,0,0,0
11252529,1,0,1,0,1,1,0,0,0
11252770,3,3,0,0,1,1,0,0,0
11252940,5,5,0,0,1,1,0,0,0
11253059,1,1,0,0,1,1,0,0,1
11253224,5,5,0,0,1,1,0,1,1
11253403,6,3,3,0,2,1,1,0,1
11253428,5,4,1,0,2,1,1,2,1
11254281,5,5,0,0,1,1,0,1,1
11254331,2,2,0,0,2,2,0,0,0
11255076,1,1,0,0,1,1,0,0,0
11255600,1,1,0,0,0,0,0,0,0
11255776,1,1,0,0,1,1,0,0,0
11256057,3,3,0,0,1,1,0,0,1
11256512,3,2,1,0,3,2,1,0,0
11256993,4,4,0,0,2,2,0,0,0
11257121,2,2,0,0,2,2,0,0,0
11257143,1,1,0,0,1,1,0,0,0
11257249,1,1,0,0,1,1,0,0,0
11257705,2,1,1,0,2,1,1,0,0
11257738,1,0,1,0,1,1,0,0,0
11257760,4,2,2,0,1,1,0,1,1
11257852,2,1,1,0,2,1,1,0,0
11258197,1,1,0,0,1,1,0,0,0
11258286,3,3,0,0,2,2,0,0,0
11258334,1,1,0,0,1,1,0,0,0
11258385,2,1,1,0,2,1,1,0,0
11258438,1,1,0,0,1,1,0,0,0
11258771,1,1,0,0,1,1,0,0,0
11258902,2,2,0,0,2,2,0,0,0
11259008,2,2,0,0,2,2,0,0,0
11259028,2,2,0,0,1,1,0,0,0
11259125,1,1,0,0,1,1,0,0,0
11259297,3,2,1,0,2,1,1,0,0
11259376,2,2,0,0,1,1,0,1,1
11259527,1,1,0,0,1,1,0,0,0
11259639,2,2,0,0,1,1,0,0,0
11259807,2,2,0,0,2,2,0,0,0
11259882,5,5,0,0,1,1,0,0,0
11260564,3,2,1,0,1,1,0,1,0
11260587,4,3,1,0,0,0,0,0,1
11260759,3,3,0,0,2,2,0,0,0
11260937,2,2,0,0,2,2,0,0,0
11261053,1,1,0,0,1,1,0,0,0
11261144,2,2,0,0,2,2,0,0,0
11261167,3,3,0,0,1,1,0,0,1
11261361,1,1,0,0,1,1,0,0,0
11261603,3,3,0,0,3,3,0,0,0
11261725,5,5,0,0,1,1,0,0,0
11262003,2,1,1,0,2,2,0,0,1
11262264,2,2,0,0,2,2,0,0,0
11262355,3,2,1,0,1,1,0,1,0
11262592,2,2,0,0,2,2,0,0,0
11263293,2,1,1,0,2,1,1,0,0
11263387,1,1,0,0,1,1,0,0,0
11264027,2,2,0,0,1,1,0,1,1
11264368,2,2,0,0,1,1,0,0,0
11264564,1,1,0,0,1,1,0,0,0
11264611,1,1,0,0,1,1,0,0,0
11264838,1,1,0,0,1,1,0,0,0
11265092,2,2,0,0,1,1,0,0,0
11265639,6,6,0,0,0,0,0,0,1
11266135,1,1,0,0,0,0,0,0,0
11266143,13,10,3,0,0,0,0,0,1
11266408,2,2,0,0,2,1,1,0,0
11266474,1,1,0,0,1,1,0,0,0
11266523,1,1,0,0,3,3,0,0,0
11266571,3,2,1,0,2,1,1,0,1
11267333,1,1,0,0,1,1,0,0,0
11267796,2,0,2,0,1,1,0,0,0
11267913,2,2,0,0,2,2,0,0,0
11267959,2,2,0,0,3,2,1,1,0
11267988,1,1,0,0,1,1,0,0,0
11268224,4,4,0,0,0,0,0,0,0
11268969,1,1,0,0,1,1,0,0,0
11269615,1,1,0,0,1,1,0,0,0
11269648,3,3,0,0,1,1,0,0,0
11269688,1,1,0,0,1,1,0,0,0
11269851,1,0,1,0,1,1,0,0,0
11269863,3,2,1,0,2,1,1,0,0
11270006,1,1,0,0,1,1,0,0,0
11270034,1,1,0,0,0,0,0,0,0
11270152,1,1,0,0,1,1,0,0,0
11270211,4,3,1,0,1,1,0,1,1
11270275,1,1,0,0,1,1,0,0,0
11270466,2,0,2,0,1,1,0,0,0
11270542,2,2,0,0,2,2,0,0,1
11270606,4,4,0,0,1,1,0,1,1
11270702,3,0,3,0,0,0,0,0,0
11270956,1,1,0,0,1,1,0,0,0
11271127,1,1,0,0,2,2,0,0,0
11271228,2,2,0,0,1,1,0,0,1
11271339,1,1,0,0,1,1,0,0,0
11271458,2,2,0,0,3,2,1,0,0
11271629,2,2,0,0,2,2,0,0,0
11271700,3,3,0,0,2,2,0,0,0
11271940,1,1,0,0,1,1,0,0,0
11273123,1,1,0,0,1,1,0,1,0
11273523,3,2,1,0,1,1,0,1,1
11274014,1,1,0,0,1,1,0,0,0
11274365,10,3,7,0,4,1,3,4,0
11274409,3,2,1,0,1,1,0,0,0
11274709,1,1,0,0,1,1,0,0,0
11274760,2,2,0,0,2,2,0,0,0
11275112,8,7,1,0,2,2,0,0,0
11275179,3,3,0,0,1,1,0,1,0
11275419,3,3,0,0,1,1,0,1,1
11275482,2,1,1,0,1,1,0,0,0
11275607,5,4,1,0,2,2,0,0,1
11275691,2,2,0,0,1,1,0,0,0
11275758,7,5,2,0,1,1,0,1,0
11275889,4,4,0,0,0,0,0,0,0
11276328,2,0,2,0,0,0,0,0,0
11276457,2,2,0,0,1,1,0,1,1
11276713,1,1,0,0,1,1,0,0,0
11276836,4,4,0,0,0,0,0,0,1
11276880,1,1,0,0,1,1,0,0,0
11276996,1,1,0,0,0,0,0,0,0
11277923,3,3,0,0,1,1,0,1,1
11278209,2,2,0,0,1,1,0,0,0
11278230,1,1,0,0,1,1,0,0,0
11278853,2,2,0,0,1,1,0,0,1
11278957,2,1,1,0,1,1,0,0,1
11279004,11,11,0,0,0,0,0,0,0
11279072,8,7,1,2,1,1,0,1,0
11279174,4,4,0,2,1,1,0,1,0
11279304,6,6,0,2,1,1,0,1,0
11279539,1,1,0,0,1,1,0,0,0
11279799,1,1,0,0,1,1,0,0,0
11279917,1,0,1,0,1,1,0,0,0
11280285,3,3,0,0,0,0,0,0,1
11280534,2,2,0,0,2,1,1,0,1
11280626,1,1,0,0,1,1,0,0,1
11280977,1,1,0,0,1,1,0,0,0
11281086,2,2,0,0,1,1,0,0,1
11281143,1,1,0,0,1,1,0,0,0
11281421,2,2,0,0,2,2,0,0,0
11281469,1,1,0,0,1,1,0,1,0
11281798,13,10,3,0,5,5,0,0,0
11281892,1,1,0,0,1,1,0,0,0
11281942,1,1,0,0,1,1,0,0,1
11281965,4,4,0,2,1,1,0,1,0
11282147,2,2,0,0,1,1,0,1,1
11282151,1,1,0,0,1,1,0,0,0
11282205,2,2,0,0,1,1,0,1,1
11282217,2,2,0,0,1,1,0,1,1
11282286,1,1,0,0,1,1,0,0,0
11282296,2,2,0,0,1,1,0,1,1
11282416,3,2,1,0,1,1,0,0,0
11282448,2,1,1,0,1,1,0,0,1
11282541,1,1,0,0,1,1,0,0,0
11282615,2,2,0,0,0,0,0,0,0
11282759,1,1,0,0,1,1,0,0,0
11283641,1,1,0,0,1,1,0,0,1
11283835,1,1,0,0,1,1,0,0,0
11284709,1,1,0,0,1,1,0,0,0
11285163,2,2,0,0,1,1,0,1,1
11285736,1,1,0,0,1,1,0,0,1
11286468,3,3,0,0,2,2,0,0,0
11286511,2,1,1,0,2,1,1,1,1
11287031,1,1,0,0,1,1,0,0,0
11287850,2,2,0,0,2,2,0,0,0
11288240,2,2,0,0,1,1,0,0,0
11288482,1,1,0,0,1,1,0,0,0
11289217,2,2,0,0,1,1,0,0,0
11289573,3,3,0,0,2,2,0,0,0
11290069,4,4,0,0,1,1,0,1,1
11290413,4,4,0,0,2,0,2,0,0
11290775,1,1,0,0,1,1,0,0,0
11290866,5,4,1,0,1,1,0,1,0
11290904,1,1,0,0,1,1,0,0,0
11290908,3,3,0,0,1,1,0,1,0
11290982,2,2,0,0,2,2,0,0,0
11291029,5,4,1,0,1,1,0,1,0
11291085,5,4,1,0,1,1,0,1,0
11291184,4,2,2,0,2,2,0,0,0
11291555,5,2,3,0,1,1,0,1,1
11291587,4,4,0,0,1,1,0,1,1
11291591,3,1,2,0,1,1,0,1,1
11291732,11,10,1,0,3,0,3,0,0
11292066,2,2,0,0,3,2,1,2,0
11292188,3,3,0,0,0,0,0,0,0
11292328,3,3,0,0,1,1,0,1,0
11292431,3,3,0,0,1,1,0,0,0
11292436,2,2,0,0,2,2,0,0,1
11292634,7,4,3,0,1,1,0,1,1
11292950,3,2,1,0,3,2,1,2,1
11293536,6,3,3,0,1,1,0,1,1
11293579,1,1,0,0,1,1,0,0,0
11293626,1,1,0,0,1,1,0,1,0
11293724,2,2,0,0,2,2,0,0,0
11293816,5,2,3,0,1,1,0,1,1
11293849,1,1,0,0,1,0,1,0,1
11294009,5,4,1,0,1,1,0,1,0
11294114,5,4,1,0,1,1,0,1,0
11294173,1,1,0,0,1,1,0,0,0
11294236,6,5,1,0,1,1,0,1,0
11294264,2,2,0,0,1,1,0,0,0
11294507,12,11,1,0,2,1,1,2,1
11294623,1,1,0,0,1,1,0,0,0
11294797,5,4,1,0,0,0,0,0,1
11294877,2,1,1,0,3,1,2,1,0
11295680,2,2,0,0,2,2,0,0,0
11296765,2,1,1,0,2,1,1,0,0
11296820,3,3,0,0,1,1,0,1,1
11296861,2,1,1,0,2,1,1,0,0
11296979,1,1,0,0,1,1,0,0,0
11297271,1,1,0,0,1,1,0,0,0
11297770,4,4,0,0,0,0,0,0,0
11298221,1,1,0,0,1,1,0,0,0
11298359,2,2,0,0,1,0,1,0,0
11298697,2,2,0,0,0,0,0,0,0
11299058,4,3,1,0,3,2,1,0,0
11300245,1,0,1,0,1,1,0,0,0
11300497,7,7,0,2,1,1,0,1,0
11300584,1,1,0,0,1,1,0,0,0
11300659,1,1,0,0,1,1,0,0,0
11300701,4,4,0,0,0,0,0,0,0
11300988,2,2,0,0,1,1,0,0,0
11301067,1,1,0,0,1,1,0,0,0
11301080,2,2,0,0,2,2,0,0,0
11301357,7,4,3,0,3,3,0,0,0
11301596,2,2,0,0,1,1,0,1,1
11301795,7,3,4,0,1,1,0,1,1
11301868,1,1,0,0,0,0,0,0,0
11302084,1,1,0,0,1,1,0,0,0
11302368,1,1,0,0,1,1,0,0,0
11302552,2,2,0,0,2,2,0,0,0
11302727,4,3,1,0,3,2,1,0,0
11302922,2,2,0,0,1,1,0,1,1
11303202,2,1,1,0,2,1,1,0,0
11304220,4,3,1,0,1,1,0,1,1
11304448,4,4,0,0,1,1,0,0,0
11304698,2,2,0,0,3,3,0,0,0
11305894,2,2,0,0,2,2,0,0,0
11305943,1,1,0,0,1,1,0,0,0
11305966,1,1,0,0,3,2,1,0,0
11305973,2,0,2,0,2,2,0,0,1
11306036,4,4,0,0,2,2,0,2,1
11306297,1,1,0,0,1,1,0,0,0
11307473,2,2,0,0,1,1,0,0,0
11307559,3,3,0,0,1,1,0,1,1
11307664,3,3,0,0,3,3,0,0,0
11307680,1,1,0,0,1,1,0,0,0
11307760,1,1,0,0,2,1,1,0,0
11307830,2,2,0,0,2,2,0,0,1
11308185,7,6,1,0,1,1,0,1,1
11308534,2,2,0,0,1,1,0,0,0
11309050,2,2,0,0,0,0,0,0,0
11309329,5,5,0,0,0,0,0,0,1
11309698,1,1,0,0,0,0,0,0,0
11310075,1,1,0,0,1,1,0,0,0
11310250,1,1,0,0,1,1,0,0,0
11310295,1,1,0,0,1,1,0,0,0
11310331,2,2,0,0,1,1,0,0,0
11310830,2,2,0,0,0,0,0,0,0
11311156,1,1,0,0,1,1,0,0,0
11311184,3,3,0,0,1,1,0,0,0
11311384,2,2,0,0,1,1,0,0,0
11311535,2,2,0,0,1,1,0,1,0
11311557,1,0,1,0,1,1,0,0,0
11312323,1,1,0,0,1,1,0,0,0
11312351,1,1,0,0,1,1,0,0,0
11312462,1,1,0,0,1,1,0,0,0
11312644,1,1,0,0,0,0,0,0,0
11312730,3,3,0,0,2,2,0,0,1
11312799,2,0,2,0,1,1,0,0,0
11312810,1,1,0,0,1,1,0,0,0
11313167,1,1,0,0,1,1,0,0,1
11313380,2,2,0,0,2,2,0,0,1
11314058,3,3,0,0,2,2,0,0,1
11314070,1,1,0,0,1,1,0,0,0
11314374,1,1,0,0,1,1,0,0,0
11314510,2,2,0,0,2,2,0,0,0
11314673,1,1,0,0,1,1,0,0,0
11314726,1,1,0,0,0,0,0,0,0
11315303,1,1,0,0,1,1,0,0,0
11315679,3,3,0,0,1,1,0,0,0
11316347,2,2,0,0,2,2,0,0,1
11316498,1,1,0,0,1,1,0,0,0
11316824,10,4,6,0,3,1,2,2,1
11316868,1,1,0,0,0,0,0,0,0
11317907,1,1,0,0,1,1,0,0,0
11318468,1,1,0,0,1,1,0,0,0
11318669,5,5,0,0,3,3,0,0,0
11318794,1,1,0,0,1,1,0,0,0
11319016,3,3,0,0,3,3,0,0,0
11319086,2,2,0,0,1,1,0,0,0
11319164,1,1,0,0,1,1,0,0,0
11319373,1,1,0,0,1,1,0,0,0
11319479,1,1,0,0,1,1,0,0,0
11319784,2,2,0,0,1,1,0,0,0
11319899,10,6,4,0,0,0,0,0,0
11320155,3,3,0,0,1,1,0,1,0
11320576,2,2,0,0,5,3,2,0,0
11320615,3,3,0,0,2,2,0,1,0
11320658,1,1,0,0,1,1,0,0,0
11320783,1,1,0,0,2,2,0,0,1
11320925,3,3,0,0,1,1,0,1,1
11321148,2,1,1,0,0,0,0,0,0
11321486,1,1,0,0,2,2,0,1,1
11321576,2,2,0,0,2,2,0,0,0
11321667,1,1,0,0,1,1,0,0,0
11321701,4,4,0,0,1,1,0,1,1
11321815,4,3,1,0,1,1,0,1,0
11322212,3,3,0,0,3,3,0,0,1
11322973,2,2,0,0,1,1,0,0,0
11323100,2,2,0,0,2,2,0,0,0
11323113,2,2,0,0,2,2,0,0,0
11323197,2,2,0,0,1,1,0,1,1
11323302,2,2,0,0,1,1,0,1,1
11323323,2,2,0,0,1,1,0,0,1
11323479,5,3,2,0,2,1,1,2,1
11323509,2,2,0,0,1,1,0,1,1
11323554,1,1,0,0,1,1,0,0,0
11545015,2,2,0,0,1,1,0,1,1
11545069,1,1,0,0,1,1,0,0,0
11545245,3,3,0,0,1,1,0,1,1
11545589,1,1,0,0,1,1,0,0,0
11545984,1,0,1,0,1,1,0,0,0
11546030,1,1,0,0,2,2,0,0,1
11546212,2,2,0,0,2,2,0,0,0
11546324,1,1,0,0,1,1,0,0,0
11546526,1,1,0,0,1,1,0,0,0
11546579,5,5,0,0,0,0,0,0,0
11546623,3,3,0,0,1,1,0,1,1
11546696,6,5,1,0,2,1,1,2,1
11546747,2,2,0,0,1,1,0,0,0
11546768,1,1,0,0,1,1,0,0,0
11546808,7,5,2,0,2,1,1,2,1
11547219,1,1,0,0,1,1,0,0,0
11547877,1,1,0,0,1,1,0,0,0
11548224,1,1,0,0,1,1,0,0,0
11548866,2,2,0,0,2,2,0,0,0
11549062,1,1,0,0,1,1,0,0,0
11549065,1,1,0,0,0,0,0,0,0
11549137,1,1,0,0,2,1,1,0,1
11549206,2,2,0,0,0,0,0,0,0
11549235,1,1,0,0,1,1,0,0,0
11549590,3,3,0,0,1,1,0,1,0
11550154,4,1,3,0,1,1,0,0,0
11550283,1,1,0,0,1,1,0,0,0
11550317,2,2,0,0,2,2,0,0,0
11550334,1,1,0,0,1,1,0,0,0
11550477,1,1,0,0,1,1,0,0,0
11550765,1,1,0,0,1,1,0,0,0
11550838,1,1,0,0,1,1,0,0,0
11551107,2,2,0,0,2,2,0,0,0
11551156,1,1,0,0,1,1,0,0,0
11551455,1,1,0,0,1,1,0,0,0
11551553,1,1,0,0,1,1,0,0,0
11551741,2,2,0,0,1,1,0,0,0
11551754,2,2,0,0,1,1,0,0,0
11551757,2,2,0,0,1,1,0,0,0
11552116,2,2,0,0,2,2,0,0,0
11552124,3,3,0,0,1,1,0,1,1
11552147,2,2,0,0,2,2,0,0,1
11552248,3,3,0,0,1,1,0,1,0
11552451,2,2,0,0,1,1,0,0,0
11552892,2,2,0,0,2,2,0,0,0
11553088,2,2,0,0,2,2,0,0,0
11553421,1,1,0,0,1,1,0,0,0
11553746,1,1,0,0,1,1,0,0,0
11553798,2,2,0,0,2,2,0,0,0
11554197,2,1,1,0,2,1,1,0,0
11554349,1,1,0,0,1,1,0,0,0
11554796,1,1,0,0,1,1,0,0,1
11555296,1,1,0,0,1,1,0,0,0
11555455,2,2,0,0,1,1,0,0,0
11555931,3,3,0,0,1,1,0,1,0
11556382,2,2,0,0,2,2,0,0,1
11556441,2,1,1,0,4,2,2,0,0
11556592,2,2,0,0,2,2,0,0,0
11556721,1,1,0,0,1,1,0,1,0
11557210,1,1,0,0,1,1,0,0,0
11557444,2,2,0,0,1,1,0,0,0
11557524,1,1,0,0,2,2,0,0,0
11557700,1,1,0,0,1,1,0,0,0
11557758,5,0,5,0,1,1,0,1,0
11558247,1,1,0,0,1,1,0,0,0
11558447,1,1,0,0,1,1,0,0,0
11558635,1,1,0,0,1,1,0,1,0
11558649,2,2,0,0,2,2,0,0,1
11559290,7,6,1,0,0,0,0,0,0
11559367,1,1,0,0,1,1,0,0,0
11559498,1,1,0,0,2,2,0,0,0
11559803,2,2,0,0,2,2,0,0,0
11559939,1,1,0,0,1,1,0,0,0
11560092,1,1,0,0,1,1,0,0,0
11560281,6,6,0,0,2,0,2,0,1
11560373,2,2,0,0,2,2,0,0,1
11560408,1,1,0,0,1,1,0,0,0
11560865,2,2,0,0,2,2,0,0,0
11561433,3,3,0,0,1,1,0,1,0
11561497,2,2,0,0,0,0,0,0,0
11561987,1,1,0,0,1,1,0,0,0
11562240,3,3,0,0,1,1,0,0,0
11562907,1,1,0,0,1,1,0,0,0
11563064,1,1,0,0,1,1,0,0,0
11563070,1,1,0,0,1,1,0,0,0
11563120,4,4,0,0,2,2,0,0,1
11563998,2,2,0,0,3,2,1,0,0
11564506,1,1,0,0,2,2,0,0,0
11564640,1,1,0,0,1,1,0,0,0
11564830,1,1,0,0,1,1,0,0,0
11564865,8,7,1,0,1,1,0,1,1
11564959,1,1,0,0,1,1,0,0,0
11565365,2,2,0,0,1,1,0,0,1
11565541,3,2,1,0,1,1,0,0,0
11565924,3,3,0,0,1,1,0,1,1
11566113,1,1,0,0,1,1,0,0,0
11566414,1,1,0,0,2,2,0,0,0
11566416,1,1,0,0,1,1,0,0,0
11566815,2,2,0,0,2,2,0,0,0
11566992,1,1,0,0,1,1,0,0,0
11567010,1,1,0,0,1,1,0,0,0
11567095,3,1,2,0,3,1,2,0,0
11567356,2,2,0,0,2,2,0,0,0
11567500,1,1,0,0,1,1,0,0,0
11567628,1,1,0,0,1,1,0,0,0
11567757,2,2,0,0,1,1,0,1,1
11567790,1,1,0,0,2,2,0,0,0
11567999,2,2,0,0,1,1,0,0,1
11568340,2,0,2,0,2,1,1,0,1
11568441,3,2,1,0,2,2,0,2,0
11568671,6,6,0,0,0,0,0,0,0
11568694,1,1,0,0,1,1,0,0,0
11568811,3,3,0,0,2,2,0,0,0
11568983,1,1,0,0,1,1,0,0,0
11569008,2,2,0,0,2,2,0,0,0
11569455,2,2,0,0,1,1,0,1,1
11569548,2,2,0,0,2,2,0,0,0
11569665,2,2,0,0,1,1,0,0,1
11569941,2,2,0,0,1,1,0,0,0
11570318,1,1,0,0,1,1,0,0,0
11570330,5,3,2,0,1,1,0,0,1
11570383,1,1,0,0,0,0,0,0,0
11570388,1,1,0,0,1,1,0,0,0
11570785,3,3,0,0,1,1,0,1,1
11570811,4,4,0,0,3,3,0,0,1
11571276,1,1,0,0,1,1,0,0,0
11571293,1,1,0,0,1,1,0,0,0
11571304,1,1,0,0,1,1,0,0,0
11571623,3,3,0,0,1,1,0,1,1
11571676,4,3,1,0,0,0,0,0,1
11571711,3,3,0,0,1,1,0,1,1
11572023,1,1,0,0,1,1,0,0,0
11572159,1,1,0,0,1,1,0,0,0
11572440,2,2,0,0,1,1,0,0,0
11572510,2,2,0,0,1,1,0,1,0
11572846,1,1,0,0,1,1,0,0,0
11574309,1,1,0,0,1,1,0,0,0
11574430,2,2,0,0,2,2,0,0,1
11574689,3,3,0,0,3,1,2,0,0
11574753,1,1,0,0,1,1,0,0,0
11574849,1,1,0,0,0,0,0,0,0
11574922,2,2,0,0,1,1,0,0,1
11575486,2,2,0,0,2,2,0,0,1
11575688,3,3,0,0,2,1,1,2,1
11575911,6,6,0,0,0,0,0,0,0
11576133,2,2,0,0,1,1,0,0,0
11576297,1,1,0,0,1,1,0,0,0
11576516,1,1,0,0,2,2,0,0,0
11576562,1,1,0,0,1,1,0,0,0
11576711,2,2,0,0,2,2,0,0,0
11576752,5,2,3,0,4,1,3,4,1
11576942,2,2,0,0,2,2,0,0,0
11577260,3,3,0,0,1,1,0,1,1
11577452,1,1,0,0,0,0,0,0,0
11577733,4,4,0,0,1,1,0,0,0
11577962,1,1,0,0,1,1,0,0,0
11578245,2,1,1,0,2,1,1,0,0
11578609,3,0,3,0,2,0,2,0,1
11578818,1,1,0,0,1,1,0,0,0
11579685,1,1,0,0,1,1,0,0,1
11579760,6,4,2,0,2,1,1,2,1
11579880,6,4,2,0,2,1,1,2,1
11579968,2,2,0,0,1,1,0,1,0
11579989,1,1,0,0,1,1,0,0,1
11580068,6,4,2,0,2,1,1,2,1
11580858,3,3,0,0,1,1,0,1,1
11580948,4,4,0,0,4,4,0,0,0
11581330,3,3,0,0,1,1,0,1,1
11581676,2,2,0,0,2,2,0,0,0
11581821,4,2,2,0,2,1,1,0,0
11581827,3,3,0,0,1,1,0,1,1
11582017,3,3,0,0,3,3,0,0,0
11582147,1,1,0,0,1,1,0,0,0
11582533,6,3,3,0,2,2,0,0,1
11582855,1,1,0,0,2,2,0,0,1
11583023,1,1,0,0,1,1,0,0,0
11583437,1,1,0,0,1,1,0,0,1
11583451,4,4,0,0,1,1,0,0,0
11583481,3,3,0,0,2,2,0,1,0
11583594,2,2,0,0,1,1,0,0,0
11583727,3,3,0,0,2,2,0,0,1
11583770,3,3,0,0,1,1,0,0,0
11583794,2,2,0,0,1,1,0,1,1
11583829,2,2,0,0,1,1,0,1,0
11584120,1,1,0,0,1,1,0,0,0
11584153,2,2,0,0,2,2,0,0,0
11584298,2,2,0,0,1,1,0,0,0
11584305,3,3,0,0,2,2,0,0,0
11584404,1,1,0,0,0,0,0,0,0
11586152,3,2,1,0,1,1,0,1,1
11586528,3,3,0,0,2,2,0,0,0
11586931,1,1,0,0,1,1,0,0,0
11587534,6,6,0,0,1,1,0,1,0
11587763,2,2,0,0,1,1,0,1,1
11588180,5,5,0,0,0,0,0,0,0
11588936,1,1,0,0,1,1,0,0,0
11588954,1,1,0,0,1,1,0,0,0
11590364,1,1,0,0,1,1,0,0,0
11590645,2,2,0,0,3,2,1,0,0
11591008,4,2,2,0,2,1,1,0,1
11591069,1,1,0,0,1,1,0,0,0
11591114,2,2,0,0,2,2,0,0,0
11591150,6,6,0,0,1,1,0,0,0
11591645,6,6,0,0,1,1,0,0,1
11591657,2,1,1,0,2,1,1,0,0
11591780,1,1,0,0,1,1,0,0,0
11591839,1,0,1,0,1,1,0,0,0
11591856,3,3,0,0,3,3,0,0,0
11592200,2,1,1,0,2,1,1,0,0
11592346,5,4,1,0,4,1,3,0,0
11592517,1,1,0,0,1,1,0,0,0
11592631,4,4,0,0,2,2,0,2,1
11592747,1,1,0,0,1,1,0,0,0
11593019,1,1,0,0,1,1,0,0,0
11593124,1,1,0,0,1,1,0,0,0
11593135,5,3,2,0,1,1,0,0,1
11593190,2,2,0,0,2,2,0,0,0
11593214,6,6,0,0,1,1,0,1,1
11593232,1,1,0,0,1,1,0,0,0
11593671,1,1,0,0,1,1,0,0,0
11594322,1,1,0,0,1,1,0,0,0
11594642,3,3,0,0,2,2,0,0,1
11594902,1,1,0,0,0,0,0,0,0
11595040,2,2,0,0,1,1,0,1,1
11595101,3,3,0,0,2,2,0,0,0
11595340,2,1,1,0,2,1,1,0,0
11595741,2,2,0,0,2,2,0,0,0
11595822,2,2,0,0,2,2,0,0,0
11596045,2,1,1,0,2,1,1,0,0
11596662,1,1,0,0,1,1,0,0,0
11596718,1,1,0,0,1,1,0,0,0
11596794,2,2,0,0,1,1,0,0,0
11597194,1,1,0,0,1,1,0,0,0
11597354,2,2,0,0,1,1,0,1,0
11597453,1,1,0,0,1,1,0,0,0
11598038,2,1,1,0,2,1,1,0,0
11598466,1,1,0,0,1,1,0,0,0
11598727,3,3,0,0,0,0,0,0,0
11599058,1,1,0,0,1,1,0,0,0
11599259,1,1,0,0,1,1,0,0,0
11599548,1,1,0,0,1,1,0,0,0
11599649,1,1,0,0,1,1,0,0,0
11599764,2,2,0,0,2,2,0,0,0
11599855,3,3,0,0,1,1,0,0,1
11600010,2,2,0,0,2,2,0,0,0
11600256,1,1,0,0,1,1,0,0,1
11600291,1,1,0,0,1,1,0,0,0
11600651,1,1,0,0,1,1,0,0,0
11601093,1,1,0,0,1,1,0,0,0
11601435,1,1,0,0,1,1,0,0,0
11601537,1,1,0,0,1,1,0,0,0
11601730,1,1,0,0,0,0,0,0,0
11601827,3,3,0,0,3,3,0,0,0
11602159,4,3,1,0,1,1,0,1,1
11602463,2,1,1,0,2,1,1,0,0
11602536,1,1,0,0,1,1,0,0,0
11602962,2,2,0,0,1,1,0,0,0
11603306,4,4,0,0,4,4,0,0,1
11603843,2,2,0,0,1,1,0,0,1
11603946,2,2,0,0,1,1,0,1,1
11603985,2,2,0,0,1,1,0,0,0
11604043,2,2,0,0,1,1,0,0,0
11604440,4,4,0,0,1,1,0,1,1
11604734,3,2,1,0,1,1,0,0,0
11604955,1,1,0,0,1,1,0,0,0
11605183,2,1,1,0,1,1,0,0,0
11605296,1,1,0,0,1,1,0,0,0
11605435,3,3,0,0,0,0,0,0,0
11605513,4,4,0,0,1,1,0,1,0
11605687,4,4,0,0,2,2,0,1,0
11605718,4,4,0,0,3,3,0,0,0
11605776,2,2,0,0,2,2,0,0,0
11606436,4,4,0,2,1,1,0,1,0
11606463,8,8,0,0,0,0,0,0,0
11606526,4,0,4,0,1,1,0,1,1
11606553,4,4,0,0,4,4,0,0,1
11606696,1,1,0,0,1,1,0,0,0
11606778,2,2,0,0,2,2,0,0,0
11606921,4,4,0,0,1,1,0,1,1
11606963,2,2,0,0,1,1,0,0,0
11607019,2,2,0,0,1,1,0,0,0
11607109,2,2,0,0,0,0,0,0,1
11607115,3,3,0,0,0,0,0,0,0
11607121,1,1,0,0,1,1,0,0,0
11607364,1,1,0,0,1,1,0,0,0
11607561,5,2,3,0,3,2,1,1,1
11607582,2,2,0,0,1,1,0,0,0
11607670,1,1,0,0,2,2,0,0,0
11607762,3,3,0,0,1,1,0,1,1
11608006,2,1,1,0,1,0,1,0,0
11608569,2,2,0,0,2,2,0,0,0
11608647,4,4,0,0,3,3,0,0,0
11608741,1,1,0,0,1,1,0,0,0
11609006,1,1,0,0,1,1,0,0,0
11609330,1,1,0,0,1,1,0,0,0
11609350,1,1,0,0,1,1,0,0,0
11609997,2,2,0,0,2,2,0,0,0
11610385,2,2,0,0,0,0,0,0,0
11610490,1,1,0,0,1,1,0,0,0
11610812,2,2,0,0,2,2,0,0,0
11610878,1,1,0,0,1,1,0,0,0
11611249,1,1,0,0,2,2,0,0,0
11611335,1,1,0,0,1,1,0,0,0
11611433,1,1,0,0,1,1,0,0,0
11611791,1,1,0,0,1,1,0,0,0
11611816,2,1,1,0,1,1,0,0,0
11612178,4,4,0,0,2,2,0,1,1
11612280,10,6,4,0,0,0,0,0,0
11612398,9,8,1,0,1,1,0,1,1
11612509,1,1,0,0,1,1,0,1,0
11612780,9,8,1,0,1,1,0,1,1
11613290,1,1,0,0,1,1,0,0,0
11613405,2,2,0,0,0,0,0,0,1
11613811,1,1,0,0,1,1,0,0,0
11615170,3,3,0,0,1,1,0,0,0
11615289,1,1,0,0,1,1,0,0,0
11615330,1,1,0,0,1,1,0,0,0
11615567,1,1,0,0,1,1,0,0,0
11615632,1,1,0,0,1,1,0,0,0
11615855,2,2,0,0,2,2,0,0,0
11616019,4,4,0,0,1,1,0,1,1
11616195,1,1,0,0,1,1,0,0,0
11616553,1,1,0,0,1,1,0,0,1
11616614,4,4,0,0,0,0,0,0,0
11616663,1,1,0,0,1,1,0,0,0
11617191,2,2,0,0,2,2,0,0,0
11617505,1,1,0,0,1,1,0,0,0
11617530,2,2,0,0,1,1,0,0,0
11617799,5,5,0,0,0,0,0,0,0
11618029,3,3,0,0,0,0,0,0,1
11618395,2,2,0,0,2,2,0,0,0
11618738,1,1,0,0,1,1,0,0,0
10626149,1,1,0,0,1,1,0,0,0
10626265,2,2,0,0,1,1,0,0,0
10626377,1,0,1,0,1,1,0,1,1
10626553,3,3,0,0,1,1,0,0,0
10626694,1,0,1,0,0,0,0,0,0
10627020,1,1,0,0,0,0,0,0,0
10627116,1,1,0,0,1,1,0,0,0
10627342,2,0,2,0,2,2,0,0,0
10627344,1,1,0,0,2,2,0,0,0
10627356,1,1,0,0,1,1,0,0,0
10627648,1,0,1,0,1,1,0,1,0
10627758,3,3,0,0,3,3,0,0,0
10628111,2,2,0,0,0,0,0,0,0
10628794,2,2,0,0,1,1,0,0,0
10628986,1,0,1,0,0,0,0,0,0
10629120,4,4,0,0,0,0,0,0,1
10629194,1,0,1,0,1,1,0,0,1
10629880,4,3,1,0,1,1,0,1,0
10629926,3,1,2,0,2,2,0,0,0
10630191,2,2,0,0,2,1,1,0,0
10630206,3,3,0,0,1,1,0,0,0
10630562,2,2,0,0,1,1,0,0,1
10631010,2,0,2,0,1,1,0,0,0
10631106,11,4,7,0,2,1,1,2,1
10631116,11,4,7,0,2,1,1,2,1
10631141,1,1,0,0,1,1,0,0,0
10631342,7,6,1,0,2,1,1,2,1
10631683,2,0,2,0,2,2,0,0,0
10632340,1,1,0,0,1,1,0,0,1
10632587,4,2,2,0,1,1,0,0,1
10632677,3,0,3,0,2,1,1,0,1
10632793,1,1,0,0,1,1,0,0,0
10632959,4,1,3,0,1,1,0,0,0
10633461,1,0,1,0,1,1,0,0,0
10634546,1,1,0,0,1,1,0,0,0
10635225,2,2,0,0,1,1,0,0,1
10635365,5,3,2,0,3,0,3,0,0
10635559,8,6,2,0,7,6,1,0,1
10636007,3,2,1,0,1,1,0,1,1
10636201,1,1,0,0,1,1,0,0,0
10636616,1,1,0,0,1,1,0,0,0
10636682,9,7,2,0,1,1,0,1,1
10636757,2,2,0,0,2,2,0,0,0
10636948,4,3,1,0,4,3,1,0,0
10638389,3,3,0,0,2,2,0,0,0
10639996,2,1,1,0,2,1,1,0,0
10640568,1,1,0,0,1,1,0,0,0
10641215,3,1,2,0,1,0,1,0,0
10641299,1,1,0,0,1,1,0,0,0
10641508,2,2,0,0,2,2,0,0,1
10641790,1,1,0,0,1,1,0,0,0
10642056,1,1,0,0,1,1,0,0,1
10642331,1,0,1,0,1,1,0,0,0
10642370,7,7,0,0,1,1,0,1,1
10642681,1,0,1,0,1,1,0,0,0
10642769,1,1,0,0,1,1,0,0,0
10642940,1,1,0,0,1,1,0,0,0
10642963,2,2,0,0,0,0,0,0,1
10642976,2,0,2,0,1,1,0,1,0
10642991,1,1,0,0,1,1,0,0,0
10643151,2,0,2,0,1,1,0,0,0
10643189,1,0,1,0,1,1,0,0,0
10643303,1,1,0,0,3,3,0,0,0
10643480,2,2,0,0,4,4,0,0,1
10643831,5,4,1,0,5,4,1,0,0
10643942,2,0,2,0,2,2,0,0,0
10643965,2,2,0,0,2,2,0,0,0
10644079,4,3,1,0,2,1,1,1,1
10644533,1,0,1,0,1,1,0,0,0
10644731,3,1,2,0,3,1,2,0,0
10644815,1,1,0,0,1,1,0,0,1
10644976,2,2,0,0,3,3,0,0,0
10645018,1,1,0,0,1,1,0,0,0
10645419,1,1,0,0,1,1,0,0,0
10645715,4,3,1,0,1,1,0,1,1
10645929,2,2,0,0,2,2,0,0,0
10646460,1,1,0,0,1,1,0,0,0
10646516,3,3,0,0,2,2,0,0,0
10646658,3,2,1,0,2,1,1,0,0
10646796,2,2,0,0,1,1,0,0,0
10646803,4,3,1,0,1,1,0,0,1
10646862,1,1,0,0,1,1,0,0,0
10647202,1,1,0,0,1,1,0,0,0
10647344,2,0,2,0,2,2,0,0,0
10647579,2,2,0,0,2,2,0,0,1
10647609,3,3,0,0,1,1,0,0,0
10647620,6,5,1,0,1,1,0,1,1
10647669,2,1,1,0,0,0,0,0,0
10647999,1,1,0,0,2,2,0,0,0
10648021,1,0,1,0,1,1,0,0,0
10648313,2,0,2,0,2,2,0,0,0
10648496,2,2,0,0,2,2,0,2,0
10648597,1,0,1,0,1,1,0,0,0
10649056,5,0,5,0,4,0,4,0,1
10649313,11,9,2,0,0,0,0,0,0
10649983,3,3,0,0,0,0,0,0,1
10650300,4,2,2,0,1,1,0,1,1
10650527,2,1,1,0,3,2,1,0,0
10650574,2,2,0,0,1,1,0,0,0
10651164,5,3,2,0,1,1,0,1,1
10651196,1,1,0,0,1,1,0,0,1
10651845,1,0,1,0,1,1,0,0,0
10652360,1,0,1,0,0,0,0,0,0
10652374,1,0,1,0,0,0,0,0,0
10652384,1,0,1,0,0,0,0,0,0
10652587,2,2,0,0,2,2,0,0,0
10653543,2,2,0,0,1,1,0,0,0
10653640,1,1,0,0,1,1,0,0,0
10654419,3,0,3,0,1,1,0,0,1
10654839,2,2,0,0,0,0,0,0,0
10654912,2,2,0,0,2,2,0,0,0
10655046,3,3,0,0,3,1,2,1,1
10655541,1,1,0,0,1,1,0,0,1
10655866,16,12,4,0,3,3,0,0,0
10656490,2,2,0,0,2,2,0,0,1
10656772,2,2,0,0,2,2,0,0,0
10657171,2,2,0,0,2,2,0,0,0
10657300,3,2,1,0,2,1,1,0,0
10657455,7,6,1,0,2,1,1,2,1
10657545,7,6,1,0,1,1,0,1,1
10657959,3,1,2,0,3,1,2,0,0
10658069,2,2,0,0,1,1,0,0,1
10658515,2,2,0,0,1,1,0,0,0
10658521,2,2,0,0,1,1,0,0,0
10658705,1,0,1,0,1,1,0,0,0
10659048,2,2,0,0,2,2,0,0,0
10659058,2,2,0,0,1,1,0,0,0
10659215,2,0,2,0,1,1,0,0,0
10659430,4,4,0,0,1,1,0,1,0
10659439,1,1,0,0,2,1,1,0,0
10660086,6,6,0,0,2,2,0,0,0
10660293,1,0,1,0,1,1,0,0,0
10660373,1,1,0,0,1,1,0,0,1
10660468,2,2,0,0,2,2,0,0,0
10660527,4,4,0,0,1,1,0,1,0
10660624,3,3,0,0,2,2,0,0,1
10660759,2,1,1,0,2,1,1,1,0
10660850,2,1,1,0,2,1,1,0,0
10661273,1,1,0,0,0,0,0,0,0
10661279,1,0,1,0,1,1,0,0,1
10661338,1,1,0,0,2,2,0,0,0
10661968,2,2,0,0,2,2,0,0,0
10662436,1,1,0,0,1,1,0,0,0
10662443,1,1,0,0,1,1,0,0,1
10662627,3,3,0,0,1,1,0,1,1
10662977,3,3,0,0,1,1,0,0,0
10663373,3,2,1,0,2,1,1,0,1
10663769,1,1,0,0,1,1,0,0,0
10663842,2,0,2,0,1,1,0,0,1
10664038,1,1,0,0,1,1,0,0,0
10664051,1,0,1,0,1,1,0,0,0
10664325,2,2,0,0,1,1,0,0,0
10664486,1,1,0,0,1,1,0,0,1
10664729,3,3,0,0,1,1,0,1,0
10664764,4,4,0,0,1,1,0,1,1
10665097,8,7,1,0,4,0,4,0,0
10665141,1,1,0,0,1,1,0,0,0
10665305,1,1,0,0,1,1,0,0,0
10665388,1,1,0,0,0,0,0,0,0
10665484,1,1,0,0,4,4,0,0,0
10665732,1,0,1,0,1,1,0,0,0
10665783,1,0,1,0,1,1,0,0,0
10665971,6,4,2,0,1,1,0,1,0
10666387,2,2,0,0,2,2,0,0,0
10666942,5,2,3,0,2,2,0,1,0
10667444,1,1,0,0,1,1,0,0,0
10668460,5,5,0,0,1,1,0,1,1
10668559,5,5,0,0,1,1,0,1,1
10668612,1,1,0,0,1,1,0,0,0
10668683,4,4,0,0,1,1,0,1,1
10668691,1,1,0,0,1,1,0,0,0
10669134,2,2,0,0,2,2,0,0,0
10669164,2,2,0,0,1,1,0,0,0
10669318,1,1,0,0,1,1,0,0,1
10669594,4,3,1,0,1,1,0,1,1
10669620,1,1,0,0,0,0,0,0,0
10669652,2,2,0,0,1,1,0,1,0
10669752,2,1,1,0,0,0,0,0,1
10669951,1,0,1,0,1,1,0,0,0
10670371,2,2,0,0,2,2,0,0,0
10670432,3,0,3,0,1,1,0,0,0
10670435,7,6,1,0,1,1,0,1,0
10670509,3,3,0,0,3,3,0,0,0
10670947,3,3,0,0,2,2,0,0,0
10671007,4,4,0,0,2,2,0,0,1
10671343,2,2,0,0,1,1,0,0,0
10671396,2,2,0,0,3,1,2,1,0
10671627,1,1,0,0,1,1,0,0,0
10671724,1,1,0,0,1,1,0,0,0
10671961,1,0,1,0,0,0,0,0,0
10672093,1,1,0,0,1,1,0,0,0
10672204,1,1,0,0,0,0,0,0,0
10672508,1,1,0,0,1,1,0,0,0
10673484,3,3,0,0,1,1,0,0,1
10673941,2,2,0,0,0,0,0,0,1
10674293,1,1,0,0,1,1,0,0,0
10674564,1,1,0,0,1,1,0,0,0
10674654,2,2,0,0,0,0,0,0,0
10674667,8,3,5,0,1,1,0,1,1
10674705,8,3,5,0,1,1,0,1,1
10674827,8,3,5,0,1,1,0,1,1
10674839,8,3,5,0,1,1,0,1,1
10675029,8,3,5,0,1,1,0,1,1
10675063,2,2,0,0,2,2,0,0,1
10675067,8,3,5,0,1,1,0,1,1
10675165,2,2,0,0,1,1,0,1,1
10675214,6,2,4,0,3,1,2,1,1
10675251,2,2,0,0,1,1,0,1,1
10675349,10,9,1,0,1,0,1,0,0
10675645,7,3,4,0,2,1,1,2,1
10675768,1,1,0,0,1,1,0,0,0
10676094,1,1,0,0,1,1,0,0,0
10676225,3,3,0,0,2,2,0,0,1
10676261,4,4,0,0,2,2,0,0,0
10676648,2,1,1,0,3,3,0,0,1
10677267,1,1,0,0,1,1,0,0,0
10677761,1,1,0,0,1,1,0,0,0
10678049,2,2,0,0,2,2,0,0,1
10678071,1,1,0,0,2,2,0,0,0
10678084,1,0,1,0,1,1,0,1,1
10678148,3,3,0,0,2,2,0,0,1
10678653,3,0,3,0,2,2,0,0,0
10679315,1,0,1,0,1,1,0,0,0
10679958,21,13,8,0,0,0,0,0,1
10680158,2,2,0,0,1,1,0,0,0
10680473,2,0,2,0,2,2,0,0,0
10680708,1,1,0,0,1,1,0,0,0
10680885,2,2,0,0,2,2,0,0,0
10681862,5,4,1,0,1,1,0,0,1
10681885,2,0,2,0,1,1,0,0,0
10681920,2,2,0,0,1,1,0,0,0
10682165,1,0,1,0,1,1,0,0,0
10682176,10,8,2,0,0,0,0,0,0
10682404,2,1,1,0,1,1,0,0,0
10682406,3,2,1,0,1,1,0,0,1
10682495,1,1,0,0,1,1,0,0,0
10682608,2,2,0,0,2,2,0,0,0
10683194,1,1,0,0,1,1,0,0,1
10683483,2,2,0,0,1,1,0,0,1
10683510,2,0,2,0,1,1,0,0,0
10683519,2,2,0,0,8,2,6,0,0
10683529,4,0,4,0,1,1,0,1,1
10683559,1,1,0,0,1,1,0,0,0
10683575,7,6,1,0,1,1,0,0,0
10683697,1,1,0,0,0,0,0,0,0
10683770,2,2,0,0,2,2,0,0,0
10683781,1,1,0,0,1,1,0,0,1
10684258,1,0,1,0,1,1,0,0,0
10684303,2,2,0,0,1,1,0,0,1
10684353,2,1,1,0,1,1,0,0,0
10684495,2,2,0,0,2,2,0,0,0
10684628,2,2,0,0,2,2,0,0,0
10684640,1,1,0,0,1,1,0,0,0
10684708,2,2,0,0,2,2,0,0,0
10684782,1,1,0,0,1,1,0,0,0
10685176,1,1,0,0,2,2,0,0,0
10685224,2,2,0,0,1,1,0,0,0
10685282,2,2,0,0,0,0,0,0,0
10685570,1,1,0,0,1,1,0,0,0
10685656,1,1,0,0,1,1,0,0,0
10685682,10,8,2,0,2,0,2,0,1
10685850,2,2,0,0,1,1,0,0,0
10685969,1,1,0,0,1,1,0,0,0
10685983,1,0,1,0,1,1,0,0,0
10686131,2,2,0,0,2,2,0,0,0
10686229,2,2,0,0,2,2,0,0,0
10686549,2,2,0,0,2,2,0,0,0
10686626,1,1,0,0,2,2,0,0,1
10686827,2,1,1,0,2,1,1,0,0
10687015,10,7,3,0,1,0,1,0,0
10687070,3,0,3,0,2,1,1,0,0
10687232,2,2,0,0,2,2,0,0,0
10687521,6,5,1,0,1,0,1,0,1
10687860,3,1,2,0,2,1,1,0,0
10687874,1,1,0,0,1,1,0,0,0
10687877,1,0,1,0,1,1,0,0,0
10687889,1,1,0,0,1,1,0,0,0
10688272,1,0,1,0,1,1,0,0,0
10688625,5,4,1,0,2,1,1,1,1
10688686,1,1,0,0,1,1,0,0,0
10688981,5,4,1,0,3,2,1,2,0
10689035,2,2,0,0,2,2,0,0,0
10689256,1,1,0,0,1,1,0,0,0
10689403,2,2,0,0,2,2,0,0,0
10689591,3,2,1,0,1,1,0,0,0
10689769,2,1,1,0,0,0,0,0,0
10689850,2,2,0,0,1,1,0,0,0
10689870,16,11,5,0,2,0,2,0,0
10690469,5,5,0,0,0,0,0,0,0
10690605,5,4,1,0,3,3,0,0,0
10690608,1,0,1,0,1,1,0,0,0
10691000,1,1,0,0,1,1,0,0,0
10691046,6,1,5,0,1,0,1,0,0
10691253,1,0,1,0,1,1,0,0,0
10691435,1,1,0,0,1,1,0,0,0
10691755,2,2,0,0,2,2,0,0,0
10691839,3,3,0,0,3,3,0,0,0
10691938,1,0,1,0,1,1,0,0,0
10691990,3,1,2,0,1,1,0,0,0
10692170,1,1,0,0,0,0,0,0,0
10692397,2,2,0,0,1,1,0,0,0
10692536,1,0,1,0,1,1,0,0,0
10692697,1,1,0,0,1,1,0,0,0
10693096,4,0,4,0,3,3,0,0,0
10693292,2,2,0,0,1,1,0,0,0
10693579,2,1,1,0,1,1,0,0,0
10693638,2,2,0,0,2,2,0,0,0
10693741,3,3,0,0,2,1,1,0,0
10694103,2,2,0,0,1,1,0,0,1
10694220,2,2,0,0,1,1,0,0,0
10694343,11,9,2,0,1,1,0,1,0
10694518,1,0,1,0,1,1,0,0,0
10694991,2,2,0,0,2,2,0,0,0
10695023,2,2,0,0,0,0,0,0,1
10695342,3,3,0,0,3,1,2,1,0
10695438,1,1,0,0,1,1,0,0,0
10695563,1,0,1,0,1,1,0,0,0
10695696,11,9,2,0,1,1,0,1,0
10695871,2,0,2,0,2,1,1,0,0
10696137,6,6,0,0,3,0,3,0,1
10696239,3,3,0,0,1,1,0,1,0
10696276,2,1,1,0,2,2,0,0,0
10696395,3,3,0,0,2,1,1,2,0
10696415,1,0,1,0,1,1,0,1,0
10696417,3,3,0,0,1,1,0,1,0
10696663,2,2,0,0,2,2,0,0,0
10696734,1,0,1,0,1,1,0,0,0
10696949,2,2,0,0,2,2,0,0,0
10697027,1,0,1,0,1,1,0,0,0
10697078,3,3,0,0,1,1,0,1,0
10697101,2,2,0,0,2,2,0,0,0
10697103,3,3,0,0,1,1,0,1,0
10697285,6,4,2,0,3,1,2,2,1
10697344,5,3,2,0,0,0,0,0,0
10697633,1,0,1,0,0,0,0,0,0
10698008,1,0,1,0,1,1,0,0,0
10698057,3,3,0,0,2,2,0,0,0
10698509,3,3,0,0,1,1,0,1,0
10698522,1,1,0,0,1,1,0,0,0
10698631,3,1,2,0,1,1,0,1,0
10698637,1,1,0,0,1,1,0,0,0
10698683,6,4,2,0,3,1,2,2,1
10698732,3,0,3,0,2,2,0,0,1
10698770,1,1,0,0,1,1,0,0,0
10698777,5,4,1,0,1,1,0,1,0
10698943,1,1,0,0,1,1,0,0,0
10699086,2,2,0,0,1,1,0,1,0
10699111,2,2,0,0,2,2,0,0,0
10699138,3,3,0,0,1,1,0,1,0
10699364,3,3,0,0,1,1,0,1,0
10699513,1,1,0,0,2,1,1,1,0
10699535,2,0,2,0,2,2,0,0,0
10699895,7,5,2,0,1,1,0,1,1
10699902,1,1,0,0,1,1,0,0,0
11928290,1,1,0,0,1,1,0,0,0
11928320,1,1,0,0,1,1,0,0,0
11928494,6,6,0,0,1,1,0,1,1
11928593,1,0,1,0,0,0,0,0,0
11929201,5,5,0,0,1,1,0,1,0
11929259,1,1,0,0,2,2,0,0,1
11929268,1,1,0,0,1,1,0,0,0
11929283,3,3,0,0,2,2,0,2,1
11929758,2,2,0,0,1,1,0,0,0
11930016,2,2,0,0,2,2,0,0,0
11930419,1,1,0,0,1,1,0,0,0
11930439,1,1,0,0,1,1,0,0,0
11930452,2,2,0,0,1,1,0,0,0
11930996,1,1,0,0,1,1,0,0,0
11931037,1,1,0,0,1,1,0,0,0
11931294,3,3,0,0,1,1,0,1,1
11931391,1,1,0,0,1,1,0,0,0
11931636,1,1,0,0,1,1,0,0,0
11932433,5,5,0,0,2,1,1,2,1
11932434,13,13,0,0,0,0,0,0,0
11932699,1,1,0,0,1,1,0,0,0
11932796,1,1,0,0,1,1,0,0,0
11933190,5,5,0,0,0,0,0,0,0
11933527,1,1,0,0,1,1,0,0,0
11933667,4,4,0,0,0,0,0,0,1
11933688,4,4,0,0,1,1,0,1,1
11933780,1,1,0,0,1,1,0,0,0
11934145,4,4,0,0,1,1,0,1,1
11934512,2,2,0,0,1,1,0,0,1
11934666,2,2,0,0,2,2,0,0,0
11934841,5,5,0,0,0,0,0,0,0
11934871,2,2,0,0,2,2,0,0,0
11934924,1,1,0,0,1,1,0,0,0
11935393,1,1,0,0,1,1,0,0,0
11935556,4,4,0,0,1,1,0,1,1
11935914,1,1,0,0,1,1,0,0,1
11936249,1,1,0,0,1,1,0,0,1
11936832,2,1,1,0,2,2,0,0,0
11936904,1,1,0,0,1,1,0,0,1
11937000,1,1,0,0,1,1,0,0,0
11937172,4,4,0,0,1,1,0,0,0
11937579,1,1,0,0,1,1,0,0,0
11938336,1,1,0,0,1,1,0,0,0
11938748,9,9,0,0,0,0,0,0,0
11938934,3,3,0,0,1,1,0,1,1
11939057,1,1,0,0,1,1,0,0,0
11939211,1,1,0,0,1,1,0,0,0
11939298,2,2,0,0,1,1,0,0,0
11939379,1,1,0,0,1,1,0,0,0
11939876,1,1,0,0,1,1,0,0,0
11939975,3,3,0,0,2,2,0,2,1
11939985,3,3,0,0,1,1,0,0,0
11940315,2,2,0,0,2,2,0,0,0
11940360,1,1,0,0,1,1,0,0,0
11940462,1,1,0,0,1,1,0,0,0
11940742,1,1,0,0,2,2,0,0,1
11940911,1,1,0,0,1,1,0,0,0
11940928,1,1,0,0,1,1,0,0,0
11941053,2,2,0,0,2,2,0,0,1
11941823,1,1,0,0,1,1,0,0,0
11941872,2,2,0,0,1,1,0,0,1
11941986,3,3,0,0,0,0,0,0,0
11942108,1,1,0,0,1,1,0,0,0
11942387,1,1,0,0,1,1,0,0,0
11942643,1,1,0,0,1,1,0,0,0
11942926,3,3,0,0,1,1,0,1,0
11943067,4,2,2,0,1,1,0,1,0
11943465,4,2,2,0,1,1,0,1,0
11943802,4,2,2,0,1,1,0,1,0
11943804,1,1,0,0,1,1,0,0,0
11944268,1,1,0,0,1,1,0,0,0
11944486,2,2,0,0,2,2,0,0,0
11944552,1,1,0,0,1,1,0,0,0
11944630,4,4,0,0,0,0,0,0,0
11944764,1,1,0,0,1,1,0,0,0
11944769,1,1,0,0,2,2,0,0,0
11944782,1,1,0,0,0,0,0,0,0
11944825,1,1,0,0,2,2,0,0,1
11944988,1,1,0,0,1,1,0,0,0
11945034,1,1,0,0,1,1,0,0,0
11945225,1,1,0,0,1,1,0,0,0
11945232,2,2,0,0,1,1,0,1,0
11945488,3,3,0,0,2,2,0,0,1
11945489,1,1,0,0,1,1,0,0,0
11945567,1,1,0,0,1,1,0,0,0
11945589,4,4,0,0,2,2,0,0,0
11945614,3,3,0,0,2,2,0,0,1
11947216,1,1,0,0,1,1,0,0,1
11947327,1,1,0,0,1,1,0,0,0
11947470,2,2,0,0,1,1,0,1,1
11948090,3,3,0,0,0,0,0,0,0
11948514,2,2,0,0,2,2,0,0,0
11948744,1,1,0,0,1,1,0,0,0
11949309,3,3,0,0,0,0,0,0,1
11951039,4,3,1,0,1,0,1,0,1
11951218,3,3,0,0,3,3,0,0,0
11951440,1,1,0,0,1,1,0,0,0
11951527,1,1,0,0,1,1,0,0,0
11951754,1,1,0,0,1,1,0,0,0
11951760,1,1,0,0,1,1,0,0,0
11951899,2,2,0,0,1,1,0,0,0
11952013,1,1,0,0,1,1,0,0,0
11952058,2,2,0,0,0,0,0,0,1
11952255,4,4,0,0,0,0,0,0,0
11952834,1,1,0,0,1,1,0,0,0
11952886,1,1,0,0,1,1,0,0,0
11953420,1,1,0,0,1,1,0,0,0
11953671,2,2,0,0,2,2,0,0,0
11953697,3,3,0,0,2,2,0,0,0
11953737,1,1,0,0,1,1,0,0,0
11954573,1,1,0,0,1,1,0,1,1
11954642,1,1,0,0,1,1,0,0,1
11954919,2,2,0,0,1,1,0,0,1
11954941,1,1,0,0,1,1,0,0,1
11955186,4,4,0,0,0,0,0,0,1
11955556,5,3,2,0,3,2,1,0,0
11955595,2,2,0,0,4,4,0,2,1
11955717,2,2,0,0,2,2,0,0,0
11955804,1,1,0,0,1,1,0,0,0
11956596,1,1,0,0,1,1,0,0,0
11956735,1,1,0,0,1,1,0,0,0
11957474,1,1,0,0,1,1,0,0,0
11957577,2,2,0,0,2,2,0,0,0
11958605,5,5,0,0,0,0,0,0,0
11958623,2,2,0,0,2,2,0,0,0
11958724,1,1,0,0,1,1,0,0,0
11958940,4,4,0,0,1,1,0,1,1
11959684,3,3,0,0,0,0,0,0,1
11959804,5,5,0,0,1,1,0,0,0
11959949,1,1,0,0,1,1,0,0,0
11960115,4,4,0,0,3,3,0,0,0
11960621,2,2,0,0,1,1,0,0,0
11960897,3,3,0,0,3,3,0,0,0
11961181,7,7,0,0,0,0,0,0,1
11961527,1,1,0,0,1,1,0,0,0
11961639,3,3,0,0,2,2,0,0,1
11961762,1,1,0,0,1,1,0,0,0
11961803,3,3,0,0,2,2,0,0,0
11961973,1,1,0,0,2,2,0,0,0
11961995,2,2,0,0,2,2,0,0,0
11962284,1,1,0,0,1,1,0,0,0
11962566,2,2,0,0,1,1,0,0,1
11963025,3,3,0,0,2,2,0,0,0
11963458,7,7,0,0,3,3,0,0,0
11963641,3,3,0,0,1,1,0,1,1
11963720,8,8,0,0,0,0,0,0,0
11963840,1,1,0,0,1,1,0,0,0
11964064,1,1,0,0,1,1,0,0,0
11964088,2,2,0,0,0,0,0,0,0
11964665,1,1,0,0,1,1,0,0,0
11965479,1,1,0,0,2,2,0,0,0
11966109,1,1,0,0,1,1,0,0,0
11966149,1,0,1,0,2,1,1,0,0
11966303,6,6,0,0,1,1,0,1,1
11966406,1,1,0,0,2,2,0,0,1
11966878,1,1,0,0,1,1,0,0,0
11967187,1,1,0,0,1,1,0,0,0
11967207,2,2,0,0,3,3,0,0,0
11967588,1,1,0,0,1,1,0,0,0
11967725,1,1,0,0,1,1,0,0,0
11967775,1,1,0,0,1,1,0,0,0
11967862,2,2,0,0,2,2,0,0,1
11968018,1,1,0,0,1,1,0,0,0
11968103,1,1,0,0,1,1,0,0,0
11968302,4,4,0,0,0,0,0,0,0
11968329,1,1,0,0,1,1,0,0,0
11968354,2,2,0,0,2,2,0,0,0
11968768,3,3,0,0,1,1,0,0,0
11969238,2,2,0,0,1,1,0,1,0
11969386,2,2,0,0,2,2,0,0,0
11969990,1,1,0,0,1,1,0,0,0
11970324,2,2,0,0,2,2,0,0,0
11970373,4,4,0,0,2,2,0,1,1
11970461,2,2,0,0,1,1,0,1,0
11970484,5,5,0,0,0,0,0,0,0
11970622,1,1,0,0,1,1,0,0,0
11971202,3,3,0,0,0,0,0,0,0
11971356,1,1,0,0,1,1,0,1,0
11971459,8,6,2,0,1,1,0,0,0
11971482,7,7,0,0,0,0,0,0,1
11971513,1,1,0,0,1,1,0,1,0
11971827,1,1,0,0,1,1,0,0,0
11971855,1,1,0,0,1,1,0,0,0
11972114,1,1,0,0,1,1,0,0,0
11972573,1,1,0,0,1,1,0,0,0
11973162,1,1,0,0,2,2,0,0,0
11973163,1,1,0,0,1,1,0,0,0
11973349,1,1,0,0,1,1,0,0,0
11973373,2,2,0,0,2,2,0,0,0
11973658,2,2,0,0,2,2,0,0,0
11974106,1,1,0,0,0,0,0,0,0
11974251,1,1,0,0,1,1,0,0,0
11974359,5,5,0,0,2,1,1,0,1
11974866,1,1,0,0,2,2,0,0,0
11975103,1,1,0,0,1,1,0,0,0
11975106,1,1,0,0,1,1,0,0,0
11975253,1,1,0,0,1,1,0,0,0
11976069,5,5,0,0,1,1,0,1,0
11976208,1,1,0,0,1,1,0,0,0
11976263,1,1,0,0,0,0,0,0,0
11976394,1,1,0,0,1,1,0,1,0
11976546,2,2,0,0,1,1,0,0,0
11977032,2,2,0,0,2,2,0,1,0
11977236,2,2,0,0,2,2,0,0,0
11977511,3,3,0,0,1,1,0,0,0
11977791,1,1,0,0,1,1,0,0,0
11978453,3,3,0,0,2,2,0,0,0
11978763,1,1,0,0,1,1,0,0,0
11978972,3,3,0,0,1,1,0,1,1
09560061,9,3,6,0,3,1,2,3,1
09560220,17,8,9,0,0,0,0,0,1
09560429,2,2,0,0,1,1,0,0,0
09560446,4,0,4,0,0,0,0,0,1
09560541,6,2,4,0,2,1,1,2,0
09560565,4,0,4,0,0,0,0,0,1
09560591,11,3,8,0,1,1,0,1,1
09560624,6,3,3,0,2,2,0,0,1
09560785,2,2,0,0,2,1,1,2,1
09560791,3,3,0,0,2,2,0,0,0
09560816,2,1,1,0,1,1,0,0,1
09560995,5,0,5,0,2,1,1,0,1
09561044,1,1,0,0,1,1,0,0,0
09561229,4,1,3,0,1,0,1,1,0
09561276,2,0,2,0,2,2,0,0,0
09561451,2,0,2,0,0,0,0,0,0
09561560,9,8,1,0,1,1,0,0,1
09562457,1,1,0,0,1,1,0,0,0
09562527,2,0,2,0,0,0,0,0,0
09562797,3,3,0,0,2,2,0,0,0
09563390,1,0,1,0,0,0,0,0,0
09563695,3,0,3,0,0,0,0,0,1
09564152,1,1,0,0,1,1,0,0,0
09564972,14,8,6,0,1,1,0,1,1
09565420,2,2,0,0,1,1,0,0,1
09565593,2,0,2,0,0,0,0,0,1
09565766,4,4,0,0,0,0,0,0,1
09565907,3,3,0,0,3,3,0,0,0
09566454,2,0,2,0,0,0,0,0,0
09566609,1,0,1,0,1,1,0,0,0
09567022,5,5,0,0,1,1,0,1,1
09567199,1,1,0,0,1,1,0,0,0
09567223,3,3,0,0,1,1,0,0,0
09567376,3,3,0,0,1,1,0,0,0
09568011,3,3,0,0,1,1,0,1,0
09568330,4,3,1,0,3,3,0,0,1
09568409,1,1,0,0,1,1,0,0,1
09568657,1,0,1,0,1,1,0,0,0
09568895,3,2,1,0,0,0,0,0,0
09569204,5,0,5,0,2,1,1,0,1
09569248,1,1,0,0,1,1,0,0,0
09569287,4,2,2,0,2,2,0,2,1
09569294,5,0,5,0,2,1,1,0,1
09569549,7,0,7,0,2,1,1,0,0
09569855,2,2,0,0,1,1,0,0,0
09569867,2,2,0,0,1,1,0,0,0
09569873,2,2,0,0,1,1,0,0,0
09569896,6,6,0,0,1,1,0,1,1
09570018,1,1,0,0,1,1,0,0,0
09570294,1,1,0,0,1,1,0,0,1
09570689,1,1,0,0,1,1,0,0,1
09570718,1,1,0,0,1,1,0,0,0
09570916,3,2,1,0,3,3,0,0,1
09570942,1,1,0,0,1,1,0,0,0
09571126,1,1,0,0,1,1,0,0,0
09571246,1,1,0,0,2,1,1,0,0
09571280,2,0,2,0,1,1,0,0,1
09571287,1,0,1,0,1,1,0,0,0
09571328,6,5,1,0,2,1,1,1,1
09571657,2,1,1,0,2,1,1,0,0
09571767,7,6,1,0,1,0,1,1,1
09572336,11,6,5,0,1,1,0,1,0
09572366,3,2,1,0,1,1,0,0,1
09572789,5,2,3,0,2,0,2,0,0
09572886,1,1,0,0,1,1,0,0,0
09572929,2,2,0,0,2,2,0,0,0
09572996,9,1,8,0,5,1,4,0,0
09573406,2,2,0,0,2,2,0,0,0
09573534,8,0,8,0,2,1,1,0,0
09573556,2,2,0,0,1,1,0,0,0
09573637,8,1,7,0,4,1,3,0,0
09573702,3,1,2,0,2,1,1,0,0
09573717,1,0,1,0,1,1,0,0,0
09573862,7,4,3,0,1,1,0,1,1
09573976,1,1,0,0,1,1,0,0,0
09574031,2,2,0,0,0,0,0,0,0
09574257,3,3,0,0,2,2,0,0,0
09574567,3,2,1,0,1,1,0,0,1
09575301,2,2,0,0,2,2,0,1,0
09575611,4,2,2,0,1,1,0,1,1
09575831,1,1,0,0,1,1,0,0,0
09575848,3,2,1,0,2,1,1,0,1
09576146,9,5,4,0,2,1,1,1,1
09576269,1,1,0,0,1,1,0,0,0
09576320,1,0,1,0,0,0,0,0,0
09576334,2,0,2,0,0,0,0,0,0
09576403,8,2,6,0,0,0,0,0,0
09576527,1,0,1,0,0,0,0,0,1
09576637,2,2,0,0,2,2,0,0,0
09576666,18,9,9,0,3,3,0,3,1
09576743,5,5,0,0,1,1,0,0,0
09576764,2,0,2,0,0,0,0,0,1
09578049,2,0,2,0,2,2,0,0,0
09578341,2,1,1,0,1,1,0,0,0
09578418,2,1,1,0,1,1,0,0,0
09578421,3,2,1,0,1,1,0,1,1
09578473,2,2,0,0,0,0,0,0,1
09578822,1,1,0,0,1,1,0,0,0
09579483,2,1,1,0,1,1,0,0,0
09580096,2,2,0,0,1,1,0,0,1
09580403,2,0,2,0,1,1,0,0,1
09580449,3,0,3,0,3,1,2,1,1
09580650,1,1,0,0,1,1,0,0,1
09580794,1,1,0,0,1,1,0,0,1
09581324,1,1,0,0,1,1,0,0,0
09581648,1,1,0,0,2,2,0,0,0
09581660,2,2,0,0,1,1,0,0,1
09582926,1,1,0,0,1,1,0,0,0
09582967,11,6,5,0,0,0,0,0,1
09582986,8,2,6,0,2,1,1,2,1
09583172,2,1,1,0,2,1,1,0,0
09583219,10,5,5,0,1,1,0,0,0
09583582,3,0,3,0,0,0,0,0,1
09583644,2,2,0,0,1,1,0,0,0
09584143,2,0,2,0,2,2,0,0,1
09584570,6,2,4,0,1,1,0,1,1
09584747,10,5,5,0,0,0,0,0,0
09584982,2,2,0,0,2,2,0,0,0
09585502,1,1,0,0,1,1,0,0,0
09586342,1,0,1,0,0,0,0,0,0
09586672,2,2,0,0,2,2,0,0,0
09586793,5,2,3,0,2,2,0,0,0
09586981,4,3,1,0,1,1,0,1,0
09586983,4,3,1,0,1,1,0,1,0
09587351,2,0,2,0,0,0,0,0,1
09587420,8,3,5,0,1,1,0,1,1
09587586,2,2,0,0,1,1,0,0,1
09587693,10,5,5,0,3,3,0,0,1
09587747,1,1,0,0,1,1,0,0,0
09587894,1,1,0,0,1,1,0,0,0
09587905,12,8,4,0,0,0,0,0,1
09588115,4,4,0,0,4,1,3,2,1
09588488,1,1,0,0,1,1,0,0,0
09588991,5,3,2,0,1,1,0,1,0
09589041,1,1,0,0,1,1,0,0,0
09589207,3,2,1,0,1,1,0,0,1
09589217,4,1,3,0,2,1,1,0,1
09589254,3,3,0,0,1,1,0,0,0
09589604,2,1,1,0,1,1,0,0,0
09589799,1,1,0,0,1,1,0,0,0
09590335,3,0,3,0,0,0,0,0,1
09590472,2,2,0,0,1,1,0,0,0
09591230,1,1,0,0,1,1,0,0,0
09591338,3,1,2,0,2,1,1,0,0
09591661,5,5,0,0,1,1,0,1,1
09591788,1,1,0,0,1,1,0,0,0
09591941,2,0,2,0,0,0,0,0,0
09592062,7,0,7,0,1,1,0,1,0
09592162,2,2,0,0,2,2,0,0,0
09592184,9,6,3,0,1,1,0,1,1
09592331,2,0,2,0,1,1,0,0,1
09592695,1,0,1,0,0,0,0,0,0
09592738,2,2,0,0,2,2,0,0,1
09592765,8,5,3,0,1,1,0,1,1
09592767,8,5,3,0,1,1,0,1,1
09592882,3,3,0,0,0,0,0,0,0
09593293,1,0,1,0,0,0,0,0,0
09593365,1,1,0,0,1,1,0,0,0
09594221,5,5,0,0,0,0,0,0,0
09594249,8,5,3,0,1,1,0,1,1
09594278,2,0,2,0,0,0,0,0,1
09594287,7,4,3,0,0,0,0,0,0
09594338,3,1,2,0,2,1,1,0,1
09594557,2,1,1,0,1,1,0,0,0
09594754,1,0,1,0,0,0,0,0,0
09594854,4,3,1,0,2,2,0,0,0
09595095,9,1,8,0,7,1,6,0,0
09595193,6,1,5,0,4,1,3,0,0
09595201,7,0,7,0,3,1,2,0,0
09595772,5,4,1,0,1,1,0,1,1
09595911,25,15,10,0,0,0,0,0,1
09595922,11,0,11,0,2,2,0,2,1
09596259,11,5,6,0,2,2,0,2,1
09596568,11,5,6,0,2,2,0,2,1
09597450,2,0,2,0,0,0,0,0,0
09598386,3,2,1,0,2,1,1,0,0
09599234,1,1,0,0,1,1,0,0,0
09599454,5,3,2,0,0,0,0,0,0
09599518,1,1,0,0,3,3,0,0,0
09599671,3,0,3,0,0,0,0,0,0
09599739,1,1,0,0,1,1,0,0,0
09599757,2,0,2,0,0,0,0,0,0
09599759,4,0,4,0,0,0,0,0,1
09599963,3,3,0,0,1,1,0,0,0
09600283,2,1,1,0,1,1,0,0,0
09600319,4,3,1,0,1,1,0,0,1
09600803,1,1,0,0,2,2,0,0,0
09600895,1,0,1,0,1,1,0,1,1
09601041,3,2,1,0,1,1,0,0,0
09601671,2,2,0,0,1,1,0,0,1
09601967,31,13,18,0,0,0,0,0,1
09602060,1,1,0,0,1,1,0,0,1
09602073,2,0,2,0,1,1,0,0,0
09602357,1,1,0,0,1,1,0,0,0
09602417,1,1,0,0,1,1,0,0,0
09602543,1,1,0,0,1,1,0,0,0
09603036,1,0,1,0,0,0,0,0,0
09603295,3,0,3,0,0,0,0,0,0
09604414,6,4,2,0,1,1,0,1,1
09604427,1,0,1,0,1,1,0,0,0
09604451,7,5,2,0,0,0,0,0,1
09604647,2,2,0,0,2,2,0,0,0
09604835,1,1,0,0,1,1,0,0,0
09605000,1,1,0,0,1,1,0,0,0
09605173,19,14,5,0,0,0,0,0,1
09605434,1,1,0,0,1,1,0,0,0
09605878,1,1,0,0,1,1,0,0,0
09605930,4,0,4,0,3,1,2,3,0
09606237,2,2,0,0,2,2,0,0,0
09606330,5,4,1,0,0,0,0,0,1
09606517,8,1,7,0,3,1,2,0,0
09606645,3,3,0,0,3,3,0,0,0
09606811,10,3,7,0,1,1,0,1,1
09606851,5,2,3,0,2,2,0,0,0
09607252,1,0,1,0,0,0,0,0,0
09607591,3,3,0,0,2,1,1,1,1
09607910,5,5,0,0,1,1,0,1,1
09608095,1,1,0,0,1,1,0,0,0
09609603,2,1,1,0,1,1,0,0,0
09609686,2,2,0,0,1,1,0,0,0
09609958,2,1,1,0,0,0,0,0,1
09610122,1,1,0,0,1,1,0,0,0
09610910,1,0,1,0,0,0,0,0,0
09610919,2,2,0,0,2,2,0,0,0
09611043,11,3,8,0,1,1,0,0,1
09612742,5,4,1,0,2,2,0,0,0
09612773,6,5,1,0,1,1,0,0,1
09612780,1,1,0,0,1,1,0,0,1
09612954,4,2,2,0,2,2,0,0,0
09612995,5,5,0,0,1,1,0,1,1
09613126,4,3,1,0,1,1,0,1,1
09613181,7,7,0,0,2,2,0,0,0
09613240,1,0,1,0,1,1,0,0,1
09613247,7,1,6,0,3,1,2,0,0
09613305,9,1,8,0,3,1,2,0,0
09613385,7,1,6,0,2,1,1,0,0
09613846,2,2,0,0,1,1,0,0,1
09613932,3,1,2,0,1,1,0,0,0
09614127,2,0,2,0,1,1,0,0,0
09614187,1,1,0,0,1,1,0,0,0
09614372,2,0,2,0,0,0,0,0,0
09614482,1,0,1,0,1,1,0,0,0
09614659,5,2,3,0,1,1,0,0,1
09614939,2,2,0,0,1,1,0,0,0
09614983,1,1,0,0,2,2,0,0,0
09615043,2,2,0,0,2,2,0,0,0
09615122,2,2,0,0,2,2,0,0,0
09615356,6,4,2,0,3,2,1,0,0
09615366,3,2,1,0,1,1,0,0,0
09615585,3,2,1,0,1,1,0,0,0
09615928,5,1,4,0,2,1,1,0,0
IP08001R,0,0,0,0,0,0,0,0,0
IP08014R,0,0,0,0,0,0,0,0,0
IP08042R,0,0,0,0,0,0,0,0,0
IP08062R,0,0,0,0,0,0,0,0,0
IP08097R,0,0,0,0,0,0,0,0,0
IP08100R,0,0,0,0,0,0,0,0,0
IP08108R,0,0,0,0,0,0,0,0,0
IP08115R,0,0,0,0,0,0,0,0,0
IP08134R,0,0,0,0,0,0,0,0,0
IP08139R,0,0,0,0,0,0,0,0,0
IP08168R,0,0,0,0,0,0,0,0,0
IP08233R,0,0,0,0,0,0,0,0,0
IP08273R,0,0,0,0,0,0,0,0,0
IP08288R,0,0,0,0,0,0,0,0,0
IP08299R,0,0,0,0,0,0,0,0,0
IP08305R,0,0,0,0,0,0,0,0,0
IP08338R,0,0,0,0,0,0,0,0,0
IP08340R,0,0,0,0,0,0,0,0,0
IP08346R,0,0,0,0,0,0,0,0,0
IP08392R,0,0,0,0,0,0,0,0,0
IP08414R,0,0,0,0,0,0,0,0,0
IP08415R,0,0,0,0,0,0,0,0,0
IP08431R,0,0,0,0,0,0,0,0,0
IP08479R,0,0,0,0,0,0,0,0,0
IP08499R,0,0,0,0,0,0,0,0,0
IP08527R,0,0,0,0,0,0,0,0,0
IP08551R,0,0,0,0,0,0,0,0,0
IP08598R,0,0,0,0,0,0,0,0,0
IP08599R,0,0,0,0,0,0,0,0,0
IP08606R,0,0,0,0,0,0,0,0,0
IP08609R,0,0,0,0,0,0,0,0,0
IP08616R,0,0,0,0,0,0,0,0,0
IP08642R,0,0,0,0,0,0,0,0,0
IP08669R,0,0,0,0,0,0,0,0,0
IP08678R,0,0,0,0,0,0,0,0,0
IP08705R,0,0,0,0,0,0,0,0,0
IP08758R,0,0,0,0,0,0,0,0,0
IP08759R,0,0,0,0,0,0,0,0,0
IP08803R,0,0,0,0,0,0,0,0,0
IP08813R,0,0,0,0,0,0,0,0,0
IP08814R,0,0,0,0,0,0,0,0,0
IP08849R,0,0,0,0,0,0,0,0,0
IP08950R,0,0,0,0,0,0,0,0,0
IP08967R,0,0,0,0,0,0,0,0,0
IP08999R,0,0,0,0,0,0,0,0,0
IP09001R,0,0,0,0,0,0,0,0,0
IP09009R,0,0,0,0,0,0,0,0,0
IP09030R,0,0,0,0,0,0,0,0,0
IP09039R,0,0,0,0,0,0,0,0,0
IP09055R,0,0,0,0,0,0,0,0,0
IP09073R,0,0,0,0,0,0,0,0,0
IP09156R,0,0,0,0,0,0,0,0,0
IP09174R,0,0,0,0,0,0,0,0,0
IP09200R,0,0,0,0,0,0,0,0,0
IP09201R,0,0,0,0,0,0,0,0,0
IP09215R,0,0,0,0,0,0,0,0,0
IP09284R,0,0,0,0,0,0,0,0,0
IP09308R,0,0,0,0,0,0,0,0,0
IP09316R,0,0,0,0,0,0,0,0,0
IP09335R,0,0,0,0,0,0,0,0,0
IP09349R,0,0,0,0,0,0,0,0,0
IP09370R,0,0,0,0,0,0,0,0,0
IP09372R,0,0,0,0,0,0,0,0,0
IP09398R,0,0,0,0,0,0,0,0,0
IP09411R,0,0,0,0,0,0,0,0,0
IP09420R,0,0,0,0,0,0,0,0,0
IP09428R,0,0,0,0,0,0,0,0,0
IP09468R,0,0,0,0,0,0,0,0,0
IP09469R,0,0,0,0,0,0,0,0,0
IP09545R,0,0,0,0,0,0,0,0,0
IP09567R,0,0,0,0,0,0,0,0,0
IP09570R,0,0,0,0,0,0,0,0,0
IP09594R,0,0,0,0,0,0,0,0,0
IP09620R,0,0,0,0,0,0,0,0,0
IP09644R,0,0,0,0,0,0,0,0,0
IP09669R,0,0,0,0,0,0,0,0,0
IP09682R,0,0,0,0,0,0,0,0,0
IP09695R,0,0,0,0,0,0,0,0,0
IP09715R,0,0,0,0,0,0,0,0,0
IP09763R,0,0,0,0,0,0,0,0,0
IP09780R,0,0,0,0,0,0,0,0,0
IP09793R,0,0,0,0,0,0,0,0,0
IP09800R,0,0,0,0,0,0,0,0,0
IP09819R,0,0,0,0,0,0,0,0,0
IP09833R,0,0,0,0,0,0,0,0,0
IP09877R,0,0,0,0,0,0,0,0,0
IP09900R,0,0,0,0,0,0,0,0,0
IP09982R,0,0,0,0,0,0,0,0,0
IP09991R,0,0,0,0,0,0,0,0,0
IP10017R,0,0,0,0,0,0,0,0,0
IP10078R,0,0,0,0,0,0,0,0,0
IP10116R,0,0,0,0,0,0,0,0,0
IP10142R,0,0,0,0,0,0,0,0,0
IP10183R,0,0,0,0,0,0,0,0,0
IP10184R,0,0,0,0,0,0,0,0,0
IP10201R,0,0,0,0,0,0,0,0,0
IP10265R,0,0,0,0,0,0,0,0,0
IP10274R,0,0,0,0,0,0,0,0,0
IP10300R,0,0,0,0,0,0,0,0,0
IP10356R,0,0,0,0,0,0,0,0,0
IP10369R,0,0,0,0,0,0,0,0,0
IP10432R,0,0,0,0,0,0,0,0,0
IP10449R,0,0,0,0,0,0,0,0,0
IP10462R,0,0,0,0,0,0,0,0,0
IP10522R,0,0,0,0,0,0,0,0,0
IP10546R,0,0,0,0,0,0,0,0,0
IP10555R,0,0,0,0,0,0,0,0,0
IP10621R,0,0,0,0,0,0,0,0,0
IP10641R,0,0,0,0,0,0,0,0,0
IP10649R,0,0,0,0,0,0,0,0,0
IP10689R,0,0,0,0,0,0,0,0,0
IP10714R,0,0,0,0,0,0,0,0,0
IP10750R,0,0,0,0,0,0,0,0,0
IP10755R,0,0,0,0,0,0,0,0,0
IP10791R,0,0,0,0,0,0,0,0,0
IP10794R,0,0,0,0,0,0,0,0,0
IP10802R,0,0,0,0,0,0,0,0,0
IP10814R,0,0,0,0,0,0,0,0,0
IP10856R,0,0,0,0,0,0,0,0,0
IP10857R,0,0,0,0,0,0,0,0,0
IP10895R,0,0,0,0,0,0,0,0,0
IP10963R,0,0,0,0,0,0,0,0,0
IP10966R,0,0,0,0,0,0,0,0,0
IP10978R,0,0,0,0,0,0,0,0,0
IP11081R,0,0,0,0,0,0,0,0,0
IP11083R,0,0,0,0,0,0,0,0,0
IP11096R,0,0,0,0,0,0,0,0,0
IP11200R,0,0,0,0,0,0,0,0,0
IP11216R,0,0,0,0,0,0,0,0,0
IP11221R,0,0,0,0,0,0,0,0,0
IP11251R,0,0,0,0,0,0,0,0,0
IP11252R,0,0,0,0,0,0,0,0,0
IP11270R,0,0,0,0,0,0,0,0,0
IP11286R,0,0,0,0,0,0,0,0,0
IP11336R,0,0,0,0,0,0,0,0,0
IP11402R,0,0,0,0,0,0,0,0,0
IP11407R,0,0,0,0,0,0,0,0,0
IP11448R,0,0,0,0,0,0,0,0,0
IP11456R,0,0,0,0,0,0,0,0,0
IP11576R,0,0,0,0,0,0,0,0,0
IP11596R,0,0,0,0,0,0,0,0,0
IP11612R,0,0,0,0,0,0,0,0,0
IP11747R,0,0,0,0,0,0,0,0,0
IP11769R,0,0,0,0,0,0,0,0,0
IP11788R,0,0,0,0,0,0,0,0,0
IP11794R,0,0,0,0,0,0,0,0,0
IP11858R,0,0,0,0,0,0,0,0,0
IP11867R,0,0,0,0,0,0,0,0,0
IP11880R,0,0,0,0,0,0,0,0,0
IP11882R,0,0,0,0,0,0,0,0,0
IP11937R,0,0,0,0,0,0,0,0,0
IP12042R,0,0,0,0,0,0,0,0,0
IP12071R,0,0,0,0,0,0,0,0,0
IP12108R,0,0,0,0,0,0,0,0,0
IP12155R,0,0,0,0,0,0,0,0,0
IP12220R,0,0,0,0,0,0,0,0,0
IP12232R,0,0,0,0,0,0,0,0,0
IP12243R,0,0,0,0,0,0,0,0,0
IP12262R,0,0,0,0,0,0,0,0,0
IP12266R,0,0,0,0,0,0,0,0,0
IP12300R,0,0,0,0,0,0,0,0,0
IP12309R,0,0,0,0,0,0,0,0,0
IP12310R,0,0,0,0,0,0,0,0,0
IP12351R,0,0,0,0,0,0,0,0,0
IP12364R,0,0,0,0,0,0,0,0,0
IP12390R,0,0,0,0,0,0,0,0,0
IP12404R,0,0,0,0,0,0,0,0,0
IP12443R,0,0,0,0,0,0,0,0,0
IP12541R,0,0,0,0,0,0,0,0,0
IP12560R,0,0,0,0,0,0,0,0,0
IP12561R,0,0,0,0,0,0,0,0,0
IP12643R,0,0,0,0,0,0,0,0,0
IP12792R,0,0,0,0,0,0,0,0,0
IP12794R,0,0,0,0,0,0,0,0,0
IP12798R,0,0,0,0,0,0,0,0,0
IP12807R,0,0,0,0,0,0,0,0,0
IP12829R,0,0,0,0,0,0,0,0,0
IP12838R,0,0,0,0,0,0,0,0,0
IP12880R,0,0,0,0,0,0,0,0,0
IP12904R,0,0,0,0,0,0,0,0,0
IP12906R,0,0,0,0,0,0,0,0,0
IP12949R,0,0,0,0,0,0,0,0,0
IP12950R,0,0,0,0,0,0,0,0,0
IP13057R,0,0,0,0,0,0,0,0,0
IP13078R,0,0,0,0,0,0,0,0,0
IP13091R,0,0,0,0,0,0,0,0,0
IP13107R,0,0,0,0,0,0,0,0,0
IP13134R,0,0,0,0,0,0,0,0,0
IP13167R,0,0,0,0,0,0,0,0,0
IP13176R,0,0,0,0,0,0,0,0,0
IP13203R,0,0,0,0,0,0,0,0,0
IP13211R,0,0,0,0,0,0,0,0,0
IP13256R,0,0,0,0,0,0,0,0,0
IP13288R,0,0,0,0,0,0,0,0,0
IP13327R,0,0,0,0,0,0,0,0,0
IP13330R,0,0,0,0,0,0,0,0,0
IP13413R,0,0,0,0,0,0,0,0,0
IP13417R,0,0,0,0,0,0,0,0,0
IP13461R,0,0,0,0,0,0,0,0,0
IP13481R,0,0,0,0,0,0,0,0,0
IP13495R,0,0,0,0,0,0,0,0,0
IP13521R,0,0,0,0,0,0,0,0,0
IP13587R,0,0,0,0,0,0,0,0,0
IP13595R,0,0,0,0,0,0,0,0,0
IP13605R,0,0,0,0,0,0,0,0,0
IP13637R,0,0,0,0,0,0,0,0,0
IP13644R,0,0,0,0,0,0,0,0,0
IP13646R,0,0,0,0,0,0,0,0,0
IP13658R,0,0,0,0,0,0,0,0,0
IP13716R,0,0,0,0,0,0,0,0,0
IP13726R,0,0,0,0,0,0,0,0,0
IP13742R,0,0,0,0,0,0,0,0,0
IP13758R,0,0,0,0,0,0,0,0,0
IP13785R,0,0,0,0,0,0,0,0,0
IP13792R,0,0,0,0,0,0,0,0,0
IP13805R,0,0,0,0,0,0,0,0,0
IP13815R,0,0,0,0,0,0,0,0,0
IP13854R,0,0,0,0,0,0,0,0,0
IP13860R,0,0,0,0,0,0,0,0,0
IP13872R,0,0,0,0,0,0,0,0,0
IP13918R,0,0,0,0,0,0,0,0,0
IP14030R,0,0,0,0,0,0,0,0,0
IP14035R,0,0,0,0,0,0,0,0,0
IP14045R,0,0,0,0,0,0,0,0,0
IP14055R,0,0,0,0,0,0,0,0,0
IP14104R,0,0,0,0,0,0,0,0,0
IP14114R,0,0,0,0,0,0,0,0,0
IP14139R,0,0,0,0,0,0,0,0,0
IP14153R,0,0,0,0,0,0,0,0,0
IP14201R,0,0,0,0,0,0,0,0,0
IP14261R,0,0,0,0,0,0,0,0,0
IP14264R,0,0,0,0,0,0,0,0,0
IP14343R,0,0,0,0,0,0,0,0,0
IP14345R,0,0,0,0,0,0,0,0,0
IP14376R,0,0,0,0,0,0,0,0,0
IP14389R,0,0,0,0,0,0,0,0,0
IP14401R,0,0,0,0,0,0,0,0,0
IP14467R,0,0,0,0,0,0,0,0,0
IP14473R,0,0,0,0,0,0,0,0,0
IP14498R,0,0,0,0,0,0,0,0,0
IP14504R,0,0,0,0,0,0,0,0,0
IP14594R,0,0,0,0,0,0,0,0,0
IP14599R,0,0,0,0,0,0,0,0,0
IP14613R,0,0,0,0,0,0,0,0,0
IP14712R,0,0,0,0,0,0,0,0,0
IP14727R,0,0,0,0,0,0,0,0,0
IP14746R,0,0,0,0,0,0,0,0,0
IP14771R,0,0,0,0,0,0,0,0,0
IP14772R,0,0,0,0,0,0,0,0,0
IP14795R,0,0,0,0,0,0,0,0,0
IP14849R,0,0,0,0,0,0,0,0,0
IP14852R,0,0,0,0,0,0,0,0,0
IP14945R,0,0,0,0,0,0,0,0,0
IP15025R,0,0,0,0,0,0,0,0,0
IP15095R,0,0,0,0,0,0,0,0,0
IP15128R,0,0,0,0,0,0,0,0,0
IP15134R,0,0,0,0,0,0,0,0,0
IP15152R,0,0,0,0,0,0,0,0,0
IP15274R,0,0,0,0,0,0,0,0,0
IP15388R,0,0,0,0,0,0,0,0,0
IP15427R,0,0,0,0,0,0,0,0,0
IP15696R,0,0,0,0,0,0,0,0,0
IP15710R,0,0,0,0,0,0,0,0,0
IP15822R,0,0,0,0,0,0,0,0,0
IP15850R,0,0,0,0,0,0,0,0,0
IP15909R,0,0,0,0,0,0,0,0,0
IP15938R,0,0,0,0,0,0,0,0,0
IP15939R,0,0,0,0,0,0,0,0,0
IP15985R,0,0,0,0,0,0,0,0,0
IP16014R,0,0,0,0,0,0,0,0,0
IP16067R,0,0,0,0,0,0,0,0,0
IP16156R,0,0,0,0,0,0,0,0,0
IP16165R,0,0,0,0,0,0,0,0,0
IP16168R,0,0,0,0,0,0,0,0,0
IP16186R,0,0,0,0,0,0,0,0,0
IP16224R,0,0,0,0,0,0,0,0,0
IP16244R,0,0,0,0,0,0,0,0,0
IP1624RS,0,0,0,0,0,0,0,0,0
IP16299R,0,0,0,0,0,0,0,0,0
IP16306R,0,0,0,0,0,0,0,0,0
IP16316R,0,0,0,0,0,0,0,0,0
IP16353R,0,0,0,0,0,0,0,0,0
IP16469R,0,0,0,0,0,0,0,0,0
IP16477R,0,0,0,0,0,0,0,0,0
IP16491R,0,0,0,0,0,0,0,0,0
IP16536R,0,0,0,0,0,0,0,0,0
IP16562R,0,0,0,0,0,0,0,0,0
IP16576R,0,0,0,0,0,0,0,0,0
IP16581R,0,0,0,0,0,0,0,0,0
IP16610R,0,0,0,0,0,0,0,0,0
IP16633R,0,0,0,0,0,0,0,0,0
IP16635R,0,0,0,0,0,0,0,0,0
IP16654R,0,0,0,0,0,0,0,0,0
IP16683R,0,0,0,0,0,0,0,0,0
IP16739R,0,0,0,0,0,0,0,0,0
IP16771R,0,0,0,0,0,0,0,0,0
IP16773R,0,0,0,0,0,0,0,0,0
IP16809R,0,0,0,0,0,0,0,0,0
IP16815R,0,0,0,0,0,0,0,0,0
IP16905R,0,0,0,0,0,0,0,0,0
IP16968R,0,0,0,0,0,0,0,0,0
IP17088R,0,0,0,0,0,0,0,0,0
IP17142R,0,0,0,0,0,0,0,0,0
IP17180R,0,0,0,0,0,0,0,0,0
IP17333R,0,0,0,0,0,0,0,0,0
IP17340R,0,0,0,0,0,0,0,0,0
IP17374R,0,0,0,0,0,0,0,0,0
IP17469R,0,0,0,0,0,0,0,0,0
IP17489R,0,0,0,0,0,0,0,0,0
IP17510R,0,0,0,0,0,0,0,0,0
IP17541R,0,0,0,0,0,0,0,0,0
IP17565R,0,0,0,0,0,0,0,0,0
IP17599R,0,0,0,0,0,0,0,0,0
IP17670R,0,0,0,0,0,0,0,0,0
IP17673R,0,0,0,0,0,0,0,0,0
IP17694R,0,0,0,0,0,0,0,0,0
IP17724R,0,0,0,0,0,0,0,0,0
IP17810R,0,0,0,0,0,0,0,0,0
IP17928R,0,0,0,0,0,0,0,0,0
IP17973R,0,0,0,0,0,0,0,0,0
IP18093R,0,0,0,0,0,0,0,0,0
IP18102R,0,0,0,0,0,0,0,0,0
IP18120R,0,0,0,0,0,0,0,0,0
IP18129R,0,0,0,0,0,0,0,0,0
IP18160R,0,0,0,0,0,0,0,0,0
IP18171R,0,0,0,0,0,0,0,0,0
IP18202R,0,0,0,0,0,0,0,0,0
IP18204R,0,0,0,0,0,0,0,0,0
IP18340R,0,0,0,0,0,0,0,0,0
IP18364R,0,0,0,0,0,0,0,0,0
IP18539R,0,0,0,0,0,0,0,0,0
IP18621R,0,0,0,0,0,0,0,0,0
IP18659R,0,0,0,0,0,0,0,0,0
IP18705R,0,0,0,0,0,0,0,0,0
IP18714R,0,0,0,0,0,0,0,0,0
IP18732R,0,0,0,0,0,0,0,0,0
IP18792R,0,0,0,0,0,0,0,0,0
IP18845R,0,0,0,0,0,0,0,0,0
IP18907R,0,0,0,0,0,0,0,0,0
IP19136R,0,0,0,0,0,0,0,0,0
IP19169R,0,0,0,0,0,0,0,0,0
IP19268R,0,0,0,0,0,0,0,0,0
IP19286R,0,0,0,0,0,0,0,0,0
IP19294R,0,0,0,0,0,0,0,0,0
IP19318R,0,0,0,0,0,0,0,0,0
IP19325R,0,0,0,0,0,0,0,0,0
IP19331R,0,0,0,0,0,0,0,0,0
IP19411R,0,0,0,0,0,0,0,0,0
IP19422R,0,0,0,0,0,0,0,0,0
IP19430R,0,0,0,0,0,0,0,0,0
IP19460R,0,0,0,0,0,0,0,0,0
IP19465R,0,0,0,0,0,0,0,0,0
IP19557R,0,0,0,0,0,0,0,0,0
IP19605R,0,0,0,0,0,0,0,0,0
IP19703R,0,0,0,0,0,0,0,0,0
IP19748R,0,0,0,0,0,0,0,0,0
IP19756R,0,0,0,0,0,0,0,0,0
IP19827R,0,0,0,0,0,0,0,0,0
IP19885R,0,0,0,0,0,0,0,0,0
IP19935R,0,0,0,0,0,0,0,0,0
IP19985R,0,0,0,0,0,0,0,0,0
IP20003R,0,0,0,0,0,0,0,0,0
IP20009R,0,0,0,0,0,0,0,0,0
IP20043R,0,0,0,0,0,0,0,0,0
IP20054R,0,0,0,0,0,0,0,0,0
IP20097R,0,0,0,0,0,0,0,0,0
IP20141R,0,0,0,0,0,0,0,0,0
IP20176R,0,0,0,0,0,0,0,0,0
IP20326R,0,0,0,0,0,0,0,0,0
IP20398R,0,0,0,0,0,0,0,0,0
IP20408R,0,0,0,0,0,0,0,0,0
IP20575R,0,0,0,0,0,0,0,0,0
IP20699R,0,0,0,0,0,0,0,0,0
IP20821R,0,0,0,0,0,0,0,0,0
IP20827R,0,0,0,0,0,0,0,0,0
IP20830R,0,0,0,0,0,0,0,0,0
IP20975R,0,0,0,0,0,0,0,0,0
IP21010R,0,0,0,0,0,0,0,0,0
IP21118R,0,0,0,0,0,0,0,0,0
IP21158R,0,0,0,0,0,0,0,0,0
IP21189R,0,0,0,0,0,0,0,0,0
IP21193R,0,0,0,0,0,0,0,0,0
IP21246R,0,0,0,0,0,0,0,0,0
IP21247R,0,0,0,0,0,0,0,0,0
IP21292R,0,0,0,0,0,0,0,0,0
IP21332R,0,0,0,0,0,0,0,0,0
IP21334R,0,0,0,0,0,0,0,0,0
IP21450R,0,0,0,0,0,0,0,0,0
IP21563R,0,0,0,0,0,0,0,0,0
IP21595R,0,0,0,0,0,0,0,0,0
IP21602R,0,0,0,0,0,0,0,0,0
IP21610R,0,0,0,0,0,0,0,0,0
IP21665R,0,0,0,0,0,0,0,0,0
IP21729R,0,0,0,0,0,0,0,0,0
IP21817R,0,0,0,0,0,0,0,0,0
IP21842R,0,0,0,0,0,0,0,0,0
IP21882R,0,0,0,0,0,0,0,0,0
IP21903R,0,0,0,0,0,0,0,0,0
IP21919R,0,0,0,0,0,0,0,0,0
04000022,28,5,23,0,1,1,0,1,1
04000144,19,4,15,0,0,0,0,0,1
04000623,24,7,17,0,1,1,0,1,1
04000835,16,3,13,0,1,1,0,1,1
04000985,51,10,41,0,1,1,0,0,1
04001287,28,5,23,0,5,3,2,0,1
04001543,11,4,7,0,1,1,0,0,1
04001715,4,0,4,0,0,0,0,0,1
04001957,5,0,5,0,0,0,0,0,1
04002032,12,3,9,0,1,1,0,0,1
04002067,16,2,14,0,0,0,0,0,1
04002077,13,2,11,0,0,0,0,0,1
04002119,14,3,11,0,1,1,0,1,1
04002170,14,3,11,0,1,1,0,1,1
04002177,26,8,18,0,0,0,0,0,1
04002287,36,7,29,0,2,1,1,0,1
04002374,13,2,11,0,0,0,0,0,1
04002389,28,3,25,0,1,1,0,1,1
04002412,6,2,4,0,1,1,0,0,0
04002471,13,2,11,0,1,1,0,1,1
04002476,34,4,30,0,1,1,0,1,1
04002575,60,19,41,0,0,0,0,0,1
04002600,23,3,20,0,1,1,0,1,1
04002709,10,3,7,0,3,2,1,0,1
04003091,25,1,24,0,1,1,0,1,1
04003207,22,4,18,0,2,0,2,0,1
04003357,44,7,37,0,13,0,13,1,1
04003804,10,2,8,0,2,2,0,2,1
04004492,25,4,21,0,1,1,0,1,1
04004516,24,0,24,0,0,0,0,0,1
04005020,23,12,11,0,0,0,0,0,0
04005456,18,3,15,0,1,1,0,0,1
04005473,24,9,15,0,1,1,0,0,1
04005515,6,3,3,0,2,2,0,0,1
04005676,8,4,4,0,0,0,0,0,1
04005809,11,2,9,0,1,1,0,0,0
04006070,8,3,5,0,2,2,0,0,0
04006108,35,4,31,0,0,0,0,0,1
04006128,53,11,42,0,0,0,0,0,1
04006158,9,2,7,0,0,0,0,0,1
04006185,9,3,6,0,1,1,0,1,0
04006344,7,3,4,0,1,1,0,0,1
04006445,29,2,27,0,0,0,0,0,1
04006586,5,2,3,0,1,1,0,0,0
04006644,9,2,7,0,1,1,0,1,1
04006717,39,3,36,0,1,1,0,1,1
04006721,3,0,3,0,0,0,0,0,1
04006741,39,6,33,0,0,0,0,0,1
04006766,18,3,15,0,3,2,1,0,1
04006942,35,3,32,0,1,1,0,1,1
04007092,12,4,8,0,1,1,0,1,1
04007132,23,3,20,0,3,2,1,0,1
04007393,50,7,43,0,0,0,0,0,1
04007415,17,3,14,0,1,1,0,1,1
04007451,15,3,12,0,1,1,0,0,1
04007454,14,2,12,0,4,1,3,0,1
04007687,12,6,6,0,1,1,0,0,1
04007855,56,9,47,0,1,1,0,1,1
04008087,29,5,24,0,1,1,0,1,1
04008144,18,3,15,0,1,1,0,1,1
04008521,20,5,15,0,1,1,0,1,1
04008985,10,3,7,0,1,1,0,1,1
04008990,19,3,16,0,1,1,0,1,1
04009200,43,18,25,0,0,0,0,0,1
04009390,26,2,24,0,1,1,0,1,1
04009404,3,2,1,0,1,1,0,0,0
04009440,5,3,2,0,2,2,0,0,1
04009652,50,14,36,0,3,2,1,0,1
04009745,14,0,14,0,0,0,0,0,1
04009766,57,8,49,0,0,0,0,0,1
04010160,24,3,21,0,0,0,0,0,0
04010166,19,7,12,0,1,1,0,0,0
04010348,8,2,6,0,1,1,0,0,1
04010401,16,3,13,0,1,1,0,0,1
04010518,5,0,5,0,0,0,0,0,1
04010653,29,12,17,0,0,0,0,0,0
04011077,16,0,16,0,0,0,0,0,1
04011137,23,2,21,0,1,1,0,1,1
04011295,11,3,8,0,0,0,0,0,1
04011329,13,3,10,0,2,2,0,0,1
04011360,9,2,7,0,1,1,0,0,1
04011415,16,5,11,0,2,2,0,0,1
04011841,15,3,12,0,1,1,0,1,1
04012143,80,13,67,0,0,0,0,0,0
04012222,55,10,45,0,1,1,0,1,1
04012302,9,2,7,0,1,1,0,0,1
04012467,10,4,6,0,1,1,0,0,0
04012682,35,10,25,0,3,2,1,0,1
04012726,20,3,17,0,1,1,0,1,1
04013123,16,4,12,0,1,1,0,1,1
04013232,15,2,13,0,2,2,0,0,0
04013719,7,1,6,0,1,1,0,0,1
04014043,4,0,4,0,1,1,0,0,1
04014120,18,2,16,0,1,1,0,0,0
04014176,47,7,40,0,0,0,0,0,1
04014625,15,0,15,0,0,0,0,0,1
04014760,5,2,3,0,2,1,1,1,1
04015238,6,3,3,0,1,1,0,0,0
04015359,4,2,2,0,0,0,0,0,0
04015454,37,0,37,0,0,0,0,0,1
04015559,6,1,5,0,1,1,0,0,0
04015584,7,4,3,0,2,2,0,0,1
04015597,16,7,9,0,2,2,0,0,1
04015615,4,2,2,0,1,1,0,0,0
04015695,33,8,25,0,0,0,0,0,1
04015995,6,4,2,0,3,3,0,0,1
04016295,81,10,71,0,0,0,0,0,0
04016409,48,14,34,0,0,0,0,0,1
04016499,29,3,26,0,1,1,0,1,1
04016712,11,4,7,0,0,0,0,0,1
04016743,32,4,28,0,1,1,0,1,1
04016854,5,3,2,0,1,1,0,0,0
04016885,8,2,6,0,1,1,0,0,0
04017150,11,2,9,0,0,0,0,0,1
04017430,44,14,30,0,1,1,0,1,1
04017435,28,3,25,0,1,1,0,1,1
04017489,9,2,7,0,1,1,0,1,0
04017549,13,2,11,0,0,0,0,0,1
04017567,15,0,15,0,0,0,0,0,1
04017583,15,0,15,0,0,0,0,0,1
04017621,22,2,20,0,1,1,0,1,1
04017748,7,2,5,0,1,1,0,0,0
04017909,58,8,50,0,0,0,0,0,1
04018585,20,6,14,0,1,1,0,0,1
04018716,5,3,2,0,1,1,0,0,1
04018743,18,4,14,0,2,2,0,2,1
04018752,26,10,16,0,0,0,0,0,1
04018756,12,1,11,0,1,1,0,1,1
04018758,19,3,16,0,1,1,0,1,1
04018760,16,4,12,1,1,1,0,1,1
04018937,28,3,25,0,1,1,0,1,1
04019051,28,5,23,0,0,0,0,0,1
04019062,18,2,16,0,2,1,1,2,1
04019077,16,7,9,0,1,1,0,1,1
04019185,7,3,4,0,3,2,1,0,0
04019268,7,0,7,0,0,0,0,0,1
04019282,36,7,29,0,0,0,0,0,1
04019415,13,4,9,0,0,0,0,0,1
04019503,18,0,18,0,0,0,0,0,1
04019885,4,1,3,0,1,1,0,0,0
04019893,39,1,38,0,2,2,0,1,1
04020131,13,3,10,0,1,1,0,1,1
04020165,5,0,5,0,0,0,0,0,1
04020311,12,0,12,0,1,1,0,1,1
04020415,34,4,30,0,1,1,0,1,1
04020487,21,3,18,0,1,1,0,1,1
04020622,11,4,7,0,0,0,0,0,0
04020645,16,0,16,0,0,0,0,0,1
04020668,26,5,21,0,1,1,0,1,1
04020844,13,3,10,0,1,1,0,0,1
04020862,26,5,21,0,1,1,0,1,1
04021548,12,2,10,0,1,1,0,1,1
04021697,13,1,12,0,1,1,0,1,1
04021751,4,2,2,0,1,1,0,0,0
04022175,14,5,9,0,3,3,0,0,0
04022214,24,0,24,0,0,0,0,0,1
04022600,22,6,16,0,1,1,0,1,0
04022885,5,0,5,0,1,1,0,0,1
04022918,7,3,4,0,0,0,0,0,0
04023138,8,2,6,0,1,0,1,0,1
04023225,12,0,12,0,0,0,0,0,1
04023347,19,5,14,0,0,0,0,0,1
04023412,14,3,11,0,1,1,0,1,1
04023510,5,2,3,0,1,1,0,0,1
04023541,22,8,14,0,0,0,0,0,1
04023579,10,3,7,0,0,0,0,0,1
04023797,24,0,24,0,0,0,0,0,1
04023852,25,0,25,0,0,0,0,0,1
04023948,18,5,13,0,0,0,0,0,1
04024166,13,4,9,0,2,2,0,1,1
04024470,4,0,4,0,1,1,0,0,0
04024507,13,1,12,0,1,1,0,0,1
04024938,52,13,39,0,0,0,0,0,1
04024939,13,3,10,0,1,1,0,1,1
04024940,11,0,11,0,0,0,0,0,1
04025026,16,6,10,0,1,1,0,1,1
04025031,35,4,31,0,0,0,0,0,1
04025894,7,5,2,0,4,4,0,0,1
04026653,6,0,6,0,1,1,0,1,1
04026676,9,4,5,0,1,1,0,1,0
04026680,5,3,2,0,1,1,0,0,0
04026807,7,3,4,0,1,1,0,0,0
04027193,9,3,6,0,1,1,0,0,1
04027283,10,0,10,0,0,0,0,0,1
04027289,4,1,3,0,2,1,1,0,0
04027460,7,0,7,0,0,0,0,0,1
04027508,16,3,13,0,1,1,0,1,1
04027553,17,0,17,0,0,0,0,0,1
04027629,28,3,25,0,0,0,0,0,1
04027669,26,4,22,0,1,1,0,1,1
04027679,58,15,43,0,1,1,0,1,1
04027681,15,1,14,0,1,1,0,1,1
04027712,29,2,27,0,1,1,0,1,1
04027721,7,1,6,0,1,1,0,0,1
04027761,13,0,13,0,0,0,0,0,1
04027812,22,5,17,0,0,0,0,0,1
04027891,16,3,13,0,0,0,0,0,1
04027977,28,8,20,0,0,0,0,0,1
04028278,10,5,5,0,2,2,0,0,1
04028342,4,1,3,0,4,1,3,1,0
04028537,14,3,11,0,1,1,0,1,1
04028670,29,4,25,0,1,1,0,1,1
04028861,9,4,5,0,1,1,0,0,0
04028962,40,4,36,0,7,1,6,7,1
04029248,8,3,5,0,3,2,1,0,0
04029360,6,1,5,0,1,1,0,0,0
04029450,18,4,14,0,1,1,0,1,1
04029478,19,3,16,0,2,1,1,2,1
04029705,32,5,27,0,1,1,0,1,1
04029837,6,1,5,0,2,2,0,0,0
04029996,23,4,19,0,0,0,0,0,1
04030009,9,0,9,0,0,0,0,0,1
04030017,9,0,9,0,0,0,0,0,1
04030166,33,7,26,0,7,0,7,0,1
04030407,11,5,6,0,3,2,1,1,1
04031096,18,0,18,0,0,0,0,0,1
04031152,50,12,38,0,0,0,0,0,1
04031269,7,0,7,0,1,1,0,0,1
04031304,11,2,9,0,1,1,0,1,1
04031316,21,0,21,0,0,0,0,0,1
04031360,19,3,16,0,1,1,0,1,1
04031841,16,2,14,0,0,0,0,0,1
04031883,42,3,39,0,1,1,0,1,1
04032513,36,0,36,0,1,1,0,1,1
04032552,18,4,14,0,1,1,0,1,1
04032623,4,2,2,0,2,2,0,0,0
04032717,10,3,7,0,3,3,0,0,0
04032766,6,2,4,0,1,1,0,0,1
04032796,15,1,14,0,0,0,0,0,1
04032833,5,2,3,0,2,2,0,0,1
04032950,7,4,3,0,1,1,0,0,1
04033274,21,0,21,0,0,0,0,0,1
04033317,10,3,7,0,2,2,0,0,1
04033330,12,4,8,0,1,1,0,1,1
04033655,22,6,16,0,1,1,0,1,1
04033775,5,2,3,0,1,1,0,0,0
04033961,12,9,3,0,1,1,0,0,1
04034043,18,0,18,0,0,0,0,0,1
04034079,16,4,12,0,6,3,3,0,0
04034559,14,0,14,0,0,0,0,0,1
04034736,8,0,8,0,0,0,0,0,1
04034816,30,0,30,0,0,0,0,0,1
04035248,24,10,14,0,0,0,0,0,1
04035301,6,1,5,0,1,1,0,0,0
04035378,17,4,13,0,0,0,0,0,1
04035880,16,4,12,1,2,2,0,0,1
04036021,4,0,4,0,0,0,0,0,1
04036027,9,0,9,0,0,0,0,0,1
04036182,5,3,2,0,2,2,0,0,0
04036193,34,2,32,0,0,0,0,0,1
04036293,22,0,22,0,0,0,0,0,1
04036393,6,2,4,0,2,2,0,0,0
04036403,9,4,5,0,1,1,0,1,1
04036694,22,0,22,0,0,0,0,0,1
04036745,32,4,28,0,1,1,0,1,1
04036774,15,0,15,0,0,0,0,0,1
04037209,17,8,9,0,1,1,0,0,1
04037670,39,3,36,0,1,1,0,1,1
04037714,6,1,5,0,1,1,0,0,0
04038020,9,4,5,0,2,1,1,1,1
04038033,58,23,35,0,34,26,8,0,1
04038162,33,0,33,0,1,1,0,1,1
04038249,6,1,5,0,2,2,0,0,1
04038337,6,0,6,0,0,0,0,0,0
04038417,6,0,6,0,0,0,0,0,1
04038449,11,4,7,0,0,0,0,0,1
04038466,14,4,10,0,2,2,0,0,1
04038473,15,0,15,0,2,2,0,0,1
04038566,7,5,2,0,3,3,0,0,1
04038644,9,1,8,0,3,1,2,2,0
04038834,37,6,31,0,0,0,0,0,0
04039034,17,7,10,0,0,0,0,0,1
04039078,13,3,10,0,0,0,0,0,1
04039121,35,3,32,0,1,1,0,1,1
04039127,33,5,28,0,1,1,0,1,1
04039458,9,3,6,0,2,1,1,0,0
04039488,83,16,67,0,0,0,0,0,1
04039729,30,0,30,0,1,1,0,1,1
04040084,6,2,4,0,3,3,0,0,1
04040367,5,2,3,0,1,1,0,0,0
04040492,9,4,5,0,1,1,0,1,1
04040649,10,0,10,0,2,2,0,0,1
04040651,12,0,12,0,2,2,0,0,1
04040660,24,4,20,0,0,0,0,0,1
04040810,17,0,17,0,0,0,0,0,1
04041463,21,2,19,0,1,1,0,1,1
04041485,32,0,32,0,0,0,0,0,1
04041538,10,4,6,0,2,2,0,0,1
04041696,5,2,3,0,1,1,0,0,1
04041792,7,3,4,0,2,2,0,0,0
04041884,35,4,31,0,1,1,0,1,1
04041885,7,2,5,0,1,1,0,0,1
04041951,3,2,1,0,1,1,0,0,0
04041962,33,12,21,0,0,0,0,0,1
04042004,8,0,8,0,1,1,0,0,1
04042168,22,3,19,0,1,1,0,1,1
04042196,12,3,9,0,0,0,0,0,1
04042640,37,4,33,0,1,1,0,0,1
04042674,6,2,4,0,2,2,0,0,0
04042725,32,8,24,1,0,0,0,0,1
04042771,11,0,11,0,0,0,0,0,1
04042808,25,3,22,0,1,1,0,1,1
04043124,64,11,53,0,0,0,0,0,1
04043282,21,2,19,1,0,0,0,0,0
04043411,7,2,5,0,1,1,0,1,1
04043523,8,3,5,0,1,1,0,0,1
04044483,43,0,43,0,1,1,0,1,1
04044489,41,0,41,0,1,1,0,1,1
04044609,23,3,20,0,1,1,0,1,1
04044681,12,0,12,0,0,0,0,0,1
04044686,12,0,12,0,0,0,0,0,1
04045031,30,8,22,0,1,0,1,0,1
04045148,5,3,2,0,2,2,0,0,1
04045190,39,10,29,0,0,0,0,0,1
04045262,16,3,13,0,1,1,0,1,1
04045492,4,1,3,0,1,1,0,0,1
04045630,5,0,5,0,0,0,0,0,1
04045780,20,0,20,0,0,0,0,0,1
04045930,16,3,13,0,1,1,0,1,1
04046150,16,5,11,0,4,4,0,0,0
04046482,11,0,11,1,1,1,0,0,1
04046524,12,3,9,0,2,1,1,1,0
04046674,52,14,38,0,0,0,0,0,1
04046760,26,1,25,0,1,1,0,1,1
04046807,18,4,14,0,2,1,1,2,1
04046838,14,0,14,0,1,1,0,1,1
04046886,26,8,18,0,0,0,0,0,1
04047252,6,3,3,0,2,2,0,0,1
04047774,6,4,2,0,1,1,0,1,1
04047905,34,10,24,0,0,0,0,0,1
04048064,5,3,2,0,2,2,0,0,1
04048372,7,2,5,0,0,0,0,0,1
04048571,17,5,12,0,1,1,0,0,1
04048597,6,0,6,0,1,1,0,0,1
04048683,23,9,14,0,1,1,0,0,0
04048959,15,0,15,0,0,0,0,0,1
04048962,19,4,15,0,1,1,0,1,1
04048971,18,3,15,0,1,1,0,1,1
04049093,15,3,12,0,1,1,0,1,1
04049251,24,0,24,0,0,0,0,0,1
04049563,29,5,24,0,0,0,0,0,1
04050381,15,0,15,0,0,0,0,0,1
04050565,4,3,1,0,2,2,0,0,0
04050721,5,2,3,0,1,1,0,0,0
04050786,26,0,26,0,0,0,0,0,1
04050847,12,4,8,0,1,1,0,0,1
04050994,44,10,34,0,0,0,0,0,1
04051085,6,3,3,0,2,2,0,0,0
04051222,14,5,9,0,0,0,0,0,1
04051232,13,0,13,0,0,0,0,0,1
04051439,17,3,14,0,0,0,0,0,0
04051562,17,2,15,0,0,0,0,0,1
04051835,10,5,5,0,1,1,0,0,0
04051966,8,0,8,0,0,0,0,0,0
04052585,9,3,6,0,1,1,0,1,0
04053062,14,2,12,0,1,1,0,1,1
04053065,16,2,14,0,1,1,0,1,1
04053667,19,0,19,0,0,0,0,0,1
04053669,33,5,28,0,2,2,0,1,1
04054176,19,7,12,0,0,0,0,0,1
04054291,48,4,44,0,1,1,0,1,1
04054606,20,5,15,0,0,0,0,0,1
04054936,28,2,26,0,1,1,0,1,1
04055034,6,2,4,0,1,1,0,0,1
04055277,18,4,14,0,1,1,0,1,1
04055346,17,2,15,0,1,1,0,1,1
04055741,26,2,24,0,2,2,0,0,1
04055882,43,6,37,0,0,0,0,0,1
04056136,19,1,18,0,1,1,0,1,1
04056169,25,4,21,0,1,1,0,1,1
04056276,26,0,26,0,1,1,0,1,1
04056294,28,0,28,0,0,0,0,0,1
04056324,11,0,11,1,0,0,0,0,1
04056501,7,0,7,0,0,0,0,0,1
04056767,13,0,13,0,0,0,0,0,1
04057020,28,8,20,0,2,2,0,1,1
04057272,36,4,32,0,1,1,0,1,1
04057306,7,5,2,0,4,4,0,2,1
04057311,20,3,17,1,0,0,0,0,1
04057627,5,4,1,0,1,0,1,0,0
04057744,11,3,8,0,1,1,0,0,1
04058240,6,2,4,0,2,1,1,0,1
04058246,22,0,22,0,2,1,1,2,1
04059151,14,3,11,0,1,1,0,1,1
04059167,8,0,8,0,0,0,0,0,1
04059184,8,0,8,0,0,0,0,0,1
04059192,21,4,17,0,1,1,0,1,1
04059315,17,2,15,0,1,1,0,1,1
04059645,5,3,2,0,2,2,0,0,0
04059753,6,3,3,0,1,1,0,1,1
04059818,6,2,4,0,1,1,0,0,1
04059983,9,3,6,0,2,2,0,0,1
05520372,7,0,7,0,3,3,0,0,0
05520853,7,2,5,0,1,1,0,0,1
05521056,10,0,10,0,1,1,0,0,0
05521154,19,8,11,0,0,0,0,0,1
05521655,10,0,10,0,0,0,0,0,1
05521915,10,0,10,0,0,0,0,0,1
05521927,8,0,8,0,0,0,0,0,1
05521962,4,2,2,0,2,2,0,0,1
05522083,8,1,7,0,1,1,0,1,1
05522098,29,9,20,0,3,1,2,2,1
05522196,24,0,24,0,1,1,0,1,1
05522417,5,2,3,0,0,0,0,0,0
05522704,6,0,6,0,2,2,0,0,0
05522999,7,0,7,0,0,0,0,0,1
05523001,8,1,7,0,0,0,0,0,1
05523092,4,3,1,0,2,2,0,0,1
05523173,5,3,2,0,1,1,0,1,0
05523192,5,3,2,0,2,2,0,0,1
05523489,17,0,17,0,1,1,0,1,1
05523625,5,3,2,0,1,1,0,0,0
05523880,9,2,7,0,0,0,0,0,0
05523956,4,2,2,0,2,2,0,0,0
05524029,21,0,21,0,0,0,0,0,1
05524060,5,1,4,0,1,1,0,0,1
05524252,10,0,10,0,0,0,0,0,1
05524439,26,0,26,0,0,0,0,0,0
05525682,7,1,6,0,2,2,0,2,0
05525879,4,0,4,0,1,1,0,0,1
05526677,4,2,2,0,1,1,0,0,1
05527011,9,2,7,0,1,1,0,0,0
05527256,13,3,10,0,1,1,0,0,1
05527375,9,2,7,0,2,2,0,0,0
05527511,3,0,3,0,0,0,0,0,1
05528023,3,3,0,0,3,3,0,0,0
05528188,3,3,0,0,2,2,0,0,0
05528235,16,5,11,0,0,0,0,0,1
05528392,5,3,2,0,2,2,0,0,0
05528673,17,2,15,0,1,1,0,1,1
05528873,5,2,3,0,1,1,0,0,0
05529166,11,2,9,0,1,1,0,1,1
05530434,8,3,5,0,1,1,0,1,1
05530776,58,10,48,0,0,0,0,0,1
05531292,8,3,5,0,1,1,0,0,1
05531445,16,5,11,0,0,0,0,0,1
05531556,8,3,5,0,1,1,0,0,1
05531865,4,0,4,0,0,0,0,0,0
05531877,4,0,4,0,0,0,0,0,1
05532192,4,2,2,0,1,1,0,0,1
05532226,9,2,7,0,1,1,0,0,1
05532525,9,4,5,0,1,1,0,0,1
05532895,9,3,6,0,1,1,0,1,1
05533283,9,2,7,0,1,1,0,1,0
05533567,7,3,4,0,1,1,0,0,1
05533951,6,2,4,0,1,1,0,0,0
05534106,5,3,2,0,2,2,0,0,0
05534219,4,0,4,0,0,0,0,0,1
05535200,5,0,5,0,1,1,0,0,1
05535209,11,3,8,0,0,0,0,0,1
05535287,10,4,6,0,1,1,0,1,1
05535289,9,3,6,0,1,1,0,1,1
05535367,5,0,5,0,2,2,0,0,0
05535457,5,3,2,0,2,2,0,0,1
05535468,4,2,2,0,1,1,0,0,1
05535479,4,2,2,0,1,1,0,0,1
05535499,13,6,7,0,0,0,0,0,1
05535582,15,4,11,0,2,1,1,2,1
05536018,24,6,18,0,0,0,0,0,0
05536120,54,16,38,0,0,0,0,0,1
05536252,5,2,3,0,3,2,1,1,1
05536459,4,2,2,0,0,0,0,0,1
05536487,10,5,5,0,0,0,0,0,0
05536577,10,4,6,0,4,4,0,0,1
05536643,13,5,8,0,0,0,0,0,1
05536780,4,3,1,0,2,2,0,0,0
05537605,10,4,6,0,1,1,0,1,1
05537660,3,0,3,0,1,1,0,0,0
05537947,21,5,16,0,1,1,0,1,1
05538079,28,7,21,0,3,1,2,0,0
05538623,6,2,4,0,0,0,0,0,0
05538683,3,0,3,0,0,0,0,0,1
05538700,30,11,19,0,0,0,0,0,1
05538904,5,0,5,0,0,0,0,0,1
05539076,3,2,1,0,1,1,0,0,0
05539250,16,2,14,0,0,0,0,0,1
05539474,7,3,4,0,1,1,0,0,1
05539955,24,13,11,0,0,0,0,0,1
05540011,38,11,27,0,0,0,0,0,0
05540115,3,3,0,0,2,2,0,0,0
05540352,38,12,26,0,0,0,0,0,0
05540445,8,2,6,0,0,0,0,0,0
05540539,5,3,2,0,3,3,0,0,0
05540723,12,9,3,0,1,1,0,0,0
05541296,3,3,0,0,2,2,0,0,1
05541340,3,1,2,0,1,1,0,0,0
05541602,23,4,19,0,0,0,0,0,0
05541690,5,3,2,0,2,2,0,0,0
05541738,4,2,2,0,1,1,0,0,1
05541800,40,8,32,0,3,3,0,0,1
05541904,4,0,4,0,0,0,0,0,1
05541919,6,3,3,0,2,2,0,0,1
05542159,6,4,2,0,1,1,0,0,0
05542416,6,2,4,0,1,1,0,0,1
05543054,8,0,8,0,0,0,0,0,1
05543379,3,2,1,0,1,1,0,0,1
05543603,16,4,12,0,0,0,0,0,1
05543826,6,2,4,0,1,1,0,0,1
05544383,10,0,10,0,0,0,0,0,1
05544464,10,1,9,0,0,0,0,0,1
05544738,7,0,7,0,0,0,0,0,1
05544991,7,5,2,0,2,2,0,0,0
05545243,9,3,6,0,1,1,0,1,1
05545375,5,3,2,0,1,1,0,0,0
05545515,16,1,15,0,1,1,0,1,1
05545716,9,0,9,0,0,0,0,0,1
05545749,7,3,4,0,0,0,0,0,1
05545953,7,0,7,0,0,0,0,0,1
05546024,3,3,0,0,1,1,0,0,0
05546272,24,5,19,0,1,1,0,0,1
05546349,10,3,7,0,1,1,0,0,1
05546407,2,2,0,0,1,1,0,0,1
05546492,6,4,2,0,0,0,0,0,0
05546520,12,0,12,0,0,0,0,0,1
05546638,27,8,19,0,0,0,0,0,1
05546901,23,4,19,0,0,0,0,0,1
05546936,15,0,15,0,0,0,0,0,1
05546993,5,0,5,0,0,0,0,0,1
05547200,3,3,0,0,2,2,0,0,1
05547374,5,3,2,0,2,2,0,0,1
05547508,4,3,1,0,2,2,0,0,0
05547510,10,0,10,0,0,0,0,0,0
05547534,15,0,15,0,1,1,0,1,1
05547549,5,0,5,0,0,0,0,0,1
05548282,4,0,4,0,0,0,0,0,1
05548499,12,3,9,0,2,2,0,2,1
05548805,10,2,8,0,0,0,0,0,0
05549151,4,4,0,0,1,1,0,0,0
05549173,5,0,5,0,0,0,0,0,1
05549190,6,0,6,0,0,0,0,0,1
05549234,6,0,6,0,0,0,0,0,1
05549553,4,1,3,0,1,1,0,0,0
05549592,4,2,2,0,1,1,0,0,0
05549616,7,0,7,0,0,0,0,0,1
05549629,5,1,4,0,1,1,0,0,1
05549749,7,3,4,0,2,2,0,0,0
05549995,16,3,13,0,2,2,0,0,1
05550369,8,2,6,0,1,1,0,0,1
05550376,8,2,6,0,1,1,0,0,1
05550593,11,0,11,0,0,0,0,0,1
05550769,4,2,2,0,1,1,0,1,0
05551602,4,1,3,0,1,1,0,0,1
05551672,10,6,4,0,2,2,0,1,0
05552284,6,2,4,0,1,1,0,0,1
05552294,21,5,16,0,1,1,0,1,1
05553153,5,3,2,0,2,2,0,0,0
05553500,8,0,8,0,0,0,0,0,1
05553736,20,7,13,0,3,3,0,0,0
05553889,3,3,0,0,1,1,0,0,1
05554196,52,7,45,0,1,1,0,0,1
05554437,5,2,3,0,1,1,0,0,1
05554633,4,0,4,0,0,0,0,0,1
05554756,6,2,4,0,1,1,0,0,1
05555044,18,8,10,0,4,4,0,0,1
05555125,28,7,21,0,0,0,0,0,0
05555205,3,2,1,0,1,1,0,0,0
05555321,5,1,4,0,2,1,1,0,0
05556013,21,2,19,0,1,1,0,1,1
05556015,5,1,4,0,0,0,0,0,0
05556245,3,3,0,0,2,2,0,0,0
05556574,15,5,10,0,1,1,0,1,1
05557191,14,4,10,0,0,0,0,0,1
05557301,12,6,6,0,0,0,0,0,0
05557458,14,0,14,0,0,0,0,0,1
05557679,5,0,5,0,0,0,0,0,1
05557687,7,3,4,0,2,2,0,0,1
05557943,4,2,2,0,2,1,1,0,0
05558036,4,3,1,0,2,2,0,0,0
05558156,2,0,2,0,1,1,0,0,0
05558337,6,0,6,0,0,0,0,0,1
05558532,14,0,14,0,0,0,0,0,1
05558579,17,8,9,0,2,2,0,0,1
05559028,7,5,2,0,2,2,0,2,0
05559096,18,0,18,0,0,0,0,0,1
05559183,2,2,0,0,1,1,0,0,1
05559226,4,0,4,0,0,0,0,0,0
05559297,5,3,2,0,2,2,0,0,0
05559415,13,6,7,0,1,1,0,0,0
05559862,4,3,1,0,2,2,0,0,0
05560158,6,0,6,0,1,1,0,1,1
05561002,3,2,1,0,1,1,0,0,0
05561412,6,5,1,0,3,1,2,1,0
05561413,7,5,2,0,3,1,2,1,0
05561728,4,2,2,0,2,2,0,0,0
05561788,8,2,6,0,2,2,0,0,1
05562053,32,11,21,0,0,0,0,0,1
05562093,0,0,0,0,0,0,0,0,1
05562123,5,1,4,0,1,1,0,0,0
05562437,50,8,42,0,0,0,0,0,1
05562447,22,0,22,0,0,0,0,0,1
05562589,12,6,6,0,1,1,0,0,0
05562636,25,7,18,0,0,0,0,0,0
05563206,26,5,21,0,0,0,0,0,1
05563215,4,1,3,0,1,1,0,0,1
05563779,20,0,20,0,0,0,0,0,1
05563899,7,0,7,0,0,0,0,0,0
05563951,7,0,7,0,0,0,0,0,1
05563963,6,3,3,0,2,2,0,0,0
05563989,3,3,0,0,2,2,0,0,0
05564018,46,13,33,0,0,0,0,0,1
05564236,5,2,3,0,1,1,0,0,0
05564440,4,0,4,0,0,0,0,0,1
05564884,21,12,9,0,0,0,0,0,0
05565928,3,1,2,0,1,1,0,0,0
05566045,7,2,5,0,3,2,1,0,0
05566516,17,3,14,0,1,1,0,1,1
05566615,6,0,6,0,0,0,0,0,1
05566838,4,2,2,0,1,1,0,0,0
05567097,3,2,1,0,2,2,0,0,0
05567306,19,3,16,0,1,1,0,1,1
05567682,18,4,14,0,1,1,0,0,1
05567945,7,0,7,0,1,1,0,1,1
05567975,17,0,17,0,0,0,0,0,1
05567985,7,0,7,0,1,1,0,1,1
05568015,7,0,7,0,1,1,0,1,1
05568155,8,0,8,0,1,1,0,1,1
05568185,14,3,11,0,1,1,0,1,1
05568324,4,2,2,0,1,1,0,0,0
05568381,5,4,1,0,4,1,3,1,1
05569050,4,0,4,0,0,0,0,0,0
05569301,7,3,4,0,2,2,0,0,1
05569389,3,3,0,0,2,2,0,0,0
05569617,9,5,4,0,1,1,0,0,0
05569675,6,2,4,0,1,1,0,0,1
05569888,7,3,4,0,1,1,0,0,0
05570077,9,2,7,0,1,1,0,0,1
05570197,5,3,2,0,2,2,0,0,1
05570233,6,0,6,0,0,0,0,0,0
05570234,5,3,2,0,2,2,0,0,1
05570350,2,0,2,0,0,0,0,0,1
05570644,9,4,5,0,0,0,0,0,1
05570784,6,3,3,0,2,2,0,0,1
05570991,5,0,5,0,0,0,0,0,0
05571624,21,10,11,0,0,0,0,0,1
05571654,9,0,9,0,0,0,0,0,1
05571671,13,0,13,0,2,2,0,0,1
05571769,9,4,5,0,0,0,0,0,1
05572414,14,3,11,0,2,2,0,0,1
05572528,15,0,15,0,0,0,0,0,1
05572609,3,2,1,0,2,2,0,0,0
05572861,71,4,67,0,0,0,0,0,1
05572956,21,4,17,0,1,1,0,1,0
05572972,21,4,17,0,2,1,1,2,0
05573304,10,4,6,0,1,1,0,0,1
05573594,3,3,0,0,2,2,0,0,0
05573857,4,3,1,0,2,2,0,0,1
05573879,9,3,6,0,4,4,0,1,0
05574038,4,2,2,0,2,1,1,0,0
05574485,13,6,7,0,2,2,0,0,1
05574584,33,8,25,0,0,0,0,0,1
05574603,2,2,0,0,1,1,0,0,0
05575593,8,3,5,0,2,2,0,0,1
05575795,4,2,2,0,1,1,0,0,1
05575906,4,0,4,0,1,1,0,0,1
05576639,2,0,2,0,0,0,0,0,1
05576758,22,5,17,0,0,0,0,0,1
05577224,8,4,4,0,0,0,0,0,0
05577285,9,9,0,0,1,1,0,0,0
05577328,6,0,6,0,0,0,0,0,1
05578557,10,3,7,0,0,0,0,0,1
05579221,2,0,2,0,0,0,0,0,1
05579286,13,8,5,0,2,2,0,0,1
05579311,12,3,9,1,2,1,1,1,1
05579711,4,3,1,0,0,0,0,0,1
05580151,11,3,8,0,0,0,0,0,1
05580562,6,3,3,0,1,1,0,0,0
05580924,8,4,4,0,3,3,0,0,0
05581249,8,3,5,0,2,2,0,0,1
05581645,7,2,5,0,1,1,0,0,1
05581862,2,0,2,0,1,1,0,0,0
05581944,27,9,18,0,0,0,0,0,1
05582254,9,3,6,0,1,1,0,0,1
05582332,12,3,9,0,1,1,0,0,0
05582380,23,5,18,0,2,1,1,0,0
05582490,26,4,22,0,1,1,0,1,1
05582625,6,0,6,0,1,1,0,0,1
05582643,23,8,15,0,0,0,0,0,0
05582760,10,5,5,0,3,3,0,0,1
05582771,6,2,4,0,2,2,0,0,1
05582795,8,5,3,0,3,2,1,0,0
05583139,15,7,8,0,1,1,0,1,1
05583374,9,7,2,0,1,1,0,0,1
05583837,10,0,10,0,0,0,0,0,1
05583987,29,13,16,0,1,1,0,1,0
05584169,6,1,5,0,1,1,0,0,1
05584679,7,3,4,0,1,1,0,0,1
05585111,9,0,9,0,0,0,0,0,1
05585321,32,8,24,0,1,1,0,1,1
05585336,6,2,4,0,0,0,0,0,1
05585384,9,2,7,0,1,1,0,1,1
05585998,21,0,21,0,0,0,0,0,1
05586314,9,1,8,0,0,0,0,0,0
05586340,27,0,27,0,0,0,0,0,1
05586499,7,3,4,0,2,2,0,0,1
05586562,4,0,4,0,0,0,0,0,0
05586582,9,0,9,0,0,0,0,0,1
05586930,4,0,4,0,0,0,0,0,1
05587131,3,0,3,0,0,0,0,0,1
05588379,3,3,0,0,1,1,0,0,1
05588669,3,3,0,0,2,2,0,0,0
05588753,5,3,2,0,1,1,0,1,0
05589064,3,3,0,0,2,2,0,0,0
05589149,4,2,2,0,1,1,0,0,1
05589180,18,5,13,0,0,0,0,0,1
05589505,2,2,0,0,2,2,0,0,1
05589554,2,2,0,0,3,3,0,0,1
05589796,21,0,21,0,0,0,0,0,1
05590344,14,2,12,0,0,0,0,0,1
05590871,11,0,11,0,0,0,0,0,1
05590921,10,5,5,0,3,1,2,1,0
05590943,5,2,3,0,1,1,0,0,1
05590977,39,6,33,0,0,0,0,0,1
05591835,6,1,5,0,1,1,0,0,0
05591892,35,9,26,0,0,0,0,0,1
05591920,15,9,6,0,1,1,0,0,0
05592112,7,0,7,0,0,0,0,0,1
05592192,3,2,1,0,1,1,0,0,0
05592548,5,0,5,0,0,0,0,0,1
05592789,5,1,4,0,1,1,0,0,0
05593040,6,4,2,0,1,1,0,0,0
05593116,12,2,10,0,1,1,0,1,0
05593239,10,5,5,0,1,1,0,1,1
05593274,10,5,5,0,1,1,0,1,1
05593278,10,5,5,0,1,1,0,1,1
05593412,11,2,9,0,1,1,0,0,1
05593541,11,4,7,0,1,1,0,1,1
05594477,7,4,3,0,4,3,1,0,0
05594502,2,0,2,0,0,0,0,0,0
05594575,6,2,4,0,1,1,0,0,0
05594889,25,6,19,0,0,0,0,0,1
05595234,9,5,4,0,4,4,0,0,1
05595352,6,2,4,0,1,1,0,0,1
05595445,14,2,12,0,1,1,0,1,1
05595462,9,3,6,0,2,2,0,0,1
05595573,9,0,9,0,1,1,0,0,1
05595709,32,3,29,0,2,1,1,0,0
05596168,16,3,13,0,1,1,0,1,1
05596459,2,0,2,0,0,0,0,0,1
05596489,30,14,16,0,1,1,0,0,1
05596553,4,3,1,0,2,2,0,0,0
05597058,8,0,8,0,0,0,0,0,1
05597060,30,7,23,0,1,1,0,1,1
05597181,17,5,12,0,0,0,0,0,1
05597188,19,6,13,0,1,1,0,0,1
05597472,7,2,5,0,1,1,0,0,0
05597709,26,4,22,0,1,1,0,1,1
05598063,46,2,44,0,1,1,0,1,1
05598134,4,3,1,0,2,2,0,0,0
05598521,17,3,14,0,1,1,0,1,0
05598738,9,4,5,0,0,0,0,0,1
05598877,47,6,41,0,0,0,0,0,1
05599255,3,3,0,0,2,2,0,0,0
05599269,23,4,19,0,1,1,0,1,1
05599311,10,3,7,0,1,1,0,0,0
05599674,5,2,3,0,1,1,0,1,1
05599801,4,0,4,0,1,1,0,0,1
05599963,9,0,9,0,0,0,0,0,1
05600195,10,2,8,0,1,1,0,1,1
05600197,10,2,8,0,1,1,0,1,1
05600639,4,2,2,0,2,2,0,0,0
05600660,3,0,3,0,0,0,0,0,0
05600808,16,3,13,0,2,1,1,2,1
05601050,9,4,5,0,1,1,0,1,1
05601189,7,3,4,0,2,2,0,0,0
05601537,2,0,2,0,1,1,0,0,1
05601632,51,6,45,0,1,1,0,1,0
05601681,7,0,7,0,0,0,0,0,1
05601684,9,0,9,0,0,0,0,0,1
05601737,22,4,18,0,0,0,0,0,1
05601985,14,0,14,0,0,0,0,0,1
05602169,10,2,8,0,1,1,0,1,1
05602213,4,3,1,0,1,1,0,0,0
05602295,7,4,3,0,3,3,0,0,1
05602581,31,9,22,0,0,0,0,0,0
05602833,18,9,9,0,0,0,0,0,1
05603073,19,0,19,0,6,3,3,0,1
05603111,15,2,13,0,2,1,1,2,1
05603442,5,3,2,0,2,2,0,0,1
05603660,3,0,3,0,0,0,0,0,1
05603721,25,3,22,0,0,0,0,0,1
05603875,28,0,28,0,1,1,0,1,1
05603956,6,0,6,0,1,1,0,1,0
05604259,4,2,2,0,1,1,0,0,1
05604295,14,9,5,0,0,0,0,0,1
05604329,5,0,5,0,0,0,0,0,1
05604331,6,0,6,0,0,0,0,0,1
05604527,17,3,14,0,1,1,0,1,1
05604551,6,2,4,0,2,1,1,0,0
05604821,4,0,4,0,0,0,0,0,1
05604941,12,2,10,0,1,1,0,1,0
03796233,35,4,31,0,1,1,0,1,1
03796413,5,1,4,0,1,1,0,0,1
03796899,29,3,26,0,1,1,0,1,0
03796951,31,0,31,0,0,0,0,0,1
03797476,21,0,21,0,0,0,0,0,1
03797637,9,2,7,0,1,1,0,0,1
03797747,34,3,31,0,1,1,0,1,1
03798315,5,2,3,0,1,1,0,0,0
03798359,7,2,5,0,1,1,0,0,0
03798374,12,1,11,0,2,2,0,2,1
03798407,49,7,42,0,0,0,0,0,1
03798664,13,3,10,0,0,0,0,0,1
03798884,47,9,38,0,0,0,0,0,1
03798888,30,2,28,0,1,1,0,1,1
03798891,5,3,2,0,2,2,0,0,1
03798902,30,10,20,0,1,1,0,0,1
03798947,10,0,10,0,0,0,0,0,1
03798969,21,3,18,0,1,1,0,1,1
03799050,11,0,11,0,1,1,0,1,1
03799052,4,2,2,0,1,1,0,0,1
03799354,14,3,11,0,1,1,0,1,1
03799539,11,1,10,0,3,3,0,0,1
03799549,21,0,21,0,1,1,0,1,1
03799721,13,2,11,0,1,0,1,0,0
03799996,9,0,9,0,0,0,0,0,1
03800163,7,4,3,0,1,1,0,0,0
03800287,4,3,1,0,1,1,0,0,0
03800389,22,0,22,0,2,2,0,2,1
03800414,4,3,1,0,1,1,0,0,1
03800619,5,1,4,0,1,1,0,1,1
03800862,8,1,7,0,1,1,0,0,1
03800882,16,0,16,0,1,1,0,0,1
03800928,34,5,29,0,1,1,0,0,1
03801163,23,3,20,0,2,1,1,1,1
03801201,10,4,6,0,1,1,0,0,0
03801456,20,0,20,0,0,0,0,0,1
03801479,29,3,26,0,0,0,0,0,1
03801508,6,1,5,0,1,1,0,0,0
03801700,4,2,2,0,2,2,0,0,1
03801760,27,4,23,0,0,0,0,0,1
03801846,5,3,2,0,1,1,0,0,0
03802001,86,5,81,0,1,1,0,1,1
03802387,36,11,25,0,0,0,0,0,1
03802476,44,15,29,0,0,0,0,0,1
03802649,19,5,14,0,0,0,0,0,1
03802661,4,3,1,0,1,1,0,0,1
03802706,40,0,40,0,0,0,0,0,1
03802874,11,0,11,1,0,0,0,0,1
03803220,14,2,12,0,1,1,0,1,1
03803544,4,1,3,0,1,1,0,0,1
03804210,13,0,13,0,0,0,0,0,1
03804593,7,3,4,0,1,1,0,0,1
03804696,43,4,39,0,6,1,5,1,1
03804703,18,0,18,0,0,0,0,0,1
03804730,16,4,12,0,0,0,0,0,1
03804831,10,1,9,0,1,1,0,1,1
03804850,11,4,7,0,2,1,1,1,1
03805175,5,0,5,0,0,0,0,0,1
03805228,21,4,17,0,1,1,0,1,1
03805320,21,4,17,0,1,1,0,1,1
03805401,30,8,22,0,1,1,0,1,1
03805416,35,3,32,0,2,1,1,2,1
03805705,8,0,8,0,0,0,0,0,1
03805708,30,3,27,0,1,1,0,1,1
03806005,8,2,6,0,1,1,0,1,1
03806107,14,2,12,0,1,1,0,0,0
03806198,23,4,19,0,2,1,1,2,1
03806200,7,2,5,0,1,1,0,1,1
03806216,22,3,19,0,2,2,0,2,1
03806233,18,4,14,0,1,1,0,1,1
03806278,0,0,0,0,0,0,0,0,1
03806342,9,4,5,0,3,3,0,0,1
03806388,11,7,4,0,1,1,0,0,1
03806391,19,4,15,0,0,0,0,0,1
03806419,11,4,7,0,1,1,0,1,1
03806491,40,5,35,0,4,1,3,1,0
03806518,10,3,7,0,1,1,0,1,1
03806529,10,3,7,0,1,1,0,1,1
03806670,9,4,5,0,1,1,0,1,1
03807203,24,5,19,0,0,0,0,0,1
03807262,52,0,52,0,0,0,0,0,1
03807559,24,5,19,0,1,1,0,1,1
03807696,29,3,26,0,1,1,0,1,1
03807723,9,3,6,0,3,3,0,1,1
03807789,10,4,6,0,1,1,0,0,1
03807848,7,4,3,0,4,3,1,0,0
03807883,5,2,3,0,1,1,0,0,0
03807973,27,4,23,0,0,0,0,0,0
03808127,15,3,12,0,0,0,0,0,1
03808291,22,0,22,0,0,0,0,0,1
03808360,17,2,15,0,1,1,0,1,1
03808857,17,3,14,0,1,1,0,1,1
03808866,21,0,21,0,0,0,0,0,1
03808998,14,1,13,1,1,1,0,0,1
03809039,34,11,23,0,1,1,0,1,1
03809119,14,3,11,0,1,1,0,0,1
03809192,22,3,19,0,1,1,0,1,1
03809274,18,5,13,1,0,0,0,0,1
03809329,9,2,7,0,0,0,0,0,1
03809336,11,5,6,0,0,0,0,0,1
03809473,22,0,22,0,0,0,0,0,1
03809476,27,3,24,0,0,0,0,0,1
03809903,15,3,12,0,0,0,0,0,1
03810003,15,2,13,0,0,0,0,0,1
03810162,21,6,15,0,1,1,0,1,1
03810277,6,3,3,0,1,1,0,0,1
03810395,29,0,29,0,1,1,0,1,1
03810496,44,7,37,0,2,2,0,2,1
03810527,44,7,37,0,1,1,0,1,1
03810612,8,5,3,0,3,1,2,0,0
03810644,7,5,2,0,1,1,0,0,0
03810841,24,0,24,0,0,0,0,0,1
03810974,34,2,32,0,1,1,0,1,1
03811133,38,5,33,0,0,0,0,0,1
03811155,9,0,9,0,0,0,0,0,1
03811373,50,3,47,0,1,1,0,1,1
03811631,7,5,2,0,4,4,0,0,1
03811720,7,3,4,0,2,2,0,0,1
03812015,39,3,36,0,1,1,0,1,1
03812071,11,4,7,0,3,2,1,0,1
03812646,16,0,16,0,0,0,0,0,1
03812851,28,7,21,0,0,0,0,0,1
03813010,10,3,7,0,1,1,0,1,1
03813172,20,3,17,0,1,1,0,1,1
03813185,10,2,8,0,3,2,1,0,1
03813450,31,5,26,0,0,0,0,0,1
03813859,23,5,18,0,1,1,0,1,1
03813991,10,1,9,0,2,1,1,2,0
03814008,8,0,8,0,0,0,0,0,1
03814028,5,0,5,0,0,0,0,0,1
03814118,12,4,8,0,3,3,0,0,0
03814129,6,3,3,0,2,2,0,0,1
03814318,21,6,15,0,1,0,1,0,1
03814724,5,0,5,0,0,0,0,0,1
03814931,7,4,3,0,2,1,1,2,1
03815052,41,0,41,0,0,0,0,0,1
03815232,9,0,9,0,0,0,0,0,1
03815275,14,5,9,0,0,0,0,0,1
03815545,13,0,13,0,1,1,0,0,0
03815552,36,4,32,0,0,0,0,0,1
03815604,23,4,19,0,0,0,0,0,1
03815653,16,6,10,0,1,1,0,0,0
03815767,6,5,1,0,1,1,0,0,1
03815967,26,0,26,0,0,0,0,0,1
03816426,59,5,54,0,9,6,3,0,1
03816463,29,3,26,0,1,1,0,1,1
03816616,29,6,23,0,1,1,0,1,1
03816842,68,19,49,0,2,1,1,0,1
03816947,28,4,24,0,1,1,0,1,1
03816981,31,3,28,0,1,1,0,1,1
03816999,8,5,3,0,0,0,0,0,0
03817295,25,3,22,0,1,1,0,1,1
03817762,40,11,29,0,0,0,0,0,1
03817858,10,2,8,0,1,1,0,0,1
03817875,12,0,12,0,0,0,0,0,1
03818058,49,6,43,0,0,0,0,0,1
03818112,12,0,12,0,0,0,0,0,1
03818176,32,4,28,0,1,1,0,1,1
03818182,20,2,18,0,3,3,0,0,1
03818303,13,0,13,0,1,1,0,0,1
03818321,24,4,20,0,1,1,0,1,1
03818324,19,5,14,0,1,1,0,1,1
03818327,27,4,23,0,1,1,0,1,1
03818330,19,4,15,0,1,1,0,1,1
03818471,23,7,16,0,0,0,0,0,1
03818717,10,5,5,0,2,2,0,0,0
03818982,23,0,23,0,1,1,0,1,1
03818987,8,2,6,0,1,1,0,1,1
03819033,63,8,55,0,0,0,0,0,1
03819042,11,4,7,0,0,0,0,0,0
03819082,37,4,33,0,1,1,0,1,1
03819176,79,5,74,0,0,0,0,0,1
03819264,0,0,0,0,0,0,0,0,1
03819621,18,0,18,0,1,1,0,1,1
03819687,71,0,71,0,0,0,0,0,1
03819753,9,0,9,0,0,0,0,0,1
03819879,9,0,9,0,0,0,0,0,1
03819961,10,4,6,0,1,1,0,1,1
03820131,14,0,14,0,1,1,0,1,1
03820149,6,2,4,0,1,1,0,0,1
03820420,10,2,8,0,1,1,0,0,1
03820974,18,3,15,0,0,0,0,0,1
03821351,29,3,26,0,1,1,0,1,1
03821546,14,2,12,0,2,2,0,0,1
03821702,22,8,14,0,1,1,0,1,1
03821791,15,2,13,0,0,0,0,0,1
03822130,18,5,13,0,0,0,0,0,1
03822393,9,2,7,0,1,1,0,0,1
03822618,26,4,22,0,0,0,0,0,1
03822770,4,3,1,0,2,2,0,0,1
03822808,9,6,3,0,5,5,0,1,0
03823129,35,12,23,0,0,0,0,0,0
03823471,9,4,5,0,2,2,0,0,1
03823580,22,0,22,0,0,0,0,0,1
03823770,23,0,23,0,2,2,0,0,1
03824108,6,2,4,0,1,1,0,1,1
03824159,16,2,14,0,2,1,1,0,0
03824228,14,2,12,0,2,1,1,2,1
03824308,14,5,9,0,2,2,0,0,1
03824378,18,0,18,0,0,0,0,0,1
03824818,25,7,18,0,0,0,0,0,0
03825041,13,4,9,0,1,1,0,1,1
03825057,44,7,37,0,1,1,0,1,1
03825262,29,5,24,0,2,2,0,2,1
03825300,6,2,4,0,1,1,0,0,1
03825437,9,2,7,0,2,1,1,0,1
03825499,12,4,8,0,0,0,0,0,1
03825888,20,0,20,0,1,1,0,1,1
03825899,16,4,12,0,1,1,0,1,1
03826071,6,3,3,0,1,1,0,0,0
03826282,21,7,14,0,2,1,1,1,1
03826341,8,4,4,0,2,2,0,0,0
03826742,15,0,15,0,0,0,0,0,1
03826797,33,10,23,0,1,1,0,1,1
03826889,14,0,14,0,0,0,0,0,1
03826898,6,0,6,0,0,0,0,0,1
03826915,6,0,6,0,0,0,0,0,1
03827111,8,0,8,0,0,0,0,0,1
03827277,25,3,22,0,1,1,0,1,1
03827461,13,0,13,0,0,0,0,0,1
03827593,45,7,38,0,3,1,2,0,1
03827654,53,8,45,0,0,0,0,0,0
03827900,6,0,6,0,0,0,0,0,1
03828452,10,4,6,0,0,0,0,0,1
03828739,32,2,30,0,1,1,0,1,1
03828791,18,3,15,0,0,0,0,0,1
03828884,24,0,24,0,0,0,0,0,1
03829109,19,5,14,0,0,0,0,0,1
03829217,103,14,89,0,0,0,0,0,1
03829309,7,4,3,0,1,1,0,1,1
03829341,15,4,11,0,1,1,0,1,1
03829441,8,3,5,0,4,3,1,0,0
03829460,27,5,22,0,1,1,0,0,1
03829462,35,9,26,0,1,1,0,1,1
03829464,7,0,7,0,0,0,0,0,1
03829466,22,3,19,0,0,0,0,0,1
03829467,17,3,14,0,1,1,0,1,1
03829468,25,3,22,0,1,1,0,1,1
03829469,26,3,23,0,1,1,0,1,1
03829472,17,3,14,0,1,1,0,1,1
03829473,30,5,25,0,3,3,0,3,1
03829481,17,4,13,0,3,1,2,1,1
03829537,25,9,16,0,1,1,0,1,1
03829583,16,3,13,0,1,1,0,1,0
03829585,18,0,18,0,1,1,0,1,1
03829615,15,3,12,0,1,1,0,1,1
03829676,14,4,10,0,5,4,1,0,1
03829751,6,2,4,0,1,1,0,1,1
03829851,47,9,38,0,1,1,0,1,1
03829852,8,1,7,0,0,0,0,0,1
03829939,18,3,15,0,1,1,0,1,1
03830104,4,1,3,0,1,1,0,0,1
03830161,23,7,16,0,1,1,0,1,1
03830317,6,5,1,0,1,1,0,0,1
03830335,68,2,66,0,2,1,1,0,1
03830687,10,2,8,0,1,1,0,0,0
03830765,8,4,4,0,1,1,0,1,1
03830964,8,4,4,0,1,1,0,1,0
03830974,11,0,11,0,0,0,0,0,1
03831070,10,1,9,0,1,1,0,0,0
03831702,18,3,15,0,1,1,0,1,1
03831711,18,6,12,0,5,5,0,0,0
03831726,14,3,11,0,1,1,0,1,1
03832123,40,8,32,0,8,6,2,0,1
03832821,11,0,11,0,0,0,0,0,1
03833210,5,1,4,0,1,1,0,0,1
03833956,11,1,10,0,2,1,1,0,1
03833962,13,4,9,0,0,0,0,0,1
03834020,28,5,23,0,1,1,0,1,1
03834115,21,0,21,0,0,0,0,0,1
03834235,30,16,14,0,1,1,0,1,1
03834353,12,3,9,0,2,1,1,2,1
03834436,17,2,15,0,1,1,0,1,1
03834506,22,1,21,0,1,1,0,1,1
03834562,9,4,5,0,3,3,0,0,1
03834606,11,0,11,0,0,0,0,0,1
03834770,9,4,5,0,1,1,0,0,0
03834855,8,4,4,0,1,1,0,1,1
03834867,56,0,56,0,0,0,0,0,1
03834872,13,4,9,0,1,1,0,1,1
03834878,30,3,27,0,1,1,0,1,1
03835186,23,5,18,0,0,0,0,0,1
03835263,6,1,5,0,0,0,0,0,0
03835495,4,2,2,0,2,2,0,0,1
03835531,14,2,12,0,1,1,0,1,1
03835617,33,4,29,0,4,4,0,4,1
03835994,4,0,4,0,1,1,0,0,1
03836106,32,9,23,0,0,0,0,0,0
03836457,8,3,5,0,1,1,0,0,1
03836708,28,5,23,0,1,1,0,1,1
03837010,64,16,48,0,0,0,0,0,1
03837152,40,5,35,0,1,1,0,1,1
03837274,13,0,13,0,0,0,0,0,1
03837407,3,0,3,0,1,1,0,0,0
03837546,13,2,11,0,2,2,0,0,1
03837587,5,1,4,0,1,1,0,0,0
03837620,8,2,6,0,2,2,0,0,0
03837708,6,2,4,0,1,1,0,0,1
03838218,5,3,2,0,1,1,0,1,1
03838240,7,0,7,0,1,1,0,1,1
03838251,7,0,7,0,1,1,0,1,1
03838618,93,18,75,0,2,1,1,0,0
03838679,6,3,3,0,2,2,0,0,1
03838766,48,0,48,0,4,1,3,4,1
02326223,16,0,16,0,0,0,0,0,1
02326233,13,3,10,0,1,1,0,1,1
02326247,14,3,11,0,1,1,0,1,1
02326300,33,0,33,0,0,0,0,0,1
02326316,31,4,27,0,1,1,0,1,1
02326324,145,9,136,0,0,0,0,0,1
02327017,11,2,9,0,2,2,0,0,1
02327070,15,2,13,0,1,1,0,1,1
02327255,6,2,4,0,1,1,0,0,1
02327319,21,3,18,0,1,1,0,1,1
02327482,13,2,11,0,1,1,0,1,1
02327504,20,2,18,0,1,1,0,1,1
02327632,4,0,4,0,0,0,0,0,1
02327661,15,3,12,0,1,1,0,1,1
02327763,26,3,23,0,1,1,0,1,1
02328169,38,0,38,0,0,0,0,0,1
02328290,10,3,7,0,0,0,0,0,1
02328378,30,13,17,0,0,0,0,0,1
02328489,31,6,25,0,1,1,0,1,1
02328553,44,7,37,0,1,1,0,1,0
02328561,52,7,45,0,1,1,0,1,1
02328565,40,6,34,0,1,1,0,1,1
02328631,29,10,19,0,1,1,0,0,1
02328662,24,5,19,0,2,2,0,0,1
02328941,54,11,43,0,1,1,0,0,1
02329342,58,4,54,0,1,1,0,1,1
02329345,21,6,15,0,1,1,0,1,1
02329582,37,6,31,0,0,0,0,0,1
02329655,39,0,39,0,0,0,0,0,1
02330244,16,0,16,0,1,1,0,1,1
02330337,44,0,44,0,0,0,0,0,1
02330366,22,2,20,0,1,1,0,1,1
02330378,40,2,38,0,1,1,0,1,1
02330557,7,3,4,0,1,1,0,0,0
02330685,7,2,5,0,1,1,0,1,0
02330688,64,8,56,0,2,2,0,2,1
02330755,3,3,0,0,2,2,0,0,0
02330851,24,4,20,0,1,1,0,1,1
02331093,20,3,17,0,1,1,0,1,1
02331133,29,3,26,0,1,1,0,1,1
02331213,33,0,33,0,0,0,0,0,1
02331296,46,13,33,0,0,0,0,0,1
02331405,41,15,26,0,0,0,0,0,1
02331440,24,11,13,0,0,0,0,0,1
02331655,14,3,11,0,1,1,0,1,1
02331936,47,4,43,0,0,0,0,0,1
02332045,30,0,30,0,0,0,0,0,1
02332232,62,0,62,0,0,0,0,0,1
02332233,62,0,62,0,0,0,0,0,1
02332254,36,5,31,0,1,1,0,1,1
02332284,99,8,91,0,1,1,0,1,0
02332404,13,3,10,0,0,0,0,0,1
02332465,11,0,11,0,0,0,0,0,1
02332529,71,7,64,0,1,1,0,1,1
02332657,17,3,14,0,1,1,0,1,1
02332671,16,6,10,0,0,0,0,0,1
02333640,35,2,33,0,1,1,0,1,1
02333700,34,5,29,0,1,1,0,1,1
02333709,18,0,18,0,0,0,0,0,1
02333942,41,8,33,0,0,0,0,0,0
02334190,65,4,61,0,1,1,0,1,1
02334236,3,2,1,0,1,1,0,0,0
02334589,71,12,59,0,0,0,0,0,1
02334606,75,3,72,0,1,1,0,1,1
02334930,40,0,40,0,0,0,0,0,1
02334932,42,3,39,0,1,0,1,0,1
02335436,11,0,11,0,1,1,0,1,0
02335628,16,0,16,0,0,0,0,0,1
02335811,31,3,28,0,1,1,0,1,1
02335976,14,0,14,0,0,0,0,0,1
02336407,4,2,2,0,2,2,0,0,1
02336447,16,3,13,0,0,0,0,0,1
02336457,6,5,1,0,0,0,0,0,1
02336502,19,3,16,0,0,0,0,0,0
02336587,70,14,56,0,0,0,0,0,0
02336822,35,5,30,0,0,0,0,0,1
02336939,7,0,7,0,0,0,0,0,1
02337128,17,5,12,0,1,1,0,1,1
02337239,37,6,31,0,0,0,0,0,1
02337579,7,3,4,0,2,2,0,0,0
02337719,8,1,7,0,1,1,0,0,1
02337961,57,6,51,0,1,1,0,1,1
02338106,4,3,1,0,0,0,0,0,0
02338401,26,3,23,0,1,1,0,1,1
02338444,25,5,20,0,1,1,0,1,1
02338548,69,7,62,0,2,1,1,2,1
02338603,2,0,2,0,0,0,0,0,1
02338612,7,1,6,0,2,2,0,0,0
02338635,8,1,7,0,0,0,0,0,1
02338866,33,0,33,0,0,0,0,0,1
02339399,15,1,14,0,1,1,0,1,1
02339826,72,11,61,0,0,0,0,0,1
02339918,18,0,18,0,0,0,0,0,1
02340053,41,4,37,0,1,1,0,1,1
02340150,43,5,38,0,1,1,0,1,1
02340559,38,3,35,0,0,0,0,0,1
02340600,15,4,11,0,1,1,0,1,1
02341216,19,1,18,0,1,1,0,1,1
02341733,61,18,43,0,2,1,1,0,1
02341878,9,0,9,0,1,1,0,0,1
02341947,66,4,62,0,1,1,0,1,1
02341962,27,2,25,0,1,1,0,1,1
02341989,31,3,28,0,1,1,0,1,1
02342007,38,2,36,0,0,0,0,0,1
02342029,15,3,12,0,1,1,0,1,1
02342186,23,7,16,0,1,1,0,1,1
02342304,11,0,11,0,0,0,0,0,1
02342324,9,4,5,0,0,0,0,0,1
02342461,14,3,11,0,1,1,0,1,1
02342722,19,5,14,0,0,0,0,0,1
02342747,25,4,21,0,1,1,0,1,1
02343094,21,0,21,0,0,0,0,0,1
02343336,21,4,17,0,1,1,0,1,1
02343438,18,0,18,0,0,0,0,0,0
02343731,21,4,17,0,2,1,1,2,1
02343760,36,5,31,0,1,1,0,1,1
02343769,31,9,22,0,0,0,0,0,1
02343796,20,0,20,0,0,0,0,0,1
02344177,27,0,27,0,0,0,0,0,1
02344271,20,4,16,0,0,0,0,0,0
02344610,51,8,43,0,2,2,0,2,1
02345206,8,6,2,0,4,4,0,0,0
02345258,10,5,5,1,1,1,0,1,1
02345397,15,5,10,0,1,1,0,1,1
02345826,6,5,1,0,1,1,0,1,0
02346804,26,3,23,0,1,1,0,1,1
02347041,27,6,21,0,1,1,0,1,1
02347184,30,4,26,0,1,1,0,1,1
02347198,29,0,29,0,1,1,0,1,1
02347461,2,2,0,0,0,0,0,0,0
02348148,24,1,23,0,2,1,1,2,1
02348160,15,4,11,0,3,3,0,0,1
02348222,28,6,22,0,1,1,0,1,1
02348369,6,1,5,0,2,1,1,0,1
02348451,17,2,15,0,1,1,0,1,1
02348485,18,3,15,0,1,1,0,1,1
02348841,45,4,41,0,1,1,0,1,1
02348909,6,4,2,0,1,1,0,0,1
02349026,13,3,10,0,2,2,0,0,1
02349120,18,2,16,0,0,0,0,0,1
02349211,25,8,17,0,0,0,0,0,0
02349325,5,3,2,0,1,1,0,0,0
02349897,21,2,19,0,1,1,0,0,1
02350118,11,6,5,0,0,0,0,0,1
02350124,15,2,13,0,4,3,1,0,1
02350350,37,6,31,0,0,0,0,0,1
02350673,11,2,9,0,0,0,0,0,1
02351070,48,0,48,0,0,0,0,0,1
02351555,21,3,18,0,1,1,0,1,1
02352329,27,3,24,0,1,1,0,1,1
02352341,27,4,23,0,2,2,0,2,1
02352430,27,0,27,0,0,0,0,0,1
02352435,46,3,43,0,1,1,0,1,1
02352468,59,0,59,0,0,0,0,0,1
02352665,24,4,20,0,1,1,0,1,1
02352813,17,6,11,0,0,0,0,0,1
02352937,2,2,0,0,1,1,0,0,0
02353086,4,3,1,0,2,2,0,0,1
02353325,18,4,14,0,1,1,0,0,1
02353361,17,0,17,0,0,0,0,0,1
02353380,13,2,11,0,1,1,0,0,1
02353392,59,11,48,0,0,0,0,0,0
02353425,56,7,49,0,0,0,0,0,1
02353439,46,7,39,0,1,1,0,1,1
02353459,37,0,37,0,1,1,0,1,1
02353599,22,2,20,0,0,0,0,0,1
02353634,35,7,28,0,0,0,0,0,0
02353666,5,0,5,0,0,0,0,0,0
02353690,28,0,28,0,0,0,0,0,1
02353756,19,2,17,0,0,0,0,0,1
02353797,22,0,22,0,0,0,0,0,1
02353803,47,3,44,0,1,1,0,1,1
02353873,26,6,20,0,2,2,0,0,1
02354106,33,3,30,0,1,1,0,1,1
02354214,39,0,39,0,1,1,0,1,1
02354253,24,7,17,0,1,1,0,1,1
02354326,33,0,33,0,0,0,0,0,1
02354342,17,0,17,0,1,1,0,1,1
02354608,37,7,30,0,1,1,0,1,1
02354894,22,5,17,0,1,1,0,1,1
02355000,5,3,2,0,1,1,0,0,1
02355196,39,3,36,0,1,1,0,1,1
02355246,18,2,16,0,0,0,0,0,1
02355276,7,3,4,0,1,1,0,1,0
02355314,36,3,33,0,1,1,0,1,1
02355834,57,6,51,0,1,1,0,1,1
02356249,12,3,9,0,2,2,0,0,1
02356369,7,1,6,0,1,1,0,0,0
02356570,28,5,23,0,1,1,0,1,1
02357067,41,2,39,0,3,2,1,0,1
02357318,66,8,58,0,0,0,0,0,1
02357333,29,8,21,0,0,0,0,0,1
02357558,79,4,75,0,1,1,0,1,1
02357612,5,0,5,0,0,0,0,0,1
02357645,45,3,42,0,1,1,0,1,1
02357947,17,4,13,0,0,0,0,0,1
02357952,2,2,0,0,1,1,0,0,1
02358150,15,3,12,0,0,0,0,0,1
02358618,5,3,2,0,1,1,0,0,1
02358972,10,4,6,0,3,1,2,3,1
02359038,11,3,8,0,3,3,0,0,1
02359322,25,0,25,0,0,0,0,0,1
02359574,18,2,16,0,1,1,0,0,1
02359751,39,6,33,0,1,1,0,1,1
02359756,18,3,15,0,2,2,0,0,1
02360101,41,5,36,0,1,0,1,0,1
02360140,28,8,20,0,8,0,8,0,1
02360377,5,4,1,0,2,2,0,2,1
02360656,39,4,35,0,1,1,0,1,1
02361019,45,2,43,0,1,1,0,1,1
02361077,32,3,29,0,1,1,0,1,1
02361261,39,5,34,0,1,1,0,1,1
02361283,30,5,25,0,1,1,0,1,1
02361287,26,5,21,0,1,1,0,1,1
02361305,33,0,33,0,1,1,0,1,1
02361310,28,5,23,0,2,2,0,2,1
02361444,24,7,17,0,0,0,0,0,1
02361476,37,5,32,0,1,1,0,1,1
02361568,28,5,23,0,1,1,0,1,1
02361981,22,5,17,0,0,0,0,0,1
02362017,44,5,39,0,1,1,0,1,1
02362187,26,0,26,0,0,0,0,0,1
02362210,47,5,42,0,1,1,0,1,1
02362253,26,5,21,0,1,1,0,1,1
02362376,14,0,14,0,0,0,0,0,1
02362514,5,3,2,0,1,1,0,0,1
02362531,34,11,23,0,0,0,0,0,1
02362563,28,5,23,0,1,1,0,1,1
02362865,12,6,6,0,0,0,0,0,1
02362953,27,5,22,0,1,1,0,1,1
02362988,30,5,25,0,1,1,0,1,1
02363256,16,3,13,0,1,1,0,1,1
02363378,32,0,32,0,0,0,0,0,1
02363592,60,9,51,0,0,0,0,0,0
02363642,55,7,48,0,0,0,0,0,1
02363778,15,4,11,0,1,1,0,1,1
02364203,106,0,106,0,0,0,0,0,1
02364704,15,2,13,0,1,1,0,1,1
02364946,36,4,32,0,1,1,0,1,1
02365349,28,4,24,0,0,0,0,0,0
02365718,17,4,13,0,0,0,0,0,0
02365900,124,5,119,0,0,0,0,0,1
02365974,38,4,34,0,1,1,0,1,1
02366152,59,4,55,0,0,0,0,0,1
02366377,26,11,15,0,0,0,0,0,1
02366618,42,5,37,0,1,1,0,1,1
02366620,56,3,53,0,1,1,0,1,1
02366640,33,7,26,0,0,0,0,0,1
02366656,52,12,40,0,2,1,1,2,1
02366665,35,11,24,0,1,1,0,1,1
02366678,78,11,67,0,1,1,0,1,1
02366682,74,11,63,0,1,1,0,1,1
02366759,28,5,23,0,0,0,0,0,1
02366777,53,11,42,0,1,1,0,1,1
02366837,86,0,86,0,0,0,0,0,1
02366879,30,3,27,0,1,1,0,1,1
02366906,59,14,45,0,1,1,0,1,1
02366923,56,7,49,0,1,1,0,1,1
02366937,52,6,46,0,1,1,0,1,1
02366942,39,6,33,0,1,1,0,1,1
02366949,96,14,82,0,1,1,0,1,1
02366963,67,4,63,0,1,1,0,1,1
02366977,58,9,49,0,1,1,0,1,1
02366995,43,4,39,0,1,1,0,1,1
02367004,97,8,89,0,1,1,0,1,1
02367076,66,2,64,0,1,1,0,1,1
02367078,47,3,44,0,1,1,0,1,1
02367479,14,0,14,0,0,0,0,0,1
02367552,21,6,15,0,0,0,0,0,1
02367626,92,12,80,0,0,0,0,0,1
02367662,32,0,32,0,0,0,0,0,1
02367773,21,8,13,0,0,0,0,0,1
02367871,11,3,8,0,0,0,0,0,1
03540017,13,3,10,0,1,1,0,1,0
03540104,12,2,10,0,1,1,0,0,1
03540118,7,0,7,0,2,2,0,0,1
03540159,25,4,21,0,1,1,0,1,1
03540536,38,9,29,0,0,0,0,0,1
03540558,11,0,11,0,0,0,0,0,1
03540680,42,7,35,0,2,2,0,2,1
03540878,28,14,14,0,0,0,0,0,1
03540940,52,17,35,0,1,1,0,1,1
03541037,51,8,43,0,0,0,0,0,1
03541335,8,2,6,0,2,1,1,2,1
03541391,23,5,18,0,1,1,0,1,1
03541400,5,2,3,0,1,1,0,1,1
03541609,5,2,3,0,1,1,0,0,0
03541933,5,3,2,0,2,2,0,0,0
03542292,28,3,25,0,1,1,0,1,1
03542695,5,2,3,0,1,1,0,0,1
03542871,36,4,32,0,1,1,0,1,1
03542901,17,0,17,0,0,0,0,0,1
03543140,6,0,6,0,0,0,0,0,1
03543267,31,0,31,0,0,0,0,0,1
03543553,14,4,10,0,1,1,0,1,1
03543616,6,4,2,0,2,2,0,0,0
03543772,11,0,11,0,0,0,0,0,1
03544589,16,4,12,0,1,1,0,1,1
03544621,4,0,4,0,1,1,0,0,1
03544628,4,0,4,0,1,1,0,0,1
03544774,11,4,7,0,5,3,2,0,0
03545207,23,4,19,0,1,1,0,1,1
03545417,6,3,3,0,1,1,0,0,1
03545422,28,0,28,0,0,0,0,0,1
03545428,24,3,21,0,1,1,0,1,1
03545600,22,0,22,0,1,1,0,1,1
03545604,59,10,49,0,1,1,0,1,1
03545676,13,0,13,0,0,0,0,0,1
03545685,11,1,10,0,1,1,0,1,1
03545908,24,3,21,0,0,0,0,0,1
03546249,7,0,7,0,0,0,0,0,1
03546602,62,10,52,0,1,1,0,1,1
03546920,20,3,17,0,1,1,0,1,1
03546966,4,2,2,0,1,1,0,0,1
03547194,8,0,8,0,0,0,0,0,0
03547531,51,9,42,0,1,1,0,0,1
03547559,7,3,4,0,1,1,0,0,1
03547818,36,8,28,0,1,0,1,1,1
03547836,19,0,19,0,4,4,0,1,1
03548105,6,0,6,0,0,0,0,0,1
03548212,17,0,17,0,0,0,0,0,1
03548215,15,5,10,0,1,1,0,1,1
03548262,17,0,17,0,0,0,0,0,1
03548266,5,0,5,0,2,2,0,0,1
03548341,20,2,18,0,2,1,1,2,1
03548368,20,2,18,0,2,1,1,2,1
03548572,41,5,36,0,1,1,0,1,1
03548991,44,6,38,0,0,0,0,0,1
03549029,98,10,88,0,0,0,0,0,1
03549053,26,7,19,0,0,0,0,0,1
03549840,9,2,7,0,3,1,2,1,1
03550131,3,0,3,0,1,1,0,0,0
03550220,6,0,6,0,0,0,0,0,0
03550280,61,8,53,0,0,0,0,0,0
03550549,21,2,19,0,2,1,1,2,1
03550590,17,3,14,0,0,0,0,0,1
03550849,23,3,20,0,1,1,0,1,1
03550928,12,9,3,0,1,0,1,0,0
03551254,4,2,2,0,2,2,0,0,1
03551685,12,1,11,0,1,1,0,1,1
03551945,13,2,11,0,1,1,0,1,1
03552086,6,0,6,0,0,0,0,0,1
03552198,18,4,14,0,1,1,0,1,1
03552505,4,1,3,0,1,1,0,0,1
03552572,5,2,3,0,2,2,0,0,0
03553481,24,0,24,0,0,0,0,0,1
03553609,0,0,0,0,0,0,0,0,1
03553625,19,0,19,0,0,0,0,0,1
03553898,9,0,9,0,0,0,0,0,1
03554200,5,2,3,0,1,1,0,0,0
03554212,33,3,30,0,1,1,0,1,1
03554325,24,5,19,0,1,1,0,1,1
03554364,4,2,2,0,1,1,0,0,0
03554368,13,0,13,0,1,1,0,1,1
03554422,20,9,11,0,0,0,0,0,0
03554468,32,3,29,0,0,0,0,0,1
03554622,7,3,4,0,1,1,0,0,1
03554735,10,0,10,0,0,0,0,0,1
03554820,13,3,10,0,1,1,0,1,1
03554980,21,7,14,0,1,1,0,1,1
03555199,63,10,53,0,0,0,0,0,1
03555239,9,0,9,0,0,0,0,0,1
03555265,18,2,16,0,1,1,0,1,1
03555837,4,0,4,0,0,0,0,0,1
03555884,20,3,17,0,0,0,0,0,1
03556751,2,2,0,0,1,1,0,1,1
03556829,17,3,14,0,3,1,2,3,1
03556917,26,5,21,0,2,2,0,0,1
03556978,8,2,6,0,2,2,0,0,1
03557369,46,6,40,0,0,0,0,0,1
03557633,23,1,22,0,1,1,0,1,1
03557956,6,3,3,0,2,2,0,0,1
03558169,18,4,14,0,1,1,0,1,1
03558409,17,0,17,0,1,1,0,1,1
03558766,26,5,21,0,2,1,1,2,1
03558774,8,0,8,0,0,0,0,0,1
03558882,22,4,18,0,1,1,0,1,1
03559906,29,4,25,0,1,1,0,0,1
03559913,32,8,24,0,0,0,0,0,1
03560066,4,2,2,0,0,0,0,0,0
03560163,13,3,10,0,6,1,5,1,1
03560335,29,6,23,0,0,0,0,0,1
03560600,32,7,25,0,0,0,0,0,1
03560737,21,3,18,0,0,0,0,0,1
03560829,12,0,12,0,0,0,0,0,1
03561049,5,3,2,0,1,1,0,0,1
03561185,11,0,11,0,0,0,0,0,1
03561304,32,1,31,0,1,1,0,1,1
03561328,32,1,31,0,1,1,0,1,1
03561451,18,6,12,0,0,0,0,0,1
03561503,9,1,8,0,1,1,0,0,1
03561900,24,0,24,0,0,0,0,0,1
03562033,25,4,21,0,1,1,0,1,1
03562176,36,9,27,0,0,0,0,0,1
03562223,30,11,19,0,0,0,0,0,0
03562342,16,4,12,0,1,1,0,1,1
03562435,47,8,39,0,2,1,1,0,1
03562521,7,2,5,0,1,1,0,0,1
03562616,16,3,13,0,1,1,0,0,1
03562938,14,3,11,0,2,2,0,0,0
03562965,13,0,13,0,0,0,0,0,0
03563572,13,0,13,0,0,0,0,0,1
03563685,24,2,22,0,2,1,1,0,1
03563707,17,0,17,0,0,0,0,0,1
03563870,15,3,12,0,1,1,0,1,1
03563914,9,4,5,0,3,3,0,0,1
03564134,10,3,7,0,3,1,2,0,1
03564138,60,14,46,0,0,0,0,0,1
03564252,18,0,18,0,0,0,0,0,1
03564721,9,4,5,0,1,1,0,0,1
03564727,8,0,8,0,0,0,0,0,1
03564867,23,9,14,0,0,0,0,0,0
03565051,23,8,15,0,0,0,0,0,1
03565172,18,0,18,0,0,0,0,0,1
03565249,12,3,9,0,1,1,0,1,1
03565290,23,3,20,0,1,1,0,1,1
03565296,17,3,14,0,2,1,1,2,1
03565311,8,1,7,0,3,1,2,1,1
03565473,18,13,5,0,1,1,0,0,1
03565539,6,1,5,0,4,2,2,1,0
03565631,27,5,22,0,1,1,0,1,1
03565643,36,8,28,0,4,3,1,0,1
03565673,33,5,28,0,1,1,0,1,1
03565678,20,5,15,0,1,1,0,1,1
03565766,163,3,160,0,1,1,0,1,1
03566048,15,4,11,0,0,0,0,0,0
03566236,9,3,6,0,2,2,0,0,1
03566503,11,2,9,0,1,1,0,0,1
03566800,27,4,23,0,1,1,0,1,1
03566935,20,4,16,0,1,1,0,1,1
03567041,24,0,24,0,0,0,0,0,1
03567050,8,2,6,0,1,1,0,0,1
03567118,23,3,20,0,1,1,0,1,1
03567123,8,3,5,0,1,1,0,0,0
03567189,9,5,4,0,0,0,0,0,1
03567928,9,0,9,0,0,0,0,0,1
03567943,9,3,6,0,4,1,3,1,0
03568059,7,3,4,0,1,1,0,0,0
03568319,12,2,10,0,0,0,0,0,1
03568453,25,4,21,0,1,1,0,1,1
03568651,7,0,7,0,0,0,0,0,1
03568680,28,5,23,0,1,1,0,1,1
03568684,25,5,20,0,1,1,0,1,1
03568686,40,5,35,0,1,1,0,1,1
03568826,15,0,15,0,0,0,0,0,1
03568994,7,0,7,0,0,0,0,0,1
03569213,7,2,5,0,1,1,0,1,0
03569323,24,0,24,0,0,0,0,0,1
03569518,5,1,4,0,2,2,0,0,1
03570520,6,3,3,0,1,1,0,0,1
03570522,19,9,10,0,2,1,1,0,1
03570563,5,3,2,0,2,2,0,0,0
03570751,5,3,2,0,1,1,0,1,1
03570755,5,3,2,0,1,1,0,1,1
03571010,10,0,10,0,0,0,0,0,1
03571046,34,2,32,0,2,1,1,2,1
03571106,17,4,13,1,1,1,0,0,1
03571109,23,0,23,0,0,0,0,0,1
03571239,43,10,33,0,0,0,0,0,1
03571400,6,2,4,0,1,1,0,1,1
03571617,18,0,18,0,1,1,0,1,1
03571753,19,4,15,0,0,0,0,0,1
03571769,9,1,8,0,1,1,0,0,1
03571781,23,5,18,0,1,1,0,0,1
03571895,13,2,11,0,0,0,0,0,1
03571899,20,0,20,0,1,1,0,1,1
03571911,11,2,9,0,0,0,0,0,1
03571988,5,0,5,0,1,1,0,0,0
03572487,15,0,15,0,0,0,0,0,1
03572548,9,4,5,0,1,1,0,1,1
03572968,4,3,1,0,1,1,0,0,0
03573047,12,4,8,0,1,1,0,1,1
03573195,5,3,2,0,1,1,0,0,0
03573238,16,0,16,0,0,0,0,0,1
03573352,54,5,49,0,1,1,0,1,1
03573460,15,0,15,0,0,0,0,0,1
03574112,7,3,4,0,2,2,0,0,1
03574118,81,13,68,0,0,0,0,0,0
03574242,28,4,24,0,1,1,0,1,1
03574664,16,0,16,0,0,0,0,0,1
03574707,15,0,15,0,4,4,0,0,1
03574824,17,0,17,0,2,2,0,0,1
03574834,15,0,15,0,0,0,0,0,1
03574841,26,10,16,0,0,0,0,0,1
03574866,12,3,9,0,1,1,0,1,0
03574943,19,5,14,0,0,0,0,0,1
03574949,26,2,24,0,0,0,0,0,1
03575038,26,4,22,0,1,1,0,1,1
03575073,5,2,3,0,1,1,0,0,1
03575169,22,3,19,0,1,1,0,1,1
03575295,12,3,9,0,2,2,0,0,1
03575515,28,4,24,0,1,1,0,1,1
03575606,4,0,4,0,0,0,0,0,1
03575989,6,1,5,0,1,1,0,1,1
03576009,33,6,27,0,1,1,0,1,1
03576057,22,5,17,0,1,1,0,1,1
03576146,21,0,21,0,0,0,0,0,1
03576158,26,4,22,0,1,1,0,1,1
03576375,28,2,26,0,1,1,0,1,1
03576579,92,14,78,0,0,0,0,0,1
03577009,9,3,6,0,1,1,0,1,1
03577056,21,10,11,0,1,1,0,0,1
03577168,38,3,35,0,2,1,1,2,1
03577217,7,0,7,0,1,1,0,1,1
03577404,10,0,10,0,0,0,0,0,1
03578284,13,0,13,0,0,0,0,0,1
03578294,22,2,20,0,1,1,0,1,1
03578625,34,7,27,0,0,0,0,0,1
03578810,13,2,11,0,1,1,0,0,1
03579058,9,0,9,0,0,0,0,0,1
03579212,0,0,0,0,0,0,0,0,1
03579363,23,3,20,0,1,1,0,1,1
03579488,10,0,10,0,0,0,0,0,1
03579567,44,3,41,0,1,1,0,0,1
03579743,6,1,5,0,1,1,0,0,0
03579928,7,3,4,0,1,1,0,0,1
03580371,13,3,10,0,1,1,0,0,1
03580400,5,3,2,0,1,1,0,0,1
03580401,14,1,13,0,1,1,0,0,1
03580586,22,0,22,0,0,0,0,0,1
03580655,26,4,22,0,3,1,2,3,1
03580755,4,0,4,0,0,0,0,0,1
03580773,6,3,3,0,1,1,0,0,1
03580924,4,1,3,0,2,2,0,0,0
03581178,69,8,61,0,0,0,0,0,1
03581232,7,2,5,0,0,0,0,0,1
03581541,37,7,30,0,0,0,0,0,1
03581552,55,8,47,0,0,0,0,0,1
03581962,11,4,7,0,1,1,0,0,0
03582160,11,6,5,0,0,0,0,0,1
03582175,9,0,9,0,1,1,0,1,0
03582246,20,0,20,0,0,0,0,0,1
03582268,13,4,9,0,2,2,0,2,1
03582571,13,3,10,0,0,0,0,0,0
03582642,23,9,14,0,0,0,0,0,1
03582707,3,3,0,0,2,2,0,0,1
03582739,46,12,34,0,0,0,0,0,0
03582911,19,5,14,0,0,0,0,0,1
03583108,24,5,19,0,2,1,1,0,1
03584059,4,3,1,0,1,1,0,0,0
03584085,16,4,12,0,1,1,0,0,1
03584156,19,3,16,0,1,1,0,1,1
03584320,47,10,37,0,1,1,0,1,1
03584434,5,2,3,0,1,1,0,0,1
03584556,8,2,6,0,2,2,0,0,1
03584619,32,0,32,0,1,1,0,1,1
03584662,13,3,10,0,0,0,0,0,1
03584938,5,3,2,0,2,2,0,0,1
03584961,7,5,2,0,2,2,0,0,1
03585648,10,0,10,0,0,0,0,0,1
03585730,20,0,20,0,0,0,0,0,1
03585779,6,2,4,0,1,1,0,1,1
03585861,0,0,0,0,0,0,0,0,1
03586008,4,2,2,0,2,2,0,0,0
03586503,16,4,12,1,0,0,0,0,1
03586774,9,7,2,0,0,0,0,0,1
03586818,28,5,23,0,0,0,0,0,1
03586877,7,3,4,0,1,1,0,0,1
03587064,19,0,19,0,0,0,0,0,1
03587396,17,0,17,0,0,0,0,0,1
03587572,6,0,6,0,0,0,0,0,1
03587584,7,1,6,0,1,1,0,0,1
03587592,9,2,7,0,1,1,0,0,0
03587807,6,2,4,0,1,1,0,0,1
03587915,9,0,9,0,0,0,0,0,0
03587923,9,0,9,0,0,0,0,0,0
03588031,28,5,23,0,1,1,0,1,1
03588041,25,4,21,0,1,1,0,1,1
03588058,23,0,23,0,0,0,0,0,1
03588063,40,5,35,0,1,1,0,1,1
03588089,23,3,20,0,1,1,0,1,1
03588149,22,4,18,0,1,1,0,1,1
03588184,43,3,40,0,1,1,0,1,1
03588221,30,5,25,0,1,1,0,1,1
03588401,15,0,15,0,0,0,0,0,1
03588529,26,4,22,0,1,1,0,1,1
03588713,15,0,15,0,0,0,0,0,1
03588915,14,3,11,0,1,1,0,1,1
03589539,56,14,42,0,0,0,0,0,1
03589542,48,10,38,0,2,1,1,0,1
03589928,16,0,16,0,0,0,0,0,1
03590153,6,2,4,0,1,1,0,0,1
03590343,6,0,6,0,1,1,0,1,1
03590460,6,0,6,0,1,1,0,1,1
03591512,41,4,37,0,0,0,0,0,1
03591540,20,2,18,0,1,1,0,1,1
03591559,50,4,46,0,1,1,0,1,1
03591572,26,4,22,0,2,1,1,2,1
03591675,21,0,21,0,0,0,0,0,1
03591684,16,0,16,0,0,0,0,0,1
03591950,20,2,18,0,2,1,1,2,1
03592255,11,1,10,0,3,1,2,1,0
03592258,15,3,12,0,0,0,0,0,1
03592298,7,0,7,0,0,0,0,0,1
03592324,10,2,8,0,1,1,0,1,1
03592326,9,2,7,0,1,1,0,1,1
03592722,11,4,7,0,0,0,0,0,0
03592960,15,0,15,0,0,0,0,0,1
03593060,15,0,15,0,0,0,0,0,1
03593074,10,3,7,0,1,1,0,1,1
03593082,10,3,7,0,1,1,0,1,1
03593238,24,4,20,0,1,1,0,1,1
03593272,8,2,6,0,1,1,0,1,0
03593461,5,1,4,0,0,0,0,0,0
03593505,36,3,33,0,1,1,0,1,1
03593595,19,8,11,0,0,0,0,0,0
03594021,9,0,9,0,1,1,0,0,1
03595013,36,0,36,0,0,0,0,0,1
03595090,13,0,13,0,0,0,0,0,1
03595103,9,3,6,0,1,1,0,1,1
03595282,31,3,28,0,1,1,0,0,1
03595352,17,4,13,0,1,1,0,1,1
03595824,57,23,34,0,8,8,0,0,1
03595894,6,2,4,0,1,1,0,0,0
03596355,8,3,5,0,4,4,0,0,1
03596379,24,5,19,0,1,1,0,1,1
03596581,19,11,8,0,9,0,9,0,0
03596604,20,2,18,0,2,1,1,2,1
03596634,18,4,14,0,1,1,0,0,1
03596701,5,2,3,0,1,1,0,0,0
03596821,10,0,10,0,0,0,0,0,1
03596837,17,0,17,0,0,0,0,0,1
03596931,13,3,10,0,0,0,0,0,1
03596961,11,2,9,0,1,1,0,0,1
03597184,57,4,53,0,1,1,0,1,1
03598030,37,9,28,0,0,0,0,0,1
03598157,17,3,14,0,5,1,4,5,1
03598159,5,3,2,0,2,2,0,0,0
03598439,59,17,42,0,0,0,0,0,1
03598470,8,4,4,0,0,0,0,0,1
03598523,32,3,29,0,0,0,0,0,1
03598974,43,4,39,0,1,1,0,1,1
03599153,4,3,1,0,1,1,0,0,0
03599380,12,4,8,0,1,1,0,1,1
03599550,4,0,4,0,0,0,0,0,1
03599896,20,9,11,0,5,4,1,0,1
03600165,19,3,16,0,6,2,4,0,1
03600438,9,0,9,0,0,0,0,0,1
03600456,8,3,5,0,1,1,0,1,1
03600531,15,0,15,0,0,0,0,0,1
03600545,36,3,33,0,1,1,0,1,1
03600574,45,7,38,0,1,1,0,1,1
03600599,12,0,12,0,1,1,0,1,1
03600770,28,0,28,0,0,0,0,0,1
03600806,15,0,15,0,0,0,0,0,1
03600850,15,1,14,0,1,1,0,1,1
03600867,19,0,19,0,0,0,0,0,1
03601069,25,1,24,0,1,1,0,0,0
03601217,11,2,9,0,2,2,0,0,1
03601446,18,4,14,0,0,0,0,0,0
03601458,15,7,8,0,0,0,0,0,1
03601549,37,3,34,0,2,1,1,2,1
03602319,6,1,5,0,1,1,0,0,1
03602868,27,4,23,0,1,1,0,1,1
03602887,11,5,6,0,2,2,0,0,1
03603261,12,3,9,0,1,1,0,1,1
03603264,12,3,9,0,1,1,0,1,1
03603617,17,6,11,0,1,1,0,1,1
03603878,8,1,7,0,1,1,0,1,0
03604110,22,3,19,0,3,2,1,3,0
03604133,9,3,6,0,2,1,1,1,0
03604601,5,1,4,0,4,2,2,0,1
03604617,16,8,8,0,6,5,1,0,1
03604981,23,6,17,0,0,0,0,0,1
03604997,6,0,6,0,0,0,0,0,1
05200043,2,2,0,0,1,1,0,0,0
05200155,7,4,3,0,0,0,0,0,0
05200402,16,6,10,0,0,0,0,0,1
05200909,5,2,3,0,1,1,0,0,1
05200973,40,11,29,0,1,1,0,1,1
05201058,69,18,51,0,0,0,0,0,1
05201223,7,0,7,0,0,0,0,0,1
05201291,9,7,2,0,2,2,0,0,1
05201318,18,6,12,0,1,1,0,0,1
05201444,4,0,4,0,0,0,0,0,1
05201539,5,0,5,0,2,2,0,0,1
05201573,9,3,6,0,1,1,0,1,1
05201675,7,2,5,0,1,1,0,0,1
05201828,5,1,4,0,2,1,1,0,1
05201928,18,6,12,0,0,0,0,0,1
05202031,11,1,10,0,1,1,0,0,1
05202209,5,3,2,0,1,1,0,0,1
05202226,2,2,0,0,1,1,0,0,0
05202247,3,1,2,0,1,1,0,0,0
05202555,6,0,6,0,0,0,0,0,1
05202569,11,6,5,0,0,0,0,0,0
05202757,2,0,2,0,0,0,0,0,1
05202843,5,2,3,0,1,1,0,0,1
05203001,5,3,2,0,2,2,0,0,1
05203021,7,4,3,0,4,3,1,0,0
05203237,31,8,23,0,0,0,0,0,1
05203412,10,5,5,0,1,1,0,0,1
05203414,6,2,4,0,1,1,0,0,1
05203432,2,2,0,0,2,2,0,0,0
05203435,38,7,31,0,1,1,0,1,1
05203481,8,3,5,0,1,1,0,0,1
05203540,4,2,2,0,1,1,0,0,1
05203551,13,2,11,0,1,1,0,1,1
05203762,4,3,1,0,2,2,0,0,1
05203794,4,2,2,0,1,1,0,0,0
05203997,21,2,19,0,1,1,0,1,1
05204010,15,3,12,0,1,1,0,1,1
05204024,13,2,11,0,1,1,0,1,1
05204228,3,2,1,0,1,1,0,0,0
05204234,7,0,7,0,1,1,0,1,1
05204249,3,1,2,0,1,1,0,0,1
05204250,4,3,1,0,1,1,0,1,1
05204499,9,3,6,0,0,0,0,0,1
05204516,6,1,5,0,1,1,0,0,1
05204518,9,2,7,0,0,0,0,0,1
05205197,23,3,20,0,1,1,0,1,1
05205442,18,4,14,0,0,0,0,0,1
05206358,35,3,32,0,0,0,0,0,0
05206425,12,5,7,0,0,0,0,0,1
05206682,13,2,11,0,0,0,0,0,1
05207159,5,3,2,0,0,0,0,0,1
05207175,30,9,21,0,0,0,0,0,1
05207254,40,11,29,0,0,0,0,0,1
05207664,11,2,9,0,1,1,0,1,1
05207665,15,4,11,0,1,1,0,1,1
05207666,14,0,14,0,0,0,0,0,1
05207667,12,2,10,0,2,2,0,2,1
05207668,14,2,12,0,2,1,1,2,1
05207670,16,3,13,0,2,1,1,2,1
05207758,5,2,3,0,1,1,0,0,0
05208125,12,4,8,0,1,1,0,1,1
05208609,16,5,11,0,1,1,0,1,1
05208855,8,0,8,0,1,1,0,0,1
05208888,10,3,7,0,0,0,0,0,1
05208964,9,4,5,0,0,0,0,0,1
05209471,2,2,0,0,1,1,0,0,0
05209583,7,0,7,0,0,0,0,0,1
05209835,11,2,9,0,1,1,0,0,1
05209909,22,3,19,0,0,0,0,0,1
05210127,12,6,6,0,1,1,0,1,1
05210333,6,0,6,0,1,1,0,0,1
05210542,27,6,21,0,0,0,0,0,1
05210544,34,10,24,0,0,0,0,0,1
05210553,17,6,11,0,1,1,0,1,1
05210563,10,5,5,0,3,2,1,2,1
05210891,8,7,1,0,0,0,0,0,1
05211218,9,5,4,0,3,1,2,1,0
05211220,9,5,4,0,3,1,2,1,0
05211370,11,3,8,0,0,0,0,0,1
05211560,15,0,15,0,1,1,0,1,0
05211996,20,4,16,0,1,1,0,1,1
05212725,45,13,32,0,0,0,0,0,1
05212726,24,9,15,0,2,1,1,2,1
05212852,38,0,38,0,0,0,0,0,1
05213025,3,0,3,0,0,0,0,0,1
05213082,2,2,0,0,1,1,0,0,1
05213586,9,4,5,0,1,1,0,1,1
05214255,4,2,2,0,0,0,0,0,1
05214334,4,2,2,0,2,2,0,0,0
05214443,5,3,2,0,2,2,0,0,1
05214585,18,10,8,0,0,0,0,0,1
05214729,16,2,14,0,3,1,2,3,1
05214743,15,2,13,0,2,1,1,2,1
05214860,16,0,16,0,0,0,0,0,1
05215351,13,6,7,0,3,2,1,2,1
05215386,33,2,31,0,2,1,1,2,1
05215725,9,0,9,0,0,0,0,0,1
05215853,8,2,6,0,1,1,0,0,1
05215997,4,3,1,0,2,2,0,0,1
05216406,5,3,2,0,2,2,0,0,1
05216560,19,3,16,0,1,1,0,1,1
05216570,14,2,12,0,1,1,0,0,1
05216694,13,2,11,0,1,1,0,1,1
05216728,16,5,11,0,2,2,0,2,1
05216950,8,6,2,0,0,0,0,0,0
05217162,73,18,55,0,2,0,2,0,1
05217617,5,2,3,0,2,2,0,0,0
05217763,4,2,2,0,2,2,0,0,0
05217928,25,4,21,0,2,0,2,0,0
05218069,10,3,7,0,0,0,0,0,0
05218185,17,8,9,0,0,0,0,0,0
05218694,19,0,19,0,0,0,0,0,1
05218828,4,0,4,0,0,0,0,0,1
05218911,4,3,1,0,2,2,0,0,1
05219194,6,2,4,0,1,1,0,0,1
05219592,6,3,3,0,2,2,0,0,1
05219731,3,2,1,0,2,2,0,0,0
05220147,41,10,31,0,1,0,1,0,1
05220157,49,8,41,0,2,1,1,2,1
05221471,16,2,14,0,1,1,0,1,1
05221475,8,0,8,0,1,1,0,1,1
05221476,8,0,8,0,1,1,0,1,1
05221544,13,2,11,0,1,1,0,1,0
05221614,10,6,4,0,5,5,0,0,1
05221864,21,0,21,0,2,2,0,2,1
05222566,8,2,6,0,2,1,1,1,1
05222676,12,5,7,0,0,0,0,0,0
05223208,21,4,17,0,1,1,0,1,1
05223217,16,0,16,0,1,1,0,1,1
05223255,25,3,22,0,1,1,0,1,1
05223400,19,2,17,0,1,1,0,1,1
05223468,20,2,18,0,0,0,0,0,1
05223798,13,0,13,0,0,0,0,0,1
05223838,12,0,12,0,0,0,0,0,1
05223897,18,3,15,0,4,4,0,0,0
05224107,10,5,5,0,3,3,0,1,1
05224200,5,3,2,0,0,0,0,0,0
05224234,8,4,4,0,4,4,0,0,1
05224482,19,5,14,0,1,1,0,0,0
05225192,7,0,7,0,0,0,0,0,1
05225211,28,14,14,0,1,1,0,0,1
05225314,16,0,16,0,0,0,0,0,1
05225439,16,0,16,0,0,0,0,0,1
05225440,16,0,16,0,0,0,0,0,1
05225780,5,0,5,0,0,0,0,0,1
05225819,20,8,12,0,1,1,0,1,1
05225905,17,0,17,0,0,0,0,0,1
05226018,9,1,8,0,2,2,0,0,1
05226262,6,2,4,0,1,1,0,0,1
05226465,11,4,7,1,0,0,0,0,0
05226530,13,2,11,0,0,0,0,0,1
05226723,4,1,3,0,1,1,0,1,0
05226741,7,0,7,0,0,0,0,0,1
05226811,16,0,16,0,0,0,0,0,1
05227040,6,1,5,0,1,1,0,0,1
05227433,18,7,11,0,1,1,0,0,0
05227493,9,4,5,0,1,1,0,0,1
05227904,6,2,4,0,0,0,0,0,0
05228020,5,2,3,0,2,2,0,0,0
05228095,6,3,3,0,3,3,0,0,1
05228449,24,0,24,0,1,1,0,1,1
05228545,9,2,7,0,1,1,0,1,1
05228624,3,2,1,0,1,1,0,0,1
05228671,13,3,10,0,1,1,0,1,1
05228822,7,2,5,0,0,0,0,0,0
05228917,12,2,10,0,0,0,0,0,0
05229084,2,0,2,0,0,0,0,0,1
05229200,7,0,7,0,0,0,0,0,1
05229468,24,4,20,0,1,1,0,1,1
05229477,5,0,5,0,0,0,0,0,0
05229687,24,4,20,0,2,1,1,2,1
05229712,2,0,2,0,0,0,0,0,1
05229765,24,4,20,0,2,1,1,2,1
05229768,5,0,5,0,0,0,0,0,1
05229770,4,0,4,0,0,0,0,0,1
05230209,42,9,33,0,1,1,0,1,1
05230456,7,3,4,0,2,2,0,0,1
05230567,3,0,3,0,0,0,0,0,1
05230654,7,0,7,0,0,0,0,0,1
05230818,3,1,2,0,1,1,0,0,0
05230854,19,5,14,0,3,3,0,3,1
05231162,4,2,2,0,1,1,0,0,1
05231762,5,2,3,0,1,1,0,0,0
05231783,6,4,2,0,2,2,0,0,1
05231903,6,3,3,0,2,2,0,0,0
05232116,11,4,7,0,0,0,0,0,1
05232890,24,0,24,0,1,1,0,1,1
05232970,5,3,2,0,2,2,0,0,0
05233277,13,4,9,0,1,1,0,1,1
05233429,12,9,3,0,0,0,0,0,1
05233452,11,0,11,0,0,0,0,0,1
05233576,14,3,11,0,1,1,0,1,0
05233577,27,4,23,0,1,1,0,1,1
05233702,8,4,4,0,3,3,0,0,0
05234067,8,2,6,0,1,1,0,1,1
05234082,28,4,24,0,6,1,5,2,1
05234095,60,17,43,0,0,0,0,0,1
05234102,10,3,7,0,2,2,0,2,1
05234230,59,19,40,0,0,0,0,0,1
05234236,41,11,30,0,0,0,0,0,1
05234259,6,2,4,0,1,1,0,0,0
05234332,17,6,11,0,1,1,0,0,1
05234617,13,3,10,0,1,1,0,1,1
05234651,21,5,16,0,1,1,0,1,1
05234779,14,3,11,0,0,0,0,0,1
05234799,24,2,22,0,1,1,0,1,1
05234802,36,6,30,0,6,2,4,6,1
05234885,6,4,2,0,1,1,0,0,1
05234939,21,5,16,0,1,1,0,1,1
05235096,12,0,12,0,0,0,0,0,1
05235281,16,4,12,0,0,0,0,0,1
05235411,14,3,11,0,0,0,0,0,1
05235505,13,2,11,0,1,1,0,1,1
05235579,7,0,7,0,0,0,0,0,1
05235592,12,0,12,0,0,0,0,0,1
05235914,12,3,9,0,1,1,0,1,1
05235990,20,3,17,0,0,0,0,0,0
05236108,16,3,13,0,1,1,0,1,1
05236567,20,2,18,0,1,1,0,1,1
05236809,3,3,0,0,1,1,0,0,1
05236810,3,2,1,0,1,1,0,0,0
05236818,3,0,3,0,0,0,0,0,1
05237202,6,2,4,0,1,1,0,0,1
05237326,20,4,16,0,1,1,0,1,1
05238748,22,6,16,0,1,1,0,1,1
05239004,5,0,5,0,0,0,0,0,0
05239239,23,6,17,0,0,0,0,0,1
05239446,27,0,27,0,0,0,0,0,1
05239466,4,2,2,0,2,2,0,0,0
05239725,17,5,12,0,0,0,0,0,0
05239777,18,3,15,0,1,1,0,1,1
05239938,5,3,2,0,1,1,0,0,1
OC356155,30,0,30,0,0,0,0,0,1
OC356346,19,8,11,0,1,1,0,1,1
OC356459,2,2,0,0,2,2,0,0,0
OC356559,3,0,3,0,0,0,0,0,1
OC356602,15,0,15,0,0,0,0,0,1
OC356756,3,0,3,0,1,1,0,0,1
OC356791,4,0,4,0,1,1,0,1,1
OC356867,2,0,2,2,0,0,0,0,0
OC357095,5,0,5,0,0,0,0,0,1
OC357296,2,0,2,0,1,1,0,1,0
OC357526,3,0,3,0,0,0,0,0,1
OC357737,4,0,4,0,0,0,0,0,1
OC357879,3,3,0,0,1,1,0,0,0
OC357917,3,2,1,0,2,2,0,0,1
OC357957,94,60,34,1,0,0,0,0,1
OC358013,3,0,3,0,0,0,0,0,1
OC358016,2,0,2,0,0,0,0,0,1
OC358019,5,0,5,0,0,0,0,0,0
OC358116,11,5,6,1,3,3,0,0,1
OC358376,10,0,10,0,0,0,0,0,0
OC358406,2,0,2,0,2,2,0,0,0
OC358544,7,5,2,0,4,0,4,0,1
OC358559,3,3,0,0,2,2,0,0,0
OC358604,2,2,0,0,0,0,0,0,1
OC358851,7,3,4,0,2,1,1,0,0
OC359219,7,0,7,0,0,0,0,0,1
OC359262,2,2,0,0,1,1,0,0,0
OC359546,3,0,3,1,0,0,0,0,1
OC359556,5,0,5,0,1,1,0,0,1
OC359569,5,3,2,0,1,1,0,0,1
OC359590,3,3,0,0,3,3,0,0,1
OC359611,143,139,4,0,2,2,0,2,1
OC359821,115,111,4,0,2,2,0,2,1
OC359914,6,0,6,0,0,0,0,0,1
OC360125,15,5,10,0,1,1,0,0,0
OC360128,34,2,32,9,1,1,0,1,1
OC360255,101,51,50,0,0,0,0,0,1
OC360372,9,7,2,0,1,1,0,0,0
OC360767,24,0,24,0,0,0,0,0,1
OC360936,5,4,1,0,0,0,0,0,0
OC360989,5,0,5,0,0,0,0,0,1
OC361003,402,391,11,0,0,0,0,0,1
OC361357,3,2,1,0,0,0,0,0,1
OC361387,7,3,4,6,1,1,0,1,1
OC361417,116,49,67,0,5,3,2,0,1
OC361608,2,2,0,0,2,2,0,0,0
OC361768,2,0,2,0,0,0,0,0,1
OC361827,14,0,14,2,0,0,0,0,1
OC361836,5,4,1,0,0,0,0,0,0
OC361871,2,0,2,0,0,0,0,0,1
OC362400,5,3,2,0,1,1,0,1,1
OC362746,279,276,3,0,0,0,0,0,1
OC362761,2,2,0,0,0,0,0,0,0
OC362966,9,6,3,0,0,0,0,0,1
OC362988,9,1,8,0,0,0,0,0,1
OC363071,8,0,8,0,0,0,0,0,1
OC363126,26,22,4,3,2,2,0,0,1
OC363178,2,0,2,0,0,0,0,0,0
OC363241,4,0,4,0,0,0,0,0,1
OC363252,3,2,1,0,2,2,0,0,0
OC363442,8,7,1,1,1,1,0,0,1
OC363617,2,2,0,0,1,1,0,0,1
OC363649,2,0,2,2,0,0,0,0,1
OC363677,2,2,0,0,2,2,0,1,0
OC363793,5,3,2,0,2,2,0,0,1
OC363836,3,0,3,0,0,0,0,0,0
OC363855,2,2,0,0,2,2,0,0,0
OC363875,2,0,2,0,0,0,0,0,1
OC364032,25,20,5,1,1,1,0,0,1
OC364088,8,8,0,0,3,3,0,0,1
OC364092,2,2,0,0,2,2,0,0,1
OC364462,4,2,2,0,2,2,0,1,0
OC364525,5,5,0,0,0,0,0,0,1
OC364724,2,0,2,0,0,0,0,0,1
OC364744,9,3,6,0,1,1,0,0,0
OC364846,4,0,4,0,0,0,0,0,1
OC364939,175,0,175,0,0,0,0,0,1
OC365220,2,0,2,0,0,0,0,0,0
OC365354,2,0,2,0,0,0,0,0,1
OC365681,3,3,0,0,1,1,0,1,1
OC365773,37,30,7,0,0,0,0,0,1
OC366126,4,0,4,0,0,0,0,0,1
OC366138,3,2,1,0,1,1,0,0,1
OC366167,2,0,2,0,0,0,0,0,1
OC366196,2,2,0,0,1,1,0,0,1
OC366210,15,3,12,0,3,2,1,0,1
OC366318,26,25,1,3,2,2,0,0,1
OC366595,2,0,2,0,0,0,0,0,1
OC366699,2,0,2,0,0,0,0,0,1
OC366725,6,5,1,0,0,0,0,0,1
OC367022,13,0,13,1,0,0,0,0,1
OC367059,3,3,0,0,3,3,0,0,1
OC367395,6,0,6,0,2,2,0,0,1
OC367581,5,4,1,0,1,1,0,0,1
OC367675,5,5,0,0,2,2,0,0,1
OC367684,150,22,128,0,1,1,0,1,1
OC367941,3,0,3,1,0,0,0,0,1
OC367960,3,0,3,0,0,0,0,0,0
OC368083,4,3,1,0,1,1,0,0,0
OC368084,3,0,3,0,0,0,0,0,1
OC368161,4,0,4,2,1,1,0,0,0
OC368295,3,3,0,0,3,3,0,0,1
OC368298,6,6,0,0,0,0,0,0,1
OC368352,2,2,0,0,3,2,1,2,0
OC368433,5,2,3,0,2,2,0,0,0
OC368592,113,110,3,0,2,2,0,0,1
OC368710,3,0,3,0,0,0,0,0,1
OC369009,61,39,22,0,1,1,0,0,1
OC369076,18,2,16,0,1,1,0,0,1
OC369146,10,5,5,0,2,2,0,2,1
OC369338,2,0,2,0,2,2,0,0,1
OC369408,2,0,2,0,1,1,0,0,1
OC369433,3,2,1,0,2,2,0,0,1
OC369477,3,2,1,0,1,1,0,0,1
OC369486,22,2,20,6,1,1,0,1,1
OC369572,9,3,6,0,1,1,0,0,1
OC369588,3,0,3,0,0,0,0,0,1
OC369631,219,132,87,0,1,1,0,1,1
OC369764,3,0,3,0,0,0,0,0,1
OC369765,3,0,3,0,0,0,0,0,1
OC369866,3,0,3,0,1,1,0,0,1
OC369868,3,0,3,0,0,0,0,0,1
OC369869,4,3,1,0,1,1,0,0,1
OC370050,35,29,6,0,4,4,0,1,1
OC370214,6,5,1,0,1,1,0,1,1
OC370268,159,0,159,0,0,0,0,0,1
OC370346,4,0,4,0,0,0,0,0,1
OC370376,15,15,0,0,1,1,0,0,1
OC370622,2,2,0,0,2,2,0,0,1
OC370679,55,38,17,0,0,0,0,0,1
OC370814,2,0,2,0,1,1,0,1,1
OC370914,11,11,0,0,0,0,0,0,1
OC370974,6,3,3,0,0,0,0,0,1
OC371068,20,14,6,0,1,1,0,0,1
OC371089,3,3,0,0,3,3,0,0,1
OC371271,10,8,2,1,1,1,0,0,1
OC371398,21,21,0,4,2,2,0,2,1
OC371433,4,4,0,0,1,1,0,0,0
OC371518,5,3,2,0,2,2,0,0,1
OC371548,3,3,0,2,1,1,0,1,0
OC371681,4,4,0,0,2,2,0,0,0
OC371748,2,2,0,0,2,2,0,0,1
OC372133,6,3,3,4,1,1,0,1,1
OC372204,6,6,0,0,0,0,0,0,1
OC372276,3,2,1,0,3,2,1,3,0
OC372514,187,183,4,0,0,0,0,0,1
OC372575,2,2,0,2,1,1,0,1,0
OC372615,6,4,2,0,4,4,0,0,1
OC372822,5,0,5,0,0,0,0,0,1
OC372942,6,4,2,0,4,4,0,1,1
OC372943,4,4,0,0,3,3,0,0,1
OC372970,6,4,2,0,4,4,0,1,1
OC372987,4,4,0,0,1,1,0,0,1
OC373078,10,8,2,1,0,0,0,0,0
OC373300,11,10,1,0,2,2,0,0,1
OC373389,43,38,5,0,1,0,1,1,1
OC373659,8,4,4,0,1,1,0,1,1
OC373719,4,2,2,0,3,2,1,1,0
OC374255,5,0,5,0,2,1,1,1,1
OC374267,2,0,2,2,1,1,0,0,0
OC374272,2,2,0,0,2,2,0,0,0
OC374395,2,0,2,0,2,2,0,0,1
OC374451,12,3,9,0,4,1,3,1,1
OC374603,2,2,0,0,1,1,0,0,1
OC374612,2,2,0,0,2,2,0,1,0
OC374616,2,2,0,0,2,2,0,1,0
OC374728,3,0,3,0,0,0,0,0,1
OC375243,3,2,1,3,2,2,0,0,0
OC375283,12,2,10,2,1,1,0,0,1
OC375393,3,0,3,0,0,0,0,0,1
OC375540,23,11,12,0,1,1,0,1,1
OC375625,2,2,0,0,2,2,0,0,0
OC375755,5,4,1,0,4,3,1,1,1
OC375994,4,0,4,0,0,0,0,0,0
OC376087,4,0,4,4,0,0,0,0,0
OC376110,6,0,6,0,0,0,0,0,1
OC376169,9,6,3,0,1,1,0,1,1
OC376482,2,2,0,0,1,1,0,0,0
OC376679,9,4,5,1,2,1,1,1,0
OC376991,8,8,0,0,2,2,0,0,1
OC377292,3,0,3,0,0,0,0,0,1
OC377357,2,2,0,0,0,0,0,0,1
OC377578,12,11,1,0,3,3,0,2,1
OC377583,11,0,11,0,0,0,0,0,1
OC377737,3,0,3,0,2,2,0,0,1
OC377976,34,2,32,7,1,1,0,1,1
OC378256,14,12,2,0,2,2,0,2,1
OC378258,17,15,2,0,2,2,0,2,1
OC378576,11,11,0,0,1,1,0,0,1
OC378577,11,11,0,0,1,1,0,0,1
OC378740,86,69,17,0,1,1,0,1,1
OC378784,4,0,4,0,1,1,0,1,1
OC378912,6,6,0,0,1,1,0,0,0
OC379219,6,2,4,0,1,1,0,1,0
OC379569,2,0,2,0,0,0,0,0,1
OC379570,2,0,2,0,0,0,0,0,1
OC379655,9,2,7,1,1,1,0,0,1
OC379876,3,2,1,0,1,1,0,0,1
OC379976,4,0,4,0,0,0,0,0,1
OC379980,3,0,3,0,0,0,0,0,1
OC380519,3,0,3,0,0,0,0,0,1
OC380645,3,3,0,0,1,1,0,0,1
OC380679,7,6,1,1,7,7,0,0,0
OC380799,5,2,3,0,2,2,0,2,1
OC380805,52,52,0,0,0,0,0,0,1
OC381000,2,2,0,0,1,1,0,1,0
OC381153,3,0,3,0,0,0,0,0,1
OC381209,4,3,1,0,3,3,0,2,1
OC381394,3,0,3,0,0,0,0,0,1
OC381527,2,2,0,0,1,1,0,0,0
OC381609,4,0,4,4,3,3,0,0,0
OC381692,2,0,2,0,0,0,0,0,1
OC381809,11,3,8,0,2,2,0,0,0
OC381819,3,2,1,0,1,1,0,0,0
OC381823,2,0,2,2,0,0,0,0,0
OC381876,4,4,0,0,2,2,0,0,0
OC382145,5,0,5,0,0,0,0,0,0
OC382179,6,2,4,0,3,2,1,1,0
OC382229,99,95,4,0,0,0,0,0,1
OC382552,31,24,7,0,4,4,0,1,1
OC382704,4,0,4,0,0,0,0,0,1
OC382722,3,0,3,0,2,1,1,1,1
OC382827,3,2,1,0,2,2,0,0,0
OC382838,4,2,2,4,1,1,0,0,0
OC382917,5,2,3,0,2,2,0,2,0
OC382968,2,0,2,0,0,0,0,0,0
OC383029,5,3,2,4,1,1,0,1,1
OC383126,5,4,1,0,4,4,0,3,1
OC383133,2,0,2,1,1,1,0,0,1
OC383269,33,33,0,0,1,1,0,1,1
OC383381,3,3,0,0,3,3,0,0,1
OC383615,4,3,1,0,3,3,0,0,1
OC383688,243,185,58,0,0,0,0,0,1
OC383751,31,18,13,0,5,3,2,0,1
OC383756,4,3,1,0,2,2,0,0,1
OC383782,5,2,3,2,3,2,1,2,0
OC383873,15,9,6,1,1,1,0,0,1
OC383940,4,0,4,0,1,1,0,0,1
OC383989,18,13,5,0,1,1,0,1,0
OC384369,3,0,3,0,1,1,0,0,1
OC384467,21,15,6,0,3,3,0,0,1
OC384496,3,2,1,0,2,2,0,2,0
OC384499,3,3,0,0,3,3,0,0,1
OC384710,5,2,3,0,1,1,0,0,1
05824277,9,5,4,0,1,1,0,1,1
05824433,46,0,46,0,2,2,0,1,1
05824638,3,2,1,0,0,0,0,0,0
05824642,23,4,19,0,1,1,0,1,1
05825057,5,3,2,0,2,2,0,0,1
05825189,4,3,1,0,2,2,0,0,1
05825602,11,0,11,0,0,0,0,0,1
05825644,11,0,11,0,0,0,0,0,1
05825667,11,3,8,0,0,0,0,0,0
05825670,11,0,11,0,1,1,0,1,1
05825858,9,0,9,0,1,1,0,1,1
05826330,5,3,2,0,2,2,0,0,0
05826404,3,2,1,0,1,1,0,0,1
05826492,22,6,16,0,1,1,0,1,1
05826743,6,2,4,0,0,0,0,0,0
05826916,4,2,2,0,0,0,0,0,0
05827191,20,8,12,0,0,0,0,0,0
05827283,5,3,2,0,1,1,0,0,0
05827530,6,2,4,0,2,2,0,0,0
05827801,5,3,2,0,3,3,0,0,1
05828020,4,0,4,0,0,0,0,0,1
05828892,4,2,2,0,1,1,0,0,1
05829006,4,2,2,0,1,1,0,0,0
05829191,8,0,8,0,0,0,0,0,1
05829346,4,0,4,0,0,0,0,0,1
05829462,2,2,0,0,1,1,0,0,0
05829570,24,8,16,0,0,0,0,0,1
05829829,6,0,6,0,0,0,0,0,1
05829834,5,1,4,0,1,1,0,0,0
05830107,2,0,2,0,0,0,0,0,1
05830231,16,6,10,0,2,1,1,2,1
05830302,5,1,4,0,1,1,0,1,0
05830475,4,3,1,0,2,2,0,0,1
05830499,5,3,2,0,2,2,0,0,1
05830505,7,4,3,0,1,1,0,1,1
05831018,27,3,24,0,1,1,0,1,1
05831575,6,3,3,0,1,1,0,1,1
05831748,14,0,14,0,0,0,0,0,1
05831858,31,3,28,0,1,1,0,1,1
05831878,30,0,30,0,1,1,0,1,1
05832114,3,3,0,0,0,0,0,0,1
05832501,5,1,4,0,1,1,0,1,1
05832774,9,0,9,0,0,0,0,0,1
05833037,8,4,4,0,0,0,0,0,1
05833170,15,6,9,0,1,1,0,1,1
05833211,14,0,14,0,0,0,0,0,0
05834474,14,0,14,0,0,0,0,0,1
05834539,23,13,10,0,1,1,0,0,1
05834811,18,6,12,0,1,1,0,1,1
05834824,16,6,10,0,1,1,0,1,1
05834831,17,6,11,0,1,1,0,1,1
05834840,16,6,10,0,1,1,0,1,1
05834929,14,7,7,0,0,0,0,0,0
05835638,18,7,11,0,0,0,0,0,1
05835751,6,3,3,0,2,2,0,0,1
05836007,11,2,9,0,0,0,0,0,1
05836182,6,2,4,0,1,1,0,0,0
05836917,18,3,15,0,0,0,0,0,1
05836928,12,0,12,0,0,0,0,0,1
05836950,26,10,16,0,0,0,0,0,1
05837232,33,9,24,0,0,0,0,0,0
05837333,4,2,2,0,1,1,0,0,0
05837595,19,5,14,0,1,1,0,1,1
05838126,5,0,5,0,1,1,0,0,0
05838388,8,0,8,0,0,0,0,0,1
05838734,5,0,5,0,0,0,0,0,1
05838740,4,2,2,0,0,0,0,0,1
05838902,5,1,4,0,1,1,0,0,0
05838921,3,0,3,0,0,0,0,0,1
05838962,7,0,7,0,0,0,0,0,1
05838969,2,1,1,0,1,1,0,0,1
05839399,23,0,23,0,1,1,0,1,1
05839406,20,3,17,0,4,4,0,0,1
05839498,20,0,20,0,3,3,0,0,1
05840125,5,3,2,0,1,1,0,0,0
05840308,4,1,3,0,1,1,0,0,0
05840738,4,2,2,0,3,1,2,1,0
05840839,5,0,5,0,0,0,0,0,1
05840865,5,2,3,0,2,2,0,0,1
05841351,4,0,4,0,0,0,0,0,1
05841393,23,2,21,0,6,1,5,6,1
05841578,21,5,16,0,1,1,0,1,1
05841700,2,2,0,0,1,1,0,0,1
05841815,2,2,0,0,2,2,0,0,0
05841979,5,3,2,0,1,1,0,0,1
05842065,2,0,2,0,0,0,0,0,1
05842127,5,3,2,0,2,2,0,0,1
05842537,16,0,16,0,0,0,0,0,1
05842626,41,0,41,0,0,0,0,0,1
05842748,18,0,18,0,0,0,0,0,1
05842835,27,5,22,0,0,0,0,0,1
05842963,6,3,3,0,1,1,0,1,0
05843652,4,1,3,0,1,1,0,0,1
05843717,11,2,9,0,2,2,0,2,1
05843745,15,0,15,0,0,0,0,0,1
05843873,4,2,2,0,1,1,0,0,1
05844006,8,0,8,0,0,0,0,0,1
05844015,8,0,8,0,0,0,0,0,1
05844247,6,0,6,0,0,0,0,0,1
05844296,13,1,12,0,4,2,2,1,1
05844525,17,5,12,0,1,1,0,1,1
05844607,6,3,3,0,1,1,0,0,0
05844684,29,6,23,0,1,1,0,1,1
05844753,19,3,16,0,1,1,0,1,1
05844779,19,6,13,0,1,1,0,1,1
05844794,6,2,4,0,1,1,0,1,1
05844798,3,3,0,0,2,2,0,0,0
05844872,2,2,0,0,1,1,0,0,1
05845173,4,2,2,0,1,1,0,0,1
05845419,2,2,0,0,1,1,0,0,1
05845813,4,2,2,0,1,1,0,0,1
05845816,6,3,3,0,1,1,0,0,1
05846544,15,2,13,0,1,1,0,1,1
05846567,15,2,13,0,1,1,0,1,1
05846643,15,0,15,0,1,1,0,1,1
05846793,9,6,3,0,0,0,0,0,0
05847141,6,0,6,0,1,1,0,0,1
05847411,4,0,4,0,0,0,0,0,1
05847453,5,0,5,0,0,0,0,0,1
05847751,21,4,17,0,3,2,1,3,1
05847755,21,4,17,0,1,1,0,1,1
05847968,17,0,17,0,0,0,0,0,1
05848048,7,4,3,0,1,1,0,1,1
05848118,5,2,3,0,1,1,0,0,1
05848284,3,3,0,0,1,1,0,0,0
05848380,10,4,6,0,1,1,0,1,1
05848676,4,0,4,0,0,0,0,0,0
05848698,14,0,14,0,0,0,0,0,1
05848756,12,2,10,0,1,1,0,0,1
05849090,2,2,0,0,1,1,0,0,0
05849787,7,3,4,0,2,2,0,2,1
05849833,19,3,16,0,2,2,0,2,1
05849949,11,3,8,0,1,1,0,0,0
05850032,14,6,8,0,0,0,0,0,0
05850525,15,1,14,0,5,3,2,2,0
05850551,2,0,2,0,0,0,0,0,1
05850751,14,2,12,0,1,1,0,1,1
05851422,3,3,0,0,2,2,0,0,1
05851436,3,2,1,0,1,1,0,0,1
05852196,13,5,8,0,1,1,0,1,1
05852571,10,3,7,0,1,1,0,1,1
05852940,11,4,7,0,1,1,0,0,0
05853005,29,5,24,0,1,1,0,1,1
05853026,13,5,8,0,5,4,1,0,1
05853520,21,8,13,0,8,0,8,0,1
05853624,4,3,1,0,2,2,0,0,0
05853895,11,3,8,0,2,2,0,1,1
05854109,28,2,26,0,1,1,0,1,1
05854506,10,3,7,0,1,1,0,1,0
05854533,8,0,8,0,0,0,0,0,0
05854557,7,0,7,0,0,0,0,0,1
05854713,23,5,18,0,0,0,0,0,1
05854907,9,0,9,0,0,0,0,0,1
05855374,8,7,1,0,0,0,0,0,0
05855479,26,9,17,0,0,0,0,0,1
05855557,8,3,5,0,1,1,0,1,1
05855668,18,0,18,0,0,0,0,0,1
05855946,5,4,1,0,1,1,0,0,0
05856026,4,2,2,0,1,1,0,0,1
05856137,18,3,15,0,5,1,4,5,1
05856283,14,5,9,0,1,1,0,1,1
05856315,9,2,7,1,2,2,0,1,1
05857070,6,0,6,0,0,0,0,0,1
05857535,10,0,10,0,1,1,0,1,1
05857666,6,0,6,0,0,0,0,0,1
05857689,9,7,2,0,1,1,0,1,1
05858062,6,2,4,0,1,1,0,0,0
05858399,9,2,7,0,1,1,0,0,1
05858653,17,4,13,0,2,1,1,1,1
05858694,3,3,0,0,2,2,0,0,1
05858770,2,1,1,0,1,1,0,0,0
05859319,15,0,15,0,0,0,0,0,1
05859320,16,0,16,0,0,0,0,0,1
05859571,6,0,6,0,0,0,0,0,1
05859612,20,5,15,0,0,0,0,0,1
05860067,13,1,12,0,1,1,0,1,1
05860068,13,1,12,0,1,1,0,1,1
05860075,13,1,12,0,1,1,0,1,1
05860291,13,1,12,0,1,1,0,1,1
05860429,13,3,10,0,2,1,1,1,1
05860499,10,5,5,0,2,2,0,0,1
05860707,21,0,21,0,0,0,0,0,1
05860900,10,2,8,0,1,1,0,1,1
05860966,7,4,3,0,4,4,0,0,1
05861345,25,9,16,0,0,0,0,0,0
05862222,21,13,8,0,0,0,0,0,1
05863146,7,4,3,0,3,3,0,0,1
05863230,5,0,5,0,0,0,0,0,1
05863336,3,2,1,0,1,1,0,0,1
05863533,21,3,18,0,1,1,0,1,1
05864014,37,10,27,0,0,0,0,0,0
05864023,4,3,1,0,1,1,0,0,1
05864039,9,3,6,0,1,1,0,0,1
05864172,5,0,5,0,0,0,0,0,0
05864633,5,0,5,0,0,0,0,0,0
05864645,5,0,5,0,1,1,0,1,1
05864818,12,4,8,0,0,0,0,0,1
05864912,49,11,38,0,1,1,0,1,1
05865016,3,0,3,0,0,0,0,0,0
05865116,7,2,5,0,1,1,0,1,1
05865228,6,0,6,0,0,0,0,0,1
05865257,5,1,4,0,1,1,0,0,1
05865642,9,5,4,0,1,1,0,0,0
05865673,0,0,0,0,0,0,0,0,1
05865931,4,1,3,0,1,1,0,0,0
05866203,17,6,11,0,1,1,0,1,1
05866631,8,3,5,0,4,4,0,0,1
05866765,6,0,6,0,0,0,0,0,1
05867463,4,2,2,0,1,1,0,0,0
05867618,6,0,6,0,0,0,0,0,1
05867798,12,0,12,0,0,0,0,0,1
05867838,5,0,5,0,0,0,0,0,0
05867988,12,0,12,0,0,0,0,0,1
05868936,12,2,10,0,3,1,2,0,1
05869077,5,3,2,0,1,1,0,0,0
05869088,17,3,14,0,2,1,1,0,0
05869629,3,3,0,0,2,2,0,0,0
05869828,12,4,8,0,0,0,0,0,0
05869985,4,2,2,0,2,2,0,0,1
05870011,15,0,15,0,0,0,0,0,1
05870047,10,0,10,0,0,0,0,0,1
05870117,4,2,2,0,1,1,0,0,0
05870467,6,2,4,0,1,1,0,0,1
05870579,7,3,4,0,1,1,0,1,1
05870638,4,3,1,0,2,2,0,0,0
05871675,5,2,3,0,1,1,0,0,0
05871846,12,1,11,0,2,1,1,0,1
05871898,7,5,2,0,2,2,0,0,0
05871926,9,3,6,0,1,1,0,0,1
05871970,6,0,6,0,0,0,0,0,1
05872103,19,2,17,0,4,1,3,4,1
05872120,21,5,16,0,1,1,0,1,1
05872121,22,6,16,0,1,1,0,1,1
05872128,20,6,14,0,1,1,0,1,1
05872311,5,0,5,0,0,0,0,0,1
05872585,28,10,18,0,1,1,0,1,1
05872694,47,21,26,0,0,0,0,0,1
05873095,6,2,4,0,0,0,0,0,0
05873604,9,2,7,0,1,1,0,0,1
05873676,29,12,17,0,0,0,0,0,1
05873752,15,0,15,0,1,1,0,1,1
05874311,5,1,4,0,1,1,0,0,0
05874458,5,2,3,0,1,1,0,0,1
05874483,5,1,4,0,1,1,0,0,0
05874840,17,2,15,0,1,1,0,1,1
05875221,8,0,8,0,0,0,0,0,1
05875249,9,5,4,0,1,1,0,1,1
05875288,11,2,9,0,0,0,0,0,1
05875307,10,1,9,0,0,0,0,0,1
05875505,6,0,6,0,0,0,0,0,1
05875713,5,0,5,0,0,0,0,0,1
05875918,14,0,14,0,0,0,0,0,1
05875926,5,2,3,0,0,0,0,0,0
05876062,3,0,3,0,1,1,0,0,1
05876071,8,2,6,0,4,2,2,0,0
05876101,3,3,0,0,2,2,0,0,1
05876695,13,2,11,0,1,1,0,1,1
05876716,21,3,18,0,1,1,0,1,1
05876737,16,2,14,0,1,1,0,1,1
05877112,5,3,2,0,2,2,0,0,0
05877295,15,6,9,0,0,0,0,0,1
05877488,4,2,2,0,1,1,0,0,0
05877721,9,5,4,0,2,0,2,0,1
05878147,4,2,2,0,1,1,0,0,1
05878520,12,5,7,0,5,5,0,1,1
05878786,12,0,12,0,2,2,0,0,1
05879149,43,2,41,0,16,12,4,0,1
05879268,12,0,12,0,0,0,0,0,1
05879337,17,7,10,0,0,0,0,0,0
05879510,23,5,18,0,0,0,0,0,0
05879644,17,5,12,0,1,0,1,0,1
05879832,7,0,7,0,2,2,0,0,1
05880043,8,3,5,0,1,1,0,0,1
05880082,6,4,2,0,4,4,0,2,1
05880085,6,4,2,0,4,4,0,2,1
05880104,6,4,2,0,4,4,0,2,1
05880417,6,2,4,0,2,1,1,1,0
05880690,10,2,8,0,2,2,0,2,1
05880739,6,4,2,0,4,4,0,2,1
05880834,7,4,3,0,1,1,0,0,0
05881161,17,7,10,0,0,0,0,0,1
05881272,6,2,4,0,1,1,0,0,1
05881529,5,4,1,0,1,1,0,0,0
05881603,25,10,15,0,0,0,0,0,1
05881755,6,4,2,0,4,4,0,2,1
05882061,14,10,4,0,0,0,0,0,0
05882241,9,4,5,0,2,2,0,2,1
05882398,5,1,4,1,1,1,0,0,1
05882717,17,5,12,0,4,1,3,4,1
05882818,21,5,16,0,0,0,0,0,1
05882835,3,2,1,0,0,0,0,0,0
05883014,44,11,33,0,0,0,0,0,0
05883027,7,1,6,0,2,1,1,0,1
05883294,11,3,8,0,0,0,0,0,1
05883383,3,2,1,0,1,1,0,0,1
05883387,22,0,22,0,0,0,0,0,1
05883471,4,1,3,0,1,1,0,1,1
05883515,22,0,22,0,0,0,0,0,1
05883681,4,2,2,0,0,0,0,0,0
05883728,10,2,8,0,1,1,0,1,1
05883936,2,2,0,0,1,1,0,0,0
05884126,39,12,27,0,4,4,0,0,1
05884158,8,3,5,0,1,1,0,1,1
05884630,29,8,21,0,0,0,0,0,0
05884992,18,8,10,0,0,0,0,0,1
05885708,4,2,2,0,1,1,0,0,0
05885792,15,3,12,0,1,1,0,1,0
05885797,14,3,11,0,1,1,0,1,1
05885824,7,1,6,0,3,2,1,1,1
05886974,3,3,0,0,2,2,0,0,0
05887080,8,3,5,2,1,1,0,1,0
05887222,16,4,12,0,2,2,0,2,1
05888209,11,5,6,0,0,0,0,0,1
05888220,30,9,21,0,0,0,0,0,1
05888291,8,1,7,0,1,1,0,0,1
05888331,8,0,8,0,0,0,0,0,1
05888997,4,2,2,0,2,2,0,0,0
05889039,8,3,5,0,0,0,0,0,1
05889082,18,3,15,0,1,1,0,0,1
05889116,15,4,11,0,0,0,0,0,1
05889570,3,3,0,0,2,2,0,0,0
05890639,7,2,5,0,3,2,1,0,0
05891009,15,7,8,0,0,0,0,0,1
05891434,22,7,15,0,1,1,0,1,0
05891725,5,3,2,0,1,1,0,0,0
05891855,4,2,2,0,1,1,0,0,0
05891911,8,2,6,0,2,2,0,2,0
05891993,10,8,2,0,1,1,0,1,1
05892019,10,8,2,0,1,1,0,1,1
05892192,8,3,5,0,8,8,0,0,0
05892326,3,2,1,0,2,2,0,0,1
05892581,4,3,1,0,1,1,0,0,0
05893021,10,0,10,0,0,0,0,0,1
05893228,8,6,2,0,1,1,0,0,1
05893279,7,4,3,0,1,1,0,1,1
05893288,3,0,3,0,0,0,0,0,1
05893415,15,8,7,0,0,0,0,0,1
05893492,15,4,11,0,1,1,0,1,0
05893720,3,2,1,0,1,1,0,0,1
05894056,4,3,1,0,2,2,0,0,1
05894329,17,2,15,0,1,1,0,1,1
05894560,3,3,0,0,1,1,0,0,0
05894734,8,5,3,0,3,1,2,1,0
05894739,3,0,3,0,0,0,0,0,1
05894753,3,2,1,0,1,1,0,0,1
05895178,13,3,10,0,0,0,0,0,0
05895219,19,2,17,0,1,1,0,1,1
05895220,7,0,7,0,2,2,0,0,1
05895548,15,8,7,0,0,0,0,0,1
05895593,6,4,2,0,1,1,0,1,1
05895636,33,10,23,0,0,0,0,0,1
05895937,17,8,9,0,3,3,0,0,1
05896488,4,1,3,0,0,0,0,0,0
05896598,12,0,12,0,0,0,0,0,1
05896692,7,3,4,0,1,1,0,1,1
05896824,24,6,18,1,1,1,0,1,1
SC290003,14,12,2,1,0,0,0,0,1
SC290096,9,3,6,0,1,1,0,1,1
SC290164,5,1,4,1,1,1,0,0,1
SC290174,7,0,7,1,1,1,0,1,1
SC290199,6,0,6,0,0,0,0,0,1
SC290425,12,5,7,0,5,1,4,0,1
SC290534,4,2,2,0,2,2,0,0,0
SC290537,6,2,4,0,1,1,0,0,0
SC290548,6,4,2,0,2,2,0,0,1
SC290565,4,3,1,0,2,2,0,0,0
SC290614,11,2,9,1,1,1,0,1,1
SC290766,12,0,12,0,1,1,0,0,1
SC290925,4,2,2,0,0,0,0,0,1
SC291049,4,3,1,0,2,2,0,0,1
SC291056,14,7,7,0,1,1,0,1,0
SC291127,5,2,3,0,1,1,0,0,0
SC291165,24,6,18,1,2,2,0,2,1
SC291287,3,0,3,0,0,0,0,0,1
SC291298,21,6,15,0,1,1,0,1,0
SC291538,9,6,3,0,1,1,0,0,1
SC291539,10,4,6,0,1,1,0,0,1
SC291739,9,2,7,0,2,2,0,0,1
SC291814,23,4,19,0,4,1,3,2,1
SC291837,33,0,33,0,0,0,0,0,1
SC292121,5,4,1,0,1,1,0,1,1
SC292225,6,0,6,0,0,0,0,0,1
SC292398,5,2,3,0,1,1,0,0,0
SC292519,5,3,2,0,2,2,0,0,0
SC292551,26,3,23,0,0,0,0,0,0
SC292560,4,0,4,0,1,1,0,0,1
SC292684,8,3,5,0,2,2,0,0,0
SC292766,7,2,5,0,1,1,0,0,0
SC292793,3,3,0,0,2,2,0,0,0
SC292889,6,0,6,0,0,0,0,0,1
SC292941,21,0,21,1,0,0,0,0,1
SC293145,14,2,12,0,3,3,0,0,1
SC293157,14,0,14,0,0,0,0,0,1
SC293209,0,0,0,0,0,0,0,0,1
SC293217,13,2,11,0,1,1,0,1,1
SC293417,5,3,2,0,2,2,0,0,1
SC293438,12,4,8,0,2,2,0,0,1
SC293631,7,3,4,0,0,0,0,0,0
SC293690,12,8,4,0,7,7,0,5,1
SC293692,14,7,7,0,1,1,0,1,1
SC293877,4,0,4,0,1,1,0,1,1
SC293966,16,0,16,0,0,0,0,0,1
SC294075,7,3,4,0,1,1,0,0,0
SC294123,12,0,12,1,0,0,0,0,1
SC294182,10,5,5,0,0,0,0,0,0
SC294189,6,1,5,0,1,1,0,0,0
SC294459,9,0,9,0,0,0,0,0,1
SC294490,5,2,3,0,1,1,0,0,1
SC294491,4,1,3,0,1,1,0,0,1
SC294668,5,3,2,0,1,1,0,0,1
SC294690,19,0,19,0,0,0,0,0,1
SC294737,5,3,2,0,1,1,0,0,0
SC294751,5,3,2,0,2,2,0,0,0
SC294766,12,0,12,0,0,0,0,0,1
SC294826,22,9,13,1,3,1,2,1,1
SC294990,14,0,14,0,0,0,0,0,1
SC295044,23,3,20,2,1,1,0,1,1
SC295088,15,6,9,0,0,0,0,0,1
SC295121,5,0,5,0,0,0,0,0,0
SC295399,14,0,14,0,0,0,0,0,1
SC295443,8,1,7,0,1,1,0,0,1
SC295500,8,3,5,0,2,2,0,0,1
SC295509,8,0,8,0,0,0,0,0,1
SC295511,13,4,9,0,1,1,0,1,1
SC295516,4,2,2,0,1,1,0,1,1
SC295689,5,1,4,0,1,1,0,0,1
SC295733,3,0,3,1,0,0,0,0,1
SC295774,17,5,12,0,3,3,0,0,1
SC296124,9,0,9,0,1,1,0,1,0
SC296234,6,0,6,0,0,0,0,0,0
SC296326,10,2,8,0,1,1,0,1,1
SC296328,10,2,8,0,1,1,0,1,1
SC296346,14,0,14,0,0,0,0,0,1
SC296348,22,1,21,0,1,1,0,1,1
SC296411,16,3,13,0,1,1,0,1,1
SC296431,5,3,2,0,2,2,0,0,0
SC296513,11,0,11,0,0,0,0,0,1
SC296515,8,4,4,0,1,1,0,1,1
SC296630,4,1,3,0,1,1,0,0,1
SC296632,4,0,4,0,0,0,0,0,1
SC296672,9,2,7,0,2,1,1,0,0
SC296683,5,1,4,0,1,1,0,0,0
SC296743,5,0,5,0,2,1,1,0,1
SC296745,5,0,5,0,3,1,2,0,1
SC296863,35,7,28,0,0,0,0,0,1
SC296937,12,3,9,0,1,1,0,1,1
SC297009,11,0,11,0,1,1,0,1,1
SC297053,5,0,5,0,0,0,0,0,1
SC297301,5,3,2,0,1,1,0,0,0
SC297630,17,4,13,0,4,2,2,0,0
SC298090,9,4,5,0,1,1,0,1,1
SC298112,7,0,7,1,0,0,0,0,1
SC298589,10,0,10,0,0,0,0,0,1
SC298750,4,0,4,0,0,0,0,0,1
SC298843,19,7,12,0,0,0,0,0,1
SC298908,25,8,17,0,2,2,0,0,0
SC298940,14,5,9,0,2,2,0,0,1
SC298993,2,0,2,0,0,0,0,0,0
SC299073,4,4,0,0,1,1,0,0,1
SC299136,5,2,3,0,1,1,0,1,0
SC299234,7,3,4,0,1,1,0,1,1
SC299407,54,12,42,0,0,0,0,0,1
SC299472,6,0,6,0,0,0,0,0,0
SC299696,29,9,20,0,1,1,0,1,1
SC299900,9,0,9,0,0,0,0,0,1
SC299984,17,2,15,0,1,1,0,1,1
SC300008,10,0,10,0,0,0,0,0,1
SC300092,5,2,3,0,1,1,0,0,0
SC300121,4,2,2,0,2,2,0,0,1
SC300127,5,0,5,0,0,0,0,0,1
SC300129,5,0,5,0,0,0,0,0,1
SC300161,28,4,24,0,1,1,0,1,1
SC300164,25,7,18,0,1,1,0,0,1
SC300200,4,1,3,0,0,0,0,0,0
SC300224,6,0,6,0,2,2,0,0,1
SC300225,5,0,5,0,2,2,0,0,1
SC300226,5,0,5,0,2,2,0,0,1
SC300227,5,0,5,0,2,2,0,0,1
SC300228,5,0,5,0,2,2,0,0,1
SC300229,5,0,5,0,2,2,0,0,1
SC300230,5,0,5,0,2,2,0,0,1
SC300231,5,0,5,0,2,2,0,0,1
SC300232,5,0,5,0,2,2,0,0,1
SC300233,5,0,5,0,2,2,0,0,1
SC300380,5,0,5,0,2,2,0,0,1
SC300382,5,0,5,0,2,2,0,0,1
SC300387,5,0,5,0,2,2,0,0,1
SC300419,5,0,5,0,0,0,0,0,0
SC300460,5,1,4,0,2,1,1,0,0
SC300544,12,4,8,0,1,1,0,1,1
SC300731,3,3,0,0,2,2,0,0,0
SC300893,5,0,5,0,0,0,0,0,0
SC300933,3,2,1,0,1,1,0,0,1
SC300999,6,2,4,0,1,1,0,0,0
SC301187,24,4,20,0,0,0,0,0,1
SC301223,20,4,16,0,1,1,0,1,1
SC301232,2,2,0,0,1,1,0,0,0
SC301244,11,4,7,0,1,1,0,1,1
SC301287,4,0,4,0,0,0,0,0,1
SC301300,4,2,2,0,1,1,0,0,0
SC301304,6,0,6,0,0,0,0,0,1
SC301315,7,0,7,0,0,0,0,0,1
SC301335,5,4,1,0,3,3,0,0,0
SC301406,9,2,7,0,1,1,0,0,0
SC301586,8,1,7,0,1,1,0,0,0
SC301805,16,8,8,0,1,1,0,1,1
SC302038,9,3,6,0,1,1,0,1,1
SC302084,14,7,7,0,1,1,0,0,1
SC302132,4,2,2,0,2,2,0,0,0
SC302171,4,0,4,0,1,1,0,0,0
SC302199,6,3,3,0,2,2,0,0,1
SC302280,17,5,12,0,1,1,0,0,0
SC302425,7,4,3,0,1,1,0,0,1
SC302448,116,8,108,0,18,7,11,0,0
SC302472,3,1,2,1,1,1,0,1,1
SC302474,3,0,3,0,0,0,0,0,1
SC302496,23,5,18,0,0,0,0,0,0
SC302622,7,3,4,0,1,1,0,1,1
SC302859,2,2,0,0,1,1,0,0,0
SC302938,6,5,1,0,1,1,0,0,0
SC303077,38,5,33,0,1,1,0,0,0
SC303234,4,0,4,0,0,0,0,0,1
SC303517,17,5,12,0,1,1,0,1,1
SC303670,6,0,6,0,0,0,0,0,1
SC303708,10,0,10,0,0,0,0,0,1
SC303739,6,2,4,0,2,2,0,0,1
SC304393,5,0,5,0,0,0,0,0,0
SC304401,2,2,0,0,1,1,0,0,0
SC304439,23,8,15,0,0,0,0,0,0
SC304455,4,2,2,0,2,2,0,0,0
SC304471,13,0,13,0,0,0,0,0,1
SC304473,9,0,9,0,0,0,0,0,1
SC304609,15,5,10,0,2,2,0,2,1
SC304640,7,3,4,0,2,2,0,0,0
SC304646,25,2,23,0,1,1,0,1,1
SC304651,12,2,10,0,1,1,0,1,1
SC304791,14,6,8,1,1,1,0,1,1
SC304833,5,2,3,0,2,2,0,0,1
SC304839,6,3,3,0,1,1,0,0,1
SC305075,7,0,7,0,0,0,0,0,1
SC305425,53,9,44,0,0,0,0,0,0
SC305523,11,4,7,0,1,1,0,0,1
SC305524,12,4,8,0,1,1,0,1,1
SC305526,8,2,6,0,0,0,0,0,1
SC305856,31,5,26,0,2,1,1,2,1
SC305865,5,3,2,0,3,3,0,0,0
SC305877,4,2,2,0,2,2,0,0,1
SC306421,10,5,5,0,2,2,0,0,1
SC306871,22,3,19,0,1,1,0,1,1
SC306956,16,6,10,0,0,0,0,0,1
SC307063,6,3,3,0,4,2,2,0,1
SC307601,8,3,5,0,4,1,3,1,0
SC307677,38,13,25,1,0,0,0,0,1
SC307688,22,9,13,0,0,0,0,0,0
SC307871,4,1,3,0,2,1,1,0,0
SC307888,11,0,11,0,0,0,0,0,1
SC308222,9,3,6,0,3,1,2,1,1
SC308223,9,3,6,1,3,2,1,1,1
SC308253,10,0,10,0,0,0,0,0,1
SC308305,14,8,6,0,2,2,0,2,1
SC308306,14,8,6,0,2,2,0,2,1
SC308308,7,2,5,0,1,1,0,1,1
SC308309,7,2,5,0,1,1,0,1,1
SC308310,7,2,5,0,1,1,0,1,1
SC308382,22,3,19,0,1,1,0,1,1
SC308383,22,3,19,0,1,1,0,1,1
SC308384,28,3,25,0,1,1,0,1,1
SC308569,3,3,0,0,1,1,0,0,0
SC308610,7,4,3,0,1,1,0,0,0
SC308709,55,9,46,0,0,0,0,0,1
SC308734,10,0,10,0,0,0,0,0,1
SC308789,4,0,4,0,0,0,0,0,0
SC308873,6,2,4,0,1,1,0,1,0
SC308948,10,0,10,0,0,0,0,0,1
SC308967,17,0,17,0,0,0,0,0,1
SC309081,24,6,18,1,2,2,0,2,1
SC309167,6,2,4,0,1,1,0,0,0
SC309293,4,1,3,0,2,1,1,0,0
SC309347,10,2,8,0,1,1,0,1,1
SC309354,12,0,12,0,1,1,0,1,1
SC309383,6,3,3,1,3,2,1,0,1
SC309385,9,2,7,0,3,1,2,1,0
SC309439,5,0,5,1,0,0,0,0,1
SC309917,11,2,9,0,2,1,1,0,1
SC309964,4,0,4,0,3,3,0,1,1
SC310060,48,13,35,0,0,0,0,0,0
SC310130,10,3,7,0,3,1,2,1,1
SC310145,5,0,5,0,0,0,0,0,0
SC310494,5,3,2,0,1,1,0,1,1
SC310500,16,6,10,0,1,1,0,1,1
SC310507,7,4,3,0,1,1,0,1,1
SC310674,24,0,24,0,1,1,0,1,0
SC310696,6,3,3,0,1,1,0,1,1
SC310815,11,0,11,0,0,0,0,0,1
SC310974,34,10,24,0,0,0,0,0,1
SC311039,4,2,2,1,2,2,0,0,1
SC311342,18,0,18,0,0,0,0,0,1
SC311480,15,5,10,1,1,1,0,0,1
SC311494,15,2,13,0,1,1,0,1,1
SC311497,6,0,6,0,0,0,0,0,1
SC311625,9,5,4,0,1,1,0,0,1
SC311652,16,6,10,0,1,1,0,1,1
SC311995,6,5,1,0,1,1,0,0,0
SC312123,17,8,9,0,2,1,1,2,1
SC312191,7,5,2,0,1,1,0,1,1
SC312299,16,4,12,0,2,2,0,2,1
SC312477,8,4,4,0,0,0,0,0,0
SC312607,4,0,4,0,0,0,0,0,1
SC312797,18,8,10,0,1,1,0,1,1
SC312841,8,0,8,0,0,0,0,0,1
SC312890,5,0,5,0,0,0,0,0,1
SC312912,35,10,25,0,0,0,0,0,1
SC312980,8,2,6,0,1,1,0,1,1
SC312981,8,0,8,0,0,0,0,0,1
SC313092,7,6,1,0,0,0,0,0,1
SC313214,6,3,3,2,2,2,0,0,1
SC313218,4,1,3,1,1,1,0,0,1
SC313355,9,0,9,0,1,1,0,1,0
SC313472,7,5,2,0,0,0,0,0,1
SC313590,12,0,12,0,1,1,0,1,0
SC313664,14,10,4,1,0,0,0,0,0
SC313709,7,0,7,0,0,0,0,0,1
SC313813,5,1,4,0,1,1,0,1,1
SC313818,24,8,16,1,1,1,0,1,1
SC313819,23,6,17,1,3,3,0,2,1
SC313841,13,3,10,0,1,1,0,1,1
SC313850,43,15,28,0,1,1,0,1,1
SC313899,10,0,10,0,0,0,0,0,1
SC313913,16,5,11,0,0,0,0,0,1
SC314082,3,3,0,0,0,0,0,0,0
SC314108,7,3,4,0,1,1,0,1,1
SC314144,24,3,21,0,1,1,0,1,1
SC314278,44,14,30,0,0,0,0,0,1
SC314312,5,0,5,1,0,0,0,0,1
SC314313,7,0,7,0,0,0,0,0,1
SC314314,4,0,4,0,0,0,0,0,1
SC314330,6,1,5,0,1,1,0,0,0
SC314412,3,1,2,0,1,1,0,0,1
SC314561,4,2,2,1,1,1,0,0,1
SC314596,26,9,17,0,1,1,0,0,1
SC314671,13,6,7,0,0,0,0,0,1
SC314690,5,2,3,0,1,1,0,0,1
SC314764,34,9,25,0,1,1,0,0,1
SC314879,5,0,5,0,0,0,0,0,0
SC314923,8,0,8,0,1,1,0,1,1
SC314925,11,0,11,0,0,0,0,0,1
SC314976,3,0,3,0,1,1,0,0,0
SC315032,17,0,17,0,0,0,0,0,1
SC315121,3,0,3,0,0,0,0,0,1
SC315168,11,4,7,0,1,1,0,1,1
SC315172,13,4,9,0,1,1,0,1,1
SC315192,4,0,4,1,2,2,0,0,1
SC315284,23,5,18,0,0,0,0,0,0
SC315315,4,2,2,0,2,2,0,0,1
SC315316,10,5,5,0,1,1,0,1,1
SC315379,13,0,13,0,0,0,0,0,1
SC315747,28,0,28,0,0,0,0,0,0
SC315779,27,1,26,0,4,1,3,3,1
00940118,42,13,29,0,0,0,0,0,1
00940318,12,0,12,0,0,0,0,0,1
00940493,20,3,17,0,1,1,0,1,1
00940631,91,8,83,0,2,1,1,0,0
00940781,48,12,36,0,0,0,0,0,0
00941082,72,4,68,0,1,1,0,1,1
00941199,43,10,33,0,1,1,0,1,1
00941405,48,4,44,0,1,1,0,1,1
00941519,22,3,19,0,1,1,0,1,1
00941599,15,3,12,0,1,1,0,1,1
00941665,22,2,20,0,0,0,0,0,1
00941821,54,6,48,0,0,0,0,0,1
00941937,0,0,0,0,0,0,0,0,1
00942225,40,6,34,0,2,2,0,2,1
00942513,48,3,45,0,1,1,0,1,1
00942781,9,4,5,0,2,1,1,0,0
00942944,14,4,10,0,1,1,0,1,1
00943038,45,3,42,0,2,2,0,2,1
00943228,64,14,50,0,0,0,0,0,1
00944049,13,0,13,0,0,0,0,0,1
00944052,5,1,4,0,1,1,0,1,0
00944439,54,9,45,0,0,0,0,0,1
00944703,43,12,31,0,2,2,0,2,1
00944768,10,4,6,0,1,1,0,1,1
00944773,32,9,23,0,1,1,0,1,1
00944784,0,0,0,0,0,0,0,0,0
00945120,14,0,14,0,0,0,0,0,1
00945137,16,6,10,0,1,1,0,0,1
00945248,94,14,80,0,0,0,0,0,1
00945383,30,0,30,0,1,1,0,1,0
00945661,21,2,19,0,1,1,0,1,1
00945878,25,2,23,0,2,1,1,2,0
00946107,44,4,40,0,1,1,0,1,1
00946255,26,9,17,0,2,2,0,0,0
00946307,52,12,40,0,11,11,0,0,1
00946811,46,3,43,0,1,1,0,1,1
00946858,13,3,10,0,1,1,0,1,1
00946978,37,6,31,0,1,1,0,1,1
00947080,9,4,5,0,2,2,0,0,0
00947096,69,16,53,0,1,1,0,0,1
00947098,34,4,30,0,1,1,0,1,1
00947106,5,2,3,0,0,0,0,0,1
00947413,24,6,18,0,0,0,0,0,0
00947662,51,12,39,0,1,1,0,1,1
00947866,9,3,6,0,1,1,0,1,1
00947968,54,5,49,0,1,1,0,1,1
00947998,25,7,18,0,1,1,0,0,1
00948124,19,6,13,0,1,1,0,0,1
00948153,30,4,26,0,1,1,0,1,1
00948298,40,8,32,0,2,2,0,1,1
00948470,25,6,19,0,1,1,0,1,1
00948546,4,4,0,0,3,3,0,0,0
00948598,19,2,17,0,1,1,0,1,1
00948776,105,14,91,0,0,0,0,0,1
00948978,53,10,43,0,2,2,0,2,1
00949064,6,1,5,0,1,1,0,0,0
00949198,18,3,15,0,1,1,0,0,1
00949226,28,7,21,0,0,0,0,0,0
00949328,7,3,4,0,1,1,0,1,1
00949393,17,0,17,0,0,0,0,0,1
00949417,113,7,106,0,1,1,0,1,1
00949500,20,2,18,0,2,1,1,1,1
00949573,24,6,18,0,0,0,0,0,1
00949599,5,0,5,0,0,0,0,0,1
00949632,10,0,10,0,0,0,0,0,1
00949989,28,5,23,0,8,6,2,0,1
00950345,11,6,5,0,1,1,0,1,1
00950526,39,6,33,0,1,1,0,1,1
00950540,13,3,10,0,3,3,0,0,1
00950675,41,5,36,0,0,0,0,0,1
00950851,68,17,51,0,3,3,0,0,1
00950970,43,12,31,0,0,0,0,0,1
00951043,68,10,58,0,1,1,0,1,1
00951093,29,5,24,0,1,1,0,1,1
00951744,44,8,36,0,1,1,0,1,1
00951855,51,12,39,0,0,0,0,0,1
00952013,13,3,10,0,1,1,0,1,1
00952132,12,5,7,0,0,0,0,0,1
00952216,5,1,4,0,2,1,1,0,0
00952726,35,11,24,0,0,0,0,0,1
00953026,8,0,8,0,0,0,0,0,1
00953063,33,0,33,0,0,0,0,0,1
00953237,59,13,46,0,0,0,0,0,1
00953243,129,9,120,0,1,1,0,1,1
00953289,11,3,8,0,1,1,0,1,1
00953415,51,8,43,0,0,0,0,0,1
00953592,27,3,24,0,1,1,0,1,1
00953703,74,3,71,0,1,1,0,1,1
00953785,14,4,10,0,0,0,0,0,1
00953895,1,1,0,0,0,0,0,0,1
00954488,25,3,22,0,1,1,0,1,1
00954573,51,0,51,0,1,1,0,1,1
00954616,53,12,41,0,0,0,0,0,1
00954730,59,9,50,0,0,0,0,0,1
00954753,82,13,69,0,0,0,0,0,1
00954757,7,4,3,0,3,3,0,0,0
00955491,42,7,35,0,2,1,1,2,1
00955661,14,3,11,0,1,1,0,1,1
00955888,30,4,26,0,1,1,0,1,1
00955930,47,11,36,0,0,0,0,0,1
00955957,67,9,58,0,1,1,0,1,1
00955977,32,3,29,0,1,1,0,1,1
00956098,27,0,27,0,1,1,0,1,1
00956104,19,0,19,0,1,1,0,1,1
00956195,15,0,15,0,0,0,0,0,1
00956609,16,3,13,0,1,1,0,0,0
00957155,32,3,29,0,1,1,0,1,1
00957327,43,3,40,0,1,1,0,1,1
00958286,3,3,0,0,2,2,0,0,0
00958313,22,0,22,0,0,0,0,0,1
00958360,58,13,45,0,0,0,0,0,1
00958674,10,2,8,0,1,1,0,0,0
00958986,39,10,29,0,1,1,0,0,1
00959045,44,1,43,0,0,0,0,0,1
00959079,50,3,47,0,1,1,0,1,1
00959082,51,6,45,0,2,2,0,2,1
00959115,101,10,91,0,0,0,0,0,1
00959273,0,0,0,0,0,0,0,0,0
00959329,39,9,30,0,0,0,0,0,1
00959361,19,3,16,0,0,0,0,0,1
00959543,13,5,8,0,1,1,0,1,1
00959962,44,3,41,0,1,1,0,1,1
00960290,20,3,17,0,1,1,0,1,1
00960343,59,2,57,0,1,1,0,1,1
00960516,38,2,36,0,1,1,0,1,1
00960582,13,3,10,0,1,1,0,1,1
00960831,44,13,31,0,0,0,0,0,1
00960953,0,0,0,0,0,0,0,0,0
00960975,10,0,10,0,0,0,0,0,1
00961001,27,2,25,0,1,1,0,1,1
00961088,42,5,37,0,1,1,0,1,1
00961191,16,0,16,0,1,1,0,1,1
00961192,66,2,64,0,1,1,0,1,1
00961209,32,0,32,0,0,0,0,0,1
00961616,39,7,32,0,0,0,0,0,1
00961970,50,8,42,0,1,0,1,0,1
00962105,7,3,4,0,4,4,0,1,0
00962191,0,0,0,0,0,0,0,0,0
00962198,35,8,27,0,0,0,0,0,1
00962291,17,0,17,0,0,0,0,0,1
00962392,41,6,35,0,1,1,0,1,1
00962501,37,3,34,0,1,1,0,0,1
00962757,38,5,33,0,1,1,0,1,1
00962961,119,13,106,0,0,0,0,0,1
00963565,4,1,3,0,1,1,0,0,1
00963783,15,5,10,0,0,0,0,0,0
00963832,64,12,52,0,0,0,0,0,1
00963965,6,4,2,0,1,1,0,0,1
00964044,98,11,87,0,0,0,0,0,1
00964058,221,14,207,0,1,1,0,1,1
00964140,5,2,3,0,1,1,0,0,0
00964179,59,9,50,0,2,2,0,2,1
00964700,5,4,1,0,3,3,0,0,1
00964908,5,3,2,0,3,3,0,0,0
00965046,36,3,33,0,1,1,0,1,1
00965093,37,3,34,0,1,1,0,1,1
00965116,28,3,25,0,1,1,0,1,1
00965267,16,7,9,0,1,1,0,0,0
00965517,116,27,89,0,1,1,0,0,1
00965589,14,0,14,0,1,1,0,1,1
00966425,84,13,71,0,0,0,0,0,1
00966437,44,7,37,0,0,0,0,0,0
00966676,23,0,23,0,0,0,0,0,1
00966713,33,4,29,0,2,2,0,2,0
00966736,24,5,19,0,1,1,0,1,1
00966748,4,3,1,0,1,1,0,0,0
00966860,20,5,15,0,1,1,0,0,1
00966906,23,0,23,0,0,0,0,0,1
00967025,30,7,23,0,1,1,0,1,1
00967168,3,3,0,0,2,2,0,0,0
00967305,17,4,13,0,2,1,1,1,1
00967407,5,3,2,0,0,0,0,0,1
00967439,9,2,7,0,0,0,0,0,1
00967447,7,3,4,0,1,1,0,1,0
00967602,11,2,9,0,1,1,0,0,0
00967743,9,3,6,0,1,1,0,1,1
00967896,32,0,32,0,0,0,0,0,1
00968007,32,0,32,0,0,0,0,0,1
00968502,10,2,8,0,1,1,0,0,1
00968581,37,4,33,0,0,0,0,0,1
00968911,44,3,41,0,1,1,0,1,1
00969315,10,6,4,0,2,2,0,0,0
00969373,32,0,32,0,1,1,0,1,1
00969967,21,5,16,0,4,4,0,0,1
00969972,12,3,9,0,2,2,0,2,1
00970015,82,4,78,0,1,1,0,1,1
00970105,5,4,1,0,1,1,0,0,0
00970167,36,6,30,0,1,1,0,1,1
00970239,39,0,39,0,0,0,0,0,1
00970624,46,3,43,0,1,1,0,1,1
00970812,40,5,35,0,1,1,0,1,1
00970840,17,2,15,0,1,1,0,0,1
00971448,68,4,64,0,1,1,0,1,1
00971504,41,0,41,0,1,1,0,1,1
00971595,14,0,14,0,1,1,0,1,1
00971618,23,3,20,0,1,1,0,1,1
00972265,39,10,29,0,1,1,0,1,1
00972286,19,6,13,0,1,1,0,1,1
00972510,21,0,21,0,0,0,0,0,1
00972618,41,3,38,0,1,1,0,1,1
00972694,96,6,90,0,0,0,0,0,0
00972941,51,3,48,0,1,1,0,1,1
00973091,24,0,24,0,1,1,0,1,1
00973146,31,9,22,0,0,0,0,0,1
00973387,96,8,88,0,2,2,0,2,1
00973594,25,0,25,0,0,0,0,0,1
00973765,44,4,40,0,2,1,1,2,1
00974438,167,16,151,0,0,0,0,0,1
00974515,16,4,12,0,1,1,0,1,0
00974568,31,8,23,0,0,0,0,0,1
00974633,16,5,11,0,1,1,0,0,1
00975049,4,4,0,0,1,1,0,0,0
00975756,20,5,15,0,1,1,0,1,1
00975929,9,3,6,0,1,1,0,1,1
00976145,130,10,120,0,1,1,0,1,1
00976167,19,0,19,0,0,0,0,0,1
00976183,3,3,0,0,1,1,0,0,1
00976297,22,5,17,0,2,1,1,1,1
00976410,105,8,97,0,0,0,0,0,1
00976488,4,3,1,0,1,1,0,0,1
00976528,7,5,2,0,1,1,0,0,1
00976567,33,0,33,0,0,0,0,0,1
00976647,14,2,12,0,0,0,0,0,1
00976653,23,3,20,0,1,1,0,1,0
00976802,13,3,10,0,1,1,0,1,1
00976872,7,3,4,0,3,2,1,0,0
00977091,23,5,18,0,1,1,0,1,1
00977105,24,5,19,0,1,1,0,1,1
00977257,42,2,40,0,1,1,0,1,1
00977320,21,0,21,0,0,0,0,0,0
00977483,41,4,37,0,1,1,0,1,1
00977549,95,12,83,0,0,0,0,0,1
00977646,5,5,0,0,3,3,0,0,1
00977817,54,5,49,0,1,1,0,1,1
00977818,134,25,109,0,0,0,0,0,1
00977924,17,0,17,0,0,0,0,0,1
00978039,7,2,5,0,1,1,0,0,0
00978060,17,1,16,0,1,1,0,1,1
00978161,62,11,51,0,1,1,0,1,1
00978228,5,4,1,0,6,6,0,0,1
00978271,72,4,68,0,2,1,1,2,1
00978415,36,5,31,0,1,1,0,1,1
00979108,28,5,23,0,1,1,0,1,1
00979170,30,0,30,0,2,2,0,0,1
00979229,39,3,36,0,1,1,0,1,1
00979395,60,4,56,0,2,2,0,1,1
00979400,7,4,3,0,4,4,0,1,1
00979681,78,8,70,0,0,0,0,0,1
00979689,117,11,106,0,0,0,0,0,1
00979759,55,0,55,0,0,0,0,0,1
00979845,2,2,0,0,2,2,0,0,0
00980142,32,7,25,0,1,1,0,1,1
00980152,40,11,29,0,0,0,0,0,0
00980281,46,9,37,0,0,0,0,0,1
00980448,5,4,1,0,1,1,0,0,1
00980518,12,3,9,0,1,1,0,1,1
00980548,38,0,38,0,0,0,0,0,1
00980603,23,3,20,0,4,4,0,1,1
00980694,48,0,48,0,3,3,0,3,1
00980698,60,9,51,0,2,2,0,0,1
00980864,34,3,31,0,1,1,0,1,1
00981031,23,5,18,0,0,0,0,0,1
00981337,25,3,22,0,1,1,0,1,0
00981408,13,0,13,0,0,0,0,0,1
00981908,115,20,95,0,0,0,0,0,1
00981979,22,3,19,0,1,1,0,1,1
00982063,19,0,19,0,0,0,0,0,1
00982162,34,0,34,0,1,1,0,1,1
00982544,77,6,71,0,0,0,0,0,1
00982780,144,12,132,0,0,0,0,0,1
00982833,52,5,47,0,1,1,0,1,1
00982918,19,0,19,0,0,0,0,0,1
00983571,16,1,15,0,1,1,0,1,1
00983768,57,8,49,0,2,2,0,2,1
00983870,48,0,48,0,4,2,2,0,1
00983883,16,5,11,0,4,4,0,2,1
00984275,65,6,59,0,1,1,0,1,1
00984642,6,4,2,0,2,2,0,0,0
00984766,13,5,8,0,0,0,0,0,1
00984899,60,10,50,0,0,0,0,0,1
00984935,38,11,27,0,0,0,0,0,1
00984972,8,5,3,0,2,2,0,0,0
00985158,56,13,43,0,0,0,0,0,1
00985287,20,0,20,0,0,0,0,0,1
00985574,29,3,26,0,1,1,0,1,1
00985592,14,2,12,0,2,2,0,1,0
00985685,28,8,20,0,0,0,0,0,0
00985695,16,7,9,0,0,0,0,0,1
00986208,62,10,52,0,1,1,0,0,1
00986239,121,0,121,0,0,0,0,0,1
00986761,143,15,128,0,0,0,0,0,1
00987208,12,2,10,0,2,2,0,1,1
00987381,8,0,8,0,1,1,0,0,1
00987671,8,3,5,0,2,1,1,1,1
00987950,18,4,14,0,1,1,0,1,0
00988365,13,3,10,0,0,0,0,0,0
00988645,14,5,9,0,0,0,0,0,0
00988671,15,2,13,0,1,1,0,1,1
00988692,3,3,0,0,0,0,0,0,0
00988784,5,2,3,0,0,0,0,0,1
00988857,27,5,22,0,2,2,0,0,1
00989164,59,5,54,0,1,1,0,1,1
00989203,25,3,22,0,0,0,0,0,1
00989385,5,3,2,0,2,2,0,0,1
00989459,28,5,23,0,1,1,0,1,1
00989511,75,15,60,0,0,0,0,0,1
00989529,6,3,3,0,2,2,0,0,0
00989654,40,5,35,0,0,0,0,0,1
00989959,38,4,34,0,1,1,0,1,1
00990335,8,1,7,0,1,1,0,0,1
00990620,31,0,31,0,0,0,0,0,1
00990860,16,3,13,0,0,0,0,0,1
00990937,95,9,86,0,2,1,1,2,1
00991200,15,0,15,0,1,1,0,1,1
00991704,46,5,41,0,1,1,0,1,1
00991876,38,0,38,0,1,1,0,1,1
00991889,21,0,21,0,1,1,0,1,1
00991954,137,3,134,0,3,2,1,0,1
00992246,7,0,7,0,0,0,0,0,0
00992490,54,8,46,0,0,0,0,0,1
00992512,12,4,8,0,0,0,0,0,0
00992943,6,1,5,0,1,1,0,0,0
00993107,5,1,4,0,1,1,0,0,0
00993831,89,14,75,0,0,0,0,0,1
00994213,25,4,21,0,1,1,0,1,1
00994307,8,5,3,0,0,0,0,0,1
00994353,20,3,17,0,1,1,0,1,1
00994939,12,3,9,0,1,1,0,1,1
00995212,43,7,36,0,3,1,2,0,1
00995419,26,3,23,0,1,1,0,1,1
00995550,41,3,38,0,1,1,0,1,1
00995634,5,3,2,0,1,1,0,0,1
00995728,26,7,19,0,0,0,0,0,1
00995838,6,0,6,0,0,0,0,0,0
00995976,44,0,44,0,0,0,0,0,1
00996063,40,13,27,0,0,0,0,0,1
00996136,15,0,15,0,0,0,0,0,1
00996365,8,2,6,0,1,1,0,0,1
00996424,60,12,48,0,0,0,0,0,1
00996488,22,5,17,0,1,1,0,1,1
00996661,11,3,8,0,2,0,2,0,1
00996804,23,4,19,0,2,1,1,2,1
00996992,16,0,16,0,3,3,0,1,1
00997586,13,5,8,0,1,1,0,0,0
00998080,40,0,40,0,1,1,0,1,1
00998121,42,3,39,0,1,0,1,0,1
00998221,35,8,27,0,0,0,0,0,1
00998302,17,2,15,0,1,1,0,0,1
00998314,34,8,26,0,0,0,0,0,1
00999186,17,4,13,0,1,1,0,0,0
00999528,29,5,24,0,7,5,2,0,1
00999874,4,3,1,0,1,1,0,0,0
00999912,53,11,42,0,0,0,0,0,1
01000011,7,3,4,0,2,2,0,0,1
01000123,15,5,10,0,2,2,0,1,1
01000183,14,5,9,0,2,2,0,2,1
01000608,57,7,50,0,0,0,0,0,1
01000613,8,0,8,0,0,0,0,0,1
01000668,31,0,31,0,0,0,0,0,1
01000824,72,14,58,0,0,0,0,0,1
01000834,82,2,80,0,1,1,0,1,1
01000870,33,0,33,0,1,1,0,1,1
01000878,71,8,63,0,12,7,5,0,1
01000954,43,4,39,0,1,1,0,1,1
01000995,11,4,7,0,0,0,0,0,1
01001020,20,4,16,0,1,1,0,1,1
01001050,18,3,15,0,1,1,0,1,1
01001165,14,5,9,0,1,1,0,0,0
01001690,12,4,8,0,1,1,0,1,1
01002075,45,0,45,0,0,0,0,0,1
01002091,24,5,19,0,1,1,0,1,1
01002446,5,4,1,0,1,1,0,0,1
01002607,85,10,75,0,1,1,0,1,1
01002610,63,5,58,0,1,1,0,1,0
01002614,41,0,41,0,0,0,0,0,1
01002805,46,15,31,0,0,0,0,0,1
01002955,42,8,34,0,1,1,0,1,1
01003081,39,4,35,0,1,1,0,1,1
01003142,67,14,53,0,1,1,0,1,1
01003190,11,3,8,0,1,1,0,1,1
01003459,63,7,56,0,2,1,1,0,0
01003526,20,6,14,0,1,1,0,1,1
01003561,6,1,5,0,1,1,0,0,0
01003645,30,3,27,0,1,1,0,1,1
01003681,47,4,43,0,1,1,0,1,1
01003825,44,4,40,0,1,1,0,1,1
01003834,0,0,0,0,0,0,0,0,0
01004191,20,3,17,0,0,0,0,0,1
01004355,39,3,36,0,1,1,0,1,1
01004368,16,4,12,0,1,1,0,1,1
01004505,40,3,37,0,1,1,0,1,1
01004676,26,0,26,0,0,0,0,0,1
01005048,38,9,29,0,1,1,0,1,1
01005238,33,5,28,0,1,1,0,1,1
01005897,56,0,56,0,0,0,0,0,0
01005899,31,5,26,0,1,1,0,1,1
01006112,47,8,39,0,1,1,0,1,1
01006177,17,3,14,0,1,1,0,0,0
01006630,10,5,5,0,1,1,0,1,1
01007036,35,12,23,0,0,0,0,0,0
01007089,53,9,44,0,0,0,0,0,0
01007593,29,3,26,0,2,2,0,2,1
01007642,27,0,27,0,0,0,0,0,1
01007689,33,5,28,0,1,1,0,1,1
01007700,12,0,12,0,0,0,0,0,1
01007798,40,8,32,0,1,1,0,1,1
01007961,7,4,3,0,1,1,0,1,1
01008205,17,4,13,0,1,1,0,1,1
01008251,28,3,25,0,1,1,0,1,1
01008371,71,13,58,0,0,0,0,0,1
01008395,0,0,0,0,0,0,0,0,0
01008689,24,1,23,0,1,1,0,1,1
01008774,23,0,23,0,0,0,0,0,0
01008965,63,6,57,0,1,1,0,1,1
01009194,14,2,12,0,1,1,0,1,1
01009418,56,8,48,0,1,1,0,1,1
01009547,11,3,8,0,2,2,0,0,1
01009550,21,4,17,0,0,0,0,0,1
01338091,28,6,22,0,1,1,0,1,1
01338135,26,10,16,0,1,1,0,0,1
01338296,5,4,1,0,1,1,0,1,1
01338409,14,2,12,0,1,1,0,1,0
01338928,92,6,86,0,0,0,0,0,1
01339131,34,4,30,0,1,1,0,1,1
01339208,5,3,2,0,2,2,0,0,0
01339474,10,2,8,0,1,1,0,1,1
01339541,30,10,20,0,0,0,0,0,1
01339867,49,15,34,0,0,0,0,0,1
01339906,54,10,44,0,1,1,0,1,1
01340222,25,2,23,0,1,1,0,1,1
01340233,45,10,35,0,1,0,1,0,0
01340463,77,25,52,0,0,0,0,0,0
01340897,33,1,32,0,1,1,0,1,0
01341060,33,4,29,0,1,1,0,1,1
01341694,43,2,41,0,1,1,0,1,1
01341815,40,6,34,0,0,0,0,0,0
01341829,39,6,33,0,0,0,0,0,1
01341879,19,3,16,0,2,1,1,1,1
01341920,59,11,48,0,1,1,0,0,1
01342143,11,0,11,0,1,1,0,1,1
01342183,29,6,23,0,1,1,0,1,1
01342232,4,3,1,0,2,2,0,0,1
01342446,55,4,51,0,1,1,0,1,1
01342505,27,2,25,0,1,1,0,1,1
01342984,48,9,39,0,1,1,0,1,1
01343258,38,0,38,0,0,0,0,0,1
01343616,23,2,21,0,1,1,0,1,1
01343703,30,8,22,0,0,0,0,0,0
01343902,17,0,17,0,0,0,0,0,1
01344029,5,3,2,0,1,1,0,0,0
01344053,17,2,15,0,2,1,1,1,1
01344319,13,4,9,0,1,1,0,1,1
01344528,38,8,30,0,2,2,0,2,1
01344876,28,6,22,0,6,6,0,0,1
01345093,33,3,30,0,1,1,0,1,1
01345215,4,4,0,0,2,2,0,0,1
01345758,109,19,90,0,0,0,0,0,1
01346089,6,4,2,0,2,2,0,0,1
01346747,3,3,0,0,0,0,0,0,0
01348029,5,4,1,0,2,2,0,0,0
01348788,6,0,6,0,0,0,0,0,1
01348874,25,3,22,0,1,1,0,1,1
01348999,8,6,2,0,1,1,0,0,1
01349867,6,3,3,0,1,1,0,0,1
01350199,2,2,0,0,1,1,0,0,1
01350356,26,9,17,0,0,0,0,0,0
01350389,26,1,25,0,2,1,1,2,1
01350864,53,11,42,0,1,1,0,1,0
01350946,19,0,19,0,0,0,0,0,1
01351117,10,4,6,0,1,1,0,1,0
01351149,51,10,41,0,0,0,0,0,1
01351369,44,13,31,0,1,0,1,0,1
01351816,10,6,4,0,4,4,0,0,0
01352158,35,5,30,0,1,1,0,1,1
01352258,6,1,5,0,2,1,1,1,0
01352278,21,12,9,0,0,0,0,0,1
01352390,17,3,14,0,0,0,0,0,1
01352496,27,3,24,0,0,0,0,0,0
01352502,106,0,106,0,0,0,0,0,1
01352551,0,0,0,0,0,0,0,0,1
01352757,17,0,17,0,0,0,0,0,1
01352799,3,0,3,0,0,0,0,0,1
01352962,8,3,5,0,0,0,0,0,1
01352995,17,4,13,0,1,1,0,1,1
01353824,64,9,55,0,0,0,0,0,1
01353896,24,0,24,0,1,1,0,1,1
01353901,27,0,27,0,0,0,0,0,1
01354209,7,0,7,0,0,0,0,0,1
01354372,8,4,4,0,0,0,0,0,0
01355034,29,12,17,0,3,3,0,0,1
01355085,31,17,14,0,0,0,0,0,0
01355222,46,7,39,0,0,0,0,0,1
01355272,53,12,41,0,0,0,0,0,1
01355487,41,13,28,0,0,0,0,0,1
01355696,21,5,16,0,0,0,0,0,0
01355951,16,2,14,0,1,1,0,1,1
01356186,42,6,36,0,3,3,0,3,1
01356207,4,3,1,0,1,1,0,0,0
01356378,50,11,39,0,0,0,0,0,1
01356661,31,9,22,0,0,0,0,0,1
01356744,11,0,11,0,0,0,0,0,1
01356861,23,4,19,0,1,1,0,1,1
01356867,8,8,0,0,1,1,0,0,0
01357794,23,4,19,0,0,0,0,0,1
01357837,56,3,53,0,1,1,0,1,1
01357958,40,5,35,0,0,0,0,0,1
01358511,29,3,26,0,1,1,0,1,1
01358811,36,5,31,0,1,1,0,1,1
01358924,3,3,0,0,2,2,0,0,0
01359173,22,2,20,0,1,1,0,1,0
01359836,53,3,50,0,4,2,2,2,0
01360234,6,3,3,0,2,2,0,0,0
01360338,12,0,12,0,0,0,0,0,1
01360487,4,1,3,0,1,1,0,0,0
01360879,11,1,10,0,1,1,0,0,0
01361121,9,0,9,0,0,0,0,0,1
01361259,0,0,0,0,0,0,0,0,0
01362109,9,2,7,0,1,1,0,1,0
01362353,24,5,19,0,1,1,0,0,1
01362405,5,2,3,0,1,1,0,0,0
01362410,14,2,12,0,1,1,0,1,1
01362615,42,3,39,0,1,1,0,1,1
01363137,32,7,25,0,1,1,0,1,1
01363139,7,5,2,0,2,2,0,0,0
01363496,19,0,19,0,1,1,0,1,1
01363543,4,0,4,0,1,1,0,0,0
01363776,41,3,38,0,1,1,0,1,1
01363890,5,3,2,0,3,3,0,0,0
01363911,7,3,4,0,2,2,0,0,1
01364782,7,0,7,0,1,1,0,0,0
01365107,18,3,15,0,0,0,0,0,1
01365211,15,9,6,0,5,5,0,0,1
01365343,76,15,61,0,1,1,0,0,1
01365721,12,4,8,0,3,3,0,0,1
01365976,25,0,25,0,0,0,0,0,1
01366300,81,10,71,0,10,0,10,0,0
01366712,10,4,6,0,0,0,0,0,0
01366846,116,10,106,0,0,0,0,0,1
01366909,20,3,17,0,1,1,0,1,1
01367044,61,0,61,0,1,1,0,1,1
01367371,14,3,11,0,1,1,0,1,0
01367828,59,13,46,0,0,0,0,0,1
01367849,16,6,10,0,0,0,0,0,1
01368883,57,17,40,0,0,0,0,0,1
01368988,85,9,76,0,0,0,0,0,1
01369401,111,8,103,0,0,0,0,0,1
01369494,4,3,1,0,2,2,0,0,0
01369845,14,6,8,0,1,1,0,1,1
01369937,22,5,17,0,1,1,0,1,1
01370147,16,2,14,0,0,0,0,0,0
01370230,22,2,20,0,1,1,0,1,1
01370232,7,2,5,0,0,0,0,0,1
01370268,13,4,9,0,1,1,0,1,1
01371191,30,9,21,0,0,0,0,0,1
01371199,32,0,32,0,0,0,0,0,1
01371282,17,1,16,0,1,1,0,1,1
01371454,12,5,7,0,1,1,0,1,1
01371507,33,2,31,0,1,1,0,1,1
01371523,17,0,17,0,0,0,0,0,1
01371958,6,0,6,0,0,0,0,0,0
01371973,113,8,105,0,1,1,0,1,1
01372008,4,4,0,0,2,2,0,0,0
01372254,10,3,7,0,1,1,0,1,1
01372316,72,13,59,0,0,0,0,0,1
01372383,14,2,12,0,0,0,0,0,1
01372410,31,13,18,0,0,0,0,0,1
01372495,5,0,5,0,2,2,0,0,0
01373237,29,3,26,0,1,1,0,1,1
01373294,3,3,0,0,2,2,0,0,0
01373443,28,0,28,0,0,0,0,0,1
01373444,10,4,6,0,1,1,0,0,1
01373545,75,7,68,0,1,1,0,0,1
01373876,79,6,73,0,1,1,0,1,1
01374334,2,2,0,0,0,0,0,0,0
01374690,4,3,1,0,2,2,0,0,0
01374786,5,2,3,0,1,1,0,0,1
01375182,46,6,40,0,0,0,0,0,1
01375941,27,9,18,0,1,1,0,1,1
01376186,5,2,3,0,2,2,0,0,0
01376835,22,7,15,0,1,1,0,1,1
01377030,20,6,14,0,6,4,2,0,0
01377037,15,4,11,0,0,0,0,0,1
01377398,27,3,24,0,0,0,0,0,1
01377658,40,10,30,0,0,0,0,0,1
01378019,13,4,9,0,1,1,0,1,1
01378379,37,0,37,0,1,1,0,1,1
01378711,40,6,34,0,1,1,0,1,1
01378777,30,4,26,0,1,1,0,1,1
01378916,17,1,16,0,1,1,0,0,1
01379041,17,2,15,0,2,2,0,2,1
01379201,3,3,0,0,0,0,0,0,0
01379316,24,0,24,0,0,0,0,0,1
01379840,25,3,22,0,0,0,0,0,1
01380053,16,0,16,0,2,2,0,2,1
01380697,9,3,6,0,1,1,0,0,0
01380736,39,8,31,0,0,0,0,0,1
01380799,6,3,3,0,1,1,0,0,1
01381169,21,0,21,0,0,0,0,0,1
01381292,6,4,2,0,1,1,0,0,1
01382400,4,3,1,0,2,2,0,0,1
01382986,42,0,42,0,0,0,0,0,1
01383825,52,4,48,0,1,1,0,1,1
01383989,23,0,23,0,0,0,0,0,1
01384228,17,0,17,0,0,0,0,0,1
01384241,15,5,10,0,1,1,0,1,0
01384286,5,2,3,0,2,2,0,0,0
01384842,14,4,10,0,1,1,0,1,1
01386030,10,0,10,0,0,0,0,0,1
01386074,23,6,17,0,1,1,0,1,1
01386115,19,3,16,0,1,1,0,0,0
01386197,2,0,2,0,0,0,0,0,1
01386777,38,0,38,0,0,0,0,0,1
01386979,19,2,17,0,2,1,1,1,1
01387182,26,3,23,0,1,1,0,0,1
01387453,21,0,21,0,1,1,0,1,1
01387629,8,3,5,0,1,1,0,1,1
01388304,32,4,28,0,1,1,0,1,1
01388370,5,4,1,0,1,1,0,0,1
01388429,32,0,32,0,0,0,0,0,1
01388851,26,3,23,0,1,1,0,1,1
01388951,16,4,12,0,1,1,0,1,1
01389006,27,0,27,0,0,0,0,0,1
01389155,29,14,15,0,1,1,0,1,1
01389165,43,12,31,0,0,0,0,0,1
01389339,0,0,0,0,0,0,0,0,1
01389470,25,3,22,0,3,1,2,3,1
01389757,17,5,12,0,1,1,0,0,1
01389804,24,5,19,0,1,1,0,1,1
01390726,17,2,15,0,1,1,0,0,1
01391200,68,9,59,0,0,0,0,0,1
01391283,30,10,20,0,1,1,0,0,0
01391364,4,2,2,0,3,2,1,0,0
01391602,12,3,9,0,1,1,0,1,1
01391806,12,3,9,0,1,1,0,1,1
01392283,14,3,11,0,2,2,0,0,0
01392457,6,4,2,0,1,1,0,0,1
01392652,19,4,15,0,0,0,0,0,1
01392762,60,10,50,0,1,1,0,1,1
01393047,30,0,30,0,1,1,0,1,1
01393088,3,3,0,0,1,1,0,0,1
01393161,19,4,15,0,1,1,0,1,1
01393436,45,9,36,0,0,0,0,0,0
01393569,5,1,4,0,1,1,0,1,1
01393682,6,0,6,0,1,1,0,0,1
01393717,51,9,42,0,1,1,0,0,1
01393773,66,8,58,0,0,0,0,0,1
01393888,12,0,12,0,0,0,0,0,1
01395546,116,7,109,0,0,0,0,0,1
01395915,15,3,12,0,1,1,0,1,1
01396026,9,3,6,0,2,2,0,0,1
01396082,62,13,49,0,0,0,0,0,1
01396429,69,10,59,0,0,0,0,0,1
01396452,4,0,4,0,0,0,0,0,1
01396513,68,9,59,0,1,1,0,1,1
01396553,21,3,18,0,1,1,0,1,1
01396620,26,4,22,0,5,4,1,0,0
01397169,82,13,69,0,0,0,0,0,1
01397242,2,2,0,0,1,1,0,0,1
01397477,5,5,0,0,1,1,0,0,1
01397520,37,4,33,0,1,1,0,1,1
01397705,4,3,1,0,1,1,0,0,0
01397762,29,5,24,0,1,1,0,1,1
01397926,40,4,36,0,1,1,0,1,1
01398153,11,4,7,0,4,4,0,1,1
03286015,11,2,9,0,1,1,0,0,0
03286205,16,3,13,0,1,1,0,1,1
03286561,16,4,12,0,1,1,0,0,1
03286610,19,8,11,0,1,1,0,0,0
03286747,14,0,14,0,1,1,0,1,1
03286750,14,2,12,0,1,1,0,1,1
03286777,13,3,10,0,1,1,0,1,1
03286782,5,3,2,0,2,2,0,0,0
03286863,10,0,10,0,0,0,0,0,1
03287013,4,2,2,0,1,1,0,0,0
03287118,7,3,4,0,1,1,0,1,1
03287126,7,3,4,0,1,1,0,1,1
03287179,7,3,4,0,1,1,0,1,1
03287293,7,3,4,0,1,1,0,1,1
03287320,20,0,20,0,0,0,0,0,1
03287489,17,2,15,0,1,1,0,1,1
03287504,5,0,5,0,0,0,0,0,1
03287580,22,4,18,0,1,1,0,1,1
03287854,6,3,3,0,2,2,0,0,0
03287882,9,0,9,0,0,0,0,0,1
03288072,10,6,4,0,4,4,0,0,0
03288100,21,3,18,0,1,1,0,1,1
03288116,30,4,26,0,1,1,0,1,1
03288143,24,7,17,0,0,0,0,0,0
03288167,17,1,16,0,0,0,0,0,1
03288261,21,3,18,0,1,1,0,1,1
03288617,42,5,37,0,1,1,0,1,1
03288678,30,2,28,0,2,1,1,2,1
03288679,20,2,18,0,1,1,0,1,1
03288694,9,0,9,0,0,0,0,0,1
03288968,4,2,2,0,1,1,0,1,0
03289012,8,5,3,0,1,1,0,1,1
03289031,5,3,2,0,2,2,0,0,0
03289105,15,2,13,0,1,1,0,0,1
03289110,13,0,13,0,0,0,0,0,1
03289116,18,3,15,0,1,1,0,1,1
03289130,6,1,5,0,1,1,0,0,1
03289197,24,4,20,0,3,2,1,3,1
03289321,7,2,5,0,1,1,0,1,1
03289367,12,5,7,0,2,2,0,0,1
03289714,7,2,5,0,1,1,0,0,0
03289771,6,3,3,0,1,1,0,0,0
03289889,33,3,30,0,7,3,4,2,1
03289949,87,8,79,0,0,0,0,0,1
03290047,17,2,15,0,2,2,0,2,1
03290221,44,0,44,0,0,0,0,0,1
03290256,6,1,5,0,1,1,0,0,1
03290399,39,6,33,0,5,5,0,0,1
03290446,23,4,19,0,1,1,0,1,1
03290532,14,6,8,0,1,1,0,1,1
03290817,49,5,44,0,1,1,0,1,1
03290825,28,7,21,0,1,1,0,1,1
03291172,17,0,17,0,0,0,0,0,1
03291243,25,0,25,0,0,0,0,0,1
03291300,9,4,5,0,2,2,0,0,0
03291380,22,7,15,0,1,1,0,0,0
03291582,24,0,24,0,2,2,0,2,1
03291785,24,0,24,0,0,0,0,0,1
03291974,9,7,2,0,0,0,0,0,1
03292147,7,0,7,0,0,0,0,0,1
03292336,21,3,18,0,1,1,0,1,1
03292600,17,9,8,0,0,0,0,0,0
03292923,17,2,15,0,1,1,0,1,1
03294014,23,4,19,0,1,1,0,1,1
03294015,13,0,13,0,0,0,0,0,1
03294434,76,15,61,0,4,1,3,0,1
03294453,24,3,21,0,1,1,0,0,1
03294665,88,0,88,0,0,0,0,0,1
03294736,27,0,27,0,0,0,0,0,1
03294808,8,3,5,0,2,2,0,0,0
03295051,7,0,7,0,0,0,0,0,0
03295063,38,6,32,0,1,1,0,0,0
03295175,20,3,17,0,1,1,0,0,1
03295446,23,4,19,0,1,1,0,1,1
03295455,38,5,33,0,1,1,0,1,1
03295611,12,0,12,0,1,1,0,1,1
03295664,8,3,5,0,3,3,0,0,0
03295699,41,0,41,0,1,1,0,1,1
03295705,26,4,22,0,1,1,0,1,1
03295929,27,3,24,0,2,2,0,2,1
03296014,12,1,11,0,1,1,0,1,1
03296149,7,6,1,0,0,0,0,0,1
03296399,12,2,10,0,1,1,0,1,1
03296404,16,3,13,0,1,1,0,1,1
03296514,10,3,7,0,1,1,0,0,1
03296632,39,9,30,0,0,0,0,0,1
03296681,8,5,3,0,0,0,0,0,1
03296825,43,14,29,0,0,0,0,0,1
03296884,20,0,20,0,1,1,0,1,1
03296907,18,0,18,0,0,0,0,0,1
03296912,24,0,24,0,0,0,0,0,1
03296976,18,2,16,0,0,0,0,0,1
03296989,32,7,25,0,0,0,0,0,1
03297024,16,0,16,0,0,0,0,0,1
03297049,10,3,7,0,1,1,0,1,1
03297187,33,3,30,0,1,1,0,1,1
03297224,41,19,22,0,0,0,0,0,1
03297240,14,2,12,0,0,0,0,0,0
03297359,17,4,13,0,0,0,0,0,1
03297869,22,0,22,0,0,0,0,0,1
03298048,15,4,11,0,1,1,0,1,1
03298140,6,0,6,0,0,0,0,0,1
03298145,6,0,6,0,0,0,0,0,1
03298388,26,9,17,0,3,3,0,0,1
03298397,17,0,17,0,0,0,0,0,1
03298442,24,4,20,0,1,1,0,1,0
03298903,44,9,35,0,1,1,0,1,1
03298971,12,2,10,0,1,1,0,1,1
03299012,24,1,23,0,3,1,2,3,1
03299018,31,4,27,0,1,1,0,1,1
03299325,8,4,4,0,2,2,0,0,1
03299580,8,0,8,0,0,0,0,0,1
03299608,42,9,33,0,0,0,0,0,1
03299793,61,5,56,0,1,1,0,1,1
03300092,6,0,6,0,1,1,0,1,1
03300351,10,3,7,0,1,1,0,0,1
03300591,49,11,38,0,0,0,0,0,1
03300794,41,3,38,0,0,0,0,0,0
03300816,12,3,9,0,1,1,0,0,1
03300949,9,3,6,0,2,2,0,0,1
03300962,6,2,4,0,1,1,0,0,1
03301881,49,13,36,0,1,1,0,0,1
03301940,31,3,28,0,1,1,0,1,1
03302348,20,2,18,0,1,1,0,1,1
03302442,19,4,15,0,1,1,0,1,1
03302453,9,0,9,0,0,0,0,0,1
03302507,35,4,31,0,1,1,0,1,1
03302520,10,6,4,0,0,0,0,0,1
03302861,7,3,4,0,1,1,0,1,1
03302877,16,4,12,0,0,0,0,0,1
03302887,25,8,17,0,1,1,0,1,1
03302891,38,6,32,0,1,1,0,1,1
03302894,6,2,4,0,1,1,0,0,1
03302902,9,0,9,0,0,0,0,0,1
03302947,32,4,28,0,3,3,0,3,1
03303165,15,0,15,0,1,1,0,1,1
03303251,17,3,14,0,0,0,0,0,1
03303363,19,4,15,0,0,0,0,0,1
03303501,6,3,3,0,2,2,0,0,0
03303689,51,16,35,0,0,0,0,0,1
03303706,49,11,38,0,1,1,0,1,1
03303863,5,2,3,0,1,1,0,0,0
03304007,29,0,29,0,0,0,0,0,1
03304094,13,4,9,0,1,1,0,1,0
03304174,9,0,9,0,2,2,0,0,1
03304693,61,17,44,0,0,0,0,0,1
03304979,7,0,7,0,0,0,0,0,0
03305040,6,1,5,0,1,1,0,0,0
03305378,81,13,68,0,0,0,0,0,1
03305610,41,4,37,0,0,0,0,0,0
03305818,8,4,4,0,3,3,0,0,0
03306170,7,1,6,0,1,1,0,0,1
03306265,5,2,3,0,1,1,0,0,0
03306303,21,0,21,0,0,0,0,0,1
03306337,44,9,35,0,0,0,0,0,1
03306468,11,3,8,0,1,1,0,0,1
03306979,10,0,10,0,1,1,0,0,1
03307053,14,0,14,0,0,0,0,0,1
03307063,9,1,8,0,1,1,0,1,0
03307069,19,0,19,0,0,0,0,0,1
03307429,17,8,9,0,1,1,0,0,1
03307621,5,2,3,0,1,1,0,0,0
03307684,51,6,45,0,0,0,0,0,1
03307708,23,7,16,0,0,0,0,0,1
03308048,12,0,12,0,0,0,0,0,1
03308182,6,1,5,0,1,1,0,0,0
03308420,7,2,5,0,1,1,0,1,0
03308486,33,4,29,0,1,1,0,1,1
03308750,11,5,6,0,2,2,0,0,1
03309258,15,0,15,0,0,0,0,0,1
03309770,28,3,25,0,0,0,0,0,1
03309912,45,3,42,0,1,1,0,1,1
03310225,41,9,32,0,0,0,0,0,1
03310697,9,4,5,0,3,3,0,0,1
03311094,5,1,4,0,1,1,0,0,0
03311138,5,2,3,0,1,1,0,0,0
03311324,34,9,25,0,0,0,0,0,1
03311492,7,3,4,0,1,1,0,0,1
03311493,10,0,10,0,0,0,0,0,1
03311680,34,6,28,0,1,1,0,1,1
03311700,31,12,19,0,1,1,0,1,1
03311709,37,5,32,0,1,1,0,1,1
03311810,6,2,4,0,1,1,0,0,0
03311896,24,1,23,0,3,1,2,0,0
03311993,21,5,16,0,6,6,0,0,0
03312076,11,3,8,0,1,1,0,0,1
03312220,26,4,22,0,1,1,0,1,1
03312226,20,6,14,0,1,1,0,1,1
03312364,5,3,2,0,2,2,0,0,0
03312673,125,17,108,0,8,8,0,8,0
03312946,22,4,18,0,0,0,0,0,1
03313017,24,0,24,0,0,0,0,0,1
03313063,26,3,23,0,1,1,0,1,1
03313083,54,8,46,0,0,0,0,0,0
03313210,11,2,9,0,0,0,0,0,0
03313248,21,0,21,0,0,0,0,0,1
03313345,22,4,18,0,1,1,0,1,1
03313802,34,7,27,0,1,1,0,1,1
03313901,36,8,28,0,0,0,0,0,0
03313975,33,13,20,0,0,0,0,0,1
03314005,31,0,31,0,0,0,0,0,1
03314066,42,12,30,0,1,1,0,1,1
03314092,22,2,20,0,0,0,0,0,1
03314392,7,3,4,0,1,1,0,0,1
03314917,7,4,3,0,3,3,0,0,0
03314930,15,0,15,0,0,0,0,0,1
03315161,11,0,11,0,0,0,0,0,1
03315193,33,3,30,0,1,1,0,1,1
03315414,10,4,6,0,1,1,0,0,1
03315533,14,3,11,0,1,1,0,0,0
03315543,44,4,40,0,2,1,1,2,1
03315568,8,0,8,0,0,0,0,0,1
03315618,7,4,3,0,1,1,0,1,1
03315632,21,0,21,0,0,0,0,0,1
03315645,27,5,22,0,2,2,0,1,1
03316194,21,7,14,0,1,1,0,1,1
03316334,20,6,14,0,1,1,0,1,1
03316394,33,8,25,0,0,0,0,0,1
03316717,6,3,3,0,1,1,0,0,1
03317333,54,11,43,0,0,0,0,0,1
03317397,13,1,12,0,0,0,0,0,1
03317493,17,2,15,0,2,1,1,2,1
03317553,40,6,34,0,1,1,0,1,1
03317598,33,4,29,0,1,1,0,1,1
03317919,22,2,20,0,2,1,1,2,1
03317920,22,2,20,0,2,1,1,2,1
03317941,22,2,20,0,2,1,1,2,1
03318141,32,7,25,0,0,0,0,0,1
03318263,16,0,16,0,0,0,0,0,1
03318290,10,0,10,0,0,0,0,0,1
03318476,7,4,3,0,2,2,0,0,0
03318735,8,2,6,0,1,1,0,0,0
03318755,9,3,6,0,0,0,0,0,1
03319466,44,3,41,0,1,1,0,1,1
03319702,8,3,5,0,1,1,0,0,1
03319706,31,3,28,0,1,1,0,1,1
03319777,10,3,7,0,1,1,0,0,1
03320006,28,5,23,0,1,1,0,1,1
03320011,64,8,56,0,0,0,0,0,1
03320018,6,1,5,0,1,1,0,0,1
03320173,83,11,72,0,0,0,0,0,1
03320296,28,13,15,0,0,0,0,0,0
03320404,58,12,46,0,0,0,0,0,1
03320471,6,0,6,0,0,0,0,0,1
03320538,56,9,47,0,0,0,0,0,1
03320548,6,1,5,0,1,1,0,0,0
03320790,24,5,19,0,1,1,0,0,1
03320907,23,0,23,0,0,0,0,0,1
03320915,22,3,19,0,1,1,0,1,1
03320972,44,7,37,0,0,0,0,0,1
03321191,4,2,2,0,2,2,0,0,1
03321271,30,1,29,0,1,1,0,0,1
03321416,14,5,9,0,2,0,2,0,0
03321425,6,3,3,0,3,3,0,0,1
03321428,39,0,39,0,0,0,0,0,1
03321736,16,4,12,0,1,1,0,1,1
03321745,34,3,31,0,2,2,0,2,1
03321897,10,2,8,0,2,1,1,1,0
03322042,12,4,8,0,3,3,0,1,1
03322100,12,3,9,0,0,0,0,0,1
03322151,65,4,61,0,1,1,0,1,1
03322421,41,0,41,0,0,0,0,0,1
03322615,18,0,18,0,0,0,0,0,1
03322742,17,6,11,0,0,0,0,0,0
03322866,56,5,51,0,1,1,0,1,1
03323040,52,9,43,0,14,8,6,0,1
03323049,33,0,33,0,0,0,0,0,1
03323061,39,6,33,0,1,1,0,1,1
03323105,14,3,11,0,0,0,0,0,1
03323121,25,4,21,0,3,3,0,0,1
03323436,38,6,32,0,1,1,0,1,1
03323464,28,0,28,0,0,0,0,0,1
03323710,67,5,62,0,1,1,0,1,1
03323715,30,3,27,0,1,1,0,1,1
03324071,6,0,6,0,0,0,0,0,1
03324145,228,14,214,0,0,0,0,0,0
03324200,4,2,2,0,1,1,0,1,0
03324411,16,2,14,0,1,1,0,1,1
03324462,11,0,11,0,0,0,0,0,1
03324492,13,0,13,0,0,0,0,0,1
03324500,42,12,30,0,1,1,0,1,1
03324967,35,2,33,0,1,1,0,1,1
03325051,18,5,13,0,0,0,0,0,0
03325064,27,0,27,0,0,0,0,0,1
03325083,21,0,21,0,1,1,0,1,1
03325184,21,5,16,0,0,0,0,0,1
03325213,4,2,2,0,1,1,0,0,0
03325268,11,6,5,0,3,3,0,1,0
03325275,19,0,19,0,0,0,0,0,1
03325377,20,5,15,0,0,0,0,0,1
03325746,19,0,19,0,0,0,0,0,1
03325776,15,6,9,0,0,0,0,0,0
03325876,31,3,28,0,1,1,0,1,1
03325877,22,4,18,0,1,1,0,1,1
03326158,29,4,25,0,1,1,0,0,1
03326334,17,0,17,0,0,0,0,0,1
03326579,10,2,8,0,2,1,1,1,0
03326746,13,6,7,0,2,2,0,0,0
03326984,13,0,13,0,1,1,0,1,1
03327068,20,7,13,0,0,0,0,0,1
03327174,13,3,10,0,0,0,0,0,1
03327291,15,4,11,0,1,1,0,1,1
03327294,17,5,12,0,1,1,0,1,1
03327360,46,6,40,0,1,1,0,1,1
03327636,13,4,9,0,1,1,0,1,1
03327887,9,3,6,0,0,0,0,0,1
03327931,18,2,16,0,2,1,1,2,1
03327943,12,6,6,0,1,1,0,0,1
03328219,75,16,59,0,0,0,0,0,1
03328436,83,17,66,0,0,0,0,0,1
03328459,47,10,37,0,0,0,0,0,1
03328699,35,2,33,0,1,1,0,1,1
03328703,5,3,2,0,2,2,0,0,1
03329002,20,2,18,0,0,0,0,0,1
03329617,6,3,3,0,2,2,0,0,0
03329755,7,4,3,0,1,1,0,0,1
03329785,4,1,3,0,2,2,0,0,1
03329814,4,0,4,0,0,0,0,0,1
03329834,70,2,68,0,0,0,0,0,0
03330129,17,1,16,0,1,1,0,1,1
03330142,25,1,24,0,1,1,0,0,1
03330303,36,5,31,0,0,0,0,0,1
03330842,5,3,2,0,2,2,0,0,1
03330923,22,4,18,0,1,0,1,1,1
03330970,13,3,10,0,1,1,0,1,1
03331091,37,4,33,0,0,0,0,0,1
03331184,23,0,23,0,0,0,0,0,1
03331429,10,3,7,0,1,1,0,0,0
03331471,49,9,40,0,10,5,5,0,1
03331553,14,0,14,0,0,0,0,0,1
03331632,27,3,24,0,3,2,1,0,1
03331901,35,10,25,0,1,1,0,0,1
03331984,7,2,5,0,0,0,0,0,1
03332258,24,5,19,0,1,1,0,1,1
03332633,23,4,19,0,0,0,0,0,1
03332684,6,3,3,0,2,1,1,0,0
03332723,13,7,6,0,1,1,0,1,1
03332828,10,1,9,0,0,0,0,0,1
03332831,19,4,15,0,2,2,0,0,1
03333193,47,8,39,0,6,1,5,0,1
03333274,16,4,12,0,0,0,0,0,1
03333312,13,4,9,0,1,1,0,1,1
03333368,26,6,20,0,1,1,0,1,1
03334117,39,12,27,0,0,0,0,0,1
03334141,20,4,16,0,1,1,0,0,1
03334448,33,4,29,0,1,1,0,1,1
03334524,23,5,18,0,0,0,0,0,1
03334562,9,1,8,0,2,1,1,1,1
03334601,10,4,6,0,2,2,0,0,1
03334713,17,0,17,0,2,1,1,2,1
03334745,6,1,5,0,1,1,0,0,1
03334863,15,0,15,0,1,1,0,1,1
03334872,81,14,67,0,0,0,0,0,1
03334946,15,4,11,0,0,0,0,0,1
03335284,22,3,19,0,1,1,0,1,1
03335371,6,3,3,0,1,1,0,0,0
03335428,18,3,15,0,1,1,0,0,1
03335560,38,4,34,1,1,1,0,1,1
03335562,11,4,7,0,1,1,0,1,1
03335606,11,3,8,0,1,1,0,1,1
03335610,34,1,33,0,0,0,0,0,1
03335686,34,8,26,0,0,0,0,0,1
03335712,7,0,7,0,0,0,0,0,1
03335776,30,7,23,0,1,1,0,1,1
03336101,90,13,77,0,0,0,0,0,1
03336233,11,0,11,0,0,0,0,0,1
03336234,31,4,27,0,0,0,0,0,1
03336386,14,3,11,0,1,1,0,1,1
03336407,18,0,18,0,1,1,0,1,1
03336712,5,3,2,0,2,2,0,0,1
03336782,5,2,3,0,1,1,0,1,1
03336790,53,8,45,0,1,1,0,1,1
03337532,7,2,5,0,2,2,0,0,0
03337599,10,0,10,0,0,0,0,0,1
03337700,18,2,16,0,1,1,0,1,1
03337712,61,0,61,0,0,0,0,0,1
03337831,39,3,36,0,1,1,0,1,1
03338152,9,5,4,0,1,1,0,1,1
03338991,32,0,32,0,0,0,0,0,1
03050177,18,3,15,0,0,0,0,0,1
03050326,12,6,6,0,3,1,2,1,0
03050331,11,5,6,0,3,1,2,1,0
03050388,21,4,17,0,1,1,0,1,1
03050396,18,5,13,0,0,0,0,0,1
03050523,6,1,5,0,1,1,0,0,0
03050609,12,4,8,0,1,1,0,1,1
03050638,26,1,25,0,1,1,0,0,1
03050645,55,6,49,0,0,0,0,0,1
03050664,45,3,42,0,2,1,1,2,1
03050677,49,4,45,0,1,1,0,1,1
03050679,19,3,16,0,2,2,0,0,1
03050683,16,5,11,0,1,1,0,1,1
03050947,6,1,5,0,0,0,0,0,1
03051278,27,0,27,0,1,1,0,1,1
03051442,31,0,31,0,0,0,0,0,1
03052023,29,9,20,0,4,3,1,0,1
03052331,35,0,35,0,1,1,0,1,1
03052439,18,6,12,0,2,2,0,2,1
03052498,4,0,4,0,0,0,0,0,1
03052894,27,8,19,0,1,1,0,1,0
03053136,12,3,9,0,0,0,0,0,0
03053142,23,4,19,0,2,1,1,1,1
03053219,15,0,15,0,0,0,0,0,1
03053333,23,0,23,0,0,0,0,0,0
03053431,6,5,1,0,2,2,0,0,1
03053438,15,3,12,0,1,1,0,1,1
03053538,14,2,12,0,0,0,0,0,1
03053666,5,3,2,0,1,1,0,0,1
03053806,22,12,10,0,1,1,0,1,1
03053963,10,3,7,0,3,1,2,1,0
03054073,5,3,2,0,2,2,0,0,0
03054214,7,3,4,0,1,1,0,1,1
03054273,37,9,28,0,0,0,0,0,1
03054573,5,3,2,0,2,2,0,0,0
03054609,81,12,69,0,0,0,0,0,0
03054967,32,7,25,0,1,1,0,1,0
03055163,8,3,5,0,1,1,0,1,1
03055242,15,4,11,0,1,1,0,1,1
03055248,8,3,5,0,1,1,0,0,1
03055282,28,0,28,0,0,0,0,0,1
03055583,41,0,41,0,0,0,0,0,0
03055834,24,4,20,0,1,1,0,1,1
03056377,21,9,12,0,1,1,0,1,0
03056542,14,2,12,0,1,1,0,1,1
03056567,13,5,8,0,0,0,0,0,1
03056944,17,1,16,0,1,1,0,1,1
03057094,29,4,25,0,0,0,0,0,1
03057124,10,3,7,0,1,1,0,0,1
03057516,23,6,17,0,0,0,0,0,0
03057570,24,0,24,0,0,0,0,0,1
03057821,7,0,7,0,0,0,0,0,1
03057876,9,1,8,0,2,1,1,1,1
03057922,15,0,15,0,0,0,0,0,1
03058194,26,2,24,0,1,1,0,1,1
03058600,3,0,3,0,0,0,0,0,1
03059065,24,0,24,0,0,0,0,0,1
03059237,44,4,40,0,1,1,0,0,1
03059256,5,3,2,0,1,1,0,0,0
03059289,6,5,1,0,1,1,0,0,1
03059306,5,0,5,0,2,2,0,0,1
03059307,12,4,8,0,1,1,0,0,1
03059425,50,15,35,0,10,10,0,0,1
03059500,26,5,21,0,1,1,0,1,1
03059787,28,2,26,0,1,1,0,1,1
03059791,25,5,20,0,1,1,0,0,1
03060458,19,5,14,0,1,1,0,1,1
03060487,25,0,25,0,0,0,0,0,1
03060702,33,4,29,0,1,1,0,1,1
03060803,16,6,10,1,2,2,0,1,1
03061136,16,3,13,0,1,1,0,1,1
03061186,10,2,8,0,1,1,0,1,1
03061216,24,0,24,0,0,0,0,0,1
03061241,11,3,8,0,1,1,0,0,0
03061249,27,2,25,0,1,1,0,0,1
03061336,15,0,15,0,0,0,0,0,1
03061637,24,3,21,0,2,2,0,2,1
03061992,39,0,39,0,0,0,0,0,1
03062222,55,0,55,0,0,0,0,0,1
03062312,8,3,5,0,2,2,0,0,0
03062375,20,5,15,0,3,2,1,3,1
03062553,9,4,5,0,2,2,0,0,1
03062567,70,15,55,0,0,0,0,0,1
03062651,13,4,9,0,3,3,0,0,1
03062708,37,4,33,0,1,1,0,0,1
03062760,37,2,35,0,1,1,0,1,1
03062868,4,2,2,0,1,1,0,0,0
03063054,23,2,21,0,2,1,1,2,1
03063212,15,0,15,0,0,0,0,0,1
03063532,35,0,35,0,1,1,0,1,1
03063659,19,1,18,0,1,1,0,1,1
03063721,42,10,32,0,0,0,0,0,1
03063820,15,7,8,0,1,1,0,1,0
03064075,10,3,7,0,1,1,0,1,1
03064392,28,4,24,0,1,1,0,1,1
03064811,11,4,7,0,1,1,0,0,1
03065012,48,10,38,0,0,0,0,0,1
03065216,45,3,42,0,1,1,0,1,1
03065315,12,4,8,0,3,3,0,0,1
03066153,4,2,2,0,1,1,0,0,0
03066512,25,4,21,0,1,1,0,1,1
03066530,0,0,0,0,0,0,0,0,1
03066672,5,3,2,0,1,1,0,0,1
03066953,19,0,19,0,0,0,0,0,1
03066963,43,8,35,0,0,0,0,0,1
03067144,28,6,22,0,2,1,1,0,0
03067282,23,3,20,0,2,1,1,2,1
03067468,26,9,17,0,0,0,0,0,1
03067616,114,14,100,0,1,1,0,1,1
03068111,21,6,15,0,0,0,0,0,1
03068125,38,6,32,0,0,0,0,0,1
03068263,60,0,60,0,0,0,0,0,1
03068678,39,0,39,0,0,0,0,0,1
03068784,16,4,12,0,1,1,0,1,1
03069020,20,5,15,0,1,1,0,1,1
03070008,13,5,8,0,2,2,0,0,1
03070049,69,13,56,0,2,1,1,0,1
03070198,16,3,13,0,0,0,0,0,1
03070256,5,2,3,0,1,1,0,0,1
03070344,6,3,3,0,2,2,0,0,0
03070482,18,5,13,0,1,1,0,1,1
03070566,69,8,61,0,1,1,0,0,1
03070670,54,13,41,0,0,0,0,0,1
03070821,24,3,21,1,1,1,0,0,1
03070909,26,4,22,0,1,1,0,1,1
03070915,19,0,19,0,1,1,0,1,1
03071064,46,4,42,0,2,1,1,2,1
03071066,33,0,33,0,0,0,0,0,1
03071174,35,9,26,0,0,0,0,0,1
03071231,28,7,21,0,1,1,0,0,1
03071324,32,5,27,0,0,0,0,0,1
03071407,24,3,21,0,1,1,0,1,1
03071494,31,4,27,0,1,1,0,1,1
03071624,4,0,4,0,0,0,0,0,1
03071751,29,4,25,0,1,1,0,1,1
03071936,7,3,4,0,2,2,0,0,0
03072230,19,4,15,0,4,3,1,0,1
03072252,14,0,14,0,0,0,0,0,1
03072278,15,0,15,0,0,0,0,0,1
03072287,22,3,19,0,1,1,0,1,1
03072468,7,0,7,0,0,0,0,0,0
03072541,57,5,52,0,1,1,0,1,1
03072597,31,5,26,0,1,1,0,1,1
03072695,11,2,9,0,0,0,0,0,1
03072719,39,11,28,0,0,0,0,0,1
03072794,7,3,4,0,1,1,0,0,1
03073089,38,13,25,0,0,0,0,0,1
03073426,32,7,25,0,1,1,0,0,1
03073634,13,2,11,0,1,1,0,1,1
03073709,34,3,31,0,2,2,0,2,1
03073845,34,7,27,0,2,1,1,2,1
03074268,5,3,2,0,1,1,0,0,0
03074320,22,4,18,1,1,1,0,0,1
03074698,38,2,36,0,1,1,0,1,1
03074835,7,4,3,0,1,1,0,1,0
03075159,12,6,6,0,1,1,0,1,1
03075175,8,0,8,0,0,0,0,0,0
03075197,15,0,15,0,0,0,0,0,1
03075297,6,2,4,0,1,1,0,0,1
03075475,58,0,58,0,1,1,0,1,1
03075476,27,0,27,0,1,1,0,1,1
03075500,23,0,23,0,0,0,0,0,1
03075501,22,2,20,0,1,1,0,1,1
03075676,20,0,20,0,0,0,0,0,1
03075689,7,5,2,0,0,0,0,0,1
03075807,52,7,45,0,1,1,0,1,1
03075826,52,17,35,0,2,1,1,0,1
03076063,43,4,39,0,1,1,0,1,1
03076115,5,3,2,0,2,2,0,0,1
03076173,31,5,26,0,0,0,0,0,1
03076445,63,9,54,0,1,1,0,1,1
03076453,13,4,9,0,0,0,0,0,1
03076492,35,3,32,0,0,0,0,0,1
03077135,8,0,8,0,0,0,0,0,0
03077142,24,3,21,0,1,1,0,1,1
03077146,15,5,10,0,1,1,0,1,0
03077147,5,3,2,0,2,2,0,0,0
03077191,7,4,3,0,1,1,0,1,0
03077207,7,4,3,0,1,1,0,1,0
03077448,8,2,6,0,2,2,0,0,1
03077629,0,0,0,0,0,0,0,0,1
03077822,7,0,7,0,1,1,0,0,1
03077894,50,9,41,0,0,0,0,0,1
03078354,18,0,18,0,0,0,0,0,1
03078430,21,0,21,0,0,0,0,0,1
03078447,29,1,28,0,1,1,0,1,1
03078463,22,5,17,0,0,0,0,0,1
03078635,17,3,14,0,1,1,0,1,1
03078729,11,2,9,0,1,1,0,0,1
03078888,9,1,8,0,1,1,0,1,1
03079030,12,6,6,0,1,1,0,0,1
03079252,10,1,9,0,1,1,0,0,0
03079282,134,23,111,0,0,0,0,0,1
03079336,10,3,7,0,1,1,0,0,1
03079609,26,4,22,0,1,1,0,1,1
03079818,36,9,27,0,0,0,0,0,1
03080143,6,2,4,0,1,1,0,0,0
03080316,11,0,11,0,0,0,0,0,1
03080506,32,7,25,0,1,1,0,1,1
03080847,28,7,21,0,0,0,0,0,1
03080885,20,0,20,0,0,0,0,0,1
03081256,21,2,19,0,0,0,0,0,0
03081303,38,4,34,0,0,0,0,0,1
03081314,9,2,7,0,1,1,0,0,1
03081440,17,4,13,0,1,1,0,1,1
03081550,6,3,3,0,3,1,2,1,1
03082031,69,9,60,0,0,0,0,0,1
03082616,27,4,23,0,1,1,0,1,1
03082707,40,4,36,0,1,1,0,1,1
03082773,22,4,18,0,1,1,0,1,1
03082908,15,2,13,0,1,1,0,1,1
03082916,22,4,18,0,1,1,0,1,1
03083083,4,2,2,0,1,1,0,0,0
03083099,7,4,3,0,1,1,0,0,1
03083164,9,3,6,0,1,1,0,0,1
03083661,38,2,36,0,1,1,0,1,1
03084063,6,3,3,0,1,1,0,0,1
03084140,40,0,40,0,1,1,0,1,1
03084447,33,3,30,0,1,1,0,1,1
03084555,5,2,3,0,2,2,0,0,0
03084677,45,7,38,0,0,0,0,0,1
03084689,4,3,1,0,2,2,0,0,1
03084798,16,5,11,0,0,0,0,0,0
03084888,7,0,7,0,0,0,0,0,1
03084992,18,6,12,0,2,2,0,2,1
00190141,51,3,48,0,1,1,0,1,1
00190229,15,0,15,0,0,0,0,0,1
00190385,17,2,15,0,2,2,0,0,1
00190460,9,3,6,0,1,1,0,1,0
00190485,31,8,23,0,1,1,0,0,0
00190626,13,6,7,0,0,0,0,0,0
00190717,28,3,25,0,1,1,0,1,1
00190736,123,10,113,0,1,1,0,0,1
00190761,12,6,6,0,3,2,1,0,1
00191037,96,28,68,0,0,0,0,0,1
00191050,39,2,37,0,1,1,0,1,1
00191201,16,3,13,0,0,0,0,0,0
00191285,48,4,44,0,1,1,0,1,1
00191668,32,13,19,0,0,0,0,0,1
00191878,12,4,8,0,1,1,0,0,0
00192026,26,2,24,0,5,3,2,0,0
00192121,28,4,24,0,1,1,0,1,1
00192243,32,2,30,0,4,2,2,1,1
00192284,11,4,7,0,0,0,0,0,1
00192460,55,4,51,0,1,1,0,1,1
00192571,48,2,46,0,2,2,0,0,1
00192753,20,2,18,0,1,1,0,1,1
00192795,33,4,29,0,1,1,0,1,1
00193800,38,9,29,0,1,1,0,1,1
00194139,19,0,19,0,0,0,0,0,1
00194336,17,4,13,0,1,1,0,1,1
00194502,32,2,30,0,0,0,0,0,1
00194522,27,3,24,0,1,1,0,1,1
00194814,31,4,27,0,1,1,0,1,1
00194856,12,2,10,0,1,1,0,1,0
00194871,24,9,15,0,1,1,0,1,1
00194944,21,4,17,0,1,1,0,0,1
00195581,20,3,17,0,1,1,0,1,1
00195626,55,11,44,0,1,1,0,1,1
00195732,24,5,19,0,5,2,3,0,1
00196087,70,16,54,0,2,1,1,0,1
00196206,33,5,28,0,1,1,0,1,1
00196353,78,16,62,0,0,0,0,0,1
00197026,8,4,4,0,1,1,0,1,1
00197307,36,11,25,0,0,0,0,0,1
00197499,19,0,19,0,0,0,0,0,1
00197557,26,0,26,0,0,0,0,0,1
00197807,48,4,44,0,1,1,0,1,1
00198002,45,2,43,0,0,0,0,0,1
00198237,20,4,16,0,1,1,0,1,0
00198344,202,13,189,0,0,0,0,0,1
00198474,37,3,34,0,1,1,0,1,1
00198600,51,4,47,0,2,1,1,1,1
00198889,12,8,4,0,5,1,4,0,1
00198914,18,7,11,0,0,0,0,0,0
00199039,35,3,32,0,0,0,0,0,1
00199120,67,9,58,0,1,1,0,1,1
00199193,35,4,31,0,2,2,0,2,1
00200093,46,2,44,0,1,1,0,1,1
00200130,26,4,22,0,1,1,0,1,1
00200234,6,3,3,0,1,1,0,0,1
00200575,43,0,43,0,0,0,0,0,1
00200709,32,6,26,0,1,1,0,0,0
00200794,33,5,28,0,2,2,0,2,1
00201074,15,2,13,0,0,0,0,0,1
00201357,27,5,22,0,1,1,0,1,1
00201528,131,13,118,0,0,0,0,0,1
00202231,35,3,32,2,1,1,0,1,1
00202342,45,8,37,0,1,1,0,1,1
00202349,44,11,33,0,0,0,0,0,1
00202712,39,8,31,0,2,2,0,2,1
00202795,94,14,80,0,0,0,0,0,1
00202872,3,2,1,0,1,1,0,0,0
00203489,7,2,5,0,1,1,0,0,0
00203597,94,3,91,0,1,1,0,1,1
00203645,117,18,99,0,0,0,0,0,1
00203742,40,5,35,0,1,1,0,1,1
00203774,30,1,29,0,0,0,0,0,1
00203848,12,5,7,0,0,0,0,0,1
00203865,77,10,67,0,2,1,1,0,0
00204300,30,15,15,0,2,2,0,0,1
00204368,31,8,23,0,0,0,0,0,1
00204472,67,0,67,0,0,0,0,0,1
00204800,12,4,8,0,1,1,0,0,1
00205219,23,5,18,0,2,2,0,0,1
00205359,45,0,45,0,0,0,0,0,0
00205416,40,4,36,0,0,0,0,0,1
00205468,78,6,72,0,1,1,0,1,1
00206132,38,9,29,0,0,0,0,0,1
00206678,20,3,17,0,0,0,0,0,1
00206971,40,3,37,0,1,1,0,1,1
00207173,65,11,54,0,0,0,0,0,1
00207449,13,0,13,0,0,0,0,0,1
00207662,8,5,3,0,1,1,0,0,1
00207867,28,3,25,0,1,1,0,1,1
00208371,16,0,16,0,0,0,0,0,1
00208578,44,9,35,0,0,0,0,0,1
00208991,109,13,96,0,0,0,0,0,0
00209091,41,3,38,0,2,2,0,2,1
00209328,20,5,15,0,1,1,0,1,1
00209335,23,5,18,0,0,0,0,0,1
00209470,20,3,17,0,1,1,0,1,1
00209494,54,7,47,0,0,0,0,0,1
00209497,22,0,22,0,0,0,0,0,1
00209570,22,0,22,0,0,0,0,0,1
00209797,39,5,34,0,2,1,1,2,1
00209905,60,6,54,0,1,1,0,1,1
00209983,16,1,15,0,1,1,0,1,1
00210012,83,13,70,0,0,0,0,0,1
00210144,9,5,4,0,0,0,0,0,0
00210505,31,3,28,0,1,1,0,1,1
00210567,38,8,30,0,0,0,0,0,1
00210572,216,9,207,0,1,1,0,0,1
00210794,18,7,11,0,2,1,1,1,1
00210798,26,3,23,0,1,0,1,1,1
00210859,35,4,31,0,1,1,0,1,1
00211214,36,12,24,0,0,0,0,0,0
00211249,36,2,34,0,1,1,0,1,1
00211475,39,9,30,0,0,0,0,0,1
00211513,33,0,33,0,0,0,0,0,1
00211776,123,15,108,0,1,1,0,1,1
00212153,14,0,14,0,0,0,0,0,1
00212618,32,3,29,0,1,1,0,1,1
00212851,52,9,43,0,0,0,0,0,1
00212945,35,4,31,0,1,1,0,1,1
00212951,23,5,18,0,0,0,0,0,0
00213026,30,5,25,0,1,1,0,1,1
00213235,70,7,63,0,0,0,0,0,1
00213393,75,6,69,0,1,1,0,1,1
00213608,34,3,31,0,1,1,0,1,1
00213651,23,4,19,0,1,1,0,1,0
00213686,24,5,19,0,1,1,0,1,1
00213816,65,8,57,0,0,0,0,0,0
00214034,67,8,59,0,7,7,0,0,1
00214367,6,5,1,0,2,2,0,1,0
00214545,43,20,23,0,0,0,0,0,1
00214786,94,4,90,0,0,0,0,0,0
00215285,15,3,12,0,1,1,0,1,1
00215695,112,16,96,0,0,0,0,0,1
00215991,25,8,17,0,0,0,0,0,0
00216055,14,6,8,0,0,0,0,0,1
00216127,17,0,17,0,0,0,0,0,1
00216679,32,3,29,0,1,1,0,1,1
00216719,70,4,66,0,2,1,1,0,1
00217053,78,2,76,0,2,1,1,0,1
00217284,49,12,37,0,0,0,0,0,0
00217338,75,12,63,0,0,0,0,0,1
00217506,69,8,61,0,2,2,0,0,0
00217768,30,2,28,0,0,0,0,0,1
00218019,70,5,65,0,1,1,0,1,1
00218277,18,6,12,0,1,1,0,0,0
00218497,38,0,38,0,2,2,0,1,1
00218550,27,4,23,0,1,1,0,1,1
00218826,50,5,45,0,2,2,0,2,1
00219173,5,0,5,0,0,0,0,0,1
00219528,23,5,18,0,0,0,0,0,1
00219716,7,4,3,0,3,3,0,0,0
00219735,14,0,14,0,0,0,0,0,1
00219848,137,15,122,0,0,0,0,0,1
00220044,80,10,70,0,0,0,0,0,1
00220221,26,4,22,0,1,1,0,1,1
00220227,25,0,25,0,1,1,0,1,1
00220596,6,3,3,0,0,0,0,0,0
00221066,28,3,25,0,0,0,0,0,1
00221167,274,0,274,0,0,0,0,0,1
00221321,29,7,22,0,1,1,0,0,0
00221623,31,3,28,0,1,1,0,1,0
00221722,42,3,39,0,1,1,0,1,1
00222066,76,14,62,0,1,0,1,0,1
00222141,34,0,34,0,0,0,0,0,1
00223127,42,3,39,0,1,1,0,1,1
00223129,28,3,25,0,1,1,0,1,1
00223156,7,2,5,0,1,1,0,0,1
00223173,7,4,3,0,1,1,0,0,0
00223374,73,27,46,0,0,0,0,0,1
00223529,120,28,92,0,0,0,0,0,1
00223583,19,6,13,0,0,0,0,0,1
00223649,17,5,12,0,0,0,0,0,0
00223778,108,8,100,0,10,1,9,0,0
00223852,18,6,12,0,0,0,0,0,0
00224271,25,6,19,0,0,0,0,0,1
00224411,33,10,23,0,1,1,0,0,1
00224415,7,3,4,0,2,2,0,0,1
00224422,43,0,43,0,0,0,0,0,1
00224449,5,2,3,0,1,1,0,0,0
00224461,7,1,6,0,1,1,0,0,0
00224705,21,8,13,0,0,0,0,0,0
00224714,70,5,65,0,1,0,1,1,1
00224778,42,3,39,0,2,1,1,2,1
00224823,17,4,13,0,8,2,6,2,1
00225149,24,3,21,0,1,1,0,1,1
00225839,91,17,74,0,0,0,0,0,1
00225982,17,0,17,0,0,0,0,0,1
00226143,62,16,46,0,0,0,0,0,1
00226323,27,7,20,0,0,0,0,0,1
00226336,100,0,100,0,0,0,0,0,1
00226969,29,4,25,0,1,1,0,1,1
00227013,29,2,27,0,1,1,0,1,1
00227550,16,0,16,0,0,0,0,0,1
00227590,43,6,37,0,1,1,0,1,1
00227669,38,3,35,0,1,1,0,1,1
00227691,38,9,29,0,0,0,0,0,1
00228045,35,5,30,0,0,0,0,0,1
00228148,100,10,90,0,1,1,0,1,1
00228258,35,3,32,0,1,1,0,1,1
00228497,12,5,7,0,0,0,0,0,1
00228640,6,3,3,0,1,1,0,0,0
00228812,5,4,1,0,2,2,0,0,0
00228931,51,5,46,0,1,1,0,1,1
00228983,43,4,39,0,1,1,0,1,1
00229121,59,5,54,0,1,1,0,1,1
00229231,50,4,46,0,1,1,0,1,1
00229341,55,6,49,0,2,1,1,2,1
00229724,94,2,92,0,0,0,0,0,1
00229741,47,0,47,0,0,0,0,0,1
00229850,14,4,10,0,1,1,0,1,1
00230029,17,4,13,0,1,1,0,1,0
00230109,11,0,11,0,0,0,0,0,1
00230224,68,8,60,0,0,0,0,0,1
00230433,123,10,113,0,0,0,0,0,1
00230553,31,3,28,0,1,1,0,1,0
00230737,31,3,28,0,1,1,0,1,1
00230773,34,7,27,0,1,1,0,0,0
00231473,12,2,10,0,0,0,0,0,1
00231714,5,3,2,0,1,1,0,1,0
00231961,20,5,15,0,1,1,0,1,1
00232010,50,7,43,0,0,0,0,0,1
00232508,40,0,40,0,0,0,0,0,1
00232646,13,3,10,0,0,0,0,0,1
07340137,1,1,0,0,1,1,0,0,0
07340188,28,16,12,0,0,0,0,0,0
07340518,19,12,7,0,0,0,0,0,1
07340750,2,2,0,0,2,2,0,0,0
07340972,7,3,4,0,1,1,0,1,1
07341063,1,1,0,0,1,1,0,0,0
07341131,11,5,6,0,0,0,0,0,1
07341209,5,2,3,0,1,1,0,0,0
07341257,5,2,3,0,1,1,0,0,0
07341267,2,1,1,0,1,1,0,0,1
07341303,3,2,1,0,1,1,0,0,0
07341309,2,1,1,0,2,2,0,0,0
07341485,2,2,0,0,1,1,0,0,0
07341552,1,1,0,0,1,1,0,0,0
07341939,10,6,4,0,3,3,0,1,1
07342023,1,1,0,0,1,1,0,0,0
07342682,1,0,1,0,1,1,0,0,0
07342849,9,5,4,0,1,1,0,1,1
07343036,17,4,13,0,1,1,0,1,1
07343051,16,3,13,0,0,0,0,0,0
07343075,43,0,43,0,0,0,0,0,1
07343156,10,3,7,0,1,1,0,0,0
07343306,7,4,3,0,1,1,0,1,1
07343640,21,5,16,0,0,0,0,0,1
07344467,18,4,14,0,2,1,1,1,1
07344699,23,19,4,0,1,1,0,0,0
07344701,1,1,0,0,1,1,0,0,0
07344747,27,6,21,0,3,2,1,0,1
07344954,8,2,6,0,7,1,6,3,1
07345032,5,4,1,0,3,3,0,1,1
07345112,6,5,1,0,3,3,0,1,1
07345188,1,1,0,0,2,2,0,0,1
07345214,3,3,0,0,1,1,0,0,0
07345280,8,0,8,0,0,0,0,0,1
07345546,2,1,1,0,2,2,0,0,0
07345580,1,1,0,0,2,2,0,0,0
07346136,3,1,2,0,1,1,0,0,0
07346144,31,10,21,0,5,4,1,0,1
07346155,7,6,1,0,1,1,0,1,1
07346897,11,5,6,0,0,0,0,0,1
07346900,3,1,2,0,0,0,0,0,1
07347331,2,2,0,0,1,1,0,0,0
07347697,1,1,0,0,1,1,0,0,0
07347890,2,2,0,0,1,1,0,0,0
07347905,5,3,2,0,3,3,0,0,1
07348220,2,2,0,0,1,1,0,0,0
07348311,1,0,1,0,1,1,0,0,0
07348329,46,14,32,0,0,0,0,0,0
07348379,4,2,2,0,1,1,0,0,0
07348389,4,2,2,0,1,1,0,0,0
07348659,1,1,0,0,1,1,0,0,0
07349866,7,0,7,0,0,0,0,0,1
07350036,2,2,0,0,2,2,0,0,0
07350037,3,1,2,0,1,1,0,0,0
07350078,13,9,4,0,1,1,0,0,1
07350337,1,1,0,0,0,0,0,0,0
07350514,1,0,1,0,0,0,0,0,0
07350960,6,0,6,0,0,0,0,0,1
07351140,1,0,1,0,0,0,0,0,1
07351145,13,7,6,0,2,1,1,0,0
07351253,28,21,7,0,3,3,0,0,1
07351263,11,0,11,0,1,1,0,0,1
07351478,2,2,0,0,1,1,0,0,1
07351739,1,0,1,0,0,0,0,0,0
07351818,3,0,3,0,0,0,0,0,1
07352176,1,0,1,0,0,0,0,0,0
07352226,4,2,2,0,1,1,0,0,1
07353075,5,3,2,0,1,1,0,0,1
07353728,6,0,6,0,0,0,0,0,1
07353934,7,2,5,0,3,1,2,1,0
07354685,4,3,1,0,1,1,0,0,0
07354765,1,1,0,0,1,1,0,0,0
07354776,3,1,2,0,1,1,0,0,0
07354910,14,3,11,0,0,0,0,0,1
07354935,2,2,0,0,2,2,0,0,0
07355079,3,0,3,0,0,0,0,0,1
07355118,5,1,4,0,2,1,1,1,1
07355300,38,1,37,0,0,0,0,0,1
07355492,3,1,2,0,1,1,0,0,0
07355778,12,4,8,0,2,2,0,2,1
07356292,1,1,0,0,1,1,0,0,0
07356334,5,1,4,0,1,1,0,0,0
07356488,1,0,1,0,0,0,0,0,1
07356573,2,2,0,0,4,4,0,0,0
07356647,3,2,1,0,3,3,0,0,1
07356881,2,1,1,0,1,1,0,0,1
07357127,2,2,0,0,1,1,0,0,0
07357147,1,1,0,0,2,2,0,0,0
07357953,8,3,5,0,1,1,0,1,1
07358038,11,6,5,0,0,0,0,0,1
07358078,3,0,3,0,0,0,0,0,0
07358121,3,2,1,0,1,1,0,0,0
07358403,7,2,5,0,1,1,0,1,1
07358688,2,2,0,0,1,1,0,0,0
07359117,28,0,28,0,0,0,0,0,1
07359431,3,3,0,0,2,2,0,0,0
07359592,4,2,2,0,2,2,0,0,0
07359802,4,0,4,0,0,0,0,0,1
07359945,25,7,18,0,1,1,0,1,0
07360224,4,3,1,0,1,1,0,0,0
07360530,4,4,0,0,2,2,0,0,0
07360723,2,0,2,0,2,2,0,0,0
07360913,9,3,6,0,2,2,0,0,1
07361059,3,2,1,0,2,2,0,0,1
07361592,2,2,0,0,1,1,0,0,1
07362001,11,5,6,0,4,4,0,0,0
07362146,3,2,1,0,1,1,0,0,0
07362147,5,1,4,0,0,0,0,0,0
07362689,7,1,6,0,3,3,0,0,1
07362891,1,1,0,0,1,1,0,0,0
07363120,6,0,6,0,2,2,0,2,1
07363895,4,0,4,1,0,0,0,0,0
07363941,3,0,3,1,0,0,0,0,0
07363945,3,0,3,0,0,0,0,0,0
07363954,4,0,4,1,0,0,0,0,0
07364166,12,6,6,0,0,0,0,0,1
07364604,2,2,0,0,1,1,0,0,0
07364672,2,0,2,0,0,0,0,0,0
07364784,2,0,2,0,0,0,0,0,0
07365533,1,1,0,0,1,1,0,0,0
07365733,2,1,1,0,1,1,0,0,0
07365736,5,2,3,0,2,1,1,1,1
07365778,54,12,42,0,5,4,1,0,0
07366143,1,1,0,0,1,1,0,0,0
07366674,5,4,1,0,0,0,0,0,0
07366764,13,7,6,0,0,0,0,0,0
07366816,19,8,11,0,0,0,0,0,1
07366844,11,7,4,0,0,0,0,0,1
07366848,5,2,3,0,2,2,0,0,1
07367066,4,4,0,0,2,2,0,0,0
07367101,6,3,3,0,3,2,1,0,0
07367284,4,1,3,0,1,1,0,0,0
07367335,5,2,3,0,0,0,0,0,0
07367569,4,2,2,0,2,2,0,0,1
07367966,2,2,0,0,2,2,0,0,1
07368089,19,6,13,0,0,0,0,0,1
07368169,16,5,11,0,1,1,0,0,0
07368760,2,2,0,0,0,0,0,0,0
07368888,7,2,5,0,1,1,0,1,1
07368894,3,3,0,0,1,1,0,0,1
07369177,1,0,1,0,1,1,0,0,1
07369869,10,2,8,0,0,0,0,0,0
07369873,9,3,6,0,2,2,0,1,1
07369885,7,0,7,0,1,1,0,1,1
07369991,3,3,0,0,3,3,0,0,1
07369993,33,16,17,0,0,0,0,0,1
07370163,3,3,0,0,3,3,0,0,0
07370673,4,1,3,0,1,1,0,0,1
07370784,2,1,1,0,2,1,1,0,1
07370877,2,0,2,0,0,0,0,0,1
07371122,4,4,0,0,4,2,2,0,0
07371295,5,3,2,0,2,2,0,0,1
07371390,5,2,3,0,2,2,0,0,1
07371434,3,1,2,0,1,1,0,0,0
07371449,2,0,2,0,0,0,0,0,0
07371746,13,6,7,0,2,0,2,0,0
07371756,3,3,0,0,3,3,0,0,0
07371856,2,0,2,0,1,1,0,0,0
07372080,18,5,13,0,0,0,0,0,0
07372607,2,0,2,0,0,0,0,0,0
07372675,15,5,10,0,1,1,0,1,1
07372682,15,5,10,0,2,1,1,2,1
07372690,15,5,10,0,1,1,0,1,1
07372697,15,5,10,0,1,1,0,1,1
07372704,15,5,10,0,2,1,1,2,1
07372714,15,5,10,0,1,1,0,1,1
07372831,2,0,2,0,0,0,0,0,1
07372832,9,7,2,0,3,1,2,1,1
07372896,2,2,0,0,1,1,0,0,0
07372956,18,13,5,0,0,0,0,0,1
07373113,10,7,3,0,1,1,0,0,1
07373988,3,2,1,0,2,2,0,0,0
07374195,2,0,2,0,2,2,0,0,0
07374707,3,2,1,0,1,1,0,0,0
07374824,4,3,1,0,2,2,0,0,1
07374830,13,3,10,0,1,1,0,1,1
07375354,2,2,0,0,1,1,0,1,1
07375374,2,2,0,0,1,1,0,0,1
07375388,8,4,4,0,1,1,0,0,1
07375556,8,3,5,0,1,1,0,1,1
07375627,33,9,24,0,0,0,0,0,1
07376180,5,3,2,0,1,1,0,0,0
07376729,18,6,12,0,0,0,0,0,1
07377103,1,1,0,0,1,1,0,0,0
07377674,1,1,0,0,1,1,0,0,1
07377813,5,0,5,0,1,1,0,0,1
07377842,11,4,7,0,1,1,0,1,1
07377975,7,3,4,0,2,1,1,1,1
07377976,7,3,4,0,2,1,1,1,1
07377979,7,3,4,0,2,1,1,1,1
07377987,7,3,4,0,2,1,1,1,1
07378001,7,3,4,0,2,1,1,1,1
07378002,7,3,4,0,2,1,1,1,1
07378200,3,3,0,0,2,2,0,0,0
07378379,12,4,8,0,0,0,0,0,1
07378522,29,11,18,0,2,2,0,0,1
07378551,6,4,2,0,1,1,0,1,1
07378628,7,2,5,1,0,0,0,0,1
07378658,7,2,5,1,0,0,0,0,1
07378758,14,7,7,0,0,0,0,0,0
07379120,1,1,0,0,1,1,0,0,0
07379131,19,3,16,0,1,1,0,1,1
07379274,4,0,4,0,0,0,0,0,1
07379330,4,0,4,0,0,0,0,0,1
07379608,12,0,12,0,0,0,0,0,1
07379747,9,7,2,0,3,2,1,0,1
07379774,6,4,2,0,1,1,0,0,0
07379801,1,1,0,0,2,2,0,0,0
07379931,4,3,1,0,2,2,0,0,1
07380179,3,2,1,0,1,1,0,0,1
07380344,3,2,1,0,0,0,0,0,0
07380399,5,0,5,0,0,0,0,0,0
07380427,2,2,0,0,2,2,0,0,0
07380595,6,3,3,0,1,1,0,1,1
07380605,3,0,3,0,2,2,0,1,0
07380745,1,1,0,0,1,1,0,0,0
07380757,6,3,3,0,1,1,0,1,1
07380770,1,1,0,0,1,1,0,0,0
07381190,2,2,0,0,2,2,0,0,0
07381420,25,6,19,0,2,1,1,2,1
07381574,1,0,1,0,0,0,0,0,0
07381882,4,0,4,0,0,0,0,0,1
07381946,3,1,2,0,1,1,0,0,0
07382137,8,3,5,0,1,1,0,0,0
07382345,4,3,1,0,2,2,0,0,0
07382469,3,0,3,0,0,0,0,0,1
07382637,11,4,7,0,1,1,0,1,1
07382952,2,2,0,0,0,0,0,0,0
07383001,1,1,0,0,2,2,0,0,0
07383721,2,0,2,0,0,0,0,0,1
07383769,21,9,12,0,8,8,0,0,0
07383898,4,3,1,0,1,1,0,1,0
07384229,5,4,1,4,2,2,0,2,0
07384251,1,1,0,0,1,1,0,1,0
07384299,4,3,1,0,0,0,0,0,1
07384335,3,2,1,0,1,1,0,0,0
07384365,6,1,5,0,1,1,0,0,0
07384561,2,2,0,0,2,2,0,0,0
07384812,2,2,0,0,2,2,0,0,0
07385350,2,1,1,0,1,1,0,0,0
07385795,3,0,3,0,1,0,1,0,1
07386086,21,7,14,0,0,0,0,0,1
07386089,3,1,2,0,2,1,1,2,1
07386228,29,13,16,0,6,3,3,0,1
07386296,3,0,3,0,0,0,0,0,1
07386350,16,3,13,0,1,1,0,1,1
07386373,8,6,2,0,3,3,0,0,1
07386378,8,6,2,0,3,3,0,0,1
07386720,1,1,0,0,2,2,0,0,0
07386914,7,3,4,0,1,1,0,1,1
07387135,3,2,1,0,2,2,0,0,0
07387810,1,1,0,0,1,1,0,0,0
07387899,1,0,1,0,0,0,0,0,0
07387959,1,1,0,0,1,1,0,0,0
07388645,7,3,4,0,1,1,0,1,1
07388923,2,0,2,0,0,0,0,0,1
07388944,1,1,0,0,1,1,0,0,1
07388967,1,1,0,0,1,1,0,0,0
07389455,4,0,4,0,0,0,0,0,0
07389492,2,2,0,0,2,2,0,0,0
07389668,2,1,1,0,2,2,0,0,0
07389974,3,1,2,0,1,1,0,0,1
07390138,17,5,12,0,0,0,0,0,1
07390411,3,2,1,0,1,1,0,0,1
07390967,4,0,4,0,0,0,0,0,1
07391203,6,3,3,0,3,3,0,1,0
07391285,12,7,5,0,0,0,0,0,1
07391839,6,1,5,0,3,1,2,1,0
07391842,4,0,4,0,0,0,0,0,1
07391909,15,7,8,0,1,1,0,0,1
07391924,9,0,9,0,0,0,0,0,0
07392164,1,1,0,0,2,2,0,0,0
07392284,2,2,0,0,1,1,0,0,0
07393345,28,17,11,0,0,0,0,0,1
07393998,2,0,2,0,0,0,0,0,1
07394654,1,1,0,0,1,1,0,0,0
07394671,12,8,4,0,0,0,0,0,0
07394698,2,0,2,0,0,0,0,0,0
07394830,2,0,2,0,0,0,0,0,0
07395071,2,1,1,0,1,1,0,0,0
07395117,2,0,2,0,1,1,0,0,1
07395130,5,0,5,0,0,0,0,0,0
07395278,2,0,2,0,1,1,0,0,0
07395782,2,1,1,0,1,1,0,0,0
07396186,1,0,1,0,0,0,0,0,1
07396196,5,4,1,0,3,3,0,0,1
07396237,3,0,3,0,1,1,0,0,0
07396364,3,1,2,0,3,1,2,2,0
07396567,3,3,0,0,2,2,0,0,0
07397803,4,1,3,0,3,1,2,0,0
07397850,4,0,4,0,0,0,0,0,1
07397858,16,4,12,0,1,1,0,1,1
07397859,9,3,6,0,1,1,0,1,1
07397948,2,1,1,0,1,1,0,0,0
07398010,14,4,10,0,1,1,0,1,0
07398114,2,2,0,0,2,2,0,0,0
07398119,9,4,5,0,0,0,0,0,0
07398579,3,3,0,0,1,1,0,0,0
07398657,2,2,0,0,2,2,0,0,1
07398809,8,5,3,0,1,1,0,1,1
07398828,4,2,2,0,1,1,0,0,1
07398870,7,4,3,0,0,0,0,0,1
07398873,1,1,0,0,1,1,0,0,0
07399160,3,3,0,0,2,2,0,0,0
07399213,3,3,0,0,0,0,0,0,0
07399382,3,2,1,0,1,1,0,0,0
07399610,4,2,2,0,0,0,0,0,1
07399629,10,3,7,0,2,1,1,1,1
07399650,2,0,2,0,0,0,0,0,1
07399695,10,6,4,0,1,1,0,1,1
07400134,2,1,1,0,1,1,0,0,0
07400199,3,2,1,0,1,1,0,0,1
07400418,2,2,0,0,1,1,0,0,0
07400488,2,2,0,0,2,2,0,0,0
07400503,2,2,0,0,2,2,0,0,0
07400511,2,2,0,0,1,1,0,0,0
07400953,3,2,1,0,1,1,0,0,0
07400993,3,0,3,0,0,0,0,0,1
07401113,3,3,0,0,1,1,0,1,0
07401156,10,3,7,0,4,1,3,1,1
07401375,3,3,0,0,2,2,0,0,0
07401410,2,0,2,0,0,0,0,0,1
07401490,13,4,9,0,2,2,0,2,1
07401505,1,1,0,0,1,1,0,0,0
07401655,2,0,2,0,2,2,0,0,1
07402297,20,3,17,0,3,2,1,3,0
07403073,9,3,6,0,5,2,3,0,1
07403098,5,2,3,0,5,1,4,3,1
07403164,2,2,0,0,1,1,0,0,0
07403648,2,1,1,0,1,1,0,0,1
07403661,7,3,4,0,3,1,2,2,1
07403830,3,0,3,0,2,2,0,0,1
07404696,21,8,13,0,0,0,0,0,1
07404747,40,16,24,0,0,0,0,0,1
07404981,18,8,10,0,0,0,0,0,1
07405029,2,1,1,0,0,0,0,0,0
07405078,2,1,1,0,1,1,0,0,0
07405181,2,2,0,0,1,1,0,0,0
07405219,3,1,2,0,2,1,1,2,1
07405229,15,4,11,0,1,1,0,1,1
07405240,1,0,1,0,0,0,0,0,0
07405245,8,2,6,0,1,0,1,1,0
07405761,9,4,5,0,1,1,0,1,1
07405944,14,4,10,0,0,0,0,0,1
07405980,14,8,6,0,1,1,0,0,1
07406032,12,5,7,0,1,1,0,1,1
07406122,28,17,11,0,0,0,0,0,1
07406705,4,1,3,0,1,1,0,0,0
07407120,6,0,6,0,0,0,0,0,1
07407250,8,3,5,0,1,1,0,0,1
07407551,1,1,0,0,1,1,0,0,0
07407865,12,4,8,0,1,1,0,1,1
07407910,1,1,0,0,1,1,0,0,0
07408393,1,1,0,0,1,1,0,0,0
07408573,2,1,1,0,1,1,0,0,0
07408764,3,0,3,0,0,0,0,0,0
07409073,2,0,2,0,0,0,0,0,1
07409087,24,5,19,0,2,1,1,2,1
07409238,2,2,0,0,2,2,0,0,0
07409565,15,8,7,0,0,0,0,0,1
07410175,2,0,2,0,0,0,0,0,0
07410852,4,1,3,0,1,1,0,0,0
07410874,10,2,8,0,1,1,0,1,1
07410878,14,3,11,0,1,1,0,1,1
07411044,4,4,0,0,2,2,0,0,0
07411049,1,1,0,0,2,2,0,0,0
07411074,10,5,5,0,0,0,0,0,0
07411266,2,1,1,0,1,1,0,0,0
07411634,4,4,0,0,1,1,0,0,1
07411826,21,7,14,0,0,0,0,0,0
07412048,2,2,0,0,2,2,0,0,0
07412144,3,2,1,0,1,1,0,0,0
07412237,6,0,6,0,0,0,0,0,0
07412548,2,1,1,0,1,1,0,0,1
07413254,6,1,5,0,2,2,0,0,0
07413284,2,1,1,0,1,1,0,0,1
07413809,13,3,10,0,1,1,0,1,1
07413903,11,3,8,0,1,1,0,1,1
07414103,2,2,0,0,2,2,0,0,1
07414385,12,0,12,0,0,0,0,0,1
07414398,2,1,1,0,3,2,1,2,0
07415148,1,1,0,0,1,1,0,0,0
07415255,2,2,0,0,2,2,0,0,1
07415411,14,0,14,0,0,0,0,0,1
07415467,1,1,0,0,1,1,0,0,0
07415760,5,2,3,0,1,1,0,0,1
07415883,9,3,6,0,1,1,0,0,1
02630261,13,0,13,0,0,0,0,0,1
02630496,43,9,34,0,1,1,0,1,1
02630507,32,0,32,0,0,0,0,0,1
02630556,8,2,6,0,1,1,0,1,1
02630600,19,0,19,0,0,0,0,0,1
02630603,17,0,17,0,0,0,0,0,1
02630612,12,0,12,0,0,0,0,0,1
02630863,91,15,76,0,1,1,0,1,1
02630887,35,8,27,0,0,0,0,0,0
02630903,23,3,20,0,3,3,0,3,1
02631049,67,18,49,0,4,2,2,0,1
02631144,30,0,30,0,0,0,0,0,1
02631252,55,3,52,0,1,1,0,1,1
02631375,27,0,27,0,0,0,0,0,1
02631386,45,6,39,0,1,0,1,1,1
02631432,33,0,33,0,0,0,0,0,1
02631510,30,4,26,0,1,1,0,1,1
02631512,20,4,16,0,1,1,0,1,1
02631843,27,5,22,0,1,1,0,1,1
02631912,6,2,4,0,1,1,0,0,1
02632235,21,0,21,0,2,1,1,0,1
02632365,13,3,10,0,2,2,0,0,1
02632558,46,7,39,0,0,0,0,0,1
02632734,6,3,3,0,1,1,0,0,1
02632905,59,0,59,0,0,0,0,0,1
02632984,19,3,16,0,0,0,0,0,1
02633245,24,3,21,0,0,0,0,0,0
02633273,18,0,18,0,1,1,0,1,1
02633299,28,13,15,0,1,1,0,1,1
02633348,29,0,29,0,0,0,0,0,1
02633546,28,3,25,0,1,1,0,1,1
02633594,21,7,14,0,0,0,0,0,0
02633661,19,3,16,0,1,1,0,1,1
02633864,24,0,24,0,0,0,0,0,1
02634037,58,3,55,0,2,1,1,1,1
02634192,16,6,10,0,0,0,0,0,0
02634239,38,5,33,0,0,0,0,0,1
02634241,4,3,1,0,1,1,0,0,1
02634355,16,2,14,0,2,2,0,1,1
02634683,45,7,38,0,0,0,0,0,1
02634724,44,13,31,0,1,1,0,0,1
02634833,25,3,22,0,1,1,0,0,1
02634970,25,6,19,0,0,0,0,0,1
02635107,27,5,22,0,1,1,0,1,1
02635122,54,3,51,0,1,1,0,0,1
02635266,11,3,8,0,1,1,0,0,1
02635684,17,1,16,0,4,2,2,1,1
02635812,34,4,30,0,1,1,0,1,1
02636007,18,5,13,0,1,1,0,1,1
02636047,9,0,9,0,1,1,0,0,1
02636248,7,0,7,0,0,0,0,0,1
02636560,13,7,6,0,1,1,0,1,1
02636648,13,1,12,0,1,1,0,0,1
02636705,31,7,24,0,0,0,0,0,0
02636842,30,3,27,0,1,1,0,1,1
02637167,29,0,29,0,0,0,0,0,1
02637383,3,2,1,0,1,1,0,0,1
02637392,11,0,11,0,1,1,0,1,1
02637653,22,5,17,0,0,0,0,0,1
02637721,7,4,3,0,2,2,0,0,1
02638349,39,6,33,0,0,0,0,0,1
02638446,28,5,23,0,1,1,0,1,1
02638491,12,3,9,0,2,2,0,2,1
02638677,40,4,36,0,1,1,0,1,1
02638764,21,3,18,0,2,2,0,1,1
02639181,6,3,3,0,2,2,0,0,1
02639466,16,3,13,0,1,1,0,1,1
02639755,16,5,11,0,1,1,0,1,1
02639875,7,0,7,0,1,1,0,0,0
02640001,28,0,28,0,0,0,0,0,1
02640211,8,1,7,0,1,1,0,0,0
02640264,19,4,15,0,1,1,0,0,1
02640374,25,0,25,0,0,0,0,0,1
02640639,58,0,58,0,0,0,0,0,1
02640667,10,3,7,0,2,2,0,0,1
02640726,15,2,13,0,1,1,0,1,1
02640956,34,4,30,0,1,1,0,1,1
02641314,28,6,22,0,0,0,0,0,1
02641475,25,0,25,0,0,0,0,0,1
02641499,13,2,11,0,1,1,0,0,1
02641590,7,1,6,0,1,1,0,0,1
02641622,24,3,21,0,1,1,0,0,1
02641804,10,0,10,0,0,0,0,0,1
02642059,4,0,4,0,1,1,0,0,1
02642180,3,3,0,0,4,4,0,0,0
02642331,44,5,39,0,0,0,0,0,1
02642337,10,0,10,0,0,0,0,0,1
02642339,18,2,16,0,1,1,0,1,1
02642501,9,3,6,0,2,2,0,0,0
02642512,20,8,12,0,1,1,0,0,1
02642521,28,3,25,0,6,3,3,1,1
02642548,10,2,8,0,1,1,0,0,1
02642738,29,2,27,0,1,1,0,1,1
02643093,18,3,15,0,1,1,0,1,0
02643235,6,2,4,0,2,2,0,1,0
02643372,14,3,11,0,3,3,0,2,1
02643615,48,0,48,0,0,0,0,0,1
02643622,28,6,22,0,1,1,0,1,1
02643709,3,0,3,0,0,0,0,0,1
02644192,18,8,10,0,3,3,0,0,1
02644221,117,0,117,0,0,0,0,0,1
02644237,6,3,3,0,0,0,0,0,0
02644310,26,0,26,0,0,0,0,0,1
02644396,12,2,10,0,1,1,0,0,1
02644430,144,0,144,0,1,1,0,1,1
02644459,0,0,0,0,0,0,0,0,1
02644703,10,3,7,0,2,2,0,0,1
02644839,34,0,34,0,0,0,0,0,1
02644909,4,2,2,0,2,2,0,0,0
02645181,16,3,13,0,2,2,0,0,1
02645228,73,16,57,0,0,0,0,0,1
02645285,27,10,17,0,1,1,0,0,0
02645493,1,0,1,0,0,0,0,0,1
02645706,122,15,107,0,0,0,0,0,1
02645724,14,0,14,0,0,0,0,0,1
02645865,21,7,14,0,0,0,0,0,1
02645931,22,5,17,0,0,0,0,0,1
02645982,7,3,4,0,1,1,0,1,1
02646317,28,2,26,0,1,1,0,1,1
02646325,14,0,14,0,0,0,0,0,1
02646454,59,8,51,0,0,0,0,0,1
02646487,34,5,29,0,0,0,0,0,1
02646511,51,3,48,0,1,1,0,1,1
02646664,23,5,18,0,0,0,0,0,1
02647095,28,5,23,0,0,0,0,0,1
02647467,11,0,11,0,1,1,0,1,1
02647516,7,1,6,0,3,2,1,0,1
02647818,12,4,8,0,2,2,0,1,1
02647877,43,4,39,0,2,2,0,2,0
02648024,16,3,13,0,3,1,2,1,1
02648152,25,6,19,0,0,0,0,0,1
02648158,28,4,24,0,1,1,0,1,1
02648289,20,4,16,0,1,1,0,1,1
02648293,12,1,11,0,1,1,0,1,1
02648311,32,3,29,0,1,1,0,1,1
02648365,9,4,5,0,3,3,0,0,0
02648460,20,6,14,0,0,0,0,0,1
02648481,15,4,11,0,0,0,0,0,1
02648496,5,2,3,0,1,1,0,0,1
02648579,25,3,22,0,1,1,0,1,1
02648585,31,4,27,0,1,1,0,1,1
02648782,26,3,23,0,0,0,0,0,0
02648892,37,10,27,0,1,1,0,0,1
02649156,52,0,52,0,0,0,0,0,1
02649282,7,4,3,0,1,1,0,0,1
02649325,91,3,88,0,1,1,0,1,1
02649340,53,11,42,0,0,0,0,0,1
02649356,29,0,29,0,1,1,0,1,1
02649363,15,4,11,0,1,1,0,1,1
02649366,13,0,13,0,0,0,0,0,1
02649419,32,0,32,0,0,0,0,0,1
02649467,17,0,17,0,0,0,0,0,1
02649478,25,4,21,0,1,1,0,1,1
02649592,17,0,17,0,0,0,0,0,1
02649752,16,3,13,0,1,1,0,0,1
02649790,24,3,21,0,1,1,0,1,1
02649883,9,2,7,0,1,1,0,0,1
02649920,10,5,5,0,1,1,0,0,0
02650006,47,6,41,0,2,1,1,2,1
02650009,42,4,38,0,1,1,0,1,1
02650029,20,0,20,0,0,0,0,0,1
02650110,30,10,20,0,3,1,2,0,1
02650530,25,5,20,0,1,1,0,1,1
02650538,36,4,32,0,0,0,0,0,1
02650590,40,5,35,0,1,1,0,1,1
02651168,23,5,18,0,0,0,0,0,1
02651234,14,4,10,0,0,0,0,0,0
02651241,18,8,10,0,1,1,0,0,1
02651329,28,3,25,0,1,1,0,1,1
02651334,25,6,19,0,1,1,0,0,1
02651458,11,3,8,0,2,2,0,0,1
02651777,110,12,98,0,0,0,0,0,1
02651783,11,0,11,0,0,0,0,0,1
02651929,27,7,20,0,1,1,0,1,1
02652033,48,3,45,0,2,1,1,2,1
02652053,20,0,20,0,1,1,0,1,1
02652253,59,6,53,0,1,1,0,1,1
02652370,42,4,38,0,1,1,0,0,1
02652825,13,3,10,0,2,2,0,0,1
02652843,20,0,20,0,1,1,0,1,1
02652922,37,0,37,0,0,0,0,0,1
02653123,19,0,19,0,0,0,0,0,1
02653139,13,1,12,0,1,1,0,0,1
02653213,22,3,19,0,1,1,0,1,1
02653887,57,13,44,0,0,0,0,0,1
02653890,16,2,14,0,1,1,0,0,1
02653918,7,0,7,0,0,0,0,0,0
02654078,15,1,14,0,1,1,0,0,1
02654104,42,8,34,0,2,1,1,1,0
02654428,8,3,5,0,1,1,0,0,1
02654606,13,4,9,0,1,1,0,1,1
02654682,62,2,60,0,1,1,0,1,1
02654810,32,4,28,0,2,2,0,2,1
02654812,29,3,26,0,1,1,0,1,1
02654813,34,5,29,0,1,1,0,1,0
02654938,7,2,5,0,1,1,0,1,0
02654988,6,2,4,0,3,2,1,0,0
02655110,59,11,48,0,0,0,0,0,1
02655710,28,4,24,0,1,1,0,1,1
02655764,59,12,47,0,1,1,0,0,1
02655942,17,4,13,0,0,0,0,0,1
02656485,52,11,41,0,0,0,0,0,1
02656690,20,0,20,0,0,0,0,0,1
02656725,18,6,12,0,1,1,0,1,1
02656967,46,3,43,0,2,1,1,2,1
02657093,59,9,50,0,0,0,0,0,1
02657370,28,3,25,0,0,0,0,0,0
02657442,47,4,43,0,1,1,0,1,1
02657579,8,3,5,0,1,1,0,0,1
02657589,5,1,4,0,1,1,0,0,1
02657593,27,0,27,0,0,0,0,0,1
02657706,9,1,8,0,1,1,0,0,1
02657835,19,7,12,0,1,1,0,0,1
02658043,16,0,16,0,0,0,0,0,1
02658067,21,5,16,0,1,1,0,1,1
02658080,5,3,2,0,2,2,0,0,1
02658116,5,0,5,0,0,0,0,0,1
02658217,35,4,31,0,0,0,0,0,1
02658283,96,15,81,0,2,1,1,0,1
02658316,26,0,26,0,0,0,0,0,1
02658912,7,3,4,0,2,2,0,0,0
02659061,18,4,14,0,0,0,0,0,1
02659110,23,0,23,0,0,0,0,0,1
02659118,32,6,26,0,1,1,0,1,1
02659703,54,14,40,0,0,0,0,0,1
02660001,6,4,2,0,1,1,0,0,1
02660240,19,4,15,0,0,0,0,0,1
02660276,25,4,21,0,0,0,0,0,1
02660370,38,8,30,0,1,1,0,1,1
02660403,46,10,36,0,2,2,0,2,0
02660564,65,0,65,0,0,0,0,0,1
02660615,31,4,27,0,1,1,0,1,1
02660716,13,9,4,0,1,1,0,0,1
02660912,28,4,24,0,0,0,0,0,1
02660917,17,3,14,0,3,1,2,3,1
02661182,48,10,38,0,1,1,0,1,1
02661356,9,5,4,0,0,0,0,0,0
02661635,17,6,11,0,1,1,0,0,0
02661656,21,3,18,0,2,2,0,2,1
02661682,47,11,36,0,0,0,0,0,1
02661768,45,0,45,0,0,0,0,0,1
02661832,12,3,9,0,1,1,0,1,1
02661969,31,5,26,0,1,1,0,1,1
02662241,9,2,7,0,1,1,0,0,1
02662445,17,8,9,0,2,2,0,0,1
02662650,10,3,7,0,1,1,0,0,1
02662755,23,5,18,0,1,1,0,1,1
02662758,84,13,71,0,0,0,0,0,1
02662912,12,2,10,0,1,1,0,0,1
02663027,12,5,7,1,1,1,0,0,1
02663338,28,3,25,0,1,1,0,1,1
02663485,20,4,16,0,1,1,0,1,1
02663574,17,2,15,0,1,1,0,1,1
02663988,47,4,43,0,1,1,0,1,1
02664006,47,0,47,0,1,1,0,1,1
02664039,16,4,12,0,1,1,0,1,1
02664257,53,5,48,0,0,0,0,0,1
02664365,23,5,18,0,1,1,0,1,1
02664412,29,3,26,0,1,1,0,1,1
02664506,10,7,3,0,2,1,1,2,0
02664511,13,3,10,0,3,1,2,0,1
02664524,21,0,21,0,0,0,0,0,1
02664803,39,0,39,0,0,0,0,0,1
02664868,23,3,20,0,2,1,1,2,1
02664886,20,1,19,0,0,0,0,0,1
02665783,6,3,3,0,2,2,0,0,0
02665899,21,3,18,0,1,1,0,1,1
02665907,14,2,12,0,2,1,1,2,1
02665973,30,6,24,0,1,1,0,1,1
02665997,14,2,12,0,2,2,0,0,0
02666005,79,13,66,0,1,1,0,0,1
02666142,13,0,13,0,0,0,0,0,1
02666220,6,3,3,0,2,2,0,0,0
02666311,32,4,28,0,1,1,0,1,1
02666322,28,3,25,0,1,1,0,1,0
02666323,49,3,46,0,1,1,0,1,1
02666561,29,3,26,0,0,0,0,0,1
02666563,16,1,15,0,0,0,0,0,1
02666793,65,4,61,0,2,1,1,2,1
02666837,29,3,26,0,1,1,0,1,1
02666908,23,7,16,0,2,2,0,2,1
02666943,9,4,5,0,1,1,0,1,1
02666957,21,3,18,0,1,1,0,1,1
02667012,21,7,14,0,1,1,0,1,1
02667206,25,5,20,0,1,1,0,1,0
02667340,25,4,21,0,1,1,0,0,1
02667422,37,6,31,0,3,2,1,0,1
02667541,37,10,27,0,1,1,0,0,1
02667953,50,4,46,0,1,1,0,1,1
02667995,154,13,141,0,0,0,0,0,1
02668341,99,11,88,0,1,1,0,1,1
02668470,76,3,73,0,1,1,0,1,1
02668971,75,9,66,0,0,0,0,0,1
02669040,75,8,67,0,2,2,0,2,1
02669146,18,3,15,0,0,0,0,0,1
02669185,39,5,34,0,0,0,0,0,1
02669426,30,7,23,0,1,1,0,0,1
02669437,36,3,33,0,1,1,0,1,1
02669535,14,4,10,0,0,0,0,0,1
02669578,45,9,36,0,1,1,0,1,1
02669673,18,0,18,0,0,0,0,0,1
02669678,17,3,14,0,1,1,0,0,1
02669716,14,3,11,0,0,0,0,0,1
02669781,15,2,13,0,0,0,0,0,1
02669815,15,3,12,0,2,1,1,1,1
02669861,37,6,31,0,1,1,0,1,1
02669866,34,5,29,0,2,2,0,2,1
02669868,34,12,22,0,1,1,0,0,1
02670020,28,8,20,0,1,1,0,1,1
02670209,7,3,4,0,1,1,0,0,0
02670270,10,4,6,0,1,1,0,1,1
02670273,14,8,6,0,2,2,0,0,1
02670290,9,4,5,0,1,1,0,1,1
02670500,46,11,35,0,0,0,0,0,1
02670518,23,3,20,0,1,1,0,1,1
02670582,61,5,56,0,1,1,0,1,1
02670609,54,3,51,0,1,1,0,1,1
02670611,29,7,22,0,0,0,0,0,1
02671052,49,5,44,0,1,1,0,1,1
02671517,83,0,83,0,0,0,0,0,1
02671608,33,10,23,0,1,1,0,0,0
02671806,6,2,4,0,1,1,0,0,1
02671913,25,10,15,0,8,8,0,8,1
02672070,20,4,16,0,0,0,0,0,1
02672071,13,0,13,0,0,0,0,0,1
02672075,46,6,40,0,2,1,1,2,1
02672334,76,17,59,0,0,0,0,0,1
02672355,32,0,32,0,0,0,0,0,1
02672659,30,5,25,0,1,1,0,1,1
02672937,17,3,14,0,1,1,0,1,0
02673123,24,3,21,0,2,2,0,0,0
02673231,23,0,23,0,0,0,0,0,1
02673334,6,3,3,0,1,1,0,1,1
02673604,9,1,8,0,4,2,2,1,0
02673624,51,8,43,0,0,0,0,0,1
02673845,74,13,61,0,0,0,0,0,1
02673896,2,0,2,0,2,2,0,0,1
02674002,35,3,32,0,0,0,0,0,0
02674035,12,2,10,0,1,1,0,1,1
02674036,2,0,2,0,1,1,0,0,1
02674046,23,3,20,0,1,1,0,0,0
02674066,9,0,9,0,0,0,0,0,1
02674136,42,4,38,0,1,1,0,1,1
02674177,5,3,2,0,0,0,0,0,0
02674220,5,3,2,0,3,3,0,0,0
02674265,39,4,35,0,1,1,0,1,1
02674596,31,11,20,0,0,0,0,0,1
02674657,8,2,6,0,0,0,0,0,1
02674691,16,1,15,0,1,1,0,1,1
02674910,33,4,29,0,0,0,0,0,1
02674947,14,8,6,0,1,1,0,0,1
02675085,18,3,15,0,0,0,0,0,1
02675092,16,2,14,0,1,1,0,0,1
02675095,62,2,60,0,0,0,0,0,1
02675101,11,2,9,0,1,1,0,0,1
02675102,8,0,8,0,1,1,0,0,1
02675115,20,2,18,0,1,1,0,1,1
02675241,24,7,17,0,0,0,0,0,1
02675750,89,13,76,0,0,0,0,0,0
02675944,23,1,22,0,1,1,0,1,1
02675945,25,5,20,0,0,0,0,0,0
02675952,53,8,45,0,1,1,0,1,1
02675957,13,3,10,0,1,1,0,1,1
02676289,5,5,0,0,1,1,0,0,0
02676609,41,5,36,0,1,1,0,1,1
02676624,27,3,24,0,1,1,0,1,1
02676724,18,4,14,0,1,1,0,1,1
02676898,18,4,14,0,3,3,0,0,1
02676967,35,2,33,0,1,1,0,1,1
02677068,87,18,69,0,0,0,0,0,1
02677166,5,0,5,0,2,2,0,0,1
02677427,58,10,48,0,0,0,0,0,1
02677483,25,2,23,0,0,0,0,0,1
02677534,59,6,53,0,1,1,0,1,1
02677595,55,7,48,0,0,0,0,0,1
02677824,64,11,53,0,0,0,0,0,1
02677826,53,5,48,0,1,1,0,1,1
02677871,9,0,9,0,0,0,0,0,0
02677906,17,4,13,0,1,1,0,1,1
02677948,33,5,28,0,0,0,0,0,1
02678013,67,0,67,0,0,0,0,0,1
02678160,39,3,36,0,1,1,0,1,1
02678185,20,4,16,0,0,0,0,0,1
02678331,13,0,13,0,2,2,0,0,1
02678344,27,2,25,0,1,1,0,1,1
02678367,26,8,18,0,1,1,0,1,1
02678394,22,4,18,0,2,1,1,2,0
02678465,30,3,27,0,2,1,1,2,1
02678467,23,4,19,0,1,1,0,1,1
02678575,6,2,4,0,2,2,0,0,0
02678750,44,8,36,0,1,1,0,1,1
02678829,17,0,17,0,1,1,0,1,1
02679053,5,1,4,0,1,1,0,0,1
02679236,8,3,5,0,0,0,0,0,0
02679293,33,3,30,0,1,1,0,1,1
02679394,53,9,44,0,0,0,0,0,1
02679441,13,2,11,0,1,1,0,1,0
02679478,20,3,17,0,2,2,0,2,1
02679522,40,6,34,0,1,1,0,1,1
02679523,48,8,40,0,0,0,0,0,0
02679555,18,5,13,0,1,1,0,1,1
02679755,22,1,21,0,1,1,0,1,1
02679915,56,10,46,0,0,0,0,0,1
02680159,60,5,55,0,1,1,0,1,1
02680403,30,2,28,0,1,1,0,1,1
02680415,17,2,15,0,1,1,0,0,0
02680648,10,4,6,0,3,3,0,0,1
02680742,30,2,28,0,1,1,0,1,0
02681072,32,4,28,0,0,0,0,0,1
02681141,48,0,48,0,2,1,1,2,1
02681218,25,7,18,0,4,4,0,1,1
02681572,7,3,4,0,2,2,0,0,0
02681604,44,8,36,0,0,0,0,0,0
02681702,32,0,32,0,0,0,0,0,1
02681705,23,6,17,0,0,0,0,0,1
02681878,36,3,33,0,1,1,0,1,1
02681921,11,3,8,0,2,2,0,0,0
00550481,20,7,13,0,1,1,0,1,1
00550594,65,7,58,0,0,0,0,0,1
00551186,16,0,16,0,1,1,0,1,1
00551311,128,14,114,0,0,0,0,0,1
00551318,11,3,8,0,1,1,0,1,1
00551331,5,3,2,0,1,1,0,1,0
00551334,432,7,425,0,1,1,0,1,1
00551434,49,4,45,0,0,0,0,0,1
00551800,117,0,117,0,0,0,0,0,1
00551817,128,4,124,0,0,0,0,0,1
00551974,20,5,15,0,0,0,0,0,1
00552110,11,3,8,0,1,1,0,1,1
00552165,26,3,23,0,1,1,0,1,1
00552255,31,10,21,0,0,0,0,0,1
00552331,30,1,29,0,0,0,0,0,1
00552775,20,7,13,0,0,0,0,0,1
00552847,137,13,124,0,0,0,0,0,1
00552937,37,6,31,0,0,0,0,0,1
00553014,52,9,43,0,1,1,0,1,1
00553066,40,5,35,0,1,1,0,1,1
00553130,3,3,0,0,2,2,0,0,0
00553243,47,17,30,0,0,0,0,0,1
00554193,6,3,3,0,3,3,0,0,1
00554723,6,1,5,0,1,1,0,0,0
00554820,25,4,21,0,1,1,0,1,1
00555144,55,14,41,0,0,0,0,0,0
00555150,126,12,114,0,0,0,0,0,1
00555214,16,5,11,0,1,1,0,1,1
00555753,20,2,18,0,0,0,0,0,0
00556264,14,0,14,0,0,0,0,0,1
00556463,55,13,42,0,0,0,0,0,1
00556861,89,14,75,0,1,1,0,1,1
00557179,20,4,16,0,1,1,0,1,1
00557828,43,11,32,0,1,1,0,0,1
00557954,103,19,84,0,0,0,0,0,1
00558085,47,11,36,0,0,0,0,0,1
00558135,7,1,6,0,1,1,0,1,1
00559053,37,0,37,0,0,0,0,0,1
00559100,0,0,0,0,0,0,0,0,0
00559196,7,2,5,0,2,2,0,0,1
00559399,10,2,8,0,1,1,0,1,1
00559414,20,2,18,0,1,1,0,1,1
00559455,5,3,2,0,0,0,0,0,1
00559567,30,0,30,0,0,0,0,0,1
00559674,63,14,49,0,1,1,0,1,1
00559784,61,10,51,0,0,0,0,0,1
00560074,28,9,19,0,7,0,7,0,1
00560165,39,9,30,0,0,0,0,0,1
00560700,28,0,28,0,2,1,1,2,1
00560870,76,11,65,0,0,0,0,0,1
00561261,18,0,18,0,0,0,0,0,1
00561319,27,4,23,0,0,0,0,0,0
00561340,7,3,4,0,2,2,0,0,0
00561422,25,2,23,0,2,1,1,2,1
00562240,16,5,11,0,1,1,0,1,1
00562740,15,6,9,0,4,1,3,2,1
00562953,14,2,12,0,1,1,0,1,1
00563001,27,5,22,0,1,1,0,1,1
00563027,21,3,18,0,1,1,0,1,1
00563497,4,1,3,0,1,1,0,0,1
00563845,54,13,41,0,0,0,0,0,1
00564482,14,3,11,0,1,1,0,1,1
00564818,35,3,32,0,1,1,0,1,1
00564883,42,11,31,0,0,0,0,0,1
00564890,28,4,24,0,1,1,0,1,0
00565652,35,0,35,0,0,0,0,0,1
00565683,17,5,12,0,1,1,0,1,1
00565884,40,4,36,0,1,1,0,1,1
00566186,32,0,32,0,1,1,0,1,1
00566221,64,4,60,0,2,1,1,2,1
00566669,22,0,22,0,0,0,0,0,1
00566694,33,5,28,0,0,0,0,0,1
00566823,37,9,28,0,1,1,0,1,1
00567232,44,15,29,0,0,0,0,0,1
00567238,12,4,8,0,1,1,0,1,1
00567454,6,2,4,0,1,1,0,0,1
00568277,18,0,18,0,1,1,0,1,1
00568600,30,7,23,0,1,1,0,0,1
00568662,16,4,12,0,2,1,1,2,1
00568800,52,8,44,0,0,0,0,0,1
00568879,16,4,12,0,1,1,0,1,0
00569417,26,0,26,0,0,0,0,0,1
00569525,15,0,15,0,0,0,0,0,1
00569703,6,0,6,0,1,1,0,0,0
00569823,38,4,34,0,1,1,0,1,1
00569887,4,2,2,0,2,2,0,0,0
00570164,27,7,20,0,0,0,0,0,0
00570206,25,0,25,0,0,0,0,0,1
00570951,13,3,10,0,2,2,0,0,1
00571298,13,0,13,0,1,1,0,1,1
00571453,13,3,10,0,2,1,1,1,1
00571546,34,4,30,0,1,1,0,1,1
00571613,14,4,10,0,1,1,0,0,0
00571637,28,7,21,0,0,0,0,0,1
00571662,18,4,14,0,1,1,0,1,1
00571672,38,3,35,0,1,1,0,1,1
00571803,54,14,40,0,0,0,0,0,1
00571884,33,3,30,0,1,1,0,1,1
00572631,15,6,9,0,0,0,0,0,1
00572698,14,0,14,0,0,0,0,0,1
00573059,6,2,4,0,1,1,0,1,0
00573865,17,4,13,0,4,3,1,0,0
00573920,9,8,1,0,0,0,0,0,1
00574562,16,4,12,0,0,0,0,0,1
00574784,7,3,4,0,1,1,0,0,1
00574813,25,4,21,0,1,1,0,1,1
00574816,126,14,112,0,0,0,0,0,1
00575236,13,3,10,0,0,0,0,0,0
00575462,25,1,24,0,1,1,0,1,1
00575515,17,8,9,0,5,5,0,0,0
00576382,15,2,13,0,1,1,0,1,1
00576440,23,7,16,0,1,1,0,0,1
00576779,11,6,5,0,5,2,3,1,1
00577217,39,10,29,0,0,0,0,0,1
00577262,87,3,84,0,1,1,0,0,0
00577389,27,2,25,0,1,1,0,1,1
00577801,8,0,8,0,0,0,0,0,1
00578208,17,4,13,0,1,1,0,1,1
00578631,38,7,31,0,1,1,0,1,1
00579027,4,3,1,0,2,2,0,0,0
00579091,36,5,31,0,0,0,0,0,1
00579204,89,8,81,0,0,0,0,0,1
00579509,8,4,4,0,3,2,1,1,1
00579665,47,8,39,0,0,0,0,0,0
00579683,16,8,8,0,1,1,0,0,1
00579688,7,6,1,0,0,0,0,0,1
00579839,7,0,7,0,3,3,0,0,0
00580128,99,16,83,0,0,0,0,0,1
00580176,67,10,57,0,0,0,0,0,1
00580524,21,2,19,0,2,1,1,1,1
00580578,11,5,6,0,0,0,0,0,1
00580628,14,4,10,0,1,1,0,0,1
00580634,29,6,23,0,1,1,0,1,1
00580964,25,4,21,0,1,1,0,1,1
00581742,21,3,18,0,2,2,0,2,1
00581961,8,2,6,0,1,1,0,1,0
00582118,21,5,16,0,1,1,0,1,1
00582373,22,0,22,0,0,0,0,0,1
00582554,35,6,29,0,1,1,0,1,1
00582770,0,0,0,0,0,0,0,0,0
00583325,52,6,46,0,0,0,0,0,1
00583445,12,4,8,0,1,1,0,1,1
00584412,44,9,35,0,1,1,0,0,0
00585158,7,5,2,0,3,3,0,0,0
00585164,38,0,38,0,0,0,0,0,1
00585247,77,15,62,0,3,3,0,0,1
00585290,62,7,55,0,0,0,0,0,1
00585297,11,2,9,0,0,0,0,0,1
00585636,23,2,21,0,1,1,0,1,1
00585723,60,13,47,0,0,0,0,0,1
00585729,31,5,26,0,1,1,0,1,1
00586668,22,3,19,0,1,1,0,1,1
00587224,27,3,24,0,1,1,0,1,1
00588599,8,3,5,0,1,1,0,1,1
00588804,18,0,18,0,1,1,0,1,1
00588827,9,6,3,0,1,1,0,0,0
00588944,18,3,15,0,1,1,0,1,1
00588975,5,0,5,0,1,1,0,0,0
00589055,48,12,36,0,0,0,0,0,1
00591057,9,4,5,0,1,1,0,1,1
00591137,3,3,0,0,1,1,0,0,0
00591234,18,2,16,0,1,1,0,1,0
00591246,10,4,6,0,3,3,0,1,0
00592528,26,5,21,0,1,1,0,1,1
00592567,35,5,30,0,1,1,0,0,1
00592873,9,7,2,0,2,2,0,0,0
00593444,26,11,15,0,0,0,0,0,1
00594081,28,2,26,0,1,1,0,1,1
00594581,47,0,47,0,1,1,0,1,1
00594599,0,0,0,0,0,0,0,0,0
00594634,23,5,18,0,0,0,0,0,1
00594693,11,4,7,0,0,0,0,0,0
00594844,46,5,41,0,1,1,0,0,0
00594860,144,11,133,0,0,0,0,0,1
00595182,20,3,17,0,2,2,0,0,0
00596107,53,7,46,0,1,1,0,1,1
00596121,50,0,50,0,1,1,0,1,1
00596137,35,8,27,0,0,0,0,0,1
00596198,19,0,19,0,0,0,0,0,1
00596337,37,11,26,0,0,0,0,0,1
00596508,6,0,6,0,2,2,0,0,0
00596520,8,3,5,0,2,2,0,0,0
00598443,83,12,71,0,0,0,0,0,1
00598696,37,5,32,0,0,0,0,0,1
00599221,25,4,21,0,1,1,0,0,0
00599389,74,18,56,0,0,0,0,0,1
00599481,7,5,2,0,1,1,0,0,0
00599784,13,4,9,0,2,2,0,1,1
00599961,58,0,58,0,2,1,1,2,1
00600322,11,2,9,0,1,1,0,0,0
00600498,5,3,2,0,3,2,1,0,1
00601049,54,8,46,0,0,0,0,0,1
00601207,116,12,104,0,0,0,0,0,1
00601225,27,0,27,0,0,0,0,0,1
00601282,14,4,10,0,1,1,0,1,1
00601704,68,7,61,0,0,0,0,0,1
00601785,43,12,31,0,0,0,0,0,1
00601928,78,3,75,0,4,2,2,0,1
00601929,28,14,14,0,0,0,0,0,1
00602165,19,0,19,0,0,0,0,0,1
00602194,24,0,24,0,0,0,0,0,1
00602224,22,3,19,0,1,1,0,1,1
00602400,28,3,25,0,1,1,0,1,1
00602575,31,5,26,0,0,0,0,0,0
00602774,14,0,14,0,1,1,0,1,1
00602854,48,5,43,0,1,1,0,1,1
00603019,16,0,16,0,0,0,0,0,1
00603387,17,4,13,0,1,1,0,1,1
00603467,13,0,13,0,0,0,0,0,1
00603893,58,3,55,0,1,1,0,1,1
00604144,37,3,34,0,1,1,0,1,1
00604198,54,11,43,0,0,0,0,0,0
00604411,7,3,4,0,0,0,0,0,0
00604606,13,4,9,0,1,1,0,1,1
00604863,35,3,32,0,1,1,0,1,1
00605105,10,3,7,0,0,0,0,0,1
00605214,22,4,18,0,1,1,0,1,1
00606887,74,17,57,0,0,0,0,0,1
00607039,43,5,38,0,1,1,0,1,1
00607461,32,5,27,0,1,1,0,1,1
00607575,14,5,9,0,1,1,0,1,1
00607713,6,0,6,0,1,1,0,0,0
00607778,6,2,4,0,3,3,0,1,0
00607992,47,14,33,0,0,0,0,0,1
00609243,13,3,10,0,1,1,0,1,1
00609261,12,2,10,0,2,2,0,0,1
00609285,22,0,22,0,0,0,0,0,1
00609503,17,4,13,0,2,2,0,2,1
00609746,22,3,19,0,1,1,0,1,1
00609812,59,18,41,0,0,0,0,0,1
00610134,5,3,2,0,1,1,0,0,0
00610374,46,6,40,0,0,0,0,0,0
00611130,35,0,35,0,1,1,0,1,1
00611247,11,3,8,0,1,1,0,1,1
00611624,19,4,15,0,0,0,0,0,1
00611748,56,8,48,0,0,0,0,0,1
00611762,53,11,42,0,0,0,0,0,1
00611956,160,18,142,0,20,3,17,0,1
00611966,31,5,26,0,1,1,0,1,1
00612172,128,13,115,0,0,0,0,0,1
00612403,47,0,47,0,0,0,0,0,1
00612446,9,2,7,0,1,1,0,1,1
00612508,10,7,3,0,1,1,0,0,1
00613259,55,12,43,0,1,1,0,1,1
00613735,5,2,3,0,1,1,0,0,0
00614063,30,6,24,0,0,0,0,0,1
00614147,4,3,1,0,2,2,0,0,0
00614638,4,3,1,0,0,0,0,0,1
00615259,103,11,92,0,0,0,0,0,1
00615508,10,5,5,0,2,2,0,0,1
00615899,35,5,30,0,1,1,0,1,1
00616245,39,4,35,0,1,1,0,1,1
00616308,17,4,13,0,1,1,0,1,1
00616332,25,0,25,0,0,0,0,0,1
00616421,13,2,11,0,1,1,0,0,1
00616510,5,0,5,0,0,0,0,0,1
00616553,3,3,0,0,2,2,0,0,1
00616679,61,8,53,0,0,0,0,0,1
00616684,34,5,29,0,10,8,2,0,1
00616818,27,7,20,0,0,0,0,0,1
00617484,57,5,52,0,3,1,2,1,1
00617596,12,2,10,0,1,1,0,0,1
00617725,12,5,7,0,1,1,0,1,0
00617795,116,12,104,0,1,1,0,0,1
00617987,86,15,71,0,0,0,0,0,1
00618568,22,3,19,0,1,1,0,1,1
00619102,11,4,7,0,2,2,0,0,0
00619251,36,5,31,0,0,0,0,0,1
00620066,73,10,63,0,0,0,0,0,1
00620465,22,3,19,0,1,1,0,1,1
00620929,24,3,21,0,1,1,0,1,1
00621148,55,5,50,0,1,1,0,1,1
00621248,24,3,21,0,1,1,0,1,1
00621497,35,8,27,0,1,1,0,1,1
00621843,14,3,11,0,1,1,0,1,1
00621913,8,4,4,0,3,3,0,0,1
00621920,51,12,39,0,0,0,0,0,1
00622106,19,3,16,0,1,1,0,1,1
00622651,25,7,18,0,0,0,0,0,1
00622773,54,12,42,0,0,0,0,0,0
00622786,49,11,38,0,5,4,1,0,1
00622847,48,3,45,0,1,1,0,1,1
00623112,28,4,24,0,0,0,0,0,0
00623241,37,4,33,0,1,1,0,1,1
00623242,23,0,23,0,0,0,0,0,1
00623364,35,9,26,0,0,0,0,0,1
00623373,12,0,12,0,1,1,0,1,1
00623378,40,4,36,0,2,2,0,2,1
00623456,7,0,7,0,0,0,0,0,1
00623908,20,5,15,0,0,0,0,0,0
00623915,26,0,26,0,0,0,0,0,1
00623925,11,3,8,0,2,1,1,0,1
00624150,6,1,5,0,1,1,0,1,1
00624194,56,3,53,0,1,0,1,1,1
00624273,50,16,34,0,0,0,0,0,1
00624347,19,3,16,0,1,1,0,1,1
00624494,17,4,13,0,1,1,0,1,1
00624622,25,5,20,0,0,0,0,0,0
00625299,22,1,21,0,0,0,0,0,1
00625448,16,4,12,0,1,1,0,1,1
00625561,46,7,39,0,1,1,0,1,1
00625652,13,0,13,0,0,0,0,0,1
00625711,9,8,1,0,0,0,0,0,1
00625713,9,8,1,0,0,0,0,0,1
00625849,42,0,42,0,0,0,0,0,1
00626019,9,8,1,0,0,0,0,0,1
00626693,106,8,98,0,0,0,0,0,1
00627023,14,3,11,0,1,1,0,1,1
00628256,18,3,15,0,2,2,0,2,1
00628267,16,3,13,0,0,0,0,0,1
00628541,59,12,47,0,0,0,0,0,1
00628910,31,0,31,0,0,0,0,0,1
00628943,8,0,8,0,0,0,0,0,1
00628945,11,3,8,0,0,0,0,0,1
00628994,64,5,59,0,1,1,0,1,1
00629333,22,3,19,0,0,0,0,0,0
00629832,28,4,24,0,1,1,0,1,1
00629992,53,9,44,0,1,1,0,1,1
00630294,86,12,74,0,0,0,0,0,1
00630681,49,6,43,0,1,1,0,1,1
00631503,30,4,26,0,1,1,0,1,1
00631704,9,4,5,0,2,2,0,0,1
00631705,9,4,5,0,2,2,0,0,1
00631883,6,0,6,0,0,0,0,0,0
00632071,7,3,4,0,1,1,0,1,0
00632468,24,6,18,0,0,0,0,0,0
00632622,836,35,801,0,0,0,0,0,1
00632662,5,2,3,0,3,3,0,0,0
00634143,40,9,31,0,1,1,0,1,1
00634776,27,3,24,0,1,1,0,1,1
00635311,44,3,41,0,1,1,0,1,1
00635458,4,3,1,0,1,1,0,0,1
00635484,5,2,3,0,1,1,0,0,0
00636494,9,3,6,0,1,1,0,1,1
00637246,53,5,48,0,1,1,0,1,1
00637604,12,4,8,0,1,1,0,1,1
00637798,6,3,3,0,1,1,0,1,0
00638133,35,7,28,0,0,0,0,0,1
00638726,26,0,26,0,0,0,0,0,1
00638891,23,4,19,0,1,1,0,1,1
00638918,59,4,55,0,1,1,0,1,1
00639021,5,0,5,0,0,0,0,0,1
00639050,14,3,11,0,1,1,0,1,0
00639379,24,2,22,0,1,1,0,1,1
00639462,42,1,41,0,4,2,2,2,1
00639594,24,3,21,0,2,1,1,2,1
00639677,30,2,28,0,1,1,0,1,1
00640159,18,4,14,0,1,1,0,1,1
00640217,58,14,44,0,0,0,0,0,1
00640320,14,0,14,0,0,0,0,0,1
00640740,25,2,23,0,1,1,0,1,1
00640983,6,3,3,0,0,0,0,0,1
00641450,5,5,0,0,1,1,0,0,0
00641562,5,4,1,0,2,2,0,0,0
00641687,72,17,55,0,0,0,0,0,1
00642415,40,4,36,0,1,0,1,0,1
00643195,16,3,13,0,1,1,0,0,0
00643207,40,5,35,0,1,1,0,1,1
00643353,0,0,0,0,0,0,0,0,0
00643370,30,6,24,0,1,1,0,1,1
00643799,12,3,9,0,1,1,0,1,1
00643832,27,0,27,0,1,1,0,1,1
00643905,20,6,14,0,1,1,0,0,0
00643914,33,4,29,0,1,1,0,1,1
00643916,23,4,19,0,1,1,0,1,1
00644264,18,0,18,0,0,0,0,0,1
00644591,42,3,39,0,1,1,0,1,1
00644831,14,3,11,0,2,2,0,0,1
00645125,52,9,43,0,1,1,0,1,1
00645659,1,1,0,0,0,0,0,0,1
00645708,62,4,58,0,0,0,0,0,1
00645756,20,4,16,0,1,1,0,1,1
00645810,5,2,3,0,1,1,0,0,0
00646238,47,13,34,0,0,0,0,0,0
00646473,7,4,3,0,2,2,0,0,0
00647788,37,10,27,0,0,0,0,0,1
00647816,95,13,82,0,3,2,1,0,1
00648022,27,3,24,0,2,1,1,1,1
00648041,151,13,138,0,0,0,0,0,1
00648082,21,3,18,0,1,1,0,1,0
00648560,45,5,40,0,1,1,0,1,1
00648564,12,6,6,0,0,0,0,0,1
00649329,22,4,18,0,1,1,0,1,1
00649330,32,4,28,0,1,1,0,1,1
00649369,30,5,25,0,1,1,0,0,1
00649560,0,0,0,0,0,0,0,0,0
00649561,12,0,12,0,0,0,0,0,0
00649864,7,3,4,0,1,1,0,0,1
10260141,10,0,10,0,1,1,0,1,1
10260149,10,0,10,0,1,1,0,1,1
10260154,10,0,10,0,1,1,0,1,1
10260613,2,2,0,0,2,2,0,0,0
10260874,9,7,2,0,4,2,2,3,1
10261477,17,14,3,0,0,0,0,0,0
10261527,1,1,0,0,1,1,0,0,0
10261928,1,0,1,0,1,1,0,0,0
10262009,1,0,1,0,1,1,0,0,0
10262795,2,1,1,0,1,1,0,1,1
10262920,2,1,1,0,1,1,0,0,0
10262926,1,0,1,0,2,2,0,0,0
10263089,2,2,0,0,1,1,0,0,0
10264286,1,1,0,0,1,1,0,0,0
10264460,6,4,2,0,1,1,0,0,0
10264600,3,3,0,0,1,1,0,1,0
10264787,2,1,1,0,1,1,0,0,1
10265332,2,2,0,0,2,2,0,0,1
10265926,1,1,0,0,2,2,0,0,1
10265984,2,2,0,0,1,1,0,0,0
10266115,4,4,0,0,0,0,0,0,0
10266130,13,6,7,0,3,1,2,3,1
10266157,5,0,5,0,1,1,0,1,0
10266901,2,2,0,0,0,0,0,0,1
10266974,1,0,1,0,1,1,0,0,1
10267054,2,0,2,0,1,1,0,0,0
10267861,2,2,0,0,2,2,0,0,0
10268028,6,0,6,0,1,1,0,1,0
10268343,1,1,0,0,1,1,0,0,1
10268613,7,4,3,0,3,1,2,2,1
10268907,3,3,0,0,0,0,0,0,0
10268983,2,2,0,0,2,2,0,0,0
10269212,1,1,0,0,1,1,0,0,0
10269419,1,1,0,0,1,1,0,0,0
10269958,1,1,0,0,1,1,0,0,0
10270018,5,3,2,0,1,1,0,1,0
10270092,6,4,2,0,2,1,1,1,1
10270190,1,1,0,0,1,1,0,0,0
10270681,2,2,0,0,2,2,0,0,1
10271360,2,0,2,0,1,1,0,0,1
10271557,2,2,0,0,1,1,0,0,0
10272549,3,2,1,0,1,1,0,0,1
10272768,1,0,1,0,0,0,0,0,0
10273019,2,2,0,0,1,1,0,0,0
10273033,1,0,1,0,1,1,0,0,0
10273432,2,2,0,0,1,1,0,0,0
10273615,5,4,1,0,1,1,0,1,1
10273845,5,3,2,0,1,1,0,1,0
10273889,3,3,0,0,1,1,0,0,0
10274156,1,1,0,0,1,1,0,0,0
10274758,1,0,1,0,1,1,0,0,0
10274913,11,7,4,0,0,0,0,0,1
10275182,2,2,0,0,1,1,0,0,1
10275459,2,2,0,0,2,2,0,0,0
10275837,3,2,1,0,2,1,1,0,0
10276101,5,2,3,0,0,0,0,0,1
10276505,1,0,1,0,1,1,0,0,0
10276625,1,0,1,0,1,1,0,0,0
10277071,4,3,1,0,1,1,0,1,1
10277081,4,3,1,0,1,1,0,1,1
10277460,4,4,0,0,1,1,0,1,0
10277547,2,2,0,0,2,2,0,0,0
10277571,2,0,2,0,2,2,0,0,0
10277775,3,2,1,0,2,2,0,0,1
10278253,2,0,2,0,0,0,0,0,0
10278487,2,1,1,0,2,1,1,0,1
10278562,2,2,0,0,1,1,0,0,1
10278659,16,5,11,0,2,2,0,2,1
10278668,1,0,1,0,0,0,0,0,0
10278867,3,3,0,0,1,1,0,1,0
10279070,1,1,0,0,4,4,0,0,1
10279376,2,1,1,0,2,2,0,0,0
10280165,2,2,0,0,2,2,0,0,1
10280293,3,1,2,0,1,1,0,1,1
10281020,8,6,2,0,1,0,1,0,0
10281396,5,2,3,0,1,1,0,1,1
10281430,3,0,3,0,0,0,0,0,0
10281540,3,1,2,0,1,1,0,1,0
10282235,1,1,0,0,2,2,0,1,0
10282789,1,1,0,0,1,1,0,0,0
10283688,6,4,2,0,1,1,0,1,0
10284612,1,1,0,0,1,1,0,0,0
10284755,3,3,0,0,2,2,0,0,0
10285081,1,0,1,0,2,2,0,0,1
10285163,2,2,0,0,1,1,0,0,0
10285710,2,2,0,0,1,1,0,0,1
10285754,1,1,0,0,1,1,0,0,0
10286078,23,22,1,0,0,0,0,0,0
10286208,11,10,1,0,1,0,1,0,1
10286319,3,3,0,0,1,1,0,1,1
10286353,12,4,8,0,3,2,1,3,1
10286372,3,3,0,0,2,2,0,2,1
10286418,1,0,1,0,1,1,0,0,0
10286425,12,4,8,0,2,1,1,2,1
10286514,2,0,2,0,2,2,0,0,0
10286560,1,0,1,0,1,1,0,0,0
10287177,2,2,0,0,1,1,0,0,0
10287383,5,3,2,0,1,1,0,1,1
10287445,3,3,0,0,2,2,0,0,0
10287753,6,3,3,0,3,2,1,1,1
10287979,1,1,0,0,1,1,0,0,1
10288247,1,0,1,0,1,1,0,0,0
10288812,3,3,0,0,2,2,0,0,1
10289287,1,1,0,0,1,1,0,0,0
10289340,2,1,1,0,2,1,1,0,1
10289708,1,1,0,0,0,0,0,0,0
10289846,2,2,0,0,2,2,0,0,0
10289999,8,3,5,0,2,1,1,0,1
10290391,5,5,0,0,1,1,0,0,1
10290655,0,0,0,0,1,1,0,0,0
10290965,0,0,0,0,3,3,0,0,1
10291110,2,0,2,0,1,1,0,0,0
10291233,4,2,2,0,4,2,2,0,0
10291275,1,1,0,0,1,1,0,0,1
10291798,2,0,2,0,2,1,1,0,1
10292456,2,2,0,0,2,2,0,0,0
10292505,3,3,0,0,2,1,1,0,0
10292639,4,3,1,0,3,2,1,0,1
10293175,6,4,2,0,6,4,2,0,0
10293416,3,0,3,0,3,3,0,0,0
10293479,2,2,0,0,1,1,0,0,0
10293742,1,1,0,0,1,1,0,0,0
10293813,1,0,1,0,1,1,0,0,0
10293977,4,3,1,0,1,1,0,0,1
10294289,3,2,1,0,2,1,1,1,1
10294362,2,1,1,0,2,1,1,0,0
10294382,2,1,1,0,2,1,1,0,0
10294387,3,1,2,0,2,1,1,0,0
10294649,5,0,5,0,0,0,0,0,1
10295097,2,2,0,0,1,1,0,0,0
10295198,2,2,0,0,1,1,0,1,1
10295272,1,1,0,0,0,0,0,0,0
10295315,1,0,1,0,1,1,0,0,0
10295520,7,5,2,0,5,1,4,2,1
10295606,1,1,0,0,1,1,0,0,0
10296180,1,0,1,0,0,0,0,0,0
10296191,4,2,2,0,3,2,1,0,0
10296280,1,1,0,0,1,1,0,0,0
10297333,1,1,0,0,1,1,0,0,0
10297422,3,3,0,0,1,1,0,1,1
10297518,1,0,1,0,1,1,0,0,0
10297659,2,2,0,0,1,1,0,1,0
10297675,2,0,2,0,1,1,0,0,0
10297752,6,4,2,0,6,4,2,0,0
10298145,1,1,0,0,1,1,0,0,0
10298171,5,1,4,0,3,1,2,0,0
10298398,3,1,2,0,2,1,1,0,0
10298422,6,4,2,0,6,4,2,0,0
10298494,3,1,2,0,2,1,1,0,0
10298506,4,2,2,0,3,2,1,0,0
10298510,3,1,2,0,2,1,1,0,0
10298536,5,4,1,0,5,4,1,0,0
10298567,5,4,1,0,5,4,1,0,0
10298585,3,1,2,0,2,1,1,0,0
10298705,1,1,0,0,1,1,0,0,0
10298782,3,2,1,0,3,2,1,0,0
10298832,11,8,3,0,0,0,0,0,1
10298835,6,4,2,0,6,4,2,0,0
10298837,3,0,3,0,4,3,1,0,0
10298893,5,4,1,0,5,4,1,0,0
10299017,3,2,1,0,3,2,1,0,0
10299088,2,2,0,0,2,2,0,0,1
10299127,1,1,0,0,1,1,0,0,0
10299310,5,5,0,0,2,2,0,0,0
10299390,5,4,1,0,5,4,1,0,0
10299438,6,4,2,0,5,4,1,0,0
10299565,6,4,2,0,6,4,2,0,0
10299730,3,2,1,0,3,2,1,0,0
10299872,6,4,2,0,6,4,2,0,0
10299891,2,2,0,0,1,1,0,0,1
10300045,4,2,2,0,4,2,2,0,0
10300228,4,4,0,0,1,1,0,1,1
10300585,2,0,2,0,2,2,0,0,0
10300669,1,0,1,0,1,1,0,0,0
10300694,1,1,0,0,1,1,0,0,1
10300887,4,2,2,0,4,2,2,0,0
10301271,9,5,4,0,1,1,0,0,0
10301555,13,10,3,0,0,0,0,0,1
10301618,3,1,2,0,2,1,1,0,0
10301662,15,10,5,0,4,3,1,0,1
10301667,3,0,3,0,2,2,0,0,1
10301769,5,5,0,0,2,2,0,0,1
10301827,3,1,2,0,2,1,1,0,0
10302036,2,2,0,0,1,1,0,0,1
10302152,3,1,2,0,2,0,2,1,0
10302377,1,0,1,0,1,1,0,0,0
10302920,2,2,0,0,2,2,0,0,0
10303067,1,1,0,0,3,3,0,0,0
10303259,6,4,2,0,6,4,2,0,0
10303321,2,1,1,0,2,2,0,0,0
10303331,6,4,2,0,6,4,2,0,0
10303470,3,1,2,0,2,1,1,0,0
10303550,10,2,8,0,2,1,1,0,0
10303602,1,1,0,0,1,1,0,0,0
10303655,1,1,0,0,1,1,0,0,0
10303761,3,0,3,0,2,2,0,0,1
10303912,7,2,5,0,2,2,0,2,0
10303941,13,3,10,0,2,1,1,2,1
10303993,14,3,11,0,2,1,1,2,1
10303998,13,3,10,0,2,1,1,2,1
10304300,5,4,1,0,5,4,1,0,0
10305067,3,1,2,0,3,1,2,0,0
10305082,6,1,5,0,6,1,5,0,0
10305225,6,4,2,0,6,4,2,0,0
10305268,6,4,2,0,6,4,2,0,0
10305299,2,1,1,0,2,1,1,0,0
10305429,6,1,5,0,6,1,5,0,0
10305479,2,1,1,0,2,1,1,0,0
10305570,5,4,1,0,5,4,1,0,0
10305586,1,1,0,0,1,1,0,0,0
10305858,5,1,4,0,5,1,4,0,0
10305876,3,2,1,0,3,2,1,0,0
10305928,2,1,1,0,2,1,1,0,0
10305933,3,2,1,0,3,2,1,0,0
10306049,2,1,1,0,2,1,1,0,0
10306071,6,1,5,0,6,1,5,0,0
10306072,2,1,1,0,2,1,1,0,0
10306180,8,5,3,0,2,1,1,2,1
10306208,5,4,1,0,5,4,1,0,0
10306256,3,1,2,0,3,1,2,0,0
10306272,2,1,1,0,2,1,1,0,0
10306281,4,4,0,0,3,3,0,1,0
10306293,6,1,5,0,6,1,5,0,0
10306295,4,2,2,0,4,2,2,0,0
10306331,6,4,2,0,6,4,2,0,0
10306344,2,2,0,0,1,1,0,1,0
10306509,1,1,0,0,0,0,0,0,0
10306921,3,3,0,0,1,1,0,0,1
10307368,3,3,0,0,2,2,0,0,0
10308123,1,0,1,0,1,1,0,0,0
10310668,1,1,0,0,1,1,0,1,0
10311049,2,2,0,0,1,1,0,0,0
10311187,6,6,0,0,0,0,0,0,1
10311383,8,7,1,0,4,4,0,0,0
10311681,1,1,0,0,1,1,0,0,0
10312099,1,1,0,0,1,1,0,0,0
10313270,1,0,1,0,1,1,0,0,0
10313561,6,5,1,0,4,4,0,0,0
10313886,4,4,0,0,4,4,0,0,0
10314102,3,3,0,0,2,2,0,0,1
10314306,14,8,6,0,4,3,1,0,0
10314313,1,1,0,0,0,0,0,0,0
10314408,11,8,3,0,0,0,0,0,1
10314531,1,1,0,0,1,1,0,0,1
10315083,1,0,1,0,1,1,0,0,1
10315277,2,2,0,0,2,2,0,0,1
10315311,2,2,0,0,1,1,0,0,1
10315367,3,1,2,0,1,1,0,0,0
10315563,1,1,0,0,2,2,0,0,0
10315858,1,1,0,0,1,1,0,0,0
10316279,6,5,1,0,8,8,0,0,1
10316562,1,1,0,0,1,1,0,0,1
10316704,3,3,0,0,1,1,0,0,0
10316794,2,2,0,0,1,1,0,0,1
10316815,12,9,3,0,2,2,0,0,1
10317142,2,1,1,0,2,1,1,0,0
10317339,1,1,0,0,1,1,0,0,0
10317433,4,2,2,0,1,1,0,0,0
10317509,7,0,7,0,1,1,0,1,1
10317624,1,0,1,0,1,1,0,0,0
10318182,2,2,0,0,1,1,0,0,1
10318464,9,3,6,0,2,1,1,2,0
10320385,1,1,0,0,1,1,0,0,0
10320781,1,1,0,0,0,0,0,0,0
10321082,1,1,0,0,1,1,0,0,0
10321333,2,1,1,0,3,2,1,0,0
10321752,2,2,0,0,2,2,0,0,0
10322093,1,1,0,0,1,1,0,0,1
10322320,2,2,0,0,1,1,0,0,0
10322391,2,2,0,0,2,2,0,1,1
10322996,2,0,2,0,1,0,1,0,0
10323559,1,1,0,0,1,1,0,0,0
10323663,1,0,1,0,1,1,0,0,0
10323738,1,1,0,0,1,1,0,0,0
10323844,4,4,0,0,0,0,0,0,1
10323893,2,0,2,0,1,1,0,0,0
10324308,1,0,1,0,1,1,0,0,0
10324737,2,2,0,0,2,1,1,2,1
10325023,2,2,0,0,1,1,0,0,1
10325214,3,0,3,0,1,1,0,0,1
10325823,2,2,0,0,2,2,0,0,1
10325936,7,7,0,0,0,0,0,0,0
10325986,1,1,0,0,1,1,0,0,0
10326057,1,1,0,0,1,1,0,0,1
10326287,9,3,6,0,1,0,1,0,1
10326485,4,4,0,0,2,2,0,0,0
10327701,4,3,1,0,3,1,2,0,1
10327751,4,0,4,0,2,0,2,0,1
10327773,7,7,0,0,2,1,1,2,1
10327931,2,2,0,0,1,1,0,0,0
10328220,3,1,2,0,1,1,0,0,0
10328228,1,0,1,0,1,1,0,0,0
10328247,2,0,2,0,1,1,0,0,1
10328654,2,0,2,0,2,2,0,0,0
10328817,9,8,1,0,1,1,0,1,0
10328907,6,6,0,0,3,2,1,0,1
10329093,1,1,0,0,1,1,0,0,0
10329847,8,2,6,0,1,1,0,1,0
10329904,7,6,1,2,3,1,2,1,0
10329952,1,1,0,0,1,1,0,0,0
10330040,2,0,2,0,2,0,2,0,0
10330055,4,0,4,0,2,2,0,0,1
10330605,10,5,5,0,0,0,0,0,0
10330745,2,0,2,0,1,1,0,0,1
10330952,1,1,0,0,1,1,0,0,0
10331458,5,5,0,0,4,4,0,0,1
10331462,5,3,2,0,2,1,1,0,1
10331541,5,3,2,0,2,1,1,0,1
10332035,7,3,4,0,3,1,2,1,1
10332245,5,4,1,0,3,2,1,0,1
10332469,1,1,0,0,1,1,0,0,0
10332557,2,0,2,0,1,1,0,0,0
10332624,1,0,1,0,1,1,0,0,0
10332806,1,1,0,0,1,1,0,0,0
10333182,5,2,3,0,2,1,1,2,0
10333266,2,0,2,0,2,2,0,0,0
10333346,1,1,0,0,0,0,0,0,0
10333760,1,1,0,0,1,1,0,0,0
10333838,2,2,0,0,1,1,0,1,0
10333933,3,0,3,0,0,0,0,0,1
10334295,1,1,0,0,2,2,0,0,1
10334477,1,1,0,0,1,1,0,0,0
10335564,1,0,1,0,1,1,0,0,0
10335679,1,1,0,0,1,1,0,0,0
10335773,4,0,4,0,3,3,0,0,1
10336101,2,1,1,0,2,2,0,0,0
10336105,2,0,2,0,1,1,0,0,0
10336298,4,2,2,0,2,1,1,2,0
10336538,4,2,2,0,2,1,1,2,0
10336573,2,2,0,0,1,1,0,0,0
10336867,1,1,0,0,1,1,0,0,0
10336882,2,2,0,0,2,2,0,0,1
10337107,2,2,0,0,2,2,0,0,0
10338263,3,3,0,0,2,2,0,0,0
10338444,9,8,1,0,5,4,1,0,1
10338509,1,0,1,0,1,1,0,0,1
10338655,5,3,2,0,0,0,0,0,1
10338855,5,5,0,0,1,0,1,0,1
10339203,1,1,0,0,1,1,0,1,0
10339463,2,1,1,0,2,1,1,0,0
10339792,1,1,0,0,1,1,0,0,0
10340157,1,0,1,0,1,1,0,0,0
10340525,2,2,0,0,2,2,0,0,0
10340889,1,1,0,0,2,2,0,0,0
10342252,3,3,0,0,2,2,0,0,0
10342270,3,1,2,0,3,3,0,2,0
10342274,3,1,2,0,3,3,0,2,0
10342565,2,2,0,0,2,2,0,0,0
10342680,1,1,0,0,1,1,0,0,0
10342961,1,1,0,0,1,1,0,0,1
10343076,1,0,1,0,1,1,0,0,0
10343281,2,2,0,0,1,1,0,0,0
10343492,3,0,3,0,3,1,2,0,0
10343645,19,11,8,0,3,0,3,0,0
10343992,7,5,2,0,3,1,2,1,0
10344118,10,2,8,0,1,1,0,1,1
10344134,2,2,0,0,1,1,0,0,1
10344321,5,3,2,0,0,0,0,0,0
10344821,1,1,0,0,1,1,0,0,0
10345116,2,0,2,0,2,1,1,0,1
10345175,1,1,0,0,1,1,0,0,0
10345238,1,1,0,0,2,1,1,0,0
10346170,1,1,0,0,1,1,0,0,0
10346822,1,1,0,0,1,1,0,0,0
10347568,1,1,0,0,1,1,0,0,0
10347606,10,5,5,0,2,1,1,2,1
10347882,3,3,0,0,0,0,0,0,1
10347986,1,0,1,0,1,1,0,0,0
10348109,10,3,7,0,1,1,0,1,1
10348155,2,2,0,0,2,2,0,0,0
10348636,17,12,5,0,0,0,0,0,0
10348868,1,1,0,0,1,1,0,0,0
10349199,5,2,3,0,1,1,0,1,1
10349398,3,3,0,0,1,1,0,1,1
10349595,1,0,1,0,1,1,0,0,0
10350067,1,1,0,0,1,1,0,0,0
10350242,1,0,1,0,1,1,0,0,0
10350375,2,2,0,0,1,1,0,0,1
10351098,1,1,0,0,1,1,0,0,0
10351201,1,0,1,0,1,1,0,0,0
10351671,1,1,0,0,2,2,0,0,0
10352235,11,7,4,0,0,0,0,0,0
10352295,4,4,0,0,2,2,0,0,0
10352515,2,0,2,0,1,1,0,0,0
10352572,1,0,1,0,1,1,0,0,0
10352693,2,2,0,0,3,1,2,1,0
10352812,2,1,1,0,3,1,2,0,0
10353192,3,0,3,0,1,1,0,1,0
10353312,1,1,0,0,1,1,0,0,0
10353605,1,1,0,0,1,1,0,0,0
10353613,1,1,0,0,1,1,0,0,0
10353624,1,1,0,0,2,1,1,1,1
10353628,2,2,0,0,2,2,0,0,1
10353646,3,3,0,0,0,0,0,0,0
10353651,5,4,1,0,3,3,0,0,1
10353810,6,6,0,0,1,1,0,1,0
10354269,2,2,0,0,2,2,0,0,0
10354881,1,1,0,0,1,1,0,0,0
10355120,1,0,1,0,1,1,0,0,0
10355868,3,2,1,0,2,1,1,0,0
10355991,2,1,1,0,1,1,0,0,0
10356526,2,0,2,0,1,1,0,0,0
10356527,2,0,2,0,2,2,0,0,0
10357112,4,4,0,0,0,0,0,0,1
10357693,2,0,2,0,2,2,0,0,1
10357700,1,1,0,0,2,2,0,0,0
10357789,1,0,1,0,1,1,0,0,0
10358087,2,0,2,0,1,1,0,0,1
10358688,1,1,0,0,1,1,0,0,0
10358813,6,4,2,0,2,1,1,0,1
10359058,2,2,0,0,1,1,0,0,0
10359466,4,3,1,0,0,0,0,0,0
10359537,1,0,1,0,1,1,0,0,0
10359854,2,2,0,0,2,1,1,1,1
08936296,2,2,0,0,2,2,0,0,0
08936381,5,2,3,0,0,0,0,0,0
08936446,3,3,0,0,2,2,0,0,1
08936462,5,0,5,0,1,0,1,0,0
08936468,13,0,13,1,0,0,0,0,1
08936601,6,3,3,0,1,1,0,0,1
08936641,1,1,0,0,1,1,0,0,0
08936673,2,2,0,0,1,1,0,1,1
08936692,1,0,1,0,0,0,0,0,0
08936739,1,1,0,0,1,1,0,0,0
08937418,4,2,2,0,5,1,4,3,1
08938221,2,2,0,0,2,2,0,0,0
08938249,4,3,1,0,0,0,0,0,0
08938369,2,1,1,0,0,0,0,0,0
08938397,5,3,2,0,0,0,0,0,0
08939287,4,3,1,0,0,0,0,0,1
08940058,5,2,3,0,1,1,0,1,0
08940349,7,0,7,0,1,1,0,1,1
08940386,5,4,1,0,1,1,0,0,1
08940576,2,0,2,0,1,1,0,0,0
08940850,2,2,0,0,2,2,0,0,0
08940987,20,12,8,0,0,0,0,0,1
08941161,1,1,0,0,2,2,0,0,0
08941249,1,0,1,0,1,1,0,0,0
08941338,15,0,15,0,3,3,0,0,1
08941559,1,1,0,0,1,1,0,0,0
08941641,1,1,0,0,1,1,0,0,0
08941652,1,1,0,0,1,1,0,0,0
08941790,1,1,0,0,1,1,0,0,0
08942392,1,1,0,0,1,1,0,0,0
08943003,3,1,2,0,1,1,0,0,0
08943014,5,3,2,0,2,2,0,2,1
08943164,13,2,11,0,4,1,3,1,1
08943445,2,1,1,0,2,2,0,0,0
08943545,7,1,6,0,4,1,3,0,0
08943621,1,0,1,0,0,0,0,0,0
08943852,3,1,2,0,1,1,0,0,0
08943878,5,2,3,0,3,2,1,0,0
08944677,11,1,10,0,2,1,1,0,0
08944865,6,1,5,0,3,1,2,0,0
08945144,2,1,1,0,1,1,0,0,0
08945307,1,1,0,0,2,2,0,0,0
08945412,9,8,1,0,1,1,0,0,0
08945530,10,5,5,0,5,5,0,1,1
08945886,7,6,1,0,3,3,0,0,1
08946343,2,2,0,0,1,1,0,0,0
08946648,1,0,1,0,0,0,0,0,1
08947110,1,1,0,0,1,1,0,0,0
08947176,1,1,0,0,1,1,0,0,0
08947320,4,1,3,0,1,1,0,0,0
08947328,5,0,5,0,2,1,1,0,0
08947349,2,1,1,0,1,1,0,0,0
08947460,7,1,6,0,5,1,4,0,0
08947462,5,4,1,0,3,0,3,0,0
08947539,9,1,8,0,5,1,4,0,0
08947646,7,0,7,0,3,1,2,0,0
08947831,1,0,1,0,1,1,0,0,0
08947843,5,0,5,0,3,1,2,0,0
08947897,2,1,1,0,1,1,0,0,0
08947927,7,1,6,0,3,1,2,0,0
08947956,5,1,4,0,2,1,1,0,0
08947958,6,0,6,0,2,1,1,0,0
08948015,7,0,7,0,2,1,1,0,0
08948016,6,0,6,0,2,1,1,0,0
08948040,2,2,0,0,2,2,0,0,0
08948041,10,1,9,0,4,1,3,0,0
08948050,8,1,7,0,3,1,2,0,0
08948092,2,2,0,0,1,1,0,0,1
08948508,2,0,2,0,0,0,0,0,0
08948560,22,4,18,0,0,0,0,0,0
08948603,32,17,15,0,0,0,0,0,1
08948604,7,2,5,0,0,0,0,0,1
08948625,13,3,10,0,2,2,0,2,1
08949273,1,1,0,0,1,1,0,0,0
08949444,1,1,0,0,1,1,0,0,0
08949476,15,2,13,0,1,1,0,1,1
08949503,4,3,1,0,1,1,0,1,1
08949672,10,1,9,0,3,1,2,0,0
08949771,1,1,0,0,1,1,0,0,0
08949803,6,3,3,0,5,1,4,1,1
08949994,10,0,10,0,3,1,2,0,0
08950004,10,0,10,0,4,1,3,0,0
08950018,5,0,5,0,3,1,2,0,0
08950191,10,1,9,0,4,1,3,0,0
08950250,12,0,12,0,2,1,1,0,0
08950307,13,1,12,0,7,1,6,0,0
08950318,11,1,10,0,5,1,4,0,0
08950455,6,1,5,0,3,1,2,0,0
08950466,10,1,9,0,4,1,3,0,0
08950471,5,0,5,0,3,1,2,0,0
08950504,6,1,5,0,4,1,3,0,0
08951205,4,3,1,0,2,2,0,0,1
08951718,8,0,8,0,2,1,1,0,0
08951766,3,0,3,0,2,1,1,0,0
08951791,2,2,0,0,1,1,0,0,1
08951798,2,2,0,0,1,1,0,0,1
08952126,20,8,12,0,0,0,0,0,0
08952407,1,1,0,0,1,1,0,0,0
08952413,1,0,1,0,0,0,0,0,0
08953010,6,3,3,0,1,1,0,1,0
08953130,4,3,1,0,0,0,0,0,1
08953356,3,0,3,0,0,0,0,0,1
08953385,1,1,0,0,1,1,0,0,0
08953432,6,4,2,0,1,1,0,1,1
08954053,3,1,2,0,1,1,0,0,0
08954358,3,2,1,0,2,1,1,0,0
08954574,2,2,0,0,1,1,0,0,0
08954706,1,0,1,0,1,1,0,0,0
08955328,8,5,3,0,2,2,0,2,0
08955729,3,3,0,0,3,3,0,0,0
08955757,1,0,1,0,0,0,0,0,0
08955803,5,3,2,0,3,3,0,0,1
08956143,10,7,3,0,2,0,2,0,1
08956168,5,5,0,0,1,1,0,1,1
08956189,8,5,3,0,1,1,0,0,0
08956235,3,3,0,0,1,1,0,1,0
08956768,5,2,3,0,0,0,0,0,0
08956996,1,1,0,0,1,1,0,0,1
08957339,11,0,11,0,0,0,0,0,1
08957427,2,2,0,0,2,2,0,0,0
08957447,5,0,5,0,3,1,2,0,0
08957729,7,1,6,0,2,1,1,0,0
08957792,3,3,0,0,1,1,0,0,0
08958097,6,5,1,0,3,3,0,0,1
08958196,8,4,4,0,0,0,0,0,0
08958199,1,1,0,0,1,1,0,0,0
08958574,10,7,3,0,1,1,0,1,1
08958580,10,7,3,0,1,1,0,1,1
08958651,10,1,9,0,3,1,2,0,0
08958658,1,1,0,0,1,1,0,0,0
08958722,2,0,2,0,0,0,0,0,0
08959230,4,2,2,0,1,1,0,0,0
08959244,12,1,11,0,4,1,3,0,0
08959675,2,1,1,0,1,1,0,0,0
08959688,11,3,8,0,1,1,0,1,0
08959704,4,2,2,0,1,1,0,0,0
08959707,3,2,1,0,1,1,0,0,0
08959772,2,2,0,0,2,2,0,0,0
08959908,11,3,8,0,1,1,0,1,1
08960215,4,1,3,0,2,1,1,0,0
08960221,1,0,1,0,0,0,0,0,0
08960263,8,0,8,0,3,1,2,0,0
08960361,2,2,0,0,1,1,0,0,0
08960430,17,10,7,0,1,1,0,1,1
08960635,12,7,5,0,0,0,0,0,0
08960754,1,1,0,0,1,1,0,0,0
08960905,11,4,7,0,1,1,0,0,0
08961046,2,2,0,0,2,2,0,0,1
08961063,4,1,3,0,1,1,0,0,0
08961108,3,3,0,0,1,1,0,0,0
08961147,10,5,5,0,1,1,0,1,1
08961178,1,0,1,0,0,0,0,0,0
08961358,14,3,11,0,0,0,0,0,0
08961460,1,1,0,0,1,1,0,0,0
08961952,1,0,1,0,0,0,0,0,0
08961986,2,2,0,0,1,1,0,0,0
08962173,2,2,0,0,3,1,2,3,0
08962271,3,0,3,0,2,2,0,1,1
08962296,2,0,2,0,1,1,0,0,1
08962340,2,2,0,0,2,2,0,0,1
08962442,2,2,0,0,2,2,0,0,0
08962562,2,2,0,0,1,1,0,0,0
08962626,4,0,4,0,2,1,1,0,0
08962671,2,1,1,0,1,1,0,0,0
08962801,10,1,9,0,6,1,5,0,0
08963120,4,0,4,0,0,0,0,0,1
08963147,1,0,1,0,1,1,0,0,0
08964168,4,2,2,0,1,1,0,1,1
08964184,4,3,1,0,2,2,0,0,0
08964279,3,1,2,0,1,1,0,0,1
08964362,1,1,0,0,1,1,0,0,0
08964377,10,5,5,0,1,1,0,1,1
08964573,5,3,2,0,1,1,0,0,1
08965088,2,0,2,0,1,1,0,0,0
08965374,1,1,0,0,1,1,0,0,0
08965488,4,2,2,0,4,2,2,1,0
08965580,3,3,0,0,2,2,0,0,0
08965703,2,0,2,0,0,0,0,0,1
08966126,6,0,6,0,0,0,0,0,1
08966229,1,0,1,0,0,0,0,0,0
08966312,5,5,0,0,1,1,0,1,1
08966517,2,0,2,0,0,0,0,0,0
08966580,2,2,0,0,2,2,0,0,0
08966665,2,0,2,0,0,0,0,0,0
08966667,2,0,2,0,0,0,0,0,0
08966900,1,1,0,0,1,1,0,1,0
08966944,1,0,1,0,0,0,0,0,1
08966951,2,0,2,0,0,0,0,0,0
08966990,1,1,0,0,1,1,0,0,0
08967086,1,0,1,0,1,1,0,0,0
08967087,2,2,0,0,1,1,0,0,1
08967282,2,0,2,0,0,0,0,0,0
08967298,2,0,2,0,0,0,0,0,0
08967308,2,0,2,0,0,0,0,0,0
08967389,1,1,0,0,1,1,0,0,0
08967538,2,0,2,0,0,0,0,0,0
08967847,4,4,0,0,1,1,0,0,1
08968154,16,8,8,0,0,0,0,0,1
08968205,6,3,3,0,2,2,0,0,1
08968352,2,0,2,0,0,0,0,0,0
08968364,4,2,2,0,0,0,0,0,0
08968404,2,0,2,0,0,0,0,0,0
08968406,2,0,2,0,0,0,0,0,0
08968407,2,0,2,0,0,0,0,0,0
08968429,2,0,2,0,0,0,0,0,0
08969120,2,0,2,0,0,0,0,0,0
08969244,3,3,0,0,3,3,0,0,1
08969363,2,0,2,0,0,0,0,0,0
08969482,2,0,2,0,0,0,0,0,0
08969763,4,0,4,0,1,1,0,0,0
08969772,2,0,2,0,0,0,0,0,0
08969778,2,2,0,0,3,3,0,1,0
08969841,2,2,0,0,2,2,0,0,0
08969872,5,0,5,0,2,1,1,0,0
08970067,17,8,9,0,1,1,0,1,1
08970174,2,0,2,0,0,0,0,0,0
08970203,2,0,2,0,0,0,0,0,0
08970219,3,3,0,0,1,1,0,0,0
08970298,1,1,0,0,1,1,0,0,1
08970395,10,3,7,0,1,1,0,1,1
08971147,2,0,2,0,0,0,0,0,0
08971192,5,4,1,0,4,4,0,0,1
08971446,4,4,0,0,0,0,0,0,0
08971648,8,0,8,0,2,1,1,0,0
08971665,2,0,2,0,0,0,0,0,0
08971731,2,0,2,0,0,0,0,0,0
08971785,2,0,2,0,0,0,0,0,0
08971786,3,0,3,0,2,2,0,0,1
08971836,1,1,0,0,1,1,0,0,0
08971894,2,0,2,0,0,0,0,0,0
08971932,3,2,1,0,1,1,0,0,0
08972062,2,0,2,0,0,0,0,0,0
08972114,2,0,2,0,0,0,0,0,0
08972233,2,0,2,0,0,0,0,0,0
08972260,3,1,2,0,0,0,0,0,0
08972299,2,0,2,0,0,0,0,0,0
08972333,2,0,2,0,0,0,0,0,0
08972469,1,1,0,0,1,1,0,1,0
08972526,2,0,2,0,0,0,0,0,0
08972587,2,0,2,0,0,0,0,0,0
08972606,2,0,2,0,0,0,0,0,0
08972646,2,0,2,0,0,0,0,0,0
08972837,2,0,2,0,0,0,0,0,0
08972883,2,0,2,0,0,0,0,0,0
08972921,2,0,2,0,0,0,0,0,0
08972953,2,0,2,0,0,0,0,0,0
08973063,2,0,2,0,0,0,0,0,0
08973076,2,0,2,0,0,0,0,0,0
08973184,1,0,1,0,0,0,0,0,1
08973708,2,0,2,0,0,0,0,0,0
08973734,2,0,2,0,0,0,0,0,0
08973753,2,0,2,0,0,0,0,0,0
08973758,2,0,2,0,0,0,0,0,0
08973852,2,0,2,0,0,0,0,0,0
08973882,2,0,2,0,0,0,0,0,0
08973885,2,0,2,0,0,0,0,0,0
08973926,1,1,0,0,1,1,0,0,0
08973993,2,0,2,0,0,0,0,0,0
08974119,4,1,3,0,4,1,3,0,0
08974256,2,0,2,0,0,0,0,0,0
08974283,2,0,2,0,0,0,0,0,1
08974356,1,1,0,0,1,1,0,0,0
08974489,2,0,2,0,0,0,0,0,0
08974512,2,0,2,0,0,0,0,0,0
08974595,12,11,1,0,0,0,0,0,0
08974638,11,0,11,0,2,1,1,0,0
08974674,2,0,2,0,0,0,0,0,0
08974679,2,0,2,0,0,0,0,0,0
08974704,2,0,2,0,0,0,0,0,0
08974718,2,0,2,0,0,0,0,0,0
08974798,2,0,2,0,0,0,0,0,0
08974800,2,0,2,0,0,0,0,0,0
08974801,2,0,2,0,0,0,0,0,0
08974803,2,0,2,0,0,0,0,0,0
08974839,2,0,2,0,0,0,0,0,0
08974867,2,0,2,0,0,0,0,0,0
08974914,2,0,2,0,0,0,0,0,0
08974927,2,0,2,0,0,0,0,0,0
08974936,2,0,2,0,0,0,0,0,0
08974948,2,0,2,0,0,0,0,0,0
08974957,9,1,8,0,1,1,0,0,0
08975009,7,0,7,0,2,1,1,0,0
08975060,2,0,2,0,0,0,0,0,0
08975070,2,0,2,0,0,0,0,0,0
08975108,6,2,4,0,2,1,1,0,0
08975172,1,1,0,0,1,1,0,0,0
08975211,10,1,9,0,5,1,4,0,0
08975452,2,0,2,0,0,0,0,0,0
08975534,2,1,1,0,1,1,0,0,1
08975590,4,4,0,0,0,0,0,0,1
08975654,2,0,2,0,0,0,0,0,0
08975710,2,0,2,0,0,0,0,0,0
08975740,2,0,2,0,0,0,0,0,0
08975770,2,0,2,0,0,0,0,0,0
08975796,2,0,2,0,0,0,0,0,0
08975915,2,0,2,0,0,0,0,0,0
08975924,2,0,2,0,0,0,0,0,0
08975929,2,0,2,0,0,0,0,0,0
08975965,14,1,13,0,4,1,3,0,0
08976003,2,0,2,0,0,0,0,0,0
08976098,2,0,2,0,0,0,0,0,0
08976317,2,0,2,0,0,0,0,0,0
08976336,2,0,2,0,1,1,0,0,0
08976353,6,0,6,0,3,1,2,0,0
08976403,3,0,3,0,2,1,1,0,0
08976428,6,0,6,0,1,1,0,0,0
08976522,9,0,9,0,3,1,2,0,0
08976626,1,0,1,0,0,0,0,0,0
08976675,2,0,2,0,0,0,0,0,0
08976754,2,0,2,0,0,0,0,0,0
08976855,2,0,2,0,0,0,0,0,0
08976887,7,6,1,0,1,1,0,1,1
08976888,5,4,1,0,1,1,0,1,1
08976927,2,0,2,0,0,0,0,0,0
08976973,2,0,2,0,0,0,0,0,0
08976998,2,0,2,0,0,0,0,0,0
08977002,1,1,0,0,1,1,0,0,0
08977050,2,0,2,0,0,0,0,0,0
08977098,2,0,2,0,0,0,0,0,0
08977219,2,0,2,0,0,0,0,0,0
08977236,6,2,4,0,1,1,0,1,1
08977238,2,0,2,0,0,0,0,0,0
08977349,1,1,0,0,1,1,0,0,0
08977432,2,0,2,0,0,0,0,0,0
08977452,1,1,0,0,1,1,0,0,0
08977499,2,0,2,0,0,0,0,0,0
08977527,1,1,0,0,1,1,0,1,0
08977538,2,0,2,0,0,0,0,0,0
08977608,2,0,2,0,0,0,0,0,0
08977671,2,0,2,0,0,0,0,0,0
08977729,2,0,2,0,0,0,0,0,0
08977786,2,1,1,0,1,1,0,0,0
08977812,2,0,2,0,0,0,0,0,0
08977813,2,0,2,0,0,0,0,0,0
08977901,2,0,2,0,0,0,0,0,0
08977939,2,0,2,0,0,0,0,0,0
08977960,2,0,2,0,0,0,0,0,0
08978200,2,0,2,0,0,0,0,0,0
08978246,2,0,2,0,0,0,0,0,0
08978260,2,0,2,0,0,0,0,0,0
08978341,2,0,2,0,0,0,0,0,0
08978343,2,0,2,0,0,0,0,0,0
08978385,2,0,2,0,0,0,0,0,0
08978463,2,0,2,0,0,0,0,0,0
08978533,2,0,2,0,0,0,0,0,0
08978582,2,0,2,0,0,0,0,0,0
08978588,2,0,2,0,0,0,0,0,0
08978706,2,0,2,0,0,0,0,0,0
08978735,2,0,2,0,0,0,0,0,0
08978871,6,1,5,0,3,1,2,0,0
08979122,9,1,8,0,2,1,1,0,0
08979158,4,1,3,0,1,1,0,0,0
08979649,5,4,1,0,2,2,0,2,1
08979932,2,0,2,0,0,0,0,0,0
08979995,2,0,2,0,0,0,0,0,0
08980046,2,0,2,0,2,2,0,1,0
08980088,2,0,2,0,0,0,0,0,0
08980140,9,6,3,0,1,1,0,1,1
08980157,4,4,0,0,1,1,0,1,1
08980172,2,0,2,0,0,0,0,0,0
08980180,2,0,2,0,0,0,0,0,0
08980254,2,0,2,0,0,0,0,0,0
08980326,2,0,2,0,0,0,0,0,0
08980328,2,0,2,0,0,0,0,0,0
08980374,17,8,9,0,1,1,0,1,1
08980388,2,0,2,0,0,0,0,0,0
08980391,2,0,2,0,0,0,0,0,0
08980412,2,0,2,0,0,0,0,0,0
08980430,2,0,2,0,0,0,0,0,0
08980472,2,0,2,0,0,0,0,0,0
08980487,2,0,2,0,0,0,0,0,0
08980495,1,0,1,0,0,0,0,0,0
08980562,2,0,2,0,0,0,0,0,0
08980599,2,0,2,0,0,0,0,0,0
08980610,2,0,2,0,0,0,0,0,0
08980648,2,0,2,0,0,0,0,0,0
08980695,10,0,10,0,0,0,0,0,1
08980707,2,0,2,0,0,0,0,0,0
08980764,2,0,2,0,0,0,0,0,0
08980776,2,0,2,0,0,0,0,0,0
08980857,2,0,2,0,0,0,0,0,0
08980867,2,0,2,0,0,0,0,0,0
08980875,2,0,2,0,0,0,0,0,0
08980891,2,0,2,0,0,0,0,0,0
08980896,2,0,2,0,0,0,0,0,0
08980974,2,0,2,0,0,0,0,0,0
08980979,2,0,2,0,0,0,0,0,0
08980998,2,0,2,0,0,0,0,0,0
08981018,2,0,2,0,0,0,0,0,0
08981077,2,0,2,0,0,0,0,0,0
08981096,2,0,2,0,0,0,0,0,0
08981138,2,0,2,0,0,0,0,0,0
08981169,2,0,2,0,0,0,0,0,0
08981185,2,0,2,0,0,0,0,0,0
08981200,2,0,2,0,0,0,0,0,0
08981209,2,0,2,0,0,0,0,0,0
08981261,2,0,2,0,0,0,0,0,0
08981286,2,0,2,0,0,0,0,0,0
08981312,2,0,2,0,0,0,0,0,0
08981327,2,0,2,0,0,0,0,0,0
08981347,2,0,2,0,0,0,0,0,0
08981421,2,0,2,0,0,0,0,0,0
08981430,2,0,2,0,0,0,0,0,0
08981476,2,0,2,0,0,0,0,0,0
08981560,2,0,2,0,0,0,0,0,0
08981650,2,0,2,0,0,0,0,0,0
08981917,1,1,0,0,1,1,0,0,0
08982069,4,2,2,0,3,1,2,1,1
08982139,1,1,0,0,1,1,0,0,0
08982623,2,0,2,0,0,0,0,0,0
08982705,4,1,3,0,1,1,0,0,0
08982719,1,1,0,0,1,1,0,0,0
08982767,2,0,2,0,0,0,0,0,0
08982802,2,0,2,0,0,0,0,0,0
08982994,14,7,7,0,1,1,0,1,1
09170143,4,1,3,0,1,1,0,1,1
09170222,1,1,0,0,1,1,0,0,0
09171201,7,5,2,0,2,1,1,1,1
09171348,2,2,0,0,2,2,0,0,0
09172019,1,0,1,0,0,0,0,0,0
09172319,3,3,0,0,2,2,0,0,1
09172612,1,1,0,0,0,0,0,0,1
09172730,24,10,14,0,0,0,0,0,0
09172733,3,0,3,0,2,2,0,0,1
09172786,1,0,1,0,1,1,0,0,0
09173262,1,0,1,0,1,1,0,0,0
09173593,1,1,0,0,1,1,0,0,0
09174224,5,5,0,0,1,1,0,1,0
09174257,3,2,1,0,1,1,0,1,0
09174673,6,2,4,0,0,0,0,0,0
09176084,10,1,9,0,2,1,1,0,0
09176301,2,0,2,0,0,0,0,0,1
09176541,3,1,2,0,1,1,0,0,1
09177243,3,0,3,0,2,2,0,0,0
09177357,4,0,4,0,0,0,0,0,1
09177368,1,1,0,0,1,1,0,0,0
09178105,10,4,6,0,1,1,0,0,0
09178127,5,4,1,0,1,1,0,1,1
09178233,3,1,2,0,1,1,0,1,1
09178492,3,0,3,0,0,0,0,0,0
09178527,5,0,5,0,2,2,0,0,1
09178600,3,3,0,0,1,1,0,1,0
09179304,7,2,5,0,3,1,2,1,0
09179583,12,6,6,0,0,0,0,0,1
09179784,2,2,0,0,2,2,0,0,0
09179847,2,2,0,0,1,1,0,0,0
09179965,5,4,1,0,1,1,0,1,1
09180235,2,2,0,0,1,1,0,0,0
09180248,2,2,0,0,3,3,0,0,1
09180251,3,0,3,0,0,0,0,0,1
09180312,2,0,2,0,1,1,0,0,0
09180443,6,0,6,0,2,2,0,2,1
09180636,3,3,0,0,3,1,2,0,1
09180771,1,1,0,0,1,1,0,0,0
09180826,2,0,2,0,0,0,0,0,0
09181389,2,1,1,0,1,1,0,0,0
09181437,1,1,0,0,3,3,0,0,0
09181467,4,2,2,0,1,1,0,0,1
09181692,5,2,3,0,2,2,0,0,0
09182238,10,4,6,0,1,1,0,1,1
09182297,8,5,3,0,0,0,0,0,1
09182824,1,1,0,0,1,1,0,0,1
09182951,1,1,0,0,1,1,0,0,0
09183300,2,2,0,0,2,2,0,0,0
09183815,5,3,2,0,1,1,0,1,1
09184190,6,5,1,0,0,0,0,0,0
09184222,5,4,1,0,0,0,0,0,1
09184578,2,2,0,0,2,2,0,0,0
09184614,2,0,2,0,1,1,0,0,0
09184978,8,3,5,0,1,1,0,1,1
09185079,3,0,3,0,1,1,0,0,1
09185231,3,0,3,0,1,1,0,0,1
09185739,2,2,0,0,3,3,0,0,0
09186397,2,2,0,0,2,2,0,0,0
09186607,1,1,0,0,1,1,0,0,0
09187037,2,0,2,0,0,0,0,0,1
09187171,4,0,4,0,3,1,2,0,0
09187188,2,2,0,0,2,2,0,0,0
09187524,3,3,0,0,1,1,0,0,1
09187593,3,0,3,0,0,0,0,0,1
09188248,5,3,2,0,4,1,3,1,1
09188274,1,0,1,0,0,0,0,0,0
09188609,2,2,0,0,1,1,0,0,0
09189074,1,1,0,0,1,1,0,0,1
09189445,2,2,0,0,2,2,0,0,1
09189538,1,1,0,0,0,0,0,0,0
09189547,1,0,1,0,1,1,0,0,0
09190099,9,5,4,0,1,1,0,1,1
09190118,1,1,0,0,1,1,0,0,0
09190138,4,3,1,0,2,2,0,1,0
09190208,10,4,6,0,2,1,1,2,1
09190343,1,0,1,0,0,0,0,0,1
09190811,2,2,0,0,2,2,0,0,1
09190995,5,5,0,0,1,1,0,0,0
09191251,6,2,4,0,3,2,1,1,0
09192178,3,3,0,0,1,1,0,0,0
09192516,1,0,1,0,1,1,0,0,0
09192684,1,1,0,0,1,1,0,0,0
09192995,1,1,0,0,1,1,0,0,0
09193121,2,2,0,0,1,1,0,0,0
09193455,4,3,1,0,3,3,0,0,1
09193647,2,1,1,0,1,1,0,0,0
09193673,1,0,1,0,0,0,0,0,0
09193710,2,0,2,0,0,0,0,0,1
09193729,6,5,1,0,2,2,0,1,1
09193760,3,3,0,0,2,2,0,0,1
09194207,5,0,5,0,0,0,0,0,1
09194335,2,0,2,0,1,1,0,1,1
09194685,1,1,0,0,1,1,0,0,1
09194776,6,3,3,0,2,1,1,2,1
09194815,2,2,0,0,0,0,0,0,1
09194888,6,3,3,0,1,1,0,1,1
09194891,1,1,0,0,1,1,0,0,0
09194901,6,3,3,0,1,1,0,1,1
09195191,10,3,7,0,2,1,1,2,1
09195676,1,1,0,0,1,1,0,0,0
09195895,6,6,0,0,0,0,0,0,0
09196038,3,3,0,0,3,3,0,0,1
09196055,6,4,2,0,1,1,0,1,1
09196491,5,3,2,0,2,2,0,0,0
09196582,3,2,1,0,3,2,1,0,1
09197041,6,5,1,0,0,0,0,0,0
09197146,10,7,3,0,2,1,1,0,0
09197223,12,11,1,0,0,0,0,0,0
09197832,1,1,0,0,1,1,0,0,0
09197897,2,2,0,0,2,2,0,0,0
09198154,2,1,1,0,1,1,0,0,0
09198642,1,1,0,0,1,1,0,0,0
09198776,2,1,1,0,3,2,1,0,0
09199096,4,0,4,0,0,0,0,0,1
09199117,3,3,0,0,2,2,0,0,0
09199138,1,1,0,0,1,1,0,0,0
09199165,1,1,0,0,1,1,0,0,0
09199187,2,1,1,0,1,1,0,0,0
09200095,2,2,0,0,2,2,0,0,0
09200175,2,2,0,0,1,1,0,0,1
09200332,13,8,5,0,2,2,0,0,1
09200896,2,2,0,0,2,2,0,0,0
09201277,7,5,2,0,1,1,0,0,0
09201527,3,1,2,0,1,1,0,0,0
09201987,12,12,0,0,1,1,0,0,1
09202107,3,0,3,0,0,0,0,0,1
09202122,7,7,0,0,1,1,0,0,0
09202149,1,0,1,0,0,0,0,0,0
09202205,3,3,0,0,2,2,0,0,1
09202829,3,0,3,0,0,0,0,0,1
09203327,3,1,2,0,1,1,0,0,1
09203788,10,1,9,0,4,1,3,0,0
09203909,2,1,1,0,1,1,0,0,1
09203935,2,2,0,0,2,2,0,0,0
09203965,4,1,3,0,1,1,0,0,0
09205082,2,0,2,0,0,0,0,0,0
09205415,3,0,3,0,1,0,1,0,0
09205897,10,1,9,0,4,1,3,0,0
09205990,3,3,0,0,3,1,2,2,0
09206164,4,2,2,0,1,1,0,0,0
09206682,5,3,2,0,3,1,2,3,1
09206714,1,1,0,0,1,1,0,0,0
09206830,2,2,0,0,2,2,0,0,0
09208199,1,0,1,0,0,0,0,0,0
09208409,9,4,5,0,1,1,0,1,1
09208871,3,3,0,0,3,1,2,0,1
09208873,2,1,1,0,2,1,1,0,0
09208996,3,3,0,0,3,3,0,0,0
09209228,2,2,0,0,2,2,0,0,0
09209274,1,1,0,0,1,1,0,0,0
09209410,7,3,4,0,1,1,0,0,1
09209488,16,4,12,0,3,1,2,3,1
09210656,3,2,1,0,1,1,0,0,1
09210887,1,0,1,0,1,1,0,0,0
09210986,7,4,3,0,2,1,1,1,1
09211123,2,2,0,0,2,2,0,0,1
09211526,2,0,2,0,2,2,0,0,0
09211585,1,1,0,0,1,1,0,0,0
09211796,1,1,0,0,1,1,0,0,0
09212140,5,4,1,0,0,0,0,0,1
09213608,1,0,1,0,0,0,0,0,0
09214092,2,2,0,0,2,2,0,0,0
09214243,1,1,0,0,1,1,0,0,0
09214482,6,0,6,0,1,1,0,1,1
09214566,1,1,0,0,1,1,0,0,0
09214648,3,3,0,0,1,1,0,0,0
09215074,2,2,0,0,2,2,0,0,0
09215653,2,1,1,0,2,2,0,0,0
09215941,5,2,3,0,1,1,0,0,0
09216425,1,0,1,0,1,1,0,0,1
09216875,1,1,0,0,1,1,0,0,0
09216917,2,0,2,0,0,0,0,0,1
09217123,1,1,0,0,1,1,0,0,0
09217493,11,7,4,0,0,0,0,0,1
09217754,2,0,2,0,0,0,0,0,1
09217823,6,0,6,0,0,0,0,0,1
09218107,2,2,0,0,1,1,0,0,0
09218182,2,0,2,0,0,0,0,0,1
09218827,5,2,3,0,1,1,0,0,1
09219480,2,0,2,0,0,0,0,0,1
09219595,2,0,2,0,0,0,0,0,1
09220035,3,0,3,0,2,2,0,0,1
09220036,2,2,0,0,1,1,0,0,1
09220044,2,1,1,0,1,1,0,0,0
09220134,2,2,0,0,3,2,1,1,1
09220739,3,2,1,0,1,1,0,0,1
09220823,4,3,1,0,2,1,1,0,0
09220845,4,4,0,0,1,1,0,1,1
09220939,2,1,1,0,1,1,0,0,0
09221004,2,1,1,0,1,1,0,0,0
09221167,2,2,0,0,2,2,0,0,0
09221512,2,2,0,0,1,1,0,0,0
09221575,2,2,0,0,1,1,0,0,0
09221830,6,1,5,0,3,1,2,0,0
09221862,7,6,1,0,0,0,0,0,1
09221946,4,3,1,0,0,0,0,0,0
09222041,1,1,0,0,1,1,0,0,0
09222105,11,1,10,0,6,1,5,0,0
09222351,4,2,2,0,2,2,0,0,1
09222414,3,1,2,0,1,1,0,0,1
09222548,2,2,0,0,2,2,0,0,1
09223050,1,0,1,0,0,0,0,0,0
09223086,2,0,2,0,0,0,0,0,0
09223184,1,1,0,0,1,1,0,0,0
09223439,14,8,6,0,0,0,0,0,1
09224071,1,1,0,0,1,1,0,0,1
09224277,3,1,2,0,1,1,0,0,0
09224581,4,3,1,0,0,0,0,0,1
09225213,11,0,11,0,2,2,0,2,1
09225497,2,2,0,0,1,1,0,0,1
09225610,12,1,11,0,6,1,5,0,0
09225909,4,1,3,0,1,1,0,1,1
09226260,1,1,0,0,1,1,0,0,0
09227343,9,4,5,0,0,0,0,0,1
09227469,13,4,9,0,1,1,0,1,1
09228007,2,1,1,0,2,1,1,0,0
09228116,1,1,0,0,1,1,0,0,0
09228224,6,4,2,0,3,2,1,0,1
09228471,1,1,0,0,1,1,0,0,1
09228587,14,1,13,0,8,1,7,0,0
09228638,1,1,0,0,1,1,0,0,0
09228754,1,0,1,0,1,1,0,0,1
09229222,7,0,7,0,2,1,1,0,1
09229252,5,2,3,0,1,1,0,1,1
09229603,4,3,1,0,1,1,0,0,1
09229783,9,5,4,0,2,2,0,2,1
09231182,3,2,1,0,1,1,0,0,0
09231386,5,1,4,0,2,1,1,0,1
09231400,1,1,0,0,1,1,0,0,0
09231509,7,2,5,0,1,0,1,1,0
09231729,8,5,3,0,1,1,0,1,1
09231753,2,1,1,0,1,1,0,1,0
09231758,2,1,1,0,1,1,0,0,1
09231817,2,2,0,0,2,2,0,0,0
09231907,7,4,3,0,1,1,0,1,1
09232572,2,0,2,0,2,1,1,0,0
09232573,1,1,0,0,1,1,0,0,0
09232939,1,1,0,0,1,1,0,0,0
09233147,1,0,1,0,2,1,1,0,1
09233283,2,1,1,0,1,1,0,0,0
09233443,1,1,0,0,1,1,0,0,1
09233507,8,6,2,0,0,0,0,0,0
09233797,3,3,0,0,1,1,0,0,0
09233864,8,0,8,0,0,0,0,0,1
09234515,3,2,1,0,2,2,0,0,0
09234594,1,1,0,0,2,2,0,0,0
09234800,1,1,0,0,1,1,0,0,0
09235017,3,1,2,0,2,1,1,0,0
09235078,7,3,4,0,1,1,0,1,1
09235189,2,0,2,0,2,2,0,0,1
09235295,6,3,3,0,3,2,1,3,1
09235698,1,1,0,0,2,2,0,0,0
09235786,8,7,1,0,1,0,1,0,1
09235869,2,0,2,0,0,0,0,0,1
09235873,1,0,1,0,0,0,0,0,0
09236044,2,2,0,0,1,1,0,0,0
09236057,2,2,0,0,1,1,0,0,0
09236150,21,8,13,0,0,0,0,0,1
09236410,2,1,1,0,1,1,0,0,1
09236544,2,1,1,0,0,0,0,0,0
09236678,2,0,2,0,1,1,0,0,0
09236738,3,2,1,0,1,1,0,1,1
09236767,11,6,5,0,1,1,0,0,1
09236979,2,2,0,0,2,2,0,0,0
09237123,12,5,7,0,2,1,1,2,1
09237135,1,1,0,0,1,1,0,0,0
09237164,4,4,0,0,1,1,0,0,0
09237306,1,1,0,0,1,1,0,0,0
09237474,1,0,1,0,0,0,0,0,0
09237669,14,6,8,0,0,0,0,0,0
09237682,7,0,7,0,1,1,0,0,1
09237728,3,1,2,0,3,2,1,1,1
09237778,3,1,2,0,2,2,0,0,1
09238093,1,1,0,0,1,1,0,0,0
09238259,2,1,1,0,1,1,0,0,1
09239201,3,3,0,0,2,2,0,0,1
09239364,1,1,0,0,1,1,0,0,1
09239412,1,1,0,0,1,1,0,0,0
09241133,2,0,2,0,0,0,0,0,0
09241745,3,3,0,0,1,1,0,0,0
09241789,3,3,0,0,1,1,0,0,0
09242285,21,11,10,0,0,0,0,0,1
09242365,4,1,3,0,1,1,0,0,0
09242530,7,2,5,0,0,0,0,0,0
09242900,3,3,0,0,3,3,0,0,0
09242982,3,0,3,0,0,0,0,0,1
09242999,8,3,5,0,0,0,0,0,1
09243068,2,1,1,0,1,1,0,0,0
09243180,2,2,0,0,1,1,0,0,0
09243231,1,1,0,0,1,1,0,0,0
09243777,2,2,0,0,2,2,0,0,0
09243842,3,3,0,0,2,2,0,0,1
09244140,2,2,0,0,2,2,0,0,1
09244141,15,8,7,0,0,0,0,0,1
09244206,2,2,0,0,1,1,0,0,0
09244440,15,6,9,0,0,0,0,0,1
09244543,2,0,2,0,1,1,0,0,0
09244606,1,1,0,0,1,1,0,0,0
09244939,1,1,0,0,1,1,0,0,1
09245197,2,0,2,0,0,0,0,0,0
09245212,3,3,0,0,0,0,0,0,0
09245417,6,0,6,0,2,1,1,2,1
09245462,3,1,2,0,2,1,1,0,0
09245524,2,1,1,0,2,2,0,0,0
09245526,2,1,1,0,1,1,0,0,0
09245873,1,1,0,0,1,1,0,0,0
09246247,1,1,0,0,1,1,0,0,0
09246587,1,1,0,0,1,1,0,0,1
09246629,10,6,4,0,2,1,1,2,1
09246769,2,0,2,0,0,0,0,0,1
09247317,6,6,0,0,1,1,0,1,1
09247526,6,5,1,0,4,2,2,0,1
09247898,2,0,2,0,2,2,0,0,1
09247911,2,2,0,0,2,2,0,0,0
09248471,3,3,0,0,1,1,0,0,0
09248689,2,0,2,0,0,0,0,0,0
09248977,2,2,0,0,1,1,0,0,0
09249195,4,2,2,0,2,1,1,1,1
09249404,6,5,1,0,1,1,0,1,1
09249591,2,2,0,0,2,2,0,0,0
09249856,2,2,0,0,1,1,0,1,1
09249915,8,4,4,0,1,1,0,1,0
09250174,2,2,0,0,2,2,0,0,0
09250363,3,0,3,0,0,0,0,0,0
09251707,4,0,4,0,0,0,0,0,1
09251948,1,1,0,0,1,1,0,0,0
09251993,5,4,1,0,2,2,0,0,1
09252083,1,0,1,0,1,1,0,0,0
09252084,3,3,0,0,1,1,0,1,1
09252203,5,2,3,0,4,2,2,0,0
09252466,2,2,0,0,2,2,0,0,0
09252480,1,1,0,0,2,2,0,1,0
09252542,1,0,1,0,1,1,0,0,1
09252650,2,2,0,0,2,2,0,0,0
09253012,3,1,2,0,1,1,0,0,0
09253030,2,2,0,0,1,1,0,0,0
09253281,1,1,0,0,1,1,0,0,0
09253377,2,0,2,0,0,0,0,0,1
09253412,2,0,2,0,0,0,0,0,1
09253680,2,0,2,0,2,2,0,0,0
09253952,4,0,4,1,3,1,2,3,0
09254129,3,1,2,0,1,1,0,1,1
09254473,3,2,1,0,2,2,0,0,0
09254561,1,0,1,0,1,1,0,0,1
09254623,1,1,0,0,1,1,0,0,0
09254756,2,1,1,0,1,1,0,0,0
09254839,2,1,1,0,2,1,1,0,0
09254911,2,1,1,0,1,1,0,0,1
09255556,2,0,2,0,1,1,0,0,1
09255557,1,1,0,0,1,1,0,0,0
09255566,2,0,2,0,0,0,0,0,1
09255770,6,3,3,0,1,1,0,0,0
09256518,3,3,0,0,1,1,0,1,0
09257035,3,3,0,0,1,1,0,0,0
09257096,18,11,7,0,18,7,11,0,1
09257162,2,2,0,0,2,2,0,0,1
09257904,2,0,2,0,2,2,0,0,0
09257930,3,0,3,0,1,1,0,1,0
09258473,1,1,0,0,1,1,0,0,0
09259099,3,2,1,0,2,2,0,0,0
09259397,11,8,3,0,0,0,0,0,1
09259402,1,1,0,0,1,1,0,0,1
09259499,4,0,4,0,1,1,0,1,1
09259759,2,2,0,0,1,1,0,0,0
09259959,2,1,1,0,1,1,0,0,0
09260040,1,1,0,0,1,1,0,0,0
09260353,6,4,2,0,1,1,0,1,1
09260519,1,1,0,0,1,1,0,0,0
09261119,1,0,1,0,0,0,0,0,1
09261439,14,11,3,0,0,0,0,0,0
09261595,1,1,0,0,1,1,0,0,0
09261661,9,5,4,0,2,1,1,1,1
09261811,2,2,0,0,2,2,0,0,0
09262130,4,0,4,0,1,1,0,0,0
09262151,1,1,0,0,1,1,0,0,0
09263689,4,4,0,0,1,1,0,0,0
09263697,6,4,2,0,1,1,0,1,1
09263760,8,5,3,0,4,4,0,0,1
09263765,8,2,6,1,1,1,0,1,1
09263788,19,5,14,0,1,1,0,1,1
09263837,2,2,0,0,1,1,0,0,0
09264141,3,3,0,0,1,1,0,0,0
09264293,2,0,2,0,2,2,0,0,0
09264360,1,1,0,0,2,1,1,2,0
09264424,2,2,0,0,2,2,0,0,0
09264815,2,2,0,0,2,2,0,0,0
09264880,1,1,0,0,1,1,0,0,0
09264949,2,2,0,0,1,1,0,0,1
09265335,2,2,0,0,1,1,0,0,1
09265474,4,0,4,0,0,0,0,0,1
09265572,2,2,0,0,1,1,0,0,0
09265922,4,4,0,0,1,1,0,1,1
09265948,3,2,1,0,2,1,1,0,1
09265978,1,1,0,0,1,1,0,0,0
09266402,2,2,0,0,2,2,0,0,1
09266977,2,1,1,0,2,1,1,0,1
01999120,61,6,55,0,1,1,0,1,1
01999238,23,11,12,0,0,0,0,0,1
01999403,19,0,19,0,0,0,0,0,0
01999409,26,9,17,0,0,0,0,0,0
01999738,23,7,16,0,0,0,0,0,1
01999756,22,2,20,0,1,1,0,1,1
01999837,27,4,23,0,0,0,0,0,1
02000053,22,3,19,0,1,1,0,1,1
02000056,34,6,28,0,0,0,0,0,1
02000173,58,12,46,0,0,0,0,0,0
02000192,25,2,23,0,2,1,1,1,1
02000378,5,3,2,0,0,0,0,0,0
02000579,11,5,6,0,2,2,0,0,1
02000588,0,0,0,0,0,0,0,0,0
02000720,20,2,18,0,1,1,0,1,1
02001057,44,15,29,0,0,0,0,0,1
02001247,18,3,15,0,1,1,0,1,0
02001584,15,6,9,0,1,1,0,1,1
02001685,15,3,12,0,2,1,1,0,1
02002100,9,7,2,0,1,1,0,0,1
02002315,39,2,37,0,1,1,0,1,1
02002504,79,9,70,0,1,1,0,1,1
02002694,36,0,36,0,0,0,0,0,1
02002853,18,0,18,0,0,0,0,0,1
02002991,178,0,178,0,0,0,0,0,1
02003020,58,9,49,0,1,1,0,1,1
02003174,17,2,15,0,1,1,0,1,1
02003242,34,0,34,0,0,0,0,0,1
02003659,25,0,25,0,0,0,0,0,1
02003739,16,0,16,0,1,1,0,1,1
02004003,40,0,40,0,0,0,0,0,1
02004021,30,9,21,0,0,0,0,0,1
02004028,61,3,58,0,1,1,0,1,1
02004510,11,6,5,0,2,1,1,0,1
02004846,10,2,8,0,0,0,0,0,1
02004966,74,4,70,0,1,1,0,1,1
02004970,69,3,66,0,2,1,1,2,1
02005012,109,11,98,0,0,0,0,0,1
02005329,21,3,18,0,1,1,0,1,1
02005521,34,2,32,0,1,1,0,1,1
02005619,32,5,27,0,1,1,0,1,1
02005917,35,3,32,0,1,1,0,1,1
02006000,85,10,75,0,1,1,0,1,1
02006455,22,0,22,0,1,1,0,1,1
02006496,23,4,19,0,0,0,0,0,1
02006522,56,13,43,0,0,0,0,0,1
02006915,0,0,0,0,0,0,0,0,0
02007135,10,4,6,0,1,1,0,0,1
02007160,7,5,2,0,6,5,1,1,0
02007207,12,0,12,0,2,2,0,2,1
02007239,13,0,13,0,0,0,0,0,1
02007359,17,2,15,0,1,1,0,1,0
02007528,3,3,0,0,2,2,0,0,0
02007997,47,5,42,0,0,0,0,0,1
02008438,24,4,20,0,0,0,0,0,1
02008551,196,0,196,0,0,0,0,0,1
02008847,4,4,0,0,0,0,0,0,1
02008984,73,0,73,0,0,0,0,0,1
02009040,71,7,64,0,1,1,0,1,1
02009507,106,14,92,0,0,0,0,0,1
02009520,77,8,69,0,1,1,0,1,1
02010493,67,12,55,0,0,0,0,0,1
02010520,121,8,113,0,1,1,0,1,1
02010626,43,6,37,0,1,1,0,1,1
02011009,27,5,22,0,1,1,0,1,1
02011598,5,3,2,0,1,1,0,0,0
02011996,24,3,21,0,0,0,0,0,1
02012235,43,3,40,0,1,1,0,1,1
02012469,23,3,20,0,1,1,0,0,1
02012481,33,5,28,0,0,0,0,0,1
02013015,21,0,21,0,0,0,0,0,1
02013460,40,7,33,0,0,0,0,0,0
02013926,13,3,10,0,0,0,0,0,1
02013947,74,11,63,0,1,1,0,1,1
02014003,5,1,4,0,1,1,0,0,0
02014305,30,5,25,0,0,0,0,0,1
02014369,12,2,10,0,2,1,1,1,1
02014432,17,6,11,0,0,0,0,0,1
02014522,23,0,23,0,1,1,0,1,1
02014531,5,2,3,0,1,1,0,0,0
02014939,63,11,52,1,0,0,0,0,1
02015506,33,3,30,0,1,1,0,1,1
02015527,59,0,59,0,1,1,0,1,1
02015670,10,3,7,0,1,1,0,1,0
02015785,42,4,38,0,1,1,0,1,1
02015836,35,0,35,0,1,1,0,1,1
02016337,12,4,8,0,0,0,0,0,0
02016429,7,5,2,0,1,1,0,0,0
02016877,3,3,0,0,2,2,0,0,0
02017192,20,0,20,0,0,0,0,0,1
02017204,5,0,5,0,0,0,0,0,0
02017207,52,11,41,0,0,0,0,0,1
02017656,59,7,52,0,1,1,0,1,1
02017829,25,6,19,0,1,1,0,1,1
02017977,7,2,5,0,0,0,0,0,0
02018003,26,3,23,0,0,0,0,0,1
02018312,24,0,24,0,1,1,0,1,1
02018435,18,5,13,0,4,4,0,0,1
02018469,26,7,19,0,1,1,0,1,1
02018497,10,2,8,0,1,1,0,0,0
02018534,11,3,8,0,0,0,0,0,1
02018586,7,2,5,0,2,2,0,2,0
02018985,69,4,65,0,1,1,0,1,1
02019079,24,4,20,0,0,0,0,0,1
02019305,19,4,15,0,1,1,0,1,1
02019627,34,3,31,0,1,1,0,1,1
02019645,27,7,20,0,1,1,0,1,1
02019774,34,0,34,0,0,0,0,0,1
02019835,39,4,35,0,1,0,1,1,1
02019869,11,1,10,0,1,1,0,1,1
02020165,86,10,76,0,0,0,0,0,1
02020173,63,8,55,0,1,1,0,1,1
02020381,76,5,71,1,1,1,0,1,1
02020394,147,10,137,0,2,1,1,2,1
02020401,56,3,53,0,1,0,1,1,1
02020412,36,5,31,0,1,1,0,1,1
02020520,12,5,7,1,2,1,1,0,1
02020653,24,0,24,0,0,0,0,0,1
02020831,5,3,2,0,1,1,0,0,1
02020959,3,3,0,0,0,0,0,0,0
02021099,10,2,8,0,0,0,0,0,0
02021239,10,3,7,0,1,1,0,1,1
02021685,13,6,7,0,1,1,0,0,1
02021722,4,2,2,0,1,1,0,1,0
02022251,5,3,2,0,1,1,0,0,0
02022661,39,0,39,0,0,0,0,0,1
02022665,20,0,20,0,0,0,0,0,1
02022858,22,7,15,0,1,1,0,1,1
02023215,22,0,22,0,0,0,0,0,1
02023217,39,4,35,0,1,1,0,1,1
02023981,41,10,31,0,0,0,0,0,1
02024448,8,3,5,0,0,0,0,0,0
02024575,18,3,15,0,1,1,0,1,1
02024630,34,3,31,0,1,1,0,1,1
02024912,3,3,0,0,1,1,0,0,0
02025003,43,10,33,0,0,0,0,0,1
02025267,6,3,3,0,1,1,0,0,1
02025546,8,3,5,0,2,2,0,0,1
02025726,6,3,3,0,1,1,0,1,1
02025949,18,0,18,0,0,0,0,0,1
02026386,71,3,68,0,1,0,1,1,1
02026407,31,7,24,1,3,1,2,2,1
02026432,70,0,70,0,1,1,0,1,1
02026455,29,0,29,0,1,1,0,1,0
02026808,27,3,24,0,5,4,1,1,1
02026899,25,6,19,0,0,0,0,0,1
02027226,11,3,8,0,1,1,0,1,0
02027625,29,3,26,0,1,1,0,1,1
02027635,23,0,23,0,0,0,0,0,1
02027686,14,4,10,0,1,1,0,1,1
02027822,28,4,24,0,1,1,0,1,1
02027837,12,0,12,0,0,0,0,0,1
02027916,12,4,8,0,4,3,1,0,1
02028024,8,2,6,0,0,0,0,0,0
02028310,3,2,1,0,1,1,0,1,1
02028458,6,2,4,0,1,0,1,0,1
02028763,15,4,11,0,1,1,0,1,1
02029339,76,7,69,0,0,0,0,0,1
02029685,14,4,10,0,5,3,2,0,0
02030031,5,2,3,0,1,1,0,1,0
02030135,16,3,13,0,1,1,0,1,1
02030418,36,3,33,0,1,1,0,1,1
02030439,50,4,46,0,1,1,0,1,1
02030500,7,2,5,0,1,1,0,0,0
02030522,22,0,22,0,0,0,0,0,1
02030523,26,0,26,0,0,0,0,0,1
02030623,15,2,13,0,1,1,0,0,1
02030655,3,2,1,0,1,1,0,0,0
02030941,24,3,21,0,1,1,0,1,1
02031007,13,4,9,0,0,0,0,0,1
02031867,21,4,17,0,1,1,0,0,0
02031879,13,4,9,0,1,1,0,1,1
02032334,10,0,10,0,0,0,0,0,1
02032337,13,1,12,0,1,1,0,1,1
02032494,14,4,10,0,1,1,0,1,1
02032608,8,2,6,0,2,2,0,1,1
02032711,61,9,52,0,1,1,0,0,1
02032715,69,11,58,0,0,0,0,0,1
02032794,35,0,35,0,0,0,0,0,0
02032847,17,3,14,0,2,2,0,0,1
02033068,12,3,9,0,0,0,0,0,1
02033149,16,5,11,0,1,1,0,1,1
02033479,7,3,4,0,1,0,1,0,1
02033501,21,2,19,0,1,1,0,1,1
02033781,18,10,8,0,1,1,0,0,1
02033912,19,0,19,0,0,0,0,0,1
02033925,45,13,32,0,0,0,0,0,1
02034075,3,3,0,0,1,1,0,0,1
02034151,16,4,12,0,3,3,0,0,1
02034197,17,4,13,0,1,1,0,1,1
02034446,54,7,47,0,1,1,0,0,0
02034496,1,1,0,0,0,0,0,0,1
02034536,12,2,10,0,2,2,0,2,1
02034539,6,0,6,0,0,0,0,0,0
02034670,17,4,13,0,1,1,0,1,1
02034988,11,3,8,0,1,1,0,1,1
02034991,17,8,9,0,1,1,0,0,1
02035299,72,0,72,0,0,0,0,0,1
02035303,13,4,9,0,0,0,0,0,0
02035575,4,0,4,0,0,0,0,0,1
02035882,9,0,9,0,2,2,0,0,1
02036094,73,14,59,0,1,1,0,1,1
02036104,15,5,10,0,0,0,0,0,0
02036164,123,11,112,0,0,0,0,0,0
02036201,17,0,17,0,0,0,0,0,1
02036243,131,5,126,0,1,1,0,1,1
02036538,36,7,29,0,0,0,0,0,1
02036572,7,0,7,0,1,1,0,1,1
02036573,7,0,7,0,1,1,0,1,1
02036686,62,3,59,0,1,1,0,1,1
02037267,3,2,1,0,1,1,0,0,0
02037678,7,3,4,0,1,1,0,1,1
02037860,11,4,7,0,0,0,0,0,1
02038004,11,3,8,0,1,1,0,1,1
02038188,4,0,4,0,0,0,0,0,1
02038335,9,0,9,0,0,0,0,0,1
02038351,12,0,12,0,1,1,0,1,0
02038874,21,0,21,0,0,0,0,0,1
02038895,39,8,31,0,0,0,0,0,1
02038915,55,4,51,0,1,1,0,1,1
02039082,11,0,11,0,0,0,0,0,1
02039109,22,5,17,0,1,1,0,1,1
02039303,24,3,21,0,0,0,0,0,1
02039380,6,3,3,0,1,1,0,0,0
02039621,4,3,1,0,4,4,0,0,1
02039750,71,9,62,0,1,1,0,1,1
02040753,18,2,16,0,1,1,0,1,1
02041253,17,2,15,0,1,1,0,0,1
02041612,30,9,21,0,0,0,0,0,1
02041819,57,6,51,0,1,1,0,1,1
02041864,27,2,25,0,2,1,1,2,1
02042076,15,3,12,0,1,1,0,1,1
02042285,48,9,39,0,1,1,0,1,1
02042346,54,16,38,0,0,0,0,0,1
02042378,23,4,19,0,1,1,0,0,1
02042473,22,4,18,0,1,1,0,1,1
02042499,4,3,1,0,1,1,0,0,1
02042604,20,2,18,0,1,1,0,1,1
02042649,14,2,12,0,1,1,0,1,1
02042718,2,2,0,0,0,0,0,0,1
02042768,91,13,78,0,1,0,1,0,1
02042851,9,3,6,0,1,1,0,1,1
02042858,7,3,4,0,2,2,0,0,1
02042888,5,2,3,0,1,1,0,1,0
02043136,9,0,9,0,0,0,0,0,1
02043317,56,5,51,0,1,1,0,1,1
02043735,19,0,19,0,0,0,0,0,1
02044219,58,10,48,0,0,0,0,0,1
02044708,11,4,7,0,1,1,0,0,1
02045556,69,10,59,0,0,0,0,0,1
02045632,25,8,17,0,0,0,0,0,1
02045777,33,5,28,0,0,0,0,0,1
02045934,40,4,36,0,1,1,0,1,1
02045961,23,3,20,0,1,1,0,1,1
02045995,318,0,318,0,1,1,0,1,1
02046233,36,4,32,0,0,0,0,0,1
02046283,4,4,0,0,2,2,0,0,0
02046291,0,0,0,0,0,0,0,0,0
02046655,22,3,19,0,1,1,0,1,0
02046679,7,0,7,0,0,0,0,0,1
02046731,20,0,20,0,1,1,0,1,1
02047008,15,4,11,0,1,1,0,1,1
02047060,32,6,26,0,1,1,0,1,1
02047065,128,0,128,0,1,1,0,1,1
02047066,23,3,20,0,1,1,0,1,1
02047070,4,0,4,0,0,0,0,0,1
02047082,6,0,6,0,0,0,0,0,1
02047084,34,5,29,0,1,1,0,1,1
02047353,20,0,20,0,1,1,0,1,1
02047390,30,5,25,0,1,1,0,0,1
02047473,0,0,0,0,0,0,0,0,0
02048091,39,8,31,0,0,0,0,0,0
02048201,61,7,54,0,0,0,0,0,1
02048526,22,3,19,0,1,1,0,1,0
02048608,47,10,37,0,0,0,0,0,1
02048721,12,3,9,0,2,1,1,2,1
02048776,3,3,0,0,1,1,0,0,0
02048895,46,4,42,0,2,1,1,2,1
02048935,16,0,16,0,1,1,0,1,1
02048962,15,0,15,0,0,0,0,0,1
02049337,29,0,29,0,0,0,0,0,1
02049362,15,4,11,0,1,1,0,1,1
02049396,9,4,5,0,3,3,0,1,0
02049597,14,3,11,0,1,1,0,1,1
02050620,128,6,122,0,0,0,0,0,1
02050734,12,3,9,0,4,1,3,2,1
02050754,6,2,4,0,1,1,0,0,0
02051135,8,4,4,0,3,3,0,0,1
02051152,34,9,25,1,0,0,0,0,1
02051169,26,0,26,0,2,2,0,0,1
02051199,11,3,8,0,0,0,0,0,1
02051272,9,4,5,0,2,0,2,0,0
02051371,19,0,19,0,1,1,0,1,1
02051460,38,8,30,0,1,1,0,0,1
02051469,16,0,16,0,0,0,0,0,1
02051546,12,0,12,0,0,0,0,0,1
02051703,30,9,21,0,1,1,0,1,1
02051962,15,0,15,0,1,1,0,1,1
02052268,87,8,79,0,0,0,0,0,1
02052674,0,0,0,0,0,0,0,0,0
02052677,42,5,37,0,2,2,0,2,1
02052798,17,4,13,0,0,0,0,0,1
02052961,38,5,33,0,1,1,0,1,1
02052979,49,2,47,0,2,2,0,0,1
02052982,29,5,24,0,1,1,0,1,1
02053160,13,5,8,0,1,1,0,0,1
02053453,45,2,43,0,1,1,0,1,1
02054169,11,5,6,0,1,1,0,1,1
02054230,23,2,21,0,0,0,0,0,0
02054592,115,16,99,0,0,0,0,0,1
02054649,47,8,39,0,0,0,0,0,1
02055002,42,9,33,0,0,0,0,0,1
02055026,16,0,16,0,0,0,0,0,1
02055398,58,5,53,0,0,0,0,0,1
02840138,12,1,11,0,1,1,0,0,1
02840297,5,3,2,0,2,2,0,0,1
02840362,9,5,4,0,3,3,0,1,1
02840475,49,3,46,0,1,1,0,1,1
02840596,20,3,17,0,0,0,0,0,1
02840685,8,0,8,0,0,0,0,0,1
02840896,8,0,8,0,2,2,0,1,1
02841021,49,3,46,0,1,1,0,1,1
02841098,6,0,6,0,0,0,0,0,1
02841110,15,4,11,0,1,1,0,0,1
02841130,14,5,9,0,2,2,0,0,1
02841232,23,6,17,0,1,1,0,1,1
02841390,44,11,33,0,0,0,0,0,1
02841576,32,0,32,0,0,0,0,0,1
02841601,18,0,18,0,1,1,0,1,1
02841609,43,0,43,0,0,0,0,0,1
02841693,41,7,34,0,0,0,0,0,1
02841713,60,6,54,0,0,0,0,0,1
02841750,11,0,11,0,0,0,0,0,1
02842125,17,0,17,0,0,0,0,0,1
02842203,13,0,13,0,0,0,0,0,1
02842457,24,2,22,0,4,2,2,1,1
02842471,4,3,1,0,1,1,0,0,1
02842546,6,2,4,0,1,1,0,0,1
02842574,22,4,18,0,1,1,0,1,1
02842650,19,3,16,0,1,1,0,1,1
02842985,5,0,5,0,0,0,0,0,1
02843012,17,7,10,0,1,1,0,0,1
02843021,8,2,6,0,2,2,0,0,1
02843776,9,2,7,0,1,1,0,0,1
02843866,8,0,8,0,1,1,0,0,0
02844013,17,0,17,0,0,0,0,0,1
02844027,21,3,18,0,1,1,0,1,1
02844175,14,2,12,0,5,2,3,0,1
02844404,8,3,5,0,1,1,0,1,1
02844442,17,5,12,0,1,1,0,0,1
02844532,28,5,23,0,1,1,0,1,1
02844616,26,3,23,0,1,0,1,1,1
02844653,13,6,7,0,4,1,3,1,0
02844654,10,5,5,0,4,2,2,1,0
02844703,6,2,4,0,2,2,0,0,1
02844764,10,4,6,0,0,0,0,0,1
02844780,4,3,1,0,1,1,0,0,1
02844851,56,4,52,0,1,1,0,1,1
02844985,12,3,9,0,1,1,0,0,1
02844987,12,3,9,0,1,1,0,0,1
02845028,67,7,60,0,0,0,0,0,1
02845452,52,8,44,0,0,0,0,0,1
02845563,5,1,4,0,1,1,0,0,1
02845977,11,0,11,0,1,1,0,1,1
02845992,12,1,11,0,0,0,0,0,1
02846346,30,5,25,0,1,1,0,1,1
02846413,14,5,9,0,0,0,0,0,1
02846473,24,4,20,0,2,2,0,0,1
02846481,23,0,23,0,0,0,0,0,1
02846496,13,3,10,0,0,0,0,0,1
02846606,11,0,11,0,1,1,0,1,1
02846649,23,0,23,0,0,0,0,0,1
02846761,8,0,8,0,0,0,0,0,1
02846764,4,2,2,0,1,1,0,0,1
02846797,12,1,11,0,1,1,0,1,1
02846916,11,2,9,0,1,1,0,0,0
02846942,6,2,4,0,1,1,0,0,1
02846954,29,2,27,0,4,2,2,1,1
02847255,10,3,7,0,2,2,0,0,1
02847417,24,0,24,0,0,0,0,0,1
02847571,45,4,41,0,2,2,0,2,1
02847704,15,7,8,0,6,6,0,0,1
02847743,16,7,9,0,1,1,0,1,1
02847817,57,10,47,0,1,1,0,1,1
02847978,45,0,45,0,1,1,0,1,1
02847982,44,4,40,0,1,1,0,1,1
02847985,45,0,45,0,1,1,0,1,1
02847994,46,4,42,0,1,1,0,1,1
02848400,19,0,19,0,0,0,0,0,1
02848454,56,0,56,0,4,2,2,0,0
02848458,37,7,30,0,1,0,1,0,1
02848476,13,2,11,0,1,1,0,1,1
02848490,44,4,40,0,1,1,0,1,1
02848514,17,0,17,0,0,0,0,0,0
02848598,7,5,2,0,0,0,0,0,1
02848612,6,0,6,0,0,0,0,0,1
02848616,7,0,7,0,0,0,0,0,1
02848905,3,2,1,0,2,2,0,0,0
02848940,18,9,9,0,0,0,0,0,0
02848982,44,3,41,0,1,1,0,1,1
02849088,15,3,12,0,1,1,0,1,1
02849172,8,0,8,0,0,0,0,0,1
02849404,7,3,4,0,1,1,0,0,1
02849472,26,4,22,0,1,1,0,1,1
02849598,129,11,118,0,0,0,0,0,1
02849795,22,0,22,0,1,1,0,1,1
02849833,39,9,30,0,0,0,0,0,1
02849837,40,0,40,0,0,0,0,0,1
02849925,28,2,26,0,0,0,0,0,0
02849983,22,2,20,0,1,1,0,1,1
02850238,8,0,8,0,0,0,0,0,1
02850446,3,3,0,0,1,1,0,1,0
02850484,18,3,15,0,1,1,0,1,1
02850597,38,3,35,0,1,1,0,1,1
02850619,30,4,26,0,1,1,0,1,1
02850916,4,1,3,0,1,1,0,0,1
02851207,34,6,28,0,1,1,0,1,1
02851313,37,6,31,0,0,0,0,0,1
02851316,55,8,47,0,1,1,0,1,1
02851612,9,3,6,0,3,2,1,0,0
02851749,18,0,18,0,0,0,0,0,1
02851794,56,13,43,0,0,0,0,0,1
02851835,9,2,7,0,3,2,1,1,1
02851940,11,6,5,0,0,0,0,0,1
02852288,13,0,13,0,0,0,0,0,1
02852569,17,0,17,0,1,1,0,1,1
02852759,17,7,10,0,1,1,0,0,1
02852812,29,2,27,0,1,1,0,1,1
02853178,24,0,24,0,1,1,0,1,1
02853335,41,7,34,0,0,0,0,0,0
02853337,57,12,45,0,1,1,0,0,1
02853340,82,7,75,0,0,0,0,0,1
02853717,32,14,18,0,1,1,0,1,1
02853731,12,7,5,0,3,1,2,1,0
02853751,42,4,38,0,1,1,0,1,1
02853757,41,5,36,0,1,1,0,1,1
02853768,9,1,8,0,1,1,0,0,0
02853771,12,7,5,0,3,1,2,1,0
02853852,30,3,27,0,1,1,0,1,1
02853855,30,3,27,0,1,1,0,1,1
02853860,21,0,21,0,0,0,0,0,1
02853866,30,3,27,0,1,1,0,1,1
02853869,30,3,27,0,1,1,0,1,1
02853870,30,3,27,0,1,1,0,1,1
02853872,30,3,27,0,1,1,0,1,1
02854090,46,2,44,0,1,1,0,1,1
02854091,37,11,26,0,1,0,1,0,1
02854160,16,7,9,0,1,1,0,0,1
02854405,32,5,27,0,1,1,0,1,1
02854806,38,5,33,0,0,0,0,0,1
02854834,10,1,9,0,1,1,0,0,1
02855059,34,5,29,0,1,1,0,1,1
02855151,65,5,60,0,2,1,1,2,1
02855423,28,10,18,0,0,0,0,0,0
02855468,18,3,15,0,1,1,0,1,1
02855788,56,9,47,0,0,0,0,0,1
02855795,17,0,17,0,1,1,0,0,1
02855883,7,0,7,0,0,0,0,0,1
02856074,16,0,16,0,0,0,0,0,1
02856141,72,14,58,0,1,1,0,1,1
02856603,18,2,16,0,1,1,0,1,1
02856860,13,2,11,0,1,1,0,1,0
02856983,34,8,26,0,0,0,0,0,1
02857005,23,3,20,0,2,1,1,1,1
02857207,30,6,24,0,0,0,0,0,1
02857294,6,3,3,0,2,1,1,0,1
02857554,7,2,5,0,1,1,0,1,0
02858045,31,0,31,0,1,1,0,1,1
02858123,20,0,20,0,0,0,0,0,1
02858303,20,4,16,0,1,1,0,1,1
02858310,16,0,16,0,0,0,0,0,1
02858323,21,3,18,0,0,0,0,0,0
02858371,16,0,16,0,0,0,0,0,1
02858374,17,0,17,0,0,0,0,0,1
02858623,21,0,21,0,0,0,0,0,1
02858626,26,0,26,0,0,0,0,0,1
02859016,11,0,11,0,1,1,0,0,1
02859017,5,3,2,0,2,2,0,0,0
02859368,13,0,13,0,1,1,0,1,1
02859403,28,1,27,0,0,0,0,0,1
02859435,27,4,23,0,1,1,0,1,1
02859445,0,0,0,0,0,0,0,0,1
02859615,26,6,20,0,0,0,0,0,1
02859691,8,1,7,0,1,1,0,0,0
02859745,33,3,30,0,2,1,1,2,1
02860361,20,3,17,0,1,1,0,1,1
02860418,13,3,10,0,4,2,2,0,1
02860552,8,3,5,0,2,2,0,0,0
02860911,49,10,39,0,0,0,0,0,1
02860914,13,2,11,0,1,1,0,0,1
02861104,27,6,21,0,0,0,0,0,0
02861332,31,3,28,0,1,1,0,1,1
02861336,31,3,28,0,1,1,0,1,1
02861340,31,3,28,0,1,1,0,1,1
02861345,31,3,28,0,1,1,0,1,1
02861348,31,3,28,0,1,1,0,1,1
02861569,27,4,23,0,2,1,1,2,1
02861604,6,3,3,0,1,1,0,0,0
02861707,21,12,9,0,2,2,0,1,1
02861942,9,2,7,0,1,1,0,0,1
02862148,82,11,71,0,2,1,1,0,0
02862282,25,0,25,0,0,0,0,0,1
02862295,27,13,14,0,0,0,0,0,1
02862435,32,0,32,0,0,0,0,0,1
02862444,32,0,32,0,0,0,0,0,1
02862677,19,3,16,0,1,1,0,1,1
02862784,6,2,4,0,1,1,0,1,0
02862807,80,17,63,0,0,0,0,0,1
02862814,6,2,4,0,1,1,0,0,1
02863094,5,1,4,0,1,1,0,0,1
02863565,49,0,49,0,0,0,0,0,1
02863616,17,4,13,0,1,1,0,1,1
02863860,45,12,33,0,1,1,0,1,1
02863863,18,0,18,0,0,0,0,0,1
02863867,18,2,16,0,0,0,0,0,1
02864257,10,4,6,0,1,1,0,0,1
02864389,20,2,18,0,1,1,0,1,1
02864618,32,3,29,0,1,1,0,1,1
02864619,32,3,29,0,1,1,0,1,1
02864620,32,3,29,0,1,1,0,1,1
02864622,32,3,29,0,1,1,0,1,1
02864625,32,3,29,0,1,1,0,1,1
02865418,16,0,16,0,0,0,0,0,1
02865522,50,4,46,0,1,1,0,1,1
02865616,6,3,3,0,1,1,0,0,1
02865778,43,0,43,0,0,0,0,0,1
02865838,18,0,18,0,0,0,0,0,1
02865948,19,0,19,0,0,0,0,0,1
02866144,10,5,5,0,2,2,0,0,1
02866283,30,5,25,0,2,1,1,0,0
02866437,17,5,12,0,1,1,0,1,1
02866502,35,3,32,0,1,1,0,1,1
02867196,8,1,7,0,1,1,0,0,1
02867315,7,3,4,0,1,1,0,0,1
02867446,55,0,55,0,0,0,0,0,1
02867474,37,4,33,0,1,1,0,1,0
02867514,20,3,17,0,0,0,0,0,1
02867684,25,7,18,0,0,0,0,0,1
02867936,7,3,4,0,0,0,0,0,0
02868332,20,7,13,0,3,1,2,0,0
02868384,55,4,51,0,1,1,0,1,1
02868386,42,0,42,0,0,0,0,0,1
02868498,46,4,42,0,1,1,0,1,1
02868732,4,2,2,0,2,2,0,0,0
02868875,50,13,37,0,0,0,0,0,1
02869114,9,3,6,0,1,1,0,1,0
02869292,29,6,23,0,0,0,0,0,1
02869293,9,4,5,0,0,0,0,0,1
02869774,11,2,9,0,2,2,0,0,1
02869784,21,0,21,0,0,0,0,0,1
02869932,18,2,16,0,0,0,0,0,1
02870338,9,4,5,0,1,1,0,1,1
02870535,24,0,24,0,1,1,0,0,1
02870725,5,1,4,0,1,1,0,0,1
02871187,40,0,40,0,0,0,0,0,1
02871197,7,3,4,0,3,2,1,0,1
02871489,23,4,19,0,1,1,0,1,1
02871556,12,0,12,0,1,1,0,1,1
02871703,9,2,7,0,0,0,0,0,1
02871775,5,3,2,0,2,2,0,0,1
02871886,24,6,18,0,0,0,0,0,0
02872068,18,6,12,0,0,0,0,0,1
02872234,35,2,33,0,1,1,0,1,1
02872318,17,3,14,0,0,0,0,0,1
02872411,30,6,24,0,1,0,1,0,1
02872475,5,2,3,0,1,1,0,0,1
02872489,5,0,5,0,0,0,0,0,0
02872512,38,4,34,0,1,1,0,1,1
02872876,12,3,9,0,1,1,0,0,1
02873008,41,6,35,0,0,0,0,0,1
02873019,25,3,22,0,1,1,0,1,1
02873038,25,7,18,0,1,1,0,1,1
02873080,17,3,14,0,2,2,0,0,1
02873336,7,0,7,0,0,0,0,0,0
02873615,22,4,18,0,1,1,0,1,1
02873622,29,6,23,0,1,1,0,1,0
02873648,5,3,2,0,2,2,0,0,0
02873670,26,0,26,3,1,1,0,1,1
02873718,27,5,22,0,1,1,0,1,1
02873731,23,2,21,0,1,1,0,1,1
02873975,19,3,16,0,4,0,4,2,1
02874142,73,0,73,0,0,0,0,0,1
02874169,13,0,13,0,0,0,0,0,1
02874177,65,13,52,0,0,0,0,0,1
02874202,22,2,20,0,1,1,0,1,1
02874302,24,3,21,0,1,1,0,1,1
02874608,29,4,25,0,1,1,0,1,1
02874626,37,10,27,0,1,1,0,1,1
02874708,23,3,20,0,1,1,0,0,1
02874986,17,3,14,0,8,2,6,2,1
02875446,40,1,39,0,1,1,0,1,1
02875756,7,2,5,0,1,1,0,0,0
02875757,11,7,4,0,2,1,1,2,0
02875971,7,2,5,0,1,1,0,0,1
02875974,10,3,7,0,1,1,0,0,1
02876062,60,13,47,0,3,1,2,0,1
02876147,61,8,53,0,0,0,0,0,1
02876284,46,0,46,0,1,1,0,1,1
02876720,6,3,3,0,4,2,2,0,0
02877004,6,2,4,0,1,1,0,0,0
02877158,14,9,5,0,0,0,0,0,1
02877612,18,5,13,0,2,2,0,0,1
02878026,4,2,2,0,1,1,0,0,1
02878221,40,10,30,0,0,0,0,0,1
02878222,6,4,2,0,0,0,0,0,0
02878404,6,2,4,0,1,1,0,0,1
02878490,8,3,5,0,0,0,0,0,1
02878548,62,6,56,0,0,0,0,0,1
02878651,14,0,14,0,0,0,0,0,1
02878728,31,5,26,0,1,1,0,1,1
02878738,62,8,54,0,1,0,1,1,1
02878847,20,1,19,0,1,1,0,1,1
02878864,20,4,16,0,2,2,0,2,1
02879104,21,0,21,0,0,0,0,0,1
02879108,8,4,4,0,3,1,2,1,1
02879612,16,4,12,0,0,0,0,0,1
02879724,28,8,20,0,0,0,0,0,1
02879728,22,6,16,1,0,0,0,0,1
02879977,8,3,5,0,2,2,0,0,1
02880179,27,4,23,0,1,1,0,1,1
02880202,20,7,13,0,1,1,0,1,1
02880282,26,11,15,0,1,1,0,1,1
02880324,10,5,5,0,1,1,0,0,1
02880419,25,7,18,0,0,0,0,0,0
02880569,20,0,20,0,3,3,0,0,1
02880634,30,6,24,0,1,1,0,1,1
02881021,5,0,5,0,0,0,0,0,0
02881099,8,2,6,0,2,1,1,0,0
02881162,34,3,31,0,1,1,0,1,1
02881502,4,0,4,0,0,0,0,0,1
02881599,39,7,32,0,0,0,0,0,1
02881641,17,2,15,0,1,1,0,1,1
02881664,59,10,49,0,0,0,0,0,1
02881849,26,0,26,0,3,2,1,2,1
02881854,18,7,11,0,1,1,0,1,1
02882201,19,0,19,0,0,0,0,0,1
02882225,5,3,2,0,1,1,0,0,1
02882252,56,5,51,0,2,2,0,2,1
02882510,33,4,29,0,1,1,0,0,1
02882601,19,4,15,0,1,1,0,0,1
02882954,10,0,10,0,1,1,0,0,1
02882993,30,6,24,0,1,1,0,1,1
02883030,25,0,25,0,0,0,0,0,1
02883152,5,0,5,0,0,0,0,0,0
02883177,57,10,47,0,2,2,0,2,1
02883386,9,2,7,0,1,1,0,0,1
02883391,10,2,8,0,1,1,0,0,1
02883596,23,3,20,0,1,1,0,1,1
02883742,37,3,34,0,2,1,1,2,1
02883756,71,11,60,0,0,0,0,0,1
02883768,9,0,9,0,0,0,0,0,1
02883959,25,4,21,0,0,0,0,0,1
02883969,20,3,17,0,0,0,0,0,1
02884152,26,0,26,0,0,0,0,0,1
02884308,13,2,11,0,1,1,0,0,1
02884496,40,5,35,0,0,0,0,0,1
02884584,55,3,52,0,1,1,0,1,1
02884618,15,7,8,0,0,0,0,0,1
02884684,14,2,12,0,3,3,0,1,1
02884784,27,2,25,0,0,0,0,0,1
02885223,15,3,12,0,1,1,0,0,1
02885267,8,3,5,0,2,2,0,1,1
02885276,20,0,20,0,2,2,0,2,1
02885345,32,0,32,0,0,0,0,0,1
02885607,36,2,34,0,1,1,0,1,1
02885614,30,0,30,0,1,1,0,1,1
02885784,14,3,11,0,1,1,0,0,1
02885889,5,0,5,0,0,0,0,0,1
02886244,30,7,23,0,2,2,0,0,1
02886300,34,9,25,0,0,0,0,0,1
02886407,5,3,2,0,0,0,0,0,0
02886597,32,4,28,0,0,0,0,0,1
02886697,48,6,42,0,1,1,0,1,1
02886775,22,0,22,0,0,0,0,0,1
02886886,6,4,2,0,0,0,0,0,1
02886938,10,3,7,0,1,1,0,0,1
02886962,36,6,30,0,1,1,0,1,1
02886984,17,2,15,0,1,1,0,1,1
01720297,32,0,32,0,0,0,0,0,1
01720518,104,13,91,0,0,0,0,0,1
01720905,16,6,10,0,0,0,0,0,0
01721070,20,3,17,0,1,1,0,1,1
01721195,23,4,19,0,1,1,0,1,1
01721406,21,5,16,0,1,1,0,1,1
01721409,50,4,46,0,1,1,0,1,1
01722216,53,4,49,0,1,1,0,1,1
01722467,46,8,38,0,1,1,0,1,1
01722473,23,0,23,0,0,0,0,0,1
01722896,16,4,12,0,1,1,0,0,1
01723253,0,0,0,0,0,0,0,0,0
01723284,67,2,65,0,1,1,0,1,1
01723342,21,6,15,0,0,0,0,0,1
01723783,46,3,43,0,1,1,0,0,1
01723833,12,0,12,0,1,1,0,1,0
01724197,45,12,33,0,0,0,0,0,1
01724228,31,5,26,0,1,0,1,1,1
01724254,5,2,3,0,1,1,0,0,0
01724489,13,2,11,0,1,1,0,1,1
01724998,2,2,0,0,0,0,0,0,1
01725413,37,5,32,0,1,1,0,1,1
01725755,16,3,13,0,1,1,0,1,1
01725787,7,2,5,0,2,2,0,1,1
01725815,23,6,17,0,0,0,0,0,0
01725876,11,0,11,0,1,1,0,1,1
01725976,20,4,16,0,1,1,0,1,1
01726163,46,8,38,0,1,1,0,1,1
01726215,22,12,10,0,1,1,0,0,1
01726378,24,4,20,0,0,0,0,0,1
01726510,18,3,15,0,0,0,0,0,1
01728009,32,6,26,0,1,1,0,1,1
01728088,30,7,23,0,1,1,0,1,1
01728127,2,2,0,0,2,2,0,0,0
01728664,14,3,11,0,0,0,0,0,1
01728892,77,14,63,0,1,1,0,1,1
01728893,781,3,778,0,1,1,0,1,1
01728967,18,2,16,0,1,1,0,1,1
01729478,51,8,43,0,0,0,0,0,1
01729518,36,10,26,1,0,0,0,0,1
01729670,17,3,14,0,2,2,0,2,1
01729688,33,6,27,0,7,7,0,0,1
01729710,15,0,15,0,0,0,0,0,1
01729786,20,6,14,0,0,0,0,0,1
01729841,8,3,5,0,1,1,0,0,0
01729887,24,7,17,0,3,3,0,0,1
01730008,16,0,16,0,1,1,0,1,1
01730295,27,6,21,0,1,1,0,1,1
01730423,33,8,25,0,0,0,0,0,1
01730945,15,3,12,0,1,1,0,1,1
01730997,28,5,23,0,1,1,0,1,1
01731129,19,9,10,0,8,8,0,0,1
01731141,26,6,20,0,0,0,0,0,1
01731248,4,2,2,0,3,2,1,0,0
01731364,8,3,5,0,2,2,0,0,0
01731439,25,6,19,0,0,0,0,0,1
01731764,28,4,24,0,1,1,0,1,1
01731924,48,5,43,0,2,2,0,2,1
01732037,45,6,39,0,1,1,0,1,1
01732108,24,0,24,0,0,0,0,0,1
01732473,38,6,32,0,1,1,0,1,1
01732518,46,4,42,0,1,1,0,1,1
01733031,59,0,59,0,0,0,0,0,1
01733060,58,9,49,0,1,1,0,1,1
01733470,37,5,32,0,1,1,0,1,1
01733668,4,4,0,0,1,1,0,0,0
01733885,12,4,8,0,3,1,2,1,1
01734159,3,3,0,0,1,1,0,0,0
01734308,23,7,16,0,2,1,1,2,1
01734448,7,3,4,0,2,2,0,0,0
01734527,35,5,30,0,0,0,0,0,1
01734811,10,0,10,0,0,0,0,0,1
01734995,17,7,10,0,1,1,0,0,0
01735357,4,2,2,0,2,1,1,1,0
01735476,55,5,50,0,1,1,0,1,1
01735678,2,2,0,0,0,0,0,0,0
01735809,13,0,13,0,0,0,0,0,1
01735845,35,3,32,0,0,0,0,0,1
01735857,11,3,8,0,1,0,1,0,1
01735872,97,16,81,0,0,0,0,0,1
01736623,64,15,49,0,0,0,0,0,1
01737005,8,2,6,0,2,1,1,1,1
01737083,4,0,4,0,0,0,0,0,1
01737324,20,0,20,0,1,1,0,1,1
01737415,37,8,29,0,0,0,0,0,1
01737587,34,3,31,0,1,1,0,1,1
01737813,19,3,16,0,1,1,0,1,1
01737893,39,3,36,0,1,1,0,1,1
01737924,82,18,64,0,4,3,1,0,0
01738194,39,4,35,0,1,1,0,1,1
01738249,20,5,15,0,0,0,0,0,1
01738897,5,2,3,0,2,2,0,0,0
01738920,10,5,5,0,2,2,0,0,1
01738934,36,0,36,0,0,0,0,0,1
01739076,3,3,0,0,1,1,0,0,0
01739395,3,0,3,0,0,0,0,0,0
01739411,6,3,3,0,2,2,0,0,1
01739581,8,2,6,0,1,1,0,1,1
01739975,6,1,5,0,1,1,0,0,1
01740007,36,4,32,0,1,1,0,1,1
01740011,30,6,24,0,1,0,1,1,1
01740318,17,3,14,0,1,1,0,1,1
01740555,35,6,29,0,1,1,0,1,1
01740804,3,0,3,0,0,0,0,0,1
01740877,18,2,16,0,0,0,0,0,0
01740919,28,5,23,0,0,0,0,0,1
01741450,9,6,3,0,1,1,0,0,1
01741596,23,5,18,0,0,0,0,0,0
01741741,13,6,7,0,1,1,0,0,1
01741892,51,4,47,0,2,1,1,2,1
01742404,25,6,19,0,1,1,0,1,1
01742642,60,6,54,0,5,4,1,0,1
01742651,19,7,12,0,0,0,0,0,0
01743081,35,3,32,0,1,1,0,1,1
01743099,57,3,54,0,1,1,0,1,1
01743307,14,2,12,0,2,2,0,1,1
01743426,15,4,11,0,1,1,0,0,1
01744747,34,9,25,0,0,0,0,0,1
01744840,11,4,7,0,4,4,0,0,0
01744913,26,3,23,0,1,1,0,1,1
01745542,33,3,30,0,2,1,1,2,1
01745565,8,3,5,0,1,1,0,0,1
01745852,66,10,56,0,0,0,0,0,1
01745894,6,0,6,0,0,0,0,0,1
01745925,17,3,14,0,1,1,0,0,0
01746135,15,3,12,0,2,2,0,0,0
01746376,21,3,18,0,1,1,0,1,1
01746543,37,3,34,0,1,1,0,1,1
01746946,0,0,0,0,0,0,0,0,1
01746955,5,4,1,0,1,1,0,0,1
01747066,41,8,33,0,1,1,0,0,0
01747139,6,5,1,0,1,1,0,0,0
01747169,56,9,47,0,11,8,3,0,1
01747198,14,4,10,0,1,1,0,1,1
01747301,77,16,61,0,0,0,0,0,1
01747830,22,1,21,0,1,1,0,1,1
01747998,34,3,31,0,1,1,0,1,1
01748097,15,2,13,0,1,1,0,1,1
01748410,41,3,38,0,1,0,1,0,1
01748847,1,1,0,0,0,0,0,0,0
01748848,15,5,10,0,1,1,0,0,0
01748899,7,3,4,0,1,1,0,0,0
01748980,2,2,0,0,1,1,0,0,0
01749130,8,5,3,0,2,2,0,0,1
01749918,26,3,23,0,0,0,0,0,1
01750167,46,12,34,0,1,1,0,1,1
01751276,20,5,15,0,0,0,0,0,1
01751407,7,0,7,0,1,1,0,1,1
01751466,59,11,48,0,0,0,0,0,1
01751526,12,5,7,0,0,0,0,0,1
01751817,8,3,5,0,2,2,0,0,1
01752109,5,3,2,0,2,2,0,0,0
01752246,73,0,73,0,0,0,0,0,1
01752383,32,3,29,0,2,1,1,2,1
01752638,17,3,14,0,1,1,0,0,1
01752689,9,1,8,0,0,0,0,0,0
01752969,46,5,41,0,1,1,0,1,1
01753440,30,12,18,0,0,0,0,0,1
01753609,23,5,18,0,5,5,0,0,0
01754712,5,1,4,0,2,2,0,0,0
01754715,12,2,10,0,1,1,0,1,0
01755001,15,4,11,0,3,3,0,0,1
01755077,26,3,23,0,2,1,1,2,1
01755462,26,4,22,0,0,0,0,0,1
01755476,120,6,114,0,0,0,0,0,1
01757131,47,7,40,0,0,0,0,0,1
01757157,40,5,35,0,1,1,0,1,1
01757642,25,8,17,0,0,0,0,0,1
01757815,6,3,3,0,0,0,0,0,1
01757875,54,10,44,0,0,0,0,0,1
01758008,7,3,4,0,1,1,0,0,0
01758473,14,0,14,0,0,0,0,0,1
01758668,150,7,143,0,0,0,0,0,1
01759053,51,4,47,0,1,1,0,1,1
01759058,72,0,72,0,2,2,0,1,1
01759120,23,3,20,0,1,1,0,1,1
01759121,0,0,0,0,0,0,0,0,0
01759423,12,2,10,0,1,1,0,0,0
01759453,17,0,17,0,0,0,0,0,1
01759455,34,3,31,0,1,1,0,1,1
01759655,14,3,11,0,2,2,0,0,0
01759787,36,4,32,0,1,1,0,1,1
01759876,59,9,50,0,1,1,0,0,0
01759971,11,2,9,0,2,2,0,0,1
01760254,173,16,157,0,0,0,0,0,1
01761561,76,10,66,0,1,1,0,1,1
01761585,26,1,25,0,1,1,0,1,1
01761654,0,0,0,0,0,0,0,0,0
01761813,47,8,39,0,1,1,0,1,1
01761976,12,3,9,0,1,1,0,0,1
01762000,20,4,16,0,2,2,0,0,1
01762083,21,4,17,0,0,0,0,0,0
01762088,104,12,92,0,0,0,0,0,1
01762617,23,6,17,0,2,1,1,2,1
01762840,99,15,84,0,0,0,0,0,1
01763136,3,3,0,0,1,1,0,0,0
01763297,48,8,40,0,1,1,0,1,1
01764223,36,4,32,0,1,1,0,1,1
01764288,15,2,13,0,1,1,0,0,1
01764290,38,3,35,0,0,0,0,0,1
01764397,9,3,6,0,0,0,0,0,0
01764827,21,8,13,0,0,0,0,0,1
01765070,18,0,18,0,0,0,0,0,1
01765124,23,6,17,0,0,0,0,0,1
01765268,26,4,22,0,0,0,0,0,1
01765287,48,9,39,0,0,0,0,0,1
01765898,21,1,20,0,1,1,0,0,1
01766131,28,4,24,0,1,1,0,1,1
01766196,28,4,24,0,1,1,0,1,1
01766231,43,0,43,0,0,0,0,0,1
01766310,38,2,36,0,1,1,0,1,1
01766377,4,3,1,0,0,0,0,0,0
01766411,115,10,105,0,0,0,0,0,1
01767381,39,0,39,0,0,0,0,0,1
01767383,28,3,25,0,1,1,0,1,1
01767416,37,10,27,0,1,1,0,1,1
01767419,355,3,352,0,1,1,0,1,1
01767543,3,3,0,0,2,2,0,1,1
01767656,6,3,3,0,2,2,0,0,1
01768014,19,4,15,0,1,1,0,1,1
01768096,21,5,16,0,0,0,0,0,1
01768405,28,2,26,0,1,1,0,1,1
01768456,15,3,12,0,1,1,0,1,1
01768508,34,0,34,0,0,0,0,0,1
01768939,6,0,6,0,1,1,0,0,1
01769076,4,2,2,0,0,0,0,0,0
01769240,5,2,3,0,1,1,0,0,0
01769417,12,4,8,0,4,4,0,1,1
01769664,6,3,3,0,1,1,0,1,0
01769690,26,4,22,0,1,1,0,1,1
01770024,18,1,17,0,1,1,0,1,1
01770170,11,2,9,0,1,1,0,0,0
01770274,2,0,2,0,0,0,0,0,0
01770406,3,2,1,0,1,1,0,0,0
01770494,15,7,8,0,0,0,0,0,0
01770899,27,4,23,0,1,1,0,1,1
01771172,38,3,35,0,2,2,0,2,1
01771308,24,4,20,0,1,1,0,1,0
01771349,30,5,25,0,1,1,0,1,1
01771398,7,0,7,0,0,0,0,0,1
01771626,7,4,3,0,0,0,0,0,1
01771935,28,2,26,0,1,1,0,1,1
01772135,19,0,19,0,0,0,0,0,1
01772267,14,4,10,0,1,1,0,1,1
01772586,78,3,75,0,1,1,0,1,1
01773009,23,2,21,0,1,1,0,1,1
01774063,13,2,11,0,1,1,0,1,0
01775393,10,1,9,0,2,2,0,1,1
01776213,18,4,14,0,1,1,0,1,1
01776848,38,3,35,0,1,1,0,1,1
01777292,28,3,25,0,1,1,0,1,1
01777297,4,2,2,0,1,1,0,0,1
01777412,11,0,11,0,0,0,0,0,1
01777430,25,3,22,0,1,1,0,1,1
01777777,49,7,42,0,2,2,0,2,1
01777824,15,4,11,0,1,1,0,1,1
01777826,7,1,6,0,1,1,0,0,0
01778149,117,14,103,0,0,0,0,0,1
01778189,14,4,10,0,1,1,0,1,1
01778311,11,2,9,0,0,0,0,0,1
01778433,28,6,22,0,0,0,0,0,0
01778666,23,2,21,0,2,0,2,0,1
01778797,9,2,7,0,1,1,0,0,1
01778879,53,6,47,0,0,0,0,0,0
01779361,36,0,36,0,0,0,0,0,1
01780077,19,2,17,0,1,1,0,1,1
01780108,90,10,80,0,0,0,0,0,1
01780264,22,0,22,0,0,0,0,0,1
01780488,36,4,32,0,0,0,0,0,1
01780839,47,5,42,0,0,0,0,0,1
01781138,16,6,10,0,1,1,0,1,1
01781246,20,5,15,0,0,0,0,0,1
01781504,34,3,31,0,1,1,0,1,1
01781525,70,10,60,0,0,0,0,0,0
01781526,15,11,4,0,0,0,0,0,1
01781725,28,0,28,0,0,0,0,0,1
01782130,28,9,19,0,1,1,0,1,1
01782132,23,6,17,0,1,1,0,0,1
01782339,48,9,39,0,0,0,0,0,1
01782357,42,6,36,0,1,1,0,1,1
01782527,23,3,20,0,1,1,0,1,1
01782715,22,10,12,0,2,2,0,0,0
01782838,3,3,0,0,2,2,0,0,0
01783007,45,10,35,0,1,1,0,0,1
01783025,20,0,20,0,0,0,0,0,1
01783293,24,3,21,0,6,3,3,0,1
01783300,33,3,30,0,2,2,0,2,1
01783730,57,7,50,0,0,0,0,0,1
01783762,37,0,37,0,0,0,0,0,1
01784071,16,6,10,0,1,1,0,0,1
01784086,24,3,21,0,4,3,1,1,1
01784117,22,3,19,0,1,1,0,1,1
01785260,17,0,17,0,0,0,0,0,1
01785280,24,3,21,0,1,1,0,1,1
01785366,3,3,0,0,2,2,0,0,0
01785574,31,5,26,0,0,0,0,0,0
01785651,33,6,27,0,0,0,0,0,1
01785678,15,0,15,0,0,0,0,0,1
01785710,93,17,76,0,0,0,0,0,1
01786053,19,4,15,0,1,1,0,1,1
01786117,25,4,21,0,3,3,0,0,1
01786119,22,3,19,0,1,1,0,1,1
01786372,5,4,1,0,0,0,0,0,0
01786533,49,6,43,0,0,0,0,0,1
01786925,36,7,29,0,0,0,0,0,1
01787301,13,2,11,0,1,1,0,1,1
01787741,10,2,8,0,2,1,1,0,0
01787886,6,0,6,0,0,0,0,0,1
01788531,11,5,6,0,0,0,0,0,0
01788928,20,0,20,0,0,0,0,0,1
01789716,33,10,23,0,0,0,0,0,1
01789721,6,2,4,0,1,1,0,0,0
01789733,34,7,27,0,0,0,0,0,1
01790063,7,2,5,0,1,1,0,0,1
01790322,14,2,12,0,2,2,0,0,1
01790857,16,5,11,0,1,1,0,1,0
01790935,29,7,22,0,0,0,0,0,1
01790975,25,7,18,0,0,0,0,0,1
01791076,17,3,14,0,1,1,0,1,1
01791760,93,20,73,0,0,0,0,0,1
01792109,32,7,25,0,1,1,0,1,1
01792482,16,4,12,0,2,1,1,0,1
01792921,43,9,34,0,0,0,0,0,1
01793193,78,12,66,0,0,0,0,0,0
01793691,38,6,32,0,0,0,0,0,0
01794098,55,8,47,0,0,0,0,0,1
01794387,13,0,13,0,0,0,0,0,1
01794511,95,11,84,0,0,0,0,0,1
01794963,7,3,4,0,1,1,0,1,1
01795123,4,3,1,0,2,2,0,0,1
01795321,32,4,28,0,1,1,0,1,1
01795333,17,10,7,0,0,0,0,0,0
01795572,43,0,43,0,0,0,0,0,1
01795642,29,0,29,0,0,0,0,0,1
01795732,291,4,287,0,1,1,0,1,1
01796065,40,4,36,0,2,1,1,2,1
01796116,18,10,8,0,0,0,0,0,1
01796131,57,0,57,0,1,1,0,1,1
01796209,6,4,2,0,2,1,1,0,0
01796211,9,0,9,0,0,0,0,0,1
01796345,73,5,68,0,0,0,0,0,0
01796367,29,5,24,0,1,0,1,1,1
01796492,27,6,21,0,1,1,0,1,1
01796513,62,13,49,0,0,0,0,0,1
01796928,78,9,69,0,0,0,0,0,1
01797055,21,0,21,0,0,0,0,0,1
01797287,24,10,14,0,0,0,0,0,0
01797430,21,0,21,0,0,0,0,0,1
01798114,35,3,32,0,1,1,0,1,1
01798474,43,0,43,0,0,0,0,0,1
01798623,15,5,10,0,0,0,0,0,1
01798738,15,3,12,0,1,1,0,0,1
01798907,3,2,1,0,1,1,0,0,0
01798959,5,0,5,0,0,0,0,0,1
01798992,13,1,12,0,4,2,2,1,1
07640384,1,1,0,0,1,1,0,0,0
07640387,4,0,4,0,0,0,0,0,1
07640413,1,1,0,0,1,1,0,0,0
07640469,2,2,0,0,2,2,0,0,1
07640503,11,3,8,0,1,1,0,1,1
07640528,4,4,0,0,1,1,0,0,1
07640644,22,10,12,0,0,0,0,0,1
07640706,8,5,3,0,1,1,0,1,1
07640730,8,0,8,0,1,1,0,1,1
07641004,28,6,22,0,0,0,0,0,1
07641233,2,2,0,0,1,1,0,0,0
07641345,4,2,2,0,1,1,0,0,1
07641361,23,15,8,0,0,0,0,0,1
07641762,6,1,5,0,1,1,0,1,1
07641767,7,0,7,0,0,0,0,0,1
07641796,5,0,5,0,0,0,0,0,1
07641820,26,9,17,0,0,0,0,0,0
07642002,3,2,1,0,1,1,0,0,1
07642349,2,2,0,0,2,2,0,0,0
07643107,1,1,0,0,0,0,0,0,0
07643365,2,2,0,0,1,1,0,0,1
07643381,1,1,0,0,1,1,0,0,1
07643489,1,1,0,0,1,1,0,0,0
07643637,2,2,0,0,1,1,0,0,1
07643712,37,12,25,0,0,0,0,0,1
07643795,34,18,16,0,4,4,0,0,1
07644310,5,0,5,0,1,1,0,1,1
07645159,23,7,16,0,0,0,0,0,1
07645442,5,0,5,0,0,0,0,0,0
07645462,13,10,3,0,1,1,0,1,1
07645531,6,5,1,0,1,1,0,1,1
07645575,3,1,2,0,1,1,0,0,0
07646619,1,1,0,0,0,0,0,0,0
07646910,6,0,6,0,1,1,0,0,0
07646982,2,0,2,0,0,0,0,0,1
07647211,1,0,1,0,1,1,0,0,1
07647246,3,3,0,0,2,2,0,0,1
07647260,1,0,1,0,0,0,0,0,1
07647364,13,3,10,0,1,0,1,0,0
07647396,7,0,7,0,1,1,0,1,1
07647419,8,2,6,0,1,1,0,1,1
07647443,1,1,0,0,1,1,0,0,0
07647707,1,1,0,0,1,1,0,0,0
07647813,3,3,0,0,2,2,0,0,0
07648249,1,1,0,0,1,1,0,0,0
07648378,2,2,0,0,2,2,0,0,0
07648445,1,1,0,0,1,1,0,0,0
07648764,12,7,5,0,1,1,0,1,1
07648811,2,2,0,0,1,1,0,0,0
07648968,24,8,16,0,0,0,0,0,1
07649077,5,5,0,0,1,1,0,0,1
07649093,15,4,11,1,6,4,2,0,0
07649122,25,0,25,0,0,0,0,0,0
07649187,1,1,0,0,1,1,0,0,0
07649308,2,2,0,0,2,2,0,0,1
07649422,31,11,20,0,1,1,0,0,1
07649592,2,2,0,0,2,2,0,0,1
07649701,1,1,0,0,1,1,0,0,0
07649753,3,3,0,0,2,2,0,1,1
07650054,7,6,1,0,0,0,0,0,0
07650139,2,1,1,0,1,1,0,0,1
07650280,3,3,0,0,2,2,0,0,1
07650291,18,9,9,0,3,1,2,2,1
07650615,18,0,18,0,0,0,0,0,0
07651171,1,1,0,0,2,2,0,0,0
07651297,3,3,0,0,1,1,0,1,0
07651447,2,2,0,0,1,1,0,0,1
07652341,1,0,1,0,0,0,0,0,0
07652401,19,3,16,0,0,0,0,0,1
07652548,19,4,15,0,1,1,0,1,1
07652565,17,0,17,0,0,0,0,0,1
07652661,43,13,30,0,0,0,0,0,1
07652696,37,12,25,0,2,0,2,0,1
07652767,6,0,6,0,0,0,0,0,1
07652830,4,0,4,0,0,0,0,0,1
07652990,18,3,15,0,1,1,0,1,1
07652992,18,3,15,0,1,1,0,1,1
07653014,27,10,17,0,0,0,0,0,0
07653051,26,4,22,0,5,3,2,0,1
07653084,3,2,1,0,1,1,0,0,0
07653209,11,6,5,0,1,1,0,1,1
07653551,2,1,1,0,1,1,0,0,1
07653588,2,0,2,0,1,1,0,0,1
07653605,1,0,1,0,0,0,0,0,1
07653677,3,3,0,0,2,2,0,1,1
07653794,4,0,4,0,0,0,0,0,0
07654100,5,0,5,0,0,0,0,0,0
07654237,56,18,38,0,0,0,0,0,1
07654281,11,7,4,0,0,0,0,0,1
07654298,38,10,28,0,0,0,0,0,0
07654433,6,3,3,0,1,1,0,0,1
07654438,3,0,3,0,0,0,0,0,1
07654525,23,4,19,0,0,0,0,0,1
07654899,7,5,2,0,0,0,0,0,0
07654914,5,0,5,0,0,0,0,0,1
07655226,3,3,0,0,2,2,0,0,0
07655542,5,3,2,1,0,0,0,0,1
07655648,3,2,1,0,2,2,0,0,0
07655684,18,5,13,0,0,0,0,0,0
07656154,1,1,0,0,1,1,0,0,0
07656439,16,7,9,0,1,1,0,1,1
07656591,2,1,1,0,1,1,0,0,0
07656649,2,0,2,0,0,0,0,0,0
07656671,1,1,0,0,1,1,0,0,0
07657160,4,4,0,0,1,1,0,1,1
07657278,7,2,5,0,1,1,0,0,0
07657307,31,7,24,0,5,4,1,0,1
07657419,1,1,0,0,1,1,0,0,0
07657603,8,0,8,0,0,0,0,0,1
07657664,2,0,2,0,1,1,0,0,0
07657723,6,1,5,0,3,3,0,0,1
07657806,42,17,25,0,4,3,1,0,1
07657815,2,1,1,0,1,1,0,0,0
07658130,2,1,1,0,1,1,0,0,0
07658413,14,10,4,0,0,0,0,0,0
07658679,1,1,0,0,2,1,1,0,0
07658759,1,0,1,0,0,0,0,0,0
07658891,11,5,6,0,0,0,0,0,1
07659221,5,3,2,0,1,1,0,0,0
07659374,1,1,0,0,1,1,0,0,0
07659458,9,0,9,0,0,0,0,0,1
07659460,7,4,3,0,0,0,0,0,1
07660273,2,0,2,0,0,0,0,0,1
07660591,5,5,0,0,1,1,0,0,1
07660698,20,10,10,0,0,0,0,0,1
07660874,11,6,5,0,3,2,1,1,1
07660995,34,9,25,0,0,0,0,0,0
07661227,30,12,18,0,1,1,0,0,0
07661420,4,4,0,0,0,0,0,0,1
07661831,3,1,2,0,2,1,1,0,0
07661987,21,4,17,0,4,1,3,4,1
07662129,32,12,20,0,1,1,0,1,1
07662201,3,1,2,0,1,1,0,0,0
07662208,11,7,4,0,1,1,0,1,1
07662251,30,12,18,0,0,0,0,0,0
07662624,14,6,8,0,1,1,0,1,1
07662700,12,5,7,0,0,0,0,0,1
07662896,6,0,6,0,0,0,0,0,1
07662953,2,1,1,0,2,1,1,0,0
07663383,7,2,5,0,1,1,0,1,0
07663542,4,0,4,0,0,0,0,0,1
07664276,16,10,6,0,0,0,0,0,1
07664699,6,0,6,0,0,0,0,0,1
07664781,2,2,0,0,2,2,0,0,1
07664788,2,2,0,0,2,2,0,0,1
07664825,2,0,2,0,0,0,0,0,1
07665250,4,3,1,0,2,2,0,1,1
07665387,45,17,28,0,0,0,0,0,0
07665650,1,1,0,0,1,1,0,0,0
07665775,3,3,0,0,2,2,0,0,0
07665942,11,8,3,0,1,1,0,0,1
07665967,2,2,0,0,2,2,0,0,0
07666062,9,2,7,0,1,1,0,1,1
07666136,16,5,11,0,0,0,0,0,0
07666140,4,2,2,0,2,2,0,0,0
07666185,35,15,20,0,0,0,0,0,0
07666474,2,2,0,0,1,1,0,0,0
07666846,1,1,0,0,1,1,0,0,0
07667216,6,0,6,0,0,0,0,0,0
07667445,12,7,5,0,0,0,0,0,1
07667695,3,2,1,0,2,2,0,0,0
07667831,4,2,2,0,1,1,0,0,0
07667839,18,6,12,0,1,1,0,1,1
07667884,1,1,0,0,1,1,0,0,1
07668728,5,5,0,0,1,1,0,0,0
07668762,2,2,0,0,2,2,0,0,0
07669193,11,4,7,0,0,0,0,0,1
07669263,52,18,34,0,2,1,1,0,1
07669300,2,2,0,0,2,2,0,0,1
07669990,2,2,0,0,2,2,0,0,0
07670707,3,3,0,0,1,1,0,0,1
07670723,23,11,12,0,1,1,0,0,0
07670786,24,4,20,0,1,1,0,1,1
07670870,1,0,1,0,0,0,0,0,1
07670992,14,5,9,0,1,1,0,1,1
07671089,1,0,1,0,0,0,0,0,0
07671315,4,3,1,0,2,2,0,0,0
07671637,37,13,24,0,0,0,0,0,1
07671949,37,9,28,0,0,0,0,0,1
07671975,6,2,4,0,0,0,0,0,0
07672256,4,0,4,0,0,0,0,0,1
07672443,2,2,0,0,3,3,0,0,0
07672464,2,0,2,0,0,0,0,0,1
07672607,18,10,8,0,0,0,0,0,0
07672608,7,3,4,0,2,2,0,2,1
07672698,19,5,14,0,1,1,0,1,1
07672781,44,20,24,0,0,0,0,0,1
07672838,4,3,1,0,0,0,0,0,1
07673502,1,1,0,0,1,1,0,0,1
07673642,18,4,14,0,2,2,0,0,1
07673911,21,13,8,0,0,0,0,0,1
07674379,1,1,0,0,1,1,0,0,0
07675020,4,0,4,0,0,0,0,0,1
07675052,3,3,0,0,2,2,0,0,0
07675172,28,14,14,0,0,0,0,0,1
07675391,1,1,0,0,1,1,0,0,0
07675537,1,0,1,0,0,0,0,0,1
07675556,2,1,1,0,1,1,0,0,1
07675749,3,0,3,0,0,0,0,0,1
07675901,4,2,2,0,1,1,0,0,1
07676222,1,1,0,0,1,1,0,0,1
07676414,1,1,0,0,1,1,0,0,0
07676547,2,2,0,0,2,2,0,0,1
07676949,7,3,4,0,1,1,0,1,1
07677386,1,0,1,0,1,1,0,0,0
07677727,1,1,0,0,2,2,0,0,1
07677946,1,1,0,0,1,1,0,0,0
07677978,3,1,2,0,1,1,0,0,1
07677981,2,0,2,0,0,0,0,0,1
07678340,2,1,1,0,1,1,0,0,0
07678422,2,0,2,0,0,0,0,0,0
07678756,16,4,12,0,2,2,0,2,1
07678764,1,1,0,0,1,1,0,0,0
07678825,1,0,1,0,1,1,0,0,0
07678864,40,7,33,0,0,0,0,0,1
07678900,6,2,4,0,1,0,1,1,0
07679091,10,0,10,0,0,0,0,0,1
07679121,9,3,6,0,0,0,0,0,1
07679752,3,0,3,0,0,0,0,0,1
07679920,4,0,4,0,0,0,0,0,1
07679923,9,3,6,0,3,3,0,1,1
07680023,1,1,0,0,1,1,0,0,0
07680327,3,0,3,0,0,0,0,0,1
07680339,33,14,19,0,0,0,0,0,0
07680583,2,2,0,0,1,1,0,0,1
07680728,13,0,13,0,0,0,0,0,1
07680770,30,14,16,0,0,0,0,0,0
07680815,6,4,2,0,1,1,0,1,1
07680823,44,17,27,0,0,0,0,0,1
07680947,10,3,7,0,2,1,1,1,0
07680988,10,4,6,0,1,1,0,1,1
07681067,25,8,17,0,1,1,0,0,0
07681344,1,1,0,0,1,1,0,0,0
07681400,11,7,4,0,1,1,0,1,1
07681691,4,2,2,0,2,2,0,0,1
07681706,2,2,0,0,0,0,0,0,1
07681739,38,19,19,0,0,0,0,0,0
07681976,5,0,5,0,0,0,0,0,0
07682104,1,1,0,0,1,1,0,0,0
07682649,2,0,2,0,0,0,0,0,0
07682844,3,0,3,0,1,1,0,0,0
07683167,1,1,0,0,1,1,0,0,0
07683232,1,1,0,0,1,1,0,0,0
07683502,2,1,1,0,1,1,0,0,1
07684052,2,0,2,0,0,0,0,0,0
07684197,5,3,2,0,1,1,0,0,0
07684304,4,2,2,0,2,2,0,0,1
07684601,2,2,0,0,2,2,0,0,0
07684902,33,14,19,0,0,0,0,0,0
07684990,1,1,0,0,2,2,0,0,0
07685003,4,0,4,0,1,1,0,0,1
07685085,2,0,2,0,0,0,0,0,1
07685430,3,1,2,0,1,1,0,1,1
07685803,15,5,10,0,1,1,0,1,1
07685825,7,3,4,0,1,1,0,1,1
07685911,4,2,2,0,4,3,1,0,0
07685923,30,11,19,0,0,0,0,0,0
07686180,4,4,0,0,1,1,0,0,0
07686374,1,1,0,0,1,1,0,0,1
07686400,1,0,1,0,0,0,0,0,1
07686527,1,1,0,0,1,1,0,0,1
07686656,3,3,0,0,2,2,0,1,1
07686909,2,2,0,0,2,2,0,0,1
07686985,4,0,4,0,1,1,0,0,0
07687029,19,0,19,0,0,0,0,0,0
07687047,1,0,1,0,0,0,0,0,1
07687150,10,8,2,0,1,1,0,1,1
07687235,27,13,14,0,0,0,0,0,0
07687362,1,1,0,0,1,1,0,0,0
07687591,29,11,18,0,1,0,1,0,1
07687888,2,0,2,0,1,1,0,0,1
07688256,2,0,2,0,1,1,0,0,0
07688544,25,9,16,0,3,2,1,1,1
07688654,5,1,4,0,1,1,0,0,0
07688662,3,0,3,0,1,1,0,0,0
07688731,2,1,1,0,2,1,1,0,0
07688824,9,5,4,0,1,1,0,1,1
07688954,2,0,2,0,0,0,0,0,1
07689282,2,2,0,0,4,4,0,2,0
07689591,3,3,0,0,3,3,0,0,0
07689604,11,6,5,0,2,2,0,0,1
07689653,3,0,3,0,0,0,0,0,1
07689780,4,1,3,0,2,2,0,0,1
07691009,4,2,2,0,1,1,0,1,1
07691068,1,0,1,0,0,0,0,0,0
07691081,5,4,1,0,4,4,0,0,0
07691585,3,1,2,0,1,1,0,0,0
07691647,5,3,2,0,2,2,0,0,1
07691738,3,3,0,0,4,4,0,0,1
07691764,15,6,9,0,0,0,0,0,0
07692348,16,0,16,0,0,0,0,0,1
07692414,34,3,31,0,3,3,0,0,1
07692632,13,0,13,0,0,0,0,0,1
07692831,4,2,2,0,2,1,1,1,0
07692959,2,1,1,0,0,0,0,0,1
07693084,2,0,2,0,0,0,0,0,1
07693195,4,1,3,0,2,2,0,0,0
07693208,5,0,5,0,0,0,0,0,0
07693250,20,7,13,0,0,0,0,0,1
07693359,14,0,14,0,0,0,0,0,1
07693736,9,3,6,0,4,3,1,0,0
07693800,2,1,1,0,2,1,1,0,1
07693806,5,5,0,0,1,1,0,1,1
07694468,2,2,0,0,1,1,0,0,1
07694481,5,3,2,0,1,1,0,0,0
07694530,48,18,30,0,0,0,0,0,1
07694783,2,1,1,0,1,1,0,0,0
07695253,2,2,0,0,1,1,0,0,0
07695300,4,3,1,0,0,0,0,0,0
07695342,15,0,15,0,1,1,0,0,1
07695486,15,9,6,0,0,0,0,0,1
07695542,15,0,15,0,0,0,0,0,1
07695771,28,8,20,0,3,3,0,0,1
07695786,20,3,17,0,2,1,1,1,1
07695890,7,0,7,0,0,0,0,0,1
07695941,2,2,0,0,2,2,0,0,0
07695999,2,0,2,0,0,0,0,0,0
07696676,5,5,0,0,0,0,0,0,1
07696969,3,3,0,0,2,2,0,0,0
07696989,35,8,27,0,4,3,1,1,1
07697161,4,2,2,0,1,1,0,1,1
07697170,25,8,17,0,0,0,0,0,1
07697175,4,2,2,0,1,1,0,0,1
07697485,44,27,17,0,0,0,0,0,1
07697504,31,16,15,0,0,0,0,0,1
07697587,36,8,28,0,0,0,0,0,1
07697600,23,8,15,0,0,0,0,0,0
07697698,34,12,22,0,0,0,0,0,0
07697764,5,5,0,0,1,1,0,1,0
07698081,1,1,0,0,1,1,0,0,1
07698115,1,0,1,0,0,0,0,0,1
07698238,8,4,4,0,3,1,2,3,0
07698398,5,5,0,0,5,5,0,0,1
07698490,1,0,1,0,0,0,0,0,0
07698578,22,17,5,0,0,0,0,0,0
07698859,31,15,16,0,0,0,0,0,1
07698872,3,2,1,0,1,1,0,1,0
07698943,3,2,1,0,0,0,0,0,1
07699161,10,4,6,0,2,1,1,1,0
07699549,3,2,1,0,1,1,0,0,0
07699705,39,9,30,0,0,0,0,0,1
07699834,13,8,5,0,1,0,1,0,1
07700251,32,14,18,0,0,0,0,0,0
07700275,19,4,15,0,1,1,0,1,1
07700324,1,0,1,0,0,0,0,0,1
07700372,6,6,0,0,2,2,0,0,1
07700432,1,1,0,0,1,1,0,0,0
07700799,8,6,2,0,3,2,1,0,1
07700859,8,4,4,0,3,3,0,0,1
07701211,1,1,0,0,1,1,0,0,0
07701222,2,2,0,0,2,2,0,0,0
07701442,1,1,0,0,1,1,0,0,0
07701802,5,2,3,0,4,1,3,1,1
07701943,22,0,22,0,1,1,0,1,1
07701965,2,0,2,0,1,1,0,0,1
07702581,2,1,1,0,1,1,0,0,0
07703006,1,1,0,0,1,1,0,0,0
07703078,4,2,2,0,3,3,0,1,0
07703113,2,0,2,0,0,0,0,0,0
07703523,4,0,4,0,1,1,0,0,1
07703610,11,3,8,0,6,4,2,1,1
07703851,3,2,1,0,1,1,0,0,1
06326273,47,4,43,0,1,1,0,0,0
06326753,15,1,14,0,0,0,0,0,1
06326754,25,0,25,0,0,0,0,0,1
06327034,16,3,13,0,1,1,0,1,1
06327041,20,4,16,0,1,1,0,1,1
06327087,20,4,16,0,1,1,0,1,1
06327124,11,3,8,0,2,1,1,2,1
06327289,6,0,6,0,2,2,0,0,1
06327374,4,1,3,0,1,1,0,0,0
06327524,3,1,2,0,1,1,0,0,1
06327807,3,0,3,0,1,1,0,0,0
06328045,15,3,12,0,1,1,0,1,1
06328075,3,3,0,0,2,2,0,0,0
06328950,7,0,7,0,2,1,1,1,1
06329035,16,4,12,0,1,1,0,1,1
06329321,5,0,5,0,0,0,0,0,1
06329336,5,0,5,0,0,0,0,0,1
06329350,5,0,5,0,0,0,0,0,1
06329392,3,1,2,0,1,1,0,0,0
06329512,5,3,2,0,1,1,0,1,0
06329568,8,0,8,0,0,0,0,0,1
06330077,3,0,3,0,1,1,0,0,1
06330169,7,5,2,0,1,1,0,0,0
06330189,5,0,5,0,0,0,0,0,1
06330425,6,0,6,0,0,0,0,0,1
06330951,7,4,3,0,1,1,0,0,1
06330954,8,4,4,0,1,1,0,0,1
06331113,13,6,7,0,1,1,0,1,1
06331269,6,2,4,0,1,1,0,1,1
06331272,7,0,7,0,0,0,0,0,0
06331413,34,9,25,0,0,0,0,0,1
06331583,12,9,3,0,0,0,0,0,1
06332067,14,2,12,0,2,1,1,1,1
06332145,5,3,2,0,2,2,0,0,0
06332298,8,0,8,0,0,0,0,0,1
06332528,7,2,5,0,1,1,0,0,1
06332843,3,0,3,0,0,0,0,0,0
06333288,3,3,0,0,4,4,0,0,1
06334463,5,0,5,0,0,0,0,0,1
06334683,7,1,6,0,2,1,1,0,1
06334848,11,4,7,0,1,1,0,1,1
06335696,5,1,4,0,2,2,0,0,1
06335746,7,2,5,0,1,1,0,0,0
06335853,14,0,14,0,0,0,0,0,1
06336164,4,2,2,0,1,1,0,0,0
06336180,3,0,3,0,0,0,0,0,1
06336224,3,3,0,0,2,2,0,0,1
06336529,6,2,4,0,2,1,1,0,1
06336563,2,2,0,0,1,1,0,0,0
06336803,2,2,0,0,1,1,0,0,0
06336837,16,0,16,0,1,1,0,0,1
06336880,2,1,1,0,1,1,0,0,1
06337129,28,0,28,0,1,1,0,1,1
06337565,23,0,23,0,0,0,0,0,1
06337851,14,4,10,0,1,1,0,1,1
06337880,2,2,0,0,1,1,0,0,0
06338037,4,2,2,0,1,1,0,0,0
06338069,7,2,5,0,1,1,0,0,1
06338136,4,2,2,0,1,1,0,0,1
06338185,5,2,3,0,1,1,0,1,1
06338186,5,0,5,0,1,1,0,1,1
06338187,5,0,5,0,1,1,0,1,1
06338233,5,0,5,0,0,0,0,0,1
06338290,5,0,5,0,1,1,0,1,1
06338330,8,4,4,0,2,2,0,2,1
06338339,2,2,0,0,1,1,0,0,1
06338544,2,2,0,0,1,1,0,1,1
06338824,14,8,6,0,1,1,0,0,1
06338847,12,4,8,0,2,2,0,0,1
06338906,5,2,3,0,2,1,1,1,0
06339034,3,0,3,0,1,1,0,0,0
06339180,7,3,4,0,2,1,1,2,1
06339219,6,3,3,0,2,2,0,0,0
06339706,14,2,12,0,0,0,0,0,1
06339927,5,4,1,0,1,1,0,0,1
06340429,5,3,2,0,1,1,0,0,1
06340573,6,3,3,0,2,2,0,0,0
06340822,4,1,3,0,1,1,0,0,1
06341460,4,2,2,0,2,2,0,1,0
06341616,3,3,0,0,1,1,0,0,0
06341743,10,3,7,0,1,1,0,1,1
06342108,18,0,18,0,0,0,0,0,1
06342144,5,3,2,0,0,0,0,0,1
06342385,13,0,13,0,0,0,0,0,1
06342424,6,1,5,0,1,1,0,0,0
06342552,8,0,8,0,0,0,0,0,1
06342689,17,5,12,0,1,1,0,1,1
06342828,27,8,19,0,0,0,0,0,1
06342962,9,4,5,0,4,4,0,0,1
06343173,3,3,0,0,2,2,0,0,0
06343180,5,1,4,0,1,1,0,0,0
06343185,14,2,12,0,1,1,0,1,0
06343315,21,5,16,0,1,1,0,1,1
06343606,4,2,2,0,1,1,0,0,1
06343733,4,3,1,0,2,2,0,0,1
06343940,4,0,4,0,0,0,0,0,1
06344229,3,1,2,0,0,0,0,0,1
06344341,3,1,2,0,1,1,0,0,1
06345023,4,2,2,0,0,0,0,0,0
06345605,2,2,0,0,2,2,0,0,0
06345891,4,3,1,0,2,2,0,0,0
06346392,3,3,0,0,2,2,0,0,0
06346841,5,2,3,0,1,1,0,0,1
06347658,4,2,2,0,1,1,0,0,1
06347934,13,3,10,0,1,1,0,1,1
06348133,13,7,6,0,2,2,0,0,1
06348161,13,2,11,0,1,1,0,1,1
06348321,4,0,4,0,0,0,0,0,1
06348358,2,2,0,0,1,1,0,0,0
06348619,28,3,25,0,0,0,0,0,1
06348772,7,0,7,0,0,0,0,0,1
06348965,3,0,3,0,0,0,0,0,0
06348976,11,2,9,0,1,1,0,1,1
06349041,63,12,51,0,1,1,0,0,1
06349189,5,0,5,0,2,2,0,2,1
06349596,5,2,3,0,1,1,0,1,0
06349881,2,1,1,0,1,1,0,0,0
06350012,22,5,17,0,1,1,0,1,1
06350087,27,4,23,0,1,1,0,1,0
06350109,11,4,7,0,0,0,0,0,1
06350381,3,0,3,0,1,1,0,0,0
06350498,4,1,3,0,1,1,0,0,1
06350828,30,10,20,0,0,0,0,0,1
06350953,2,2,0,0,1,1,0,0,0
06351289,4,0,4,0,0,0,0,0,1
06351382,13,2,11,0,2,1,1,2,1
06351840,4,2,2,0,1,1,0,0,0
06351931,5,3,2,0,1,1,0,0,1
06352125,4,2,2,0,1,1,0,0,0
06352167,5,1,4,0,1,1,0,0,0
06352244,5,3,2,0,1,1,0,1,1
06352308,10,3,7,0,1,1,0,1,1
06352357,19,0,19,0,0,0,0,0,1
06352430,4,1,3,0,1,1,0,0,1
06352552,11,2,9,0,2,1,1,0,1
06352607,3,1,2,0,1,1,0,0,0
06353096,4,1,3,0,1,1,0,0,1
06353838,26,6,20,0,2,2,0,2,1
06353884,3,3,0,0,2,2,0,2,0
06353898,6,2,4,0,1,1,0,0,1
06354208,13,8,5,0,1,1,0,0,1
06354222,17,6,11,0,1,1,0,1,1
06354260,16,7,9,0,1,1,0,1,1
06354283,6,2,4,0,1,1,0,0,1
06354323,8,0,8,0,0,0,0,0,0
06356259,5,3,2,0,2,2,0,0,0
06356940,10,0,10,0,0,0,0,0,1
06357040,4,2,2,0,2,2,0,0,1
06357049,3,3,0,0,1,1,0,0,0
06357347,4,2,2,0,1,1,0,0,0
06357426,9,2,7,0,0,0,0,0,0
06357609,3,3,0,0,2,2,0,0,0
06357753,19,6,13,0,1,1,0,1,1
06358096,3,3,0,0,2,2,0,0,0
06358099,6,0,6,0,0,0,0,0,1
06358999,7,1,6,0,1,1,0,0,1
06359014,7,0,7,0,0,0,0,0,1
06359072,3,3,0,0,1,1,0,0,0
06359470,2,1,1,0,1,1,0,0,0
06359625,7,2,5,0,1,1,0,1,1
06359918,6,0,6,0,0,0,0,0,0
06360525,7,5,2,0,3,3,0,0,1
06360574,6,0,6,0,0,0,0,0,1
06360578,15,7,8,0,2,2,0,0,1
06360879,4,1,3,0,2,2,0,0,1
06362081,8,2,6,0,1,1,0,1,1
06362539,4,2,2,0,1,1,0,0,1
06362738,3,2,1,0,1,1,0,0,1
06362837,8,3,5,0,0,0,0,0,0
06363087,9,5,4,0,1,1,0,1,1
06363150,21,5,16,0,2,2,0,2,1
06363412,4,1,3,0,1,1,0,0,1
06363488,11,4,7,0,3,1,2,2,1
06363773,7,0,7,0,0,0,0,0,1
06364169,4,2,2,0,1,1,0,0,1
06364308,10,4,6,0,1,1,0,1,1
06364442,6,0,6,0,0,0,0,0,1
06364695,9,4,5,0,2,2,0,0,1
06364806,12,4,8,0,3,2,1,0,1
06364893,15,6,9,0,0,0,0,0,0
06364897,27,6,21,0,0,0,0,0,1
06365040,11,3,8,0,2,0,2,0,0
06365310,12,6,6,0,7,5,2,0,1
06365508,5,0,5,0,0,0,0,0,1
06365644,7,3,4,0,1,1,0,1,0
06365820,7,2,5,0,3,2,1,0,0
06366063,2,2,0,0,1,1,0,0,0
06366231,18,4,14,0,2,2,0,2,1
06367378,16,7,9,0,0,0,0,0,1
06367482,2,2,0,0,1,1,0,0,0
06367687,11,0,11,0,0,0,0,0,1
06367871,4,2,2,0,0,0,0,0,1
06368668,6,3,3,0,1,1,0,1,1
06368686,4,0,4,0,0,0,0,0,1
06368883,8,2,6,0,1,1,0,0,0
06368975,4,0,4,0,0,0,0,0,1
06369051,5,2,3,0,1,1,0,0,1
06369072,6,3,3,0,2,2,0,0,1
06369165,3,3,0,0,1,1,0,0,0
06369282,4,2,2,0,1,1,0,0,1
06369333,5,0,5,0,0,0,0,0,1
06369463,3,0,3,0,0,0,0,0,1
06369476,3,1,2,0,1,1,0,0,0
06369609,2,2,0,0,1,1,0,0,0
06369888,2,2,0,0,1,1,0,0,0
06370028,30,10,20,0,1,1,0,0,1
06370048,14,6,8,0,0,0,0,0,1
06370357,19,2,17,0,2,2,0,2,1
06370512,4,2,2,0,1,1,0,0,0
06370742,2,0,2,0,1,1,0,0,0
06370828,10,2,8,0,0,0,0,0,1
06371126,7,0,7,0,0,0,0,0,1
06371151,7,0,7,0,0,0,0,0,1
06371212,4,4,0,0,1,1,0,0,0
06371237,26,4,22,0,1,1,0,1,1
06371686,13,3,10,0,1,1,0,1,1
06371780,19,0,19,0,0,0,0,0,0
06372010,3,2,1,0,1,1,0,0,1
06372013,3,0,3,0,0,0,0,0,0
06372062,6,4,2,0,1,1,0,0,1
06372899,13,0,13,0,0,0,0,0,1
06372969,13,0,13,0,0,0,0,0,1
06372989,9,7,2,0,3,1,2,1,0
06372992,9,7,2,0,3,1,2,1,0
06373165,4,0,4,0,0,0,0,0,1
06373339,8,3,5,0,1,1,0,1,1
06373714,3,2,1,0,1,1,0,0,1
06374231,4,1,3,0,1,1,0,1,0
06374254,5,2,3,0,1,1,0,0,0
06374344,7,0,7,0,0,0,0,0,1
06374366,22,4,18,0,2,2,0,2,1
06374374,5,0,5,0,0,0,0,0,1
06374434,6,4,2,0,2,2,0,0,1
06374553,33,12,21,0,1,1,0,1,1
06374924,3,1,2,0,1,1,0,0,0
06375629,11,0,11,0,0,0,0,0,1
06376234,5,0,5,0,0,0,0,0,1
06376248,3,0,3,0,0,0,0,0,1
06376404,7,3,4,0,0,0,0,0,0
06376555,12,0,12,0,0,0,0,0,1
06376928,2,1,1,0,0,0,0,0,1
06377414,5,4,1,0,3,3,0,0,0
06377461,3,0,3,0,2,2,0,0,0
06377529,16,3,13,0,1,1,0,1,1
06377532,21,5,16,0,1,1,0,1,1
06377649,6,2,4,0,2,2,0,0,0
06377917,4,0,4,0,0,0,0,0,1
06378205,8,2,6,0,0,0,0,0,1
06378240,18,4,14,0,2,2,0,2,1
06378558,3,3,0,0,1,1,0,0,0
06378694,21,5,16,0,1,1,0,1,1
06378700,21,5,16,0,1,1,0,1,1
06378815,6,3,3,0,3,3,0,0,1
06378944,3,3,0,0,1,1,0,0,1
10924083,1,1,0,0,1,1,0,1,0
10924355,2,1,1,0,1,1,0,0,0
10924453,3,2,1,0,2,1,1,0,0
10924542,5,5,0,0,2,2,0,0,1
10924547,5,5,0,0,2,2,0,0,1
10924565,5,5,0,0,2,2,0,0,1
10924576,5,5,0,0,2,2,0,0,1
10924587,5,5,0,0,2,2,0,0,1
10924611,5,5,0,0,2,2,0,0,1
10924643,5,5,0,0,2,2,0,0,1
10924660,5,5,0,0,2,2,0,0,1
10924674,5,5,0,0,2,2,0,0,1
10924781,2,2,0,0,2,2,0,0,0
10925188,5,5,0,0,0,0,0,0,0
10925368,5,5,0,0,2,1,1,1,1
10925445,2,2,0,0,1,1,0,0,0
10925733,2,2,0,0,1,1,0,1,1
10925975,1,1,0,0,1,1,0,0,0
10926207,5,5,0,0,2,2,0,0,1
10926428,1,1,0,0,1,1,0,0,0
10926553,2,0,2,0,2,2,0,0,0
10926652,1,1,0,0,0,0,0,0,0
10926831,1,1,0,0,0,0,0,0,0
10926876,1,1,0,0,2,2,0,0,0
10926918,1,1,0,0,1,1,0,0,0
10927066,2,2,0,0,1,1,0,1,1
10927407,1,0,1,0,1,1,0,0,0
10927474,3,3,0,0,3,3,0,0,1
10927499,2,2,0,0,4,4,0,2,0
10927695,2,2,0,0,2,2,0,0,0
10928682,2,2,0,0,2,2,0,0,1
10928693,2,2,0,0,1,1,0,0,0
10928963,2,0,2,0,2,2,0,0,0
10929458,3,3,0,0,2,2,0,0,0
10929532,7,7,0,0,0,0,0,0,0
10929718,4,4,0,0,1,1,0,1,1
10929754,2,2,0,0,2,2,0,0,1
10929780,2,2,0,0,2,2,0,1,0
10930015,1,0,1,0,1,1,0,0,0
10930131,1,0,1,0,1,1,0,0,0
10930598,4,2,2,0,2,1,1,0,0
10931156,1,0,1,0,1,1,0,0,0
10931415,1,1,0,0,1,1,0,0,0
10931657,3,3,0,0,2,2,0,0,0
10932438,1,1,0,0,1,1,0,0,0
10932594,3,3,0,0,3,3,0,0,1
10932698,1,0,1,0,0,0,0,0,0
10932702,1,1,0,0,1,1,0,0,0
10932718,2,0,2,0,1,1,0,0,0
10932764,1,1,0,0,1,1,0,0,0
10933153,3,3,0,0,3,3,0,0,1
10933403,7,3,4,0,2,1,1,2,1
10933504,1,1,0,0,1,1,0,0,0
10934240,2,1,1,0,1,1,0,0,0
10934275,1,0,1,0,1,1,0,0,0
10934783,2,0,2,0,1,1,0,0,0
10935230,11,5,6,0,2,2,0,0,0
10935504,1,0,1,0,1,1,0,0,0
10936275,1,1,0,0,0,0,0,0,0
10936343,3,2,1,0,1,1,0,1,0
10936397,1,1,0,0,0,0,0,0,0
10936837,4,4,0,0,2,2,0,0,1
10937366,1,1,0,0,1,1,0,0,0
10937553,2,0,2,0,1,1,0,0,0
10937640,2,0,2,0,0,0,0,0,0
10937728,2,2,0,0,1,1,0,0,0
10938022,7,5,2,0,3,1,2,2,1
10938198,1,1,0,0,1,1,0,0,0
10938327,2,2,0,0,1,1,0,0,0
10939044,7,5,2,0,3,1,2,2,1
10939075,7,5,2,0,3,1,2,2,1
10939131,7,5,2,0,3,1,2,2,1
10940185,1,0,1,0,1,1,0,0,0
10940227,3,3,0,0,1,1,0,1,0
10940463,2,2,0,0,2,2,0,0,0
10940998,2,0,2,0,1,1,0,1,1
10941377,7,5,2,0,3,1,2,2,1
10941401,7,5,2,0,3,1,2,2,1
10942160,1,1,0,0,1,1,0,0,1
10942437,1,0,1,0,1,1,0,0,0
10942548,1,0,1,0,1,1,0,0,0
10943199,1,1,0,0,1,1,0,0,0
10943235,3,2,1,0,1,1,0,0,0
10943425,3,3,0,0,1,1,0,0,0
10943441,1,1,0,0,1,1,0,0,0
10943524,2,2,0,0,2,2,0,0,0
10943561,2,1,1,0,2,1,1,0,0
10943646,1,1,0,0,1,1,0,0,0
10943668,3,3,0,0,2,2,0,0,0
10943957,3,2,1,0,1,1,0,0,0
10944106,2,2,0,0,1,1,0,0,0
10944258,2,2,0,0,2,2,0,0,0
10944814,2,0,2,0,2,2,0,0,0
10945167,4,3,1,0,1,1,0,1,0
10945535,4,4,0,0,1,1,0,1,1
10946288,2,1,1,0,1,1,0,0,0
10946583,3,0,3,0,2,2,0,0,0
10946606,2,2,0,0,2,2,0,0,0
10946918,5,5,0,0,1,1,0,1,1
10947388,2,2,0,0,2,2,0,0,0
10947953,1,1,0,0,2,2,0,0,0
10948115,3,3,0,0,1,1,0,0,0
10948511,1,1,0,0,1,1,0,0,0
10948643,2,1,1,0,2,1,1,0,0
10948691,5,3,2,0,1,1,0,1,1
10948816,1,0,1,0,1,1,0,0,1
10948971,1,1,0,0,1,1,0,0,0
10949046,1,1,0,0,1,1,0,0,0
10949513,2,2,0,0,1,1,0,0,0
10949545,9,4,5,0,0,0,0,0,0
10949560,5,2,3,0,1,0,1,1,1
10950350,1,1,0,0,1,1,0,0,0
10950608,4,3,1,0,0,0,0,0,1
10950834,2,2,0,0,1,1,0,0,0
10951604,1,1,0,0,1,1,0,0,0
10951737,5,5,0,0,0,0,0,0,0
10951909,4,0,4,0,1,1,0,1,1
10951916,2,2,0,0,2,2,0,0,0
10952032,4,2,2,0,2,2,0,0,1
10952334,3,3,0,0,2,2,0,1,1
10952419,3,3,0,0,1,1,0,1,0
10952666,3,3,0,0,1,1,0,1,1
10952709,4,4,0,0,1,1,0,0,0
10952782,1,1,0,0,1,1,0,0,0
10952906,3,3,0,0,1,1,0,1,1
10952949,1,1,0,0,1,1,0,0,0
10952991,1,1,0,0,1,1,0,0,0
10953300,3,3,0,0,1,1,0,1,1
10953330,3,3,0,0,1,1,0,1,1
10953336,6,4,2,0,4,2,2,3,1
10953521,3,3,0,0,1,1,0,1,1
10953792,1,1,0,0,1,1,0,0,0
10954069,2,2,0,0,1,1,0,0,0
10954095,1,0,1,0,1,1,0,0,0
10954209,5,5,0,0,6,2,4,1,1
10954219,3,3,0,0,0,0,0,0,0
10954497,1,1,0,0,1,1,0,0,0
10955019,2,2,0,0,2,2,0,0,0
10955186,1,0,1,0,0,0,0,0,0
10955312,2,2,0,0,2,2,0,0,1
10955433,1,1,0,0,1,1,0,1,1
10955588,1,0,1,0,1,1,0,0,0
10955661,3,3,0,0,1,1,0,0,1
10955742,1,1,0,0,1,1,0,0,0
10955796,4,4,0,0,1,1,0,0,0
10956151,2,2,0,0,2,2,0,0,0
10956620,4,4,0,0,1,1,0,1,1
10956628,4,4,0,0,2,1,1,2,1
10956884,1,0,1,0,1,1,0,0,0
10957107,2,1,1,0,3,1,2,0,0
10957195,1,1,0,0,1,1,0,1,0
10957784,6,6,0,2,3,1,2,1,0
10958026,1,1,0,0,0,0,0,0,0
10958042,3,2,1,0,1,1,0,1,0
10958280,6,3,3,0,1,1,0,1,0
10958288,2,2,0,0,2,2,0,0,0
10958547,4,2,2,0,2,2,0,0,0
10958898,1,1,0,0,1,1,0,0,0
10959419,1,0,1,0,1,1,0,0,0
10959427,1,1,0,0,1,1,0,0,0
10959518,5,3,2,0,1,1,0,1,1
10960084,1,1,0,0,0,0,0,0,0
10960749,10,8,2,0,4,3,1,1,0
10960758,3,3,0,0,0,0,0,0,1
10960804,1,1,0,0,1,1,0,0,0
10960904,1,1,0,0,1,1,0,0,0
10961338,2,2,0,0,0,0,0,0,1
10961356,2,2,0,0,2,2,0,0,1
10961457,2,2,0,0,1,1,0,0,1
10961634,1,0,1,0,1,1,0,0,0
10961698,2,2,0,0,1,1,0,0,0
10961983,3,0,3,0,2,1,1,0,0
10962027,1,1,0,0,1,1,0,0,0
10962061,2,1,1,0,1,1,0,0,0
10962869,4,3,1,0,3,2,1,0,1
10963005,9,8,1,0,2,1,1,1,1
10963229,2,2,0,0,2,2,0,0,0
10963247,3,2,1,0,3,3,0,0,0
10963262,1,0,1,0,1,1,0,0,0
10963561,4,4,0,0,1,1,0,1,1
10963618,1,0,1,0,1,1,0,0,0
10963728,2,0,2,0,1,1,0,1,1
10963871,1,1,0,0,1,1,0,0,0
10963999,2,2,0,0,2,2,0,0,0
10964014,3,2,1,0,2,2,0,1,0
10964036,5,4,1,0,1,1,0,1,1
10964082,3,3,0,0,1,1,0,1,1
10964090,2,1,1,0,0,0,0,0,0
10964129,2,2,0,0,1,1,0,1,0
10964305,1,1,0,0,1,1,0,0,0
10964325,1,1,0,0,1,1,0,0,0
10964370,1,0,1,0,1,1,0,0,0
10964582,1,0,1,0,0,0,0,0,0
10964684,4,4,0,0,3,2,1,2,1
10964791,6,3,3,0,1,1,0,1,1
10964855,7,6,1,0,2,2,0,2,0
10964931,3,2,1,0,1,1,0,0,0
10964945,2,1,1,0,0,0,0,0,0
10965008,2,0,2,0,1,1,0,0,0
10965403,1,1,0,0,1,1,0,0,0
10966278,2,0,2,0,2,2,0,0,0
10966562,1,1,0,0,1,1,0,0,0
10966610,6,3,3,0,1,1,0,1,1
10967059,7,6,1,0,1,1,0,0,1
10967183,5,5,0,0,0,0,0,0,1
10967330,3,0,3,0,2,2,0,0,0
10967540,2,2,0,0,1,1,0,0,1
10967875,3,3,0,0,1,1,0,0,0
10967931,1,1,0,0,1,1,0,0,1
10968406,4,0,4,0,1,1,0,0,1
10969393,2,0,2,0,2,1,1,0,1
10969719,5,5,0,0,7,2,5,0,0
10970009,5,5,0,0,0,0,0,0,1
10970223,2,2,0,0,1,1,0,0,0
10970239,3,3,0,0,3,3,0,0,0
10970541,1,0,1,0,1,1,0,0,0
10970772,2,2,0,0,2,2,0,0,0
10971321,4,3,1,0,1,0,1,0,1
10971332,4,4,0,0,3,3,0,0,0
10971428,3,3,0,0,3,3,0,0,0
10971751,1,0,1,0,2,2,0,0,0
10972250,2,2,0,0,1,1,0,0,1
10972368,2,2,0,0,2,2,0,0,0
10972375,2,2,0,0,2,2,0,0,0
10972596,6,4,2,0,1,1,0,1,1
10972863,1,1,0,0,1,1,0,0,0
10972915,3,1,2,0,3,1,2,0,0
10972976,1,0,1,0,1,1,0,0,0
10973198,2,2,0,0,2,2,0,0,0
10973378,2,2,0,0,1,1,0,1,1
10973517,1,1,0,0,1,1,0,0,0
10973584,1,0,1,0,1,1,0,0,0
10973616,1,0,1,0,1,1,0,0,0
10974129,2,2,0,0,2,2,0,0,0
10974195,6,4,2,0,1,1,0,1,1
10974284,1,1,0,0,2,1,1,1,0
10974710,7,6,1,0,1,1,0,1,1
10974937,2,2,0,0,1,1,0,0,0
10975304,4,3,1,0,2,2,0,0,0
10975335,5,2,3,0,1,1,0,1,1
10975468,1,1,0,0,1,1,0,0,0
10975726,2,2,0,0,1,1,0,0,0
10975819,1,1,0,0,1,1,0,0,0
10975871,1,1,0,0,1,1,0,0,0
10976098,2,0,2,0,1,0,1,0,0
10976237,3,1,2,0,1,1,0,0,0
10976309,1,1,0,0,1,1,0,0,0
10976483,1,1,0,0,1,1,0,0,0
10976672,2,2,0,0,2,2,0,0,0
10976897,2,2,0,0,1,1,0,0,0
10977258,1,1,0,0,2,2,0,0,0
10977342,2,2,0,0,1,1,0,1,1
10977815,2,2,0,0,2,2,0,0,0
10977989,2,2,0,0,1,1,0,1,0
10978268,1,1,0,0,1,1,0,0,0
10978336,3,3,0,0,0,0,0,0,0
10978350,3,3,0,0,0,0,0,0,0
10978767,2,1,1,0,2,1,1,0,0
10979004,1,0,1,0,1,1,0,0,0
10979006,1,0,1,0,1,1,0,0,0
10979319,2,2,0,0,1,1,0,0,1
10979689,1,1,0,0,1,1,0,0,0
10979882,1,1,0,0,1,1,0,1,0
10979943,1,1,0,0,1,1,0,1,0
10980713,4,0,4,0,2,0,2,0,0
10980802,10,6,4,0,0,0,0,0,0
10980875,3,3,0,0,1,1,0,1,0
10980934,3,3,0,0,1,1,0,0,0
10981389,3,2,1,0,3,3,0,0,0
10982039,1,1,0,0,1,1,0,0,0
10982181,1,1,0,0,0,0,0,0,0
10982511,1,0,1,0,1,1,0,0,0
10982714,4,4,0,0,1,1,0,1,0
10982721,1,1,0,0,1,1,0,0,0
10983525,4,3,1,0,0,0,0,0,1
10983615,1,0,1,0,1,1,0,0,0
10983679,2,2,0,0,1,1,0,0,0
10983743,5,4,1,0,1,1,0,1,1
10983867,3,1,2,0,2,2,0,0,0
10983939,2,2,0,0,0,0,0,0,1
10983971,1,1,0,0,1,1,0,0,0
10984156,1,0,1,0,0,0,0,0,0
10984517,4,4,0,0,2,2,0,0,1
10984981,1,1,0,0,1,1,0,0,0
10985117,13,3,10,0,1,1,0,1,1
10985310,2,0,2,0,2,2,0,0,0
10985333,5,4,1,0,1,1,0,1,0
10985358,4,2,2,0,2,1,1,0,0
10985458,2,2,0,0,1,1,0,1,0
10985688,5,1,4,0,2,2,0,0,0
10985874,2,2,0,0,2,2,0,0,0
10986287,1,1,0,0,1,1,0,0,0
10986458,2,2,0,0,1,1,0,0,1
10986527,3,1,2,0,3,1,2,0,0
10986644,1,0,1,0,1,1,0,0,0
10987397,1,1,0,0,1,1,0,0,1
10987644,1,1,0,0,1,1,0,0,0
10987837,1,1,0,0,1,1,0,0,0
10988116,2,2,0,0,1,1,0,0,0
10988204,2,2,0,0,2,2,0,0,1
10988446,1,1,0,0,1,1,0,0,0
10988655,3,2,1,0,3,2,1,0,0
10988700,1,0,1,0,1,1,0,0,0
10989006,8,5,3,0,3,1,2,2,1
10989395,3,3,0,0,1,1,0,0,0
10989557,3,3,0,0,1,1,0,1,1
10989893,3,2,1,0,1,0,1,1,1
10990191,2,2,0,0,1,1,0,0,0
10990198,2,0,2,0,1,1,0,0,0
10990361,7,3,4,0,1,1,0,0,1
10990754,3,2,1,0,1,1,0,0,0
10991150,2,2,0,0,1,1,0,0,0
10991207,1,0,1,0,1,1,0,0,0
10991406,2,0,2,0,1,1,0,0,0
10991435,2,2,0,0,3,1,2,0,1
10991499,2,0,2,0,1,0,1,0,0
10991611,7,5,2,0,2,2,0,1,1
10991688,1,1,0,0,1,1,0,0,0
10991835,7,5,2,0,1,1,0,1,1
10992959,10,9,1,2,3,1,2,1,0
10993133,1,1,0,0,1,1,0,0,0
10993391,1,1,0,0,2,2,0,0,0
10993403,5,5,0,0,0,0,0,0,1
10993903,2,2,0,0,2,2,0,0,0
10994512,4,4,0,0,1,1,0,0,0
10994572,1,1,0,0,1,1,0,0,0
10994901,4,4,0,0,0,0,0,0,1
10995081,1,1,0,0,1,1,0,0,0
10995200,4,4,0,2,3,1,2,1,0
10995363,1,1,0,0,1,1,0,0,0
10996098,1,0,1,0,1,1,0,0,0
10996123,1,1,0,0,1,1,0,0,0
10996295,3,3,0,0,0,0,0,0,0
10996661,6,0,6,0,1,1,0,1,1
10996707,6,0,6,0,1,1,0,1,1
10996749,6,0,6,0,1,1,0,1,1
10996774,6,0,6,0,1,1,0,1,1
10996860,6,0,6,0,1,1,0,1,1
10996899,6,0,6,0,1,1,0,1,1
10996941,6,0,6,0,1,1,0,1,1
10997188,6,2,4,0,4,1,3,1,1
10997452,2,1,1,0,2,2,0,0,1
10997643,1,1,0,0,1,1,0,0,0
10997890,4,4,0,0,1,1,0,1,0
10998281,3,2,1,0,0,0,0,0,0
10998557,2,0,2,0,0,0,0,0,0
10998781,1,1,0,0,1,1,0,0,0
10998993,2,0,2,0,1,1,0,0,0
10999309,1,1,0,0,1,1,0,0,0
10999480,2,2,0,0,3,2,1,0,1
10999513,1,0,1,0,1,1,0,0,0
10999916,2,2,0,0,2,2,0,0,0
11000008,7,6,1,0,0,0,0,0,1
11000155,1,1,0,0,1,1,0,0,0
11000364,2,2,0,0,1,1,0,0,0
11000585,2,1,1,0,2,1,1,0,0
11000809,1,1,0,0,1,1,0,0,0
11000810,1,1,0,0,1,1,0,0,0
11000912,1,1,0,0,1,1,0,0,1
11001365,2,2,0,0,1,1,0,0,0
11001408,3,3,0,0,2,2,0,0,1
11001576,1,1,0,0,2,2,0,0,1
11001654,2,2,0,0,1,1,0,1,0
11001712,2,2,0,0,1,1,0,0,0
11001834,6,5,1,0,3,1,2,2,1
11001855,7,5,2,0,3,1,2,2,1
11001998,7,5,2,0,3,1,2,2,1
11002318,1,1,0,0,1,1,0,0,0
11002672,2,2,0,0,0,0,0,0,0
11002764,8,6,2,0,3,1,2,2,1
11002976,1,0,1,0,1,1,0,0,0
11003310,1,1,0,0,1,1,0,0,0
11003348,3,3,0,0,2,2,0,0,1
11003955,1,1,0,0,1,1,0,0,0
06820227,16,7,9,0,0,0,0,0,1
06820441,27,9,18,0,1,1,0,1,1
06820756,4,1,3,0,1,1,0,0,1
06820931,4,0,4,0,0,0,0,0,0
06821450,18,13,5,0,1,0,1,0,1
06821503,6,2,4,0,2,2,0,0,1
06822125,10,0,10,0,1,1,0,1,1
06822185,8,0,8,0,1,1,0,1,1
06822210,14,4,10,0,1,1,0,1,1
06822212,15,4,11,0,1,1,0,1,1
06822214,11,3,8,0,1,1,0,1,1
06822218,12,3,9,0,1,1,0,1,1
06822219,11,3,8,0,1,1,0,1,1
06822670,12,3,9,0,1,1,0,1,1
06822717,7,5,2,0,0,0,0,0,0
06822718,8,0,8,0,1,1,0,1,1
06822745,1,1,0,0,1,1,0,0,0
06822810,6,0,6,0,0,0,0,0,0
06822819,33,16,17,0,1,1,0,0,1
06822985,6,1,5,0,1,1,0,0,1
06823128,25,8,17,0,0,0,0,0,0
06823184,2,2,0,0,1,1,0,1,1
06823239,35,6,29,0,2,1,1,0,0
06823256,29,7,22,0,0,0,0,0,1
06824206,5,5,0,0,2,2,0,0,1
06825034,2,1,1,0,1,1,0,0,0
06825082,5,2,3,0,0,0,0,0,0
06825454,5,3,2,0,0,0,0,0,1
06825465,4,2,2,0,1,1,0,0,1
06825594,12,0,12,0,0,0,0,0,1
06825798,37,8,29,0,0,0,0,0,1
06826046,9,4,5,0,1,1,0,1,1
06826110,4,3,1,0,2,2,0,0,0
06827240,3,2,1,0,2,2,0,0,0
06827560,2,1,1,0,1,1,0,0,0
06827644,14,0,14,0,1,1,0,1,1
06827660,4,3,1,0,1,1,0,0,1
06827733,4,0,4,0,0,0,0,0,1
06827966,12,0,12,0,1,1,0,1,1
06828066,18,4,14,1,0,0,0,0,1
06828200,4,2,2,0,2,2,0,0,0
06828472,2,0,2,0,0,0,0,0,0
06828579,3,3,0,0,1,1,0,0,0
06828680,5,4,1,0,1,1,0,1,1
06828769,25,4,21,0,0,0,0,0,1
06828864,10,3,7,0,1,1,0,1,0
06828905,8,3,5,0,2,2,0,0,1
06828945,2,2,0,0,2,2,0,0,0
06829019,6,3,3,0,1,1,0,1,1
06829417,15,2,13,0,1,1,0,1,1
06829893,20,7,13,0,0,0,0,0,0
06830221,2,0,2,0,2,2,0,0,1
06830440,4,2,2,0,0,0,0,0,0
06830610,9,3,6,0,2,2,0,1,0
06830751,10,4,6,0,1,1,0,1,1
06830762,8,4,4,0,6,6,0,5,1
06831097,3,2,1,0,1,1,0,0,1
06831408,4,4,0,0,0,0,0,0,1
06831430,6,0,6,0,0,0,0,0,1
06831578,8,2,6,0,1,1,0,0,1
06831783,2,1,1,0,2,2,0,0,1
06831803,3,0,3,0,0,0,0,0,1
06831988,2,0,2,0,0,0,0,0,1
06832208,13,7,6,0,0,0,0,0,0
06832393,3,3,0,0,3,3,0,0,0
06832416,30,11,19,1,1,1,0,1,1
06832761,11,0,11,0,0,0,0,0,0
06833014,3,0,3,0,0,0,0,0,0
06833092,3,3,0,0,2,2,0,0,0
06833438,3,2,1,0,1,1,0,0,0
06833681,2,1,1,0,2,1,1,0,0
06833924,2,0,2,0,0,0,0,0,0
06834107,5,1,4,0,1,1,0,0,0
06834538,18,4,14,0,0,0,0,0,1
06834543,17,8,9,0,0,0,0,0,1
06834677,17,7,10,0,0,0,0,0,1
06834694,4,1,3,0,1,1,0,0,0
06834853,5,3,2,0,2,2,0,0,0
06835017,4,3,1,0,2,2,0,0,0
06835105,6,1,5,0,1,1,0,1,1
06835122,15,6,9,0,0,0,0,0,1
06835708,3,2,1,0,1,1,0,0,0
06835974,11,3,8,0,1,1,0,1,1
06836020,18,7,11,0,0,0,0,0,1
06836090,2,0,2,0,0,0,0,0,0
06836248,3,0,3,1,0,0,0,0,1
06836348,16,7,9,0,0,0,0,0,1
06836594,8,1,7,0,1,0,1,1,1
06836819,17,8,9,0,0,0,0,0,0
06836986,2,2,0,0,1,1,0,0,0
06837173,3,3,0,0,2,2,0,0,0
06837446,2,2,0,0,2,2,0,0,0
06838055,4,0,4,0,0,0,0,0,1
06838247,14,0,14,0,0,0,0,0,1
06838460,3,2,1,0,1,1,0,0,1
06838965,3,3,0,0,1,1,0,0,0
06839153,4,2,2,0,1,1,0,0,1
06839484,2,1,1,0,1,1,0,0,0
06839490,3,2,1,0,2,2,0,0,0
06839754,3,2,1,0,1,1,0,0,1
06839817,12,0,12,0,0,0,0,0,1
06840504,7,5,2,0,0,0,0,0,1
06841314,20,10,10,0,0,0,0,0,1
06841687,5,3,2,0,1,1,0,0,1
06841786,22,1,21,0,2,1,1,1,1
06841812,3,0,3,0,2,2,0,0,0
06841980,2,1,1,0,1,1,0,0,0
06842120,4,1,3,0,1,1,0,0,1
06842544,30,4,26,0,0,0,0,0,1
06842603,2,1,1,0,1,1,0,0,0
06842711,12,3,9,0,0,0,0,0,1
06842996,3,1,2,0,1,1,0,0,1
06843290,4,2,2,0,1,1,0,0,1
06843338,13,6,7,0,0,0,0,0,0
06843356,1,0,1,0,0,0,0,0,0
06843567,9,2,7,0,1,1,0,1,1
06844171,3,1,2,0,2,2,0,0,0
06844413,11,7,4,0,1,1,0,0,1
06844511,3,3,0,0,3,3,0,0,0
06844557,14,3,11,0,1,1,0,1,1
06844742,3,0,3,0,0,0,0,0,0
06845038,2,0,2,0,0,0,0,0,0
06845210,31,12,19,0,10,6,4,0,1
06845424,16,3,13,0,0,0,0,0,1
06845434,16,6,10,0,1,1,0,1,1
06845451,28,9,19,0,4,0,4,0,1
06845465,31,6,25,0,3,1,2,0,1
06845787,18,3,15,0,2,2,0,2,1
06846128,13,6,7,0,1,1,0,0,1
06846236,2,1,1,0,1,1,0,0,0
06846298,8,0,8,0,0,0,0,0,1
06846325,15,7,8,0,0,0,0,0,1
06846523,5,3,2,0,3,3,0,0,0
06846695,7,3,4,0,2,2,0,0,0
06847195,4,3,1,0,2,2,0,0,1
06847260,7,0,7,0,0,0,0,0,1
06847424,8,4,4,0,1,1,0,1,0
06847468,2,1,1,0,1,1,0,0,0
06847492,7,3,4,0,1,1,0,1,0
06847567,9,2,7,0,2,2,0,0,0
06847747,23,9,14,0,1,1,0,0,0
06847757,4,2,2,0,1,1,0,0,0
06848059,15,8,7,0,0,0,0,0,1
06848267,20,0,20,0,2,2,0,0,1
06848384,25,15,10,0,0,0,0,0,1
06848780,2,2,0,0,2,2,0,0,1
06848849,2,1,1,0,1,1,0,0,0
06848978,3,0,3,0,0,0,0,0,0
06849134,11,4,7,0,1,0,1,0,1
06849984,5,0,5,0,0,0,0,0,0
06850129,5,0,5,0,1,1,0,0,0
06850239,6,2,4,0,2,1,1,0,0
06850597,1,1,0,0,1,1,0,0,1
06851153,2,1,1,0,1,1,0,0,0
06851437,3,2,1,0,2,2,0,0,0
06851516,2,1,1,0,1,1,0,0,1
06851535,2,2,0,0,1,1,0,0,0
06851597,12,8,4,0,0,0,0,0,1
06851738,7,3,4,0,2,1,1,1,1
06852007,5,0,5,0,0,0,0,0,1
06852084,8,0,8,0,0,0,0,0,1
06852095,1,0,1,0,0,0,0,0,0
06852162,14,3,11,0,0,0,0,0,0
06852680,2,0,2,0,0,0,0,0,0
06852700,3,3,0,0,1,1,0,0,1
06852789,7,1,6,0,1,1,0,0,0
06852920,4,0,4,0,0,0,0,0,1
06853020,4,0,4,0,0,0,0,0,1
06853065,2,2,0,0,2,2,0,0,1
06853109,11,4,7,0,1,1,0,1,1
06853120,2,2,0,0,1,1,0,0,1
06853152,5,0,5,0,0,0,0,0,0
06853328,53,18,35,0,0,0,0,0,1
06853431,1,1,0,0,1,1,0,0,0
06853971,20,6,14,0,2,1,1,0,1
06854083,2,1,1,0,0,0,0,0,0
06854191,11,5,6,0,2,2,0,2,1
06854337,3,1,2,0,1,1,0,0,1
06854392,4,3,1,0,1,1,0,0,0
06854760,3,2,1,0,2,2,0,0,0
06854812,16,0,16,0,0,0,0,0,1
06854994,2,2,0,0,2,2,0,0,0
06855223,4,1,3,0,1,1,0,0,0
06855504,1,0,1,0,0,0,0,0,1
06855533,20,8,12,0,4,3,1,2,1
06855586,6,0,6,0,1,1,0,1,1
06855667,4,4,0,0,4,4,0,1,1
06855798,6,5,1,0,1,1,0,0,1
06855806,5,2,3,0,1,1,0,0,0
06855943,2,1,1,0,1,1,0,0,0
06856110,7,5,2,0,4,4,0,0,1
06856305,7,0,7,0,0,0,0,0,1
06856368,5,3,2,0,1,1,0,1,1
06856568,10,7,3,0,0,0,0,0,0
06857417,13,8,5,0,0,0,0,0,1
06857512,3,0,3,0,0,0,0,0,0
06857615,3,2,1,0,0,0,0,0,0
06858174,4,2,2,0,2,2,0,0,1
06858208,1,1,0,0,1,1,0,0,0
06858410,2,2,0,0,0,0,0,0,1
06858515,3,2,1,0,1,1,0,1,1
06858672,4,2,2,0,1,1,0,1,1
06858903,8,4,4,0,1,1,0,1,1
06859180,14,3,11,0,1,1,0,1,1
06859894,48,12,36,0,1,1,0,1,1
06860067,4,2,2,0,2,2,0,0,0
06860290,22,2,20,0,1,1,0,1,1
06860375,19,9,10,0,3,3,0,0,1
06860457,3,0,3,0,0,0,0,0,0
06860518,14,5,9,0,1,1,0,1,1
06860795,3,3,0,0,2,2,0,0,0
06861132,6,4,2,0,2,1,1,2,1
06861176,5,3,2,0,3,3,0,0,0
06861273,10,3,7,0,0,0,0,0,0
06861293,14,9,5,0,1,1,0,0,1
06861343,16,0,16,0,0,0,0,0,1
06861486,11,4,7,0,3,3,0,1,1
06861809,5,1,4,0,0,0,0,0,1
06862000,2,0,2,0,0,0,0,0,0
06862278,2,2,0,0,2,2,0,0,1
06862788,4,0,4,0,1,1,0,0,1
06862870,14,6,8,0,2,2,0,1,1
06862901,18,4,14,0,2,2,0,2,1
06862913,5,0,5,0,0,0,0,0,1
06863179,4,1,3,0,1,1,0,0,0
06863248,10,6,4,0,0,0,0,0,1
06863312,2,0,2,0,0,0,0,0,0
06863357,6,0,6,0,0,0,0,0,1
06863524,4,0,4,0,0,0,0,0,1
06864138,2,0,2,0,0,0,0,0,1
06864430,5,0,5,0,0,0,0,0,1
06864737,21,5,16,0,1,1,0,1,1
06864923,16,6,10,0,0,0,0,0,0
06865448,4,2,2,0,1,1,0,0,0
06865508,2,1,1,0,2,1,1,0,1
06865772,9,8,1,0,0,0,0,0,1
06865810,5,0,5,0,0,0,0,0,1
06865909,5,2,3,0,1,1,0,0,1
06866266,14,2,12,0,1,1,0,1,1
06866358,15,7,8,0,0,0,0,0,0
06866790,3,3,0,0,1,1,0,0,1
06867458,3,3,0,0,2,2,0,0,0
06867491,3,3,0,0,2,2,0,0,0
06867550,14,2,12,0,1,1,0,1,1
06868115,4,0,4,0,0,0,0,0,0
06868881,14,7,7,0,0,0,0,0,1
06868926,5,2,3,0,2,2,0,0,1
06868991,4,1,3,0,1,1,0,0,1
06869031,8,3,5,0,1,1,0,1,1
06869309,13,7,6,0,1,1,0,1,1
06869499,6,3,3,0,1,1,0,1,0
06869540,1,1,0,0,1,1,0,0,0
06869709,11,4,7,0,1,0,1,1,0
06871011,13,4,9,0,0,0,0,0,1
06871042,41,15,26,0,0,0,0,0,1
06871274,5,2,3,0,1,1,0,0,0
06871624,1,1,0,0,1,1,0,0,1
06872514,1,1,0,0,1,1,0,0,0
06872557,3,2,1,0,1,1,0,0,1
06872880,16,3,13,0,0,0,0,0,1
06872894,7,0,7,0,2,1,1,0,1
06872973,2,0,2,0,0,0,0,0,1
06872984,6,1,5,0,1,1,0,0,0
06873051,16,6,10,0,1,1,0,1,1
06873257,4,1,3,0,2,1,1,0,0
06873277,4,0,4,0,0,0,0,0,1
06873441,2,1,1,0,1,1,0,0,1
06873610,3,3,0,0,1,1,0,0,0
06873659,8,3,5,0,1,1,0,1,1
06873769,4,2,2,0,1,1,0,0,0
06873825,1,1,0,0,1,1,0,0,1
06873831,8,5,3,0,0,0,0,0,0
06873912,35,16,19,0,0,0,0,0,0
06873923,3,0,3,0,0,0,0,0,1
06874440,17,4,13,0,0,0,0,0,1
06874524,7,6,1,0,0,0,0,0,0
06874527,23,5,18,0,0,0,0,0,0
06875099,12,6,6,0,1,1,0,0,0
06875410,2,0,2,0,0,0,0,0,1
06875417,2,2,0,0,1,1,0,0,0
06875625,2,2,0,0,1,1,0,0,0
06876260,5,3,2,0,1,1,0,0,0
06876652,4,2,2,0,2,2,0,0,0
06876751,10,3,7,0,1,1,0,1,1
06876964,17,7,10,0,0,0,0,0,0
06877152,2,1,1,0,1,1,0,0,1
06877502,1,1,0,0,1,1,0,0,0
06877626,2,0,2,0,0,0,0,0,1
06877980,2,1,1,0,1,1,0,0,1
06877987,7,5,2,0,2,2,0,0,1
06877997,16,0,16,0,0,0,0,0,1
06878225,53,19,34,0,0,0,0,0,1
06878610,2,1,1,0,1,1,0,1,0
06878745,8,5,3,0,1,1,0,0,1
06878843,5,1,4,0,1,1,0,0,1
06879044,7,0,7,0,0,0,0,0,1
06879246,3,2,1,0,2,2,0,0,1
06879553,2,0,2,0,1,1,0,0,1
06879671,3,2,1,0,1,1,0,0,1
06880155,19,8,11,0,2,2,0,0,1
06880196,11,6,5,0,2,1,1,1,1
06880387,6,1,5,0,1,1,0,1,1
06880415,7,1,6,0,1,1,0,1,1
06880504,3,2,1,0,1,1,0,0,0
06880612,5,4,1,0,1,1,0,0,0
06880615,2,0,2,0,2,1,1,0,0
06880678,2,1,1,0,1,1,0,0,1
06880830,5,3,2,0,1,1,0,0,1
06881301,3,0,3,0,0,0,0,0,1
06881418,4,0,4,0,0,0,0,0,1
06881519,1,1,0,0,1,1,0,0,0
06882710,15,5,10,0,1,1,0,1,1
06882826,2,0,2,0,0,0,0,0,1
06882973,8,3,5,0,3,1,2,1,1
06883228,4,2,2,0,2,2,0,0,0
06883704,5,2,3,0,3,2,1,0,1
06884395,4,1,3,0,1,1,0,1,1
06884476,27,16,11,0,0,0,0,0,0
06884631,7,6,1,0,0,0,0,0,0
06885174,1,1,0,0,1,1,0,0,0
06885275,5,2,3,0,1,1,0,1,1
06885317,4,4,0,0,1,1,0,1,1
06885389,11,5,6,0,2,1,1,0,1
06885442,3,0,3,0,0,0,0,0,1
06885462,37,13,24,0,0,0,0,0,1
06885556,8,4,4,0,1,1,0,1,0
06885579,17,0,17,1,0,0,0,0,1
06886164,4,0,4,0,0,0,0,0,1
06886213,8,4,4,0,1,1,0,1,1
06886244,17,6,11,0,1,1,0,1,1
06886708,13,6,7,0,0,0,0,0,1
06886733,3,1,2,0,1,1,0,0,0
06886948,1,1,0,0,1,1,0,0,1
06887051,1,1,0,0,1,1,0,0,0
06888387,4,3,1,0,1,1,0,1,1
06888641,9,4,5,0,0,0,0,0,1
06888710,3,3,0,0,1,1,0,0,1
06888857,10,6,4,0,0,0,0,0,1
06888873,28,0,28,0,0,0,0,0,1
06888906,10,6,4,0,3,3,0,1,1
06888918,4,4,0,0,3,3,0,0,1
06889053,6,3,3,0,2,0,2,0,1
06889169,2,0,2,0,0,0,0,0,1
06889236,3,0,3,0,0,0,0,0,1
06889372,2,1,1,0,1,1,0,0,1
06889536,4,1,3,0,1,1,0,0,1
06889576,7,3,4,0,1,1,0,0,0
06889660,2,0,2,0,1,1,0,0,1
06889700,9,6,3,0,1,1,0,0,0
09920534,2,2,0,0,1,1,0,0,1
09920819,2,0,2,0,0,0,0,0,0
09920940,2,2,0,0,1,1,0,0,1
09921093,1,1,0,0,1,1,0,0,0
09921383,4,3,1,0,3,2,1,0,0
09921536,2,1,1,0,2,1,1,0,0
09922077,1,1,0,0,0,0,0,0,1
09922236,2,2,0,0,2,2,0,0,0
09922379,5,4,1,0,0,0,0,0,0
09922935,1,0,1,0,0,0,0,0,0
09922991,9,6,3,0,0,0,0,0,1
09923002,6,5,1,0,0,0,0,0,1
09923076,4,4,0,0,1,1,0,1,0
09923087,2,0,2,0,0,0,0,0,0
09923415,1,0,1,0,1,1,0,0,0
09923431,2,2,0,0,0,0,0,0,0
09923451,2,1,1,0,3,1,2,3,1
09923520,3,3,0,0,0,0,0,0,1
09924018,2,2,0,0,2,2,0,0,0
09925149,17,9,8,0,1,1,0,1,1
09925316,6,4,2,1,3,3,0,0,1
09925677,2,2,0,0,2,2,0,0,0
09925704,2,2,0,0,1,1,0,0,0
09925803,2,2,0,0,1,1,0,0,0
09926428,6,4,2,0,2,2,0,0,1
09926779,3,2,1,0,1,1,0,1,1
09926936,1,0,1,0,1,1,0,0,0
09926957,6,4,2,0,0,0,0,0,0
09926994,2,2,0,0,2,2,0,0,0
09927603,2,2,0,0,2,2,0,0,0
09927779,1,1,0,0,1,1,0,0,1
09927995,7,0,7,0,0,0,0,0,0
09928220,3,1,2,0,1,1,0,0,1
09928225,1,1,0,0,1,1,0,0,0
09928412,16,12,4,0,2,1,1,2,1
09928542,4,4,0,0,4,4,0,0,0
09928547,12,9,3,0,3,1,2,0,1
09928931,1,1,0,0,1,1,0,0,0
09929221,4,0,4,0,0,0,0,0,1
09930009,2,1,1,0,1,1,0,0,0
09930120,3,3,0,0,2,2,0,0,0
09930996,3,2,1,0,1,1,0,0,0
09931251,3,2,1,0,1,1,0,0,0
09931962,7,2,5,0,1,1,0,1,1
09932293,6,4,2,0,1,1,0,1,0
09932856,3,0,3,0,0,0,0,0,1
09933074,1,0,1,0,2,2,0,0,0
09933543,2,1,1,0,1,1,0,0,0
09933845,1,1,0,0,1,1,0,0,0
09934283,2,2,0,0,1,1,0,0,1
09935016,1,1,0,0,2,2,0,0,0
09935225,1,1,0,0,1,1,0,0,0
09935297,3,2,1,0,2,2,0,0,1
09935727,1,1,0,0,1,1,0,0,1
09935767,2,2,0,0,1,1,0,0,0
09935952,3,3,0,0,3,3,0,0,0
09936051,5,4,1,0,1,1,0,1,1
09936137,5,3,2,0,1,1,0,0,1
09936295,1,1,0,0,1,1,0,0,0
09936344,1,0,1,0,1,1,0,0,0
09936362,1,0,1,0,1,1,0,0,0
09937279,2,0,2,0,0,0,0,0,1
09937300,1,1,0,0,1,1,0,0,0
09937544,2,2,0,0,1,1,0,0,0
09937613,3,0,3,0,1,1,0,0,0
09937810,1,1,0,0,1,1,0,0,0
09938159,1,1,0,0,1,1,0,0,0
09938295,2,0,2,0,1,1,0,0,0
09938297,1,0,1,0,1,1,0,0,0
09938525,1,0,1,0,1,1,0,0,0
09939099,17,11,6,0,2,2,0,2,1
09939402,2,2,0,0,2,2,0,0,0
09939533,2,2,0,0,1,1,0,0,0
09939937,1,1,0,0,1,1,0,0,0
09940205,3,3,0,0,1,1,0,1,1
09940261,1,1,0,0,1,1,0,0,0
09940268,2,2,0,0,2,2,0,0,0
09940647,1,1,0,0,1,1,0,0,1
09941388,1,1,0,0,1,1,0,0,1
09941604,2,2,0,0,2,2,0,0,0
09941783,1,1,0,0,1,1,0,0,0
09942046,2,2,0,0,2,1,1,0,1
09942158,7,5,2,0,3,3,0,0,0
09943103,4,3,1,0,1,1,0,1,0
09943123,1,0,1,0,1,1,0,0,0
09943351,1,1,0,0,1,1,0,0,0
09943393,7,4,3,0,1,1,0,1,0
09943407,2,0,2,0,1,1,0,1,0
09944191,2,1,1,0,2,1,1,0,0
09945113,1,0,1,0,0,0,0,0,1
09945399,2,2,0,0,1,1,0,0,0
09945667,2,1,1,0,2,1,1,0,0
09945788,2,2,0,0,2,2,0,0,0
09946110,1,1,0,0,1,1,0,0,0
09946160,2,2,0,0,2,2,0,0,1
09946550,4,3,1,0,2,1,1,2,1
09946606,1,1,0,0,1,1,0,0,0
09946659,6,4,2,0,1,1,0,0,0
09947147,1,1,0,0,2,2,0,0,0
09947245,2,2,0,0,1,1,0,0,0
09947416,3,3,0,0,2,2,0,0,0
09948080,1,0,1,0,1,1,0,0,0
09948900,1,0,1,0,1,1,0,0,0
09948962,1,1,0,0,1,1,0,1,0
09949408,6,4,2,0,3,3,0,0,0
09949662,5,0,5,0,0,0,0,0,1
09949999,4,0,4,0,0,0,0,0,1
09950016,4,0,4,0,0,0,0,0,1
09950925,1,1,0,0,2,2,0,0,0
09951689,1,1,0,0,1,1,0,0,0
09951822,1,0,1,0,0,0,0,0,0
09951955,2,0,2,0,1,1,0,0,0
09952280,1,1,0,0,1,1,0,0,0
09952667,2,2,0,0,1,1,0,0,0
09952830,6,5,1,0,1,1,0,0,0
09953156,4,1,3,1,1,1,0,0,0
09953690,2,0,2,0,1,1,0,0,0
09953773,6,4,2,0,0,0,0,0,0
09954676,8,5,3,0,1,0,1,1,1
09954717,12,2,10,0,1,1,0,0,1
09954912,9,8,1,0,0,0,0,0,0
09955116,2,2,0,0,2,1,1,2,0
09955204,2,1,1,0,1,1,0,0,0
09956080,11,6,5,0,2,1,1,2,1
09956625,3,2,1,0,2,2,0,0,1
09957315,2,1,1,0,1,1,0,1,1
09958003,13,6,7,0,2,1,1,2,1
09958403,1,1,0,0,1,1,0,0,0
09958525,22,18,4,0,0,0,0,0,0
09958805,2,1,1,0,1,1,0,0,1
09959136,4,4,0,0,1,1,0,1,1
09959332,1,1,0,0,1,1,0,0,0
09959426,1,1,0,0,1,1,0,0,0
09959619,2,2,0,0,1,1,0,0,0
09959637,6,6,0,0,0,0,0,0,1
09959654,3,3,0,0,1,1,0,0,1
09960018,1,1,0,0,1,1,0,0,0
09960719,2,2,0,0,1,1,0,0,1
09960769,9,3,6,0,3,1,2,3,1
09961033,5,4,1,0,1,1,0,1,1
09961241,1,1,0,0,1,1,0,0,0
09961445,2,2,0,0,2,2,0,0,1
09961633,1,0,1,0,0,0,0,0,0
09961936,1,0,1,0,0,0,0,0,1
09962010,3,2,1,0,3,3,0,0,0
09962113,1,1,0,0,1,1,0,0,0
09962165,3,0,3,0,0,0,0,0,1
09962312,3,2,1,0,1,1,0,1,1
09962560,3,3,0,0,3,3,0,0,1
09962667,3,2,1,0,1,1,0,0,0
09962900,2,1,1,0,2,2,0,0,0
09963935,1,1,0,0,1,1,0,0,0
09963997,6,5,1,0,0,0,0,0,1
09964064,7,3,4,0,1,1,0,1,1
09964070,7,3,4,0,1,1,0,1,1
09964075,7,3,4,0,1,1,0,1,1
09964231,11,3,8,0,2,1,1,2,1
09964243,1,1,0,0,0,0,0,0,0
09964306,14,3,11,0,2,1,1,2,1
09964345,11,3,8,0,2,1,1,2,1
09964958,2,2,0,0,2,1,1,1,0
09965081,6,3,3,0,1,1,0,1,1
09965184,3,3,0,0,2,2,0,0,1
09965254,4,3,1,0,1,1,0,0,1
09965684,2,0,2,0,2,2,0,0,0
09965803,1,1,0,0,1,1,0,0,0
09965954,6,4,2,0,1,1,0,1,1
09966224,11,3,8,0,2,1,1,2,1
09966486,6,2,4,0,1,1,0,0,1
09966662,6,0,6,0,0,0,0,0,1
09967032,7,5,2,0,2,1,1,0,0
09967119,1,1,0,0,1,1,0,0,0
09967384,1,1,0,0,1,1,0,0,0
09967490,1,0,1,0,1,1,0,0,0
09967944,1,1,0,0,1,1,0,0,0
09968277,2,1,1,0,1,1,0,0,0
09968464,8,3,5,0,0,0,0,0,1
09968644,1,1,0,0,1,1,0,0,0
09968915,2,2,0,0,1,1,0,0,0
09969110,3,2,1,0,2,1,1,2,0
09969640,12,6,6,0,1,1,0,0,1
09969694,8,7,1,0,0,0,0,0,1
09969706,2,1,1,0,2,1,1,0,0
09969937,2,0,2,0,1,1,0,0,1
09969950,2,0,2,0,1,1,0,0,1
09970055,2,2,0,0,2,2,0,0,0
09970522,6,0,6,0,0,0,0,0,1
09971472,1,1,0,0,1,1,0,0,0
09971632,1,1,0,0,1,1,0,0,0
09972178,2,0,2,0,1,1,0,0,0
09972203,4,4,0,0,2,2,0,0,1
09972433,6,6,0,0,0,0,0,0,0
09972965,3,1,2,0,3,1,2,0,0
09973076,1,1,0,0,1,1,0,0,0
09973281,2,2,0,0,1,1,0,0,0
09973409,8,8,0,0,1,1,0,1,1
09973456,3,3,0,0,1,1,0,1,1
09973707,4,4,0,0,4,4,0,0,0
09973953,3,3,0,0,2,2,0,0,0
09974867,2,2,0,0,1,1,0,1,1
09974949,2,2,0,0,1,1,0,0,1
09975038,3,2,1,0,2,2,0,0,0
09975192,3,3,0,0,1,1,0,1,0
09975230,11,4,7,0,3,0,3,0,1
09976055,19,12,7,0,0,0,0,0,0
09976204,12,4,8,0,0,0,0,0,1
09976283,1,0,1,0,1,1,0,0,0
09976988,9,9,0,0,0,0,0,0,0
09977013,2,1,1,0,1,1,0,0,0
09977062,1,1,0,0,1,1,0,0,0
09977128,1,1,0,0,1,1,0,0,0
09977478,2,2,0,0,2,2,0,0,0
09978034,14,8,6,0,0,0,0,0,1
09978183,3,2,1,0,1,1,0,1,1
09978282,8,5,3,0,4,1,3,2,1
09978327,7,0,7,0,1,1,0,1,1
09978380,2,2,0,0,1,1,0,0,0
09978410,17,4,13,0,0,0,0,0,1
09978459,14,10,4,0,3,3,0,0,1
09978542,11,0,11,0,1,1,0,1,1
09979067,1,0,1,0,1,1,0,0,0
09979091,1,1,0,0,2,2,0,1,0
09980626,3,2,1,0,2,2,0,0,0
09980752,11,8,3,0,1,1,0,0,1
09980813,6,3,3,0,0,0,0,0,1
09980907,2,0,2,0,1,1,0,0,0
09981331,4,3,1,0,3,3,0,0,1
09981335,6,4,2,0,4,3,1,0,1
09981643,3,3,0,0,1,1,0,0,0
09981841,1,0,1,0,0,0,0,0,0
09982025,2,2,0,0,2,2,0,0,0
09982155,2,1,1,0,2,1,1,0,0
09982517,4,4,0,0,0,0,0,0,1
09982640,3,1,2,0,2,2,0,2,1
09983600,5,1,4,0,4,4,0,0,1
09984124,3,2,1,0,2,2,0,0,1
09984516,1,1,0,0,1,1,0,0,0
09984999,2,2,0,0,2,2,0,0,0
09985002,1,1,0,0,1,1,0,0,0
09985007,6,5,1,0,3,2,1,0,1
09985129,5,4,1,0,1,1,0,0,1
09985146,4,0,4,0,0,0,0,0,0
09985276,4,3,1,0,1,1,0,1,1
09985317,5,2,3,0,1,1,0,0,1
09985572,6,0,6,0,0,0,0,0,1
09985844,1,1,0,0,1,1,0,0,0
09986426,7,6,1,0,3,1,2,3,1
09986676,4,3,1,0,1,1,0,0,1
09986729,1,1,0,0,1,1,0,0,0
09987089,7,4,3,0,0,0,0,0,1
09987167,4,3,1,0,0,0,0,0,1
09987495,12,7,5,0,2,1,1,0,0
09987590,2,2,0,0,2,2,0,0,0
09987897,2,2,0,0,2,2,0,0,1
09987907,12,7,5,0,0,0,0,0,1
09987956,1,1,0,0,1,1,0,0,0
09988064,2,0,2,0,3,3,0,1,1
09988600,1,1,0,0,1,1,0,0,0
09988909,3,3,0,0,2,2,0,0,0
09989000,5,2,3,0,1,1,0,1,1
09989015,6,5,1,0,5,5,0,0,0
09989167,2,2,0,0,1,1,0,0,1
09989185,6,2,4,0,1,1,0,1,1
09990194,2,2,0,0,2,2,0,0,0
09990212,1,1,0,0,1,1,0,0,0
09990582,2,2,0,0,1,1,0,0,1
09990959,4,3,1,0,0,0,0,0,0
09991541,2,2,0,0,2,2,0,0,0
09991881,3,0,3,0,1,1,0,0,0
09991916,3,3,0,0,2,2,0,0,1
09991965,2,1,1,0,3,2,1,1,0
09992203,15,10,5,0,1,1,0,1,1
09994123,3,3,0,0,3,3,0,0,0
09994353,5,5,0,0,2,2,0,0,1
09994485,1,0,1,0,0,0,0,0,0
09994556,1,1,0,0,1,1,0,0,0
09994826,3,3,0,0,1,1,0,0,0
09994832,1,1,0,0,0,0,0,0,0
09994939,2,2,0,0,2,2,0,0,0
09994997,1,0,1,0,1,1,0,0,0
09995057,4,4,0,0,4,4,0,0,1
09995412,3,0,3,0,2,2,0,0,0
09995571,3,2,1,0,1,1,0,0,0
09996181,1,0,1,0,1,1,0,0,0
09996277,2,2,0,0,2,2,0,0,0
09996432,7,3,4,0,0,0,0,0,1
09996435,1,1,0,0,1,1,0,0,0
09996485,3,2,1,0,2,0,2,0,1
09996564,1,0,1,0,1,1,0,0,0
09996604,5,5,0,0,2,2,0,0,1
09996664,5,4,1,0,1,1,0,1,1
02220236,7,1,6,0,1,1,0,0,1
02220564,45,10,35,0,0,0,0,0,1
02220627,14,3,11,0,1,1,0,1,1
02220777,32,6,26,0,1,1,0,1,1
02220935,30,0,30,0,0,0,0,0,1
02221244,32,0,32,0,0,0,0,0,1
02221425,10,3,7,0,1,1,0,1,0
02221475,18,3,15,0,1,1,0,1,1
02221536,61,3,58,0,0,0,0,0,1
02221701,15,4,11,0,4,2,2,0,1
02221912,34,0,34,0,0,0,0,0,1
02221992,13,3,10,0,3,2,1,0,1
02222066,39,3,36,0,1,1,0,1,1
02222099,18,5,13,0,0,0,0,0,1
02222181,7,0,7,0,0,0,0,0,1
02222190,99,13,86,0,0,0,0,0,1
02222373,44,8,36,0,2,1,1,1,1
02222777,18,6,12,0,1,0,1,0,1
02222933,19,5,14,0,1,1,0,0,0
02222953,113,10,103,0,0,0,0,0,1
02222998,45,3,42,0,0,0,0,0,1
02223002,29,0,29,0,1,1,0,1,1
02223006,29,4,25,0,1,1,0,1,1
02223016,27,3,24,0,2,1,1,2,1
02223143,74,13,61,0,1,1,0,1,1
02223148,42,5,37,0,3,1,2,3,1
02223202,54,9,45,0,1,1,0,1,1
02223203,25,6,19,0,1,1,0,1,1
02223589,27,3,24,0,1,1,0,1,1
02223662,10,2,8,0,1,1,0,0,1
02223725,7,2,5,0,1,1,0,0,1
02223786,27,8,19,0,0,0,0,0,1
02223851,2,0,2,0,0,0,0,0,1
02224079,21,0,21,0,0,0,0,0,1
02224403,65,11,54,0,12,12,0,0,1
02224562,11,0,11,0,0,0,0,0,1
02225727,56,14,42,0,0,0,0,0,1
02225732,17,0,17,0,0,0,0,0,1
02226151,22,0,22,0,1,1,0,1,1
02226414,31,3,28,0,0,0,0,0,1
02226566,17,2,15,0,2,1,1,0,1
02226886,55,5,50,0,2,2,0,2,1
02226926,49,12,37,0,0,0,0,0,1
02227449,10,3,7,0,2,2,0,2,0
02227450,35,0,35,0,1,1,0,1,1
02227583,14,0,14,0,0,0,0,0,1
02227594,20,5,15,0,1,1,0,0,1
02227706,58,7,51,0,0,0,0,0,1
02227909,18,3,15,1,1,1,0,0,1
02228001,11,0,11,0,0,0,0,0,1
02228050,38,5,33,0,1,1,0,0,1
02228346,58,10,48,0,0,0,0,0,1
02228388,19,4,15,0,0,0,0,0,1
02228390,19,3,16,0,1,1,0,1,1
02228533,45,7,38,0,2,1,1,2,1
02228599,46,4,42,0,0,0,0,0,1
02228813,7,3,4,0,0,0,0,0,0
02228978,60,7,53,0,8,4,4,0,1
02229357,49,4,45,0,0,0,0,0,1
02229492,42,5,37,0,1,1,0,1,1
02229702,16,5,11,0,1,1,0,1,1
02229970,17,0,17,0,0,0,0,0,1
02229974,18,0,18,0,0,0,0,0,1
02230229,21,2,19,0,1,1,0,1,1
02230411,51,6,45,0,1,1,0,1,1
02230494,32,3,29,0,1,0,1,1,1
02230634,3,2,1,0,2,2,0,0,0
02230654,13,0,13,0,0,0,0,0,1
02230663,12,2,10,0,1,1,0,1,1
02230719,38,0,38,0,1,1,0,1,1
02231043,43,5,38,0,1,1,0,1,1
02231157,27,4,23,0,1,1,0,1,1
02231246,43,10,33,0,0,0,0,0,1
02231331,36,0,36,0,0,0,0,0,1
02231497,10,4,6,0,1,1,0,1,0
02231595,26,10,16,0,1,1,0,1,0
02231620,31,5,26,0,3,2,1,0,1
02231656,22,0,22,0,1,1,0,1,1
02231974,6,1,5,0,1,1,0,0,0
02232045,0,0,0,0,0,0,0,0,1
02232547,12,0,12,0,0,0,0,0,1
02233384,38,3,35,0,2,1,1,2,1
02233451,29,3,26,0,1,1,0,1,1
02233654,84,4,80,0,1,1,0,1,1
02233737,49,5,44,0,0,0,0,0,1
02233869,39,0,39,0,2,2,0,0,1
02234290,21,0,21,0,1,1,0,1,1
02234300,21,5,16,0,1,1,0,0,1
02234338,13,6,7,0,0,0,0,0,1
02234363,7,3,4,0,2,1,1,1,1
02234442,68,9,59,0,0,0,0,0,1
02234453,17,0,17,0,0,0,0,0,1
02234775,54,11,43,0,0,0,0,0,1
02235061,71,4,67,0,0,0,0,0,1
02235215,22,3,19,0,1,1,0,1,1
02235261,20,4,16,0,1,1,0,1,1
02235447,28,4,24,0,0,0,0,0,1
02235556,19,4,15,0,0,0,0,0,1
02235581,19,0,19,0,0,0,0,0,1
02235602,18,0,18,0,0,0,0,0,1
02235754,14,0,14,0,0,0,0,0,1
02235761,24,0,24,0,1,1,0,1,1
02235994,54,5,49,0,1,1,0,1,1
02236179,37,9,28,0,0,0,0,0,1
02236187,2,2,0,0,1,1,0,0,0
02236190,11,4,7,0,0,0,0,0,0
02236337,24,4,20,0,2,1,1,1,1
02236448,32,0,32,0,0,0,0,0,1
02237421,22,4,18,0,0,0,0,0,1
02237424,54,0,54,0,0,0,0,0,1
02237525,11,1,10,0,1,1,0,0,1
02237536,12,0,12,0,0,0,0,0,1
02238053,56,3,53,0,3,2,1,0,1
02238069,30,3,27,0,1,1,0,1,1
02238081,13,4,9,0,1,1,0,1,1
02238143,40,2,38,0,1,1,0,1,1
02238415,72,14,58,0,1,1,0,1,1
02238517,36,0,36,0,0,0,0,0,1
02239545,27,0,27,0,0,0,0,0,1
02239584,19,6,13,0,0,0,0,0,1
02239663,29,3,26,0,1,1,0,1,1
02239794,34,7,27,0,2,1,1,0,1
02240496,56,9,47,0,1,1,0,1,1
02241004,15,4,11,0,0,0,0,0,0
02241223,39,9,30,0,0,0,0,0,1
02241388,8,4,4,0,1,1,0,0,1
02241423,24,4,20,0,3,1,2,3,1
02241917,3,2,1,0,1,1,0,0,0
02241961,11,4,7,0,2,1,1,2,1
02241974,33,0,33,0,0,0,0,0,1
02242132,8,3,5,0,0,0,0,0,0
02242272,5,4,1,0,2,2,0,0,1
02242500,27,3,24,0,1,1,0,1,1
02243048,14,1,13,0,1,1,0,1,0
02243060,25,0,25,0,1,1,0,1,1
02243094,11,2,9,0,2,1,1,1,1
02243193,4,0,4,0,0,0,0,0,1
02243361,14,0,14,0,1,1,0,1,1
02243568,27,0,27,0,0,0,0,0,1
02243832,47,7,40,0,4,3,1,0,0
02244240,7,5,2,0,1,1,0,1,0
02244297,35,10,25,0,1,1,0,1,1
02244565,48,3,45,0,2,2,0,2,1
02244773,8,4,4,0,1,1,0,1,1
02244967,53,3,50,0,1,1,0,1,1
02245562,45,5,40,0,0,0,0,0,1
02245594,38,6,32,0,1,1,0,1,1
02245999,12,4,8,0,1,1,0,1,1
02246058,72,3,69,0,1,0,1,1,1
02246207,14,0,14,0,0,0,0,0,1
02246366,20,5,15,0,1,1,0,1,1
02246583,41,7,34,0,0,0,0,0,1
02246585,6,2,4,0,1,1,0,0,1
02246643,45,8,37,0,1,1,0,1,1
02246781,16,4,12,0,1,1,0,1,1
02246802,3,2,1,0,1,1,0,0,1
02246951,28,3,25,0,1,1,0,1,1
02246961,17,0,17,0,0,0,0,0,1
02247011,0,0,0,0,0,0,0,0,0
02247305,5,3,2,0,1,1,0,0,0
02247309,7,5,2,0,2,2,0,1,1
02247432,31,5,26,0,0,0,0,0,1
02247671,36,3,33,0,1,1,0,1,1
02247735,89,4,85,0,1,1,0,1,1
02247908,7,3,4,0,1,1,0,0,1
02248022,34,9,25,0,0,0,0,0,1
02248023,7,2,5,0,1,1,0,1,0
02248334,25,3,22,0,1,1,0,1,1
02248738,17,2,15,0,1,1,0,1,1
02248805,32,6,26,1,0,0,0,0,1
02249123,5,1,4,0,1,1,0,0,0
02249164,22,6,16,0,1,1,0,1,1
02249271,28,5,23,0,1,1,0,1,1
02249382,24,4,20,0,1,1,0,1,1
02249561,24,5,19,0,1,1,0,1,1
02249575,11,4,7,0,1,1,0,0,0
02249727,15,0,15,0,0,0,0,0,1
02249978,15,2,13,0,1,1,0,1,1
02250705,5,0,5,0,0,0,0,0,1
02250714,6,4,2,0,1,1,0,1,0
02250999,36,4,32,0,1,1,0,0,1
02251093,15,0,15,0,0,0,0,0,1
02251098,6,3,3,0,1,1,0,0,1
02251099,28,0,28,0,0,0,0,0,1
02251116,20,3,17,0,1,1,0,1,1
02251321,22,0,22,0,0,0,0,0,1
02251540,24,4,20,0,2,1,1,2,1
02251659,29,3,26,0,1,1,0,1,1
02251822,29,0,29,0,0,0,0,0,1
02252101,8,3,5,0,0,0,0,0,1
02252339,29,6,23,0,5,5,0,0,1
02252498,25,4,21,0,0,0,0,0,1
02252625,34,5,29,0,2,1,1,2,1
02252852,7,3,4,0,0,0,0,0,1
02252945,5,3,2,0,3,3,0,0,0
02253172,13,5,8,0,1,1,0,1,1
02253188,4,3,1,0,2,2,0,2,1
02253289,20,7,13,0,0,0,0,0,1
02253975,9,2,7,0,1,1,0,1,1
02254232,19,7,12,0,0,0,0,0,0
02254388,27,3,24,0,0,0,0,0,1
02254715,24,2,22,0,0,0,0,0,1
02254895,4,3,1,0,1,1,0,0,0
02254918,33,3,30,0,1,1,0,1,1
02255151,41,15,26,0,1,0,1,0,1
02255180,19,2,17,0,0,0,0,0,0
02255224,7,1,6,0,1,1,0,1,1
02255353,11,3,8,0,5,1,4,1,1
02255384,34,2,32,0,1,1,0,1,1
02255458,20,8,12,0,1,1,0,0,1
02255591,7,3,4,0,3,1,2,1,1
02255846,41,4,37,0,1,1,0,1,1
02256001,37,4,33,0,0,0,0,0,1
02256129,61,13,48,0,1,1,0,1,1
02256271,32,3,29,0,0,0,0,0,1
02256478,3,2,1,0,1,1,0,0,0
02256491,29,3,26,0,1,1,0,1,1
02256725,3,3,0,0,2,2,0,0,0
02256780,17,2,15,0,1,1,0,1,1
02256844,22,5,17,0,0,0,0,0,1
02256861,9,3,6,0,0,0,0,0,1
02257616,22,3,19,0,1,1,0,1,1
02258097,6,2,4,0,3,1,2,0,1
02258235,11,5,6,0,1,1,0,0,0
02258294,15,0,15,0,0,0,0,0,1
02258495,22,3,19,0,1,1,0,1,0
02258585,20,5,15,0,0,0,0,0,0
02258628,30,7,23,0,1,1,0,1,1
02258674,0,0,0,0,0,0,0,0,0
02258740,6,3,3,0,2,2,0,0,0
02258780,28,11,17,0,0,0,0,0,1
02258851,30,5,25,0,1,1,0,1,1
02259016,67,3,64,0,1,1,0,1,1
02259168,30,5,25,0,1,1,0,1,1
02259175,36,0,36,0,1,1,0,1,1
02259349,36,4,32,0,1,1,0,1,1
02259512,22,5,17,0,0,0,0,0,1
02259514,20,0,20,0,0,0,0,0,1
02259526,96,9,87,0,0,0,0,0,1
02259954,11,6,5,0,4,1,3,1,1
02260036,27,4,23,0,1,1,0,0,0
02260143,34,5,29,0,1,1,0,1,1
02260145,34,0,34,0,1,1,0,1,1
02260183,4,2,2,0,1,1,0,1,0
02260474,12,3,9,0,1,1,0,1,1
02260552,27,3,24,0,1,1,0,1,1
02260648,25,2,23,0,2,2,0,1,1
02260840,48,9,39,0,0,0,0,0,1
02260892,51,9,42,0,0,0,0,0,1
02260991,79,17,62,0,0,0,0,0,1
02261117,37,6,31,0,2,2,0,2,1
02261135,49,1,48,0,2,2,0,0,1
02261795,12,2,10,0,1,1,0,0,1
02262098,26,5,21,0,0,0,0,0,1
02262102,14,2,12,0,1,1,0,1,1
02262172,40,2,38,0,1,1,0,1,1
02262206,40,9,31,0,0,0,0,0,1
02262315,26,3,23,0,1,1,0,1,1
02262517,4,0,4,0,0,0,0,0,1
02262641,36,6,30,0,0,0,0,0,0
02262654,7,3,4,0,4,3,1,0,0
02262730,45,4,41,0,0,0,0,0,1
02262746,15,3,12,0,1,1,0,0,1
02262815,5,2,3,0,1,1,0,0,0
02263030,23,3,20,0,1,1,0,1,1
02263055,17,3,14,0,3,3,0,0,1
02263368,30,3,27,0,1,1,0,1,1
02263454,26,4,22,0,1,1,0,1,1
02263496,10,3,7,0,1,1,0,1,1
02263554,16,0,16,0,1,1,0,1,1
02263711,22,3,19,0,0,0,0,0,1
02263833,17,0,17,0,1,1,0,1,1
02263950,45,3,42,0,3,3,0,1,1
02263951,132,22,110,0,1,1,0,1,1
02263952,12,3,9,0,1,1,0,1,1
02263980,39,11,28,0,0,0,0,0,1
02264245,19,4,15,0,1,1,0,1,1
02264251,80,11,69,0,1,1,0,1,1
02264279,25,3,22,0,2,0,2,2,1
02264577,0,0,0,0,0,0,0,0,1
02264927,21,0,21,0,0,0,0,0,1
02265126,3,2,1,0,1,1,0,0,0
02265140,31,4,27,0,1,1,0,1,1
02265179,94,0,94,0,0,0,0,0,1
02265182,86,8,78,0,8,7,1,0,1
02265425,18,3,15,0,1,1,0,0,1
02265539,60,9,51,0,0,0,0,0,0
02265579,32,5,27,0,2,2,0,2,1
02265614,9,3,6,0,1,1,0,1,1
02265766,26,0,26,0,1,1,0,1,1
02266092,47,3,44,0,1,1,0,1,1
02266201,8,0,8,0,0,0,0,0,1
02266287,41,2,39,0,2,1,1,2,1
02266864,28,7,21,0,0,0,0,0,1
02267055,34,5,29,0,1,1,0,1,1
02267090,57,6,51,0,0,0,0,0,1
02267304,11,4,7,0,1,1,0,0,1
02267533,3,1,2,0,1,1,0,0,0
02267867,4,3,1,0,2,2,0,0,1
02267985,12,0,12,0,0,0,0,0,1
02268003,37,9,28,0,9,0,9,0,1
02268032,22,0,22,0,0,0,0,0,1
02268092,72,9,63,0,0,0,0,0,1
02268167,11,1,10,0,1,1,0,0,1
02268702,30,0,30,0,1,1,0,1,1
02268817,13,3,10,0,0,0,0,0,1
02269153,36,0,36,0,0,0,0,0,1
02269227,2,2,0,0,0,0,0,0,1
02269271,20,0,20,0,0,0,0,0,1
02269292,13,3,10,0,0,0,0,0,1
02269310,50,9,41,0,0,0,0,0,0
02269670,16,3,13,0,1,1,0,0,1
02269719,32,3,29,0,0,0,0,0,1
02269894,37,8,29,0,0,0,0,0,1
02269926,10,4,6,0,4,4,0,1,1
02270044,37,11,26,0,0,0,0,0,1
02270117,59,0,59,0,0,0,0,0,1
02270152,11,4,7,0,1,1,0,0,0
02270271,35,0,35,0,0,0,0,0,1
02270991,0,0,0,0,0,0,0,0,1
02271026,3,0,3,0,2,1,1,0,0
02271092,38,3,35,0,2,2,0,2,1
02271699,16,0,16,0,1,1,0,1,1
02271790,22,3,19,0,1,1,0,1,1
02271896,36,0,36,0,0,0,0,0,1
02271935,39,0,39,0,0,0,0,0,1
02272056,21,3,18,0,1,1,0,1,1
02272167,15,3,12,0,1,1,0,0,1
02272344,9,6,3,0,6,4,2,0,1
02272411,18,2,16,0,0,0,0,0,1
02272577,42,3,39,0,1,1,0,1,1
02272789,11,1,10,0,4,2,2,1,1
02272852,8,3,5,0,3,1,2,2,1
02273559,30,5,25,0,1,1,0,1,1
02273708,108,12,96,0,0,0,0,0,1
02273763,33,0,33,0,1,1,0,1,1
02273942,10,2,8,0,1,1,0,0,1
06547210,5,3,2,0,1,1,0,0,0
06547618,5,0,5,0,1,1,0,1,1
06548014,29,1,28,0,0,0,0,0,1
06548094,8,7,1,0,4,4,0,0,1
06548265,17,3,14,0,1,1,0,1,1
06548295,14,0,14,0,0,0,0,0,1
06548296,24,7,17,0,0,0,0,0,1
06548413,7,2,5,0,3,1,2,1,1
06548500,3,1,2,0,1,1,0,0,0
06548566,12,4,8,0,3,3,0,0,0
06548653,8,0,8,0,0,0,0,0,1
06548660,9,0,9,0,0,0,0,0,1
06548681,13,3,10,0,1,1,0,1,1
06549272,5,3,2,0,1,1,0,0,0
06549630,13,3,10,0,0,0,0,0,1
06549638,13,3,10,0,1,1,0,1,1
06549824,5,3,2,0,1,1,0,0,0
06550122,3,3,0,0,2,2,0,0,0
06550177,3,3,0,0,2,2,0,0,1
06550444,2,2,0,0,1,1,0,0,0
06550605,4,1,3,0,1,1,0,0,0
06550814,5,3,2,0,2,2,0,0,0
06551042,9,4,5,0,0,0,0,0,1
06551761,13,3,10,0,1,1,0,1,1
06551800,13,3,10,0,1,1,0,1,1
06551987,2,2,0,0,1,1,0,0,0
06552023,3,3,0,0,2,2,0,0,1
06552039,7,2,5,0,1,1,0,1,1
06552216,5,3,2,0,2,2,0,0,1
06552289,9,5,4,0,3,1,2,1,0
06552579,8,3,5,0,1,1,0,0,0
06553020,15,7,8,0,1,1,0,0,1
06553035,14,4,10,0,2,2,0,2,1
06553083,7,2,5,0,1,1,0,0,1
06553119,5,3,2,0,3,3,0,0,0
06553313,4,2,2,0,1,1,0,0,0
06553315,6,4,2,0,4,4,0,0,1
06553727,14,4,10,0,2,2,0,2,1
06553837,4,0,4,0,0,0,0,0,0
06553884,14,0,14,0,0,0,0,0,1
06553923,21,8,13,0,0,0,0,0,1
06554087,3,3,0,0,5,3,2,0,1
06554406,2,0,2,0,1,1,0,0,1
06554687,5,2,3,0,1,1,0,1,0
06554781,7,5,2,0,2,2,0,0,0
06555157,27,8,19,0,1,0,1,0,1
06555379,5,1,4,0,1,1,0,0,0
06555382,6,0,6,0,1,1,0,1,1
06555385,2,0,2,0,0,0,0,0,1
06555389,4,1,3,0,1,1,0,0,0
06555903,14,11,3,0,1,1,0,0,1
06556007,13,5,8,0,0,0,0,0,1
06556193,9,0,9,0,0,0,0,0,1
06556212,2,1,1,0,1,1,0,0,0
06556344,10,0,10,0,1,1,0,1,1
06556697,3,1,2,0,1,1,0,0,1
06556971,5,2,3,0,1,1,0,0,1
06557649,11,8,3,0,0,0,0,0,1
06557960,7,0,7,0,1,1,0,1,1
06558084,2,0,2,0,0,0,0,0,1
06559203,6,2,4,0,1,1,0,0,0
06559530,11,0,11,0,1,1,0,1,1
06559658,4,2,2,0,1,1,0,0,0
06559788,6,0,6,0,1,1,0,0,1
06560162,19,6,13,0,6,5,1,0,0
06560167,1,0,1,0,0,0,0,0,0
06560588,2,2,0,0,2,2,0,0,0
06560754,6,4,2,0,3,3,0,0,1
06560987,4,0,4,0,0,0,0,0,0
06561455,3,3,0,0,1,1,0,1,1
06561917,4,3,1,0,1,1,0,0,0
06562041,6,2,4,0,0,0,0,0,0
06562082,4,2,2,0,1,1,0,0,1
06562183,5,2,3,0,2,2,0,0,0
06562391,0,0,0,0,0,0,0,0,1
06562727,3,3,0,0,1,1,0,0,0
06562743,7,2,5,0,2,1,1,0,1
06563229,5,3,2,0,2,2,0,0,0
06563486,20,7,13,0,1,1,0,1,1
06563550,16,7,9,0,0,0,0,0,0
06563597,8,2,6,0,1,1,0,1,1
06563601,6,3,3,0,1,1,0,0,1
06564093,4,0,4,0,1,1,0,0,0
06564281,11,3,8,0,1,1,0,1,1
06564282,9,2,7,0,1,1,0,1,1
06564647,5,2,3,0,1,1,0,0,1
06564901,1,0,1,0,1,1,0,0,0
06565089,10,0,10,0,0,0,0,0,1
06565117,17,6,11,0,0,0,0,0,1
06565151,2,1,1,0,1,1,0,0,0
06565349,2,2,0,0,2,2,0,0,0
06565970,11,3,8,0,0,0,0,0,1
06566112,4,1,3,0,1,1,0,0,0
06566143,3,1,2,0,1,1,0,0,1
06566162,4,4,0,0,2,2,0,0,1
06566992,6,2,4,0,2,2,0,0,0
06567253,4,0,4,0,2,2,0,0,0
06567434,12,3,9,0,0,0,0,0,0
06567935,2,2,0,0,0,0,0,0,1
06568044,6,4,2,0,2,2,0,0,0
06568402,4,3,1,0,2,2,0,0,0
06568921,6,0,6,0,0,0,0,0,1
06568982,15,6,9,0,1,1,0,1,1
06569163,5,0,5,0,0,0,0,0,1
06569173,15,0,15,0,1,1,0,1,0
06569223,16,0,16,0,0,0,0,0,1
06569262,7,0,7,0,0,0,0,0,1
06569597,15,0,15,0,0,0,0,0,0
06569604,20,6,14,0,0,0,0,0,1
06569609,20,6,14,0,0,0,0,0,1
06569621,17,5,12,0,0,0,0,0,1
06569622,21,6,15,0,0,0,0,0,1
06569680,8,4,4,0,2,2,0,0,1
06569789,34,4,30,0,3,1,2,3,1
06570409,8,1,7,0,3,2,1,0,0
06570511,6,0,6,0,0,0,0,0,0
06570822,8,0,8,0,0,0,0,0,0
06571066,4,2,2,0,1,1,0,0,0
06572077,1,0,1,0,1,1,0,0,0
06573016,4,1,3,0,1,1,0,0,1
06573056,1,1,0,0,1,1,0,0,0
06573157,8,3,5,0,1,1,0,1,1
06573221,4,2,2,0,1,1,0,0,1
06573749,2,0,2,0,0,0,0,0,0
06573899,4,2,2,0,0,0,0,0,1
06573983,7,5,2,0,1,1,0,0,1
06574326,11,4,7,0,0,0,0,0,1
06574530,4,2,2,0,1,1,0,0,0
06574689,22,4,18,0,1,1,0,1,0
06574767,19,9,10,0,1,1,0,1,1
06574857,3,0,3,0,0,0,0,0,1
06574965,22,3,19,0,1,1,0,1,1
06575611,2,0,2,0,1,1,0,0,1
06575892,10,3,7,0,0,0,0,0,0
06575962,27,3,24,0,1,1,0,1,1
06575968,3,3,0,0,1,1,0,0,0
06576255,8,4,4,0,0,0,0,0,1
06576301,9,5,4,0,1,1,0,1,1
06576342,9,5,4,0,1,1,0,1,1
06576352,7,1,6,0,1,1,0,0,1
06576443,20,4,16,0,1,1,0,1,1
06576808,2,0,2,0,0,0,0,0,1
06577050,9,2,7,0,0,0,0,0,1
06578068,25,1,24,0,1,1,0,1,1
06578239,2,2,0,0,2,2,0,0,1
06578522,5,3,2,0,3,3,0,0,1
06578711,12,2,10,0,0,0,0,0,1
06579115,9,0,9,0,0,0,0,0,1
06579338,3,2,1,0,2,0,2,0,1
06579441,3,2,1,0,1,1,0,0,0
06579450,6,0,6,0,0,0,0,0,1
06580447,18,2,16,0,2,1,1,2,1
06580499,14,2,12,0,1,1,0,1,1
06580744,11,7,4,0,0,0,0,0,0
06580862,20,3,17,0,1,1,0,1,1
06580879,11,5,6,0,1,1,0,0,1
06580884,6,4,2,0,4,3,1,0,1
06581209,1,1,0,0,1,1,0,0,0
06581421,12,5,7,0,0,0,0,0,1
06581425,15,3,12,0,2,1,1,2,0
06581676,13,5,8,0,0,0,0,0,0
06582047,7,5,2,0,2,1,1,2,1
06582290,6,4,2,0,1,1,0,1,1
06582489,39,12,27,0,0,0,0,0,1
06582618,8,2,6,0,1,1,0,1,1
06582622,8,3,5,0,4,2,2,3,0
06582835,6,2,4,0,1,1,0,1,1
06582966,3,0,3,0,0,0,0,0,0
06583419,2,2,0,0,1,1,0,0,0
06583682,25,5,20,0,1,1,0,1,1
06584137,4,1,3,0,1,1,0,0,1
06584200,4,1,3,0,1,1,0,0,1
06584365,13,4,9,0,2,2,0,1,1
06584450,5,3,2,0,0,0,0,0,1
06584462,1,1,0,0,1,1,0,0,0
06584995,4,0,4,0,0,0,0,0,1
06585214,6,4,2,0,3,3,0,0,0
06585354,11,0,11,0,0,0,0,0,1
06585360,5,4,1,0,3,3,0,0,0
06585451,6,0,6,0,0,0,0,0,0
06585457,24,3,21,0,1,1,0,1,1
06585719,13,3,10,0,1,1,0,1,1
06585950,4,0,4,0,0,0,0,0,1
06586508,2,0,2,0,0,0,0,0,1
06587071,18,5,13,0,1,1,0,1,1
06587098,7,0,7,0,0,0,0,0,1
06587124,3,1,2,0,2,2,0,0,0
06587286,12,0,12,0,0,0,0,0,0
06587303,12,10,2,0,1,1,0,1,1
06587458,5,0,5,0,0,0,0,0,1
06587832,30,11,19,0,0,0,0,0,1
06587985,12,10,2,0,1,1,0,1,1
06587989,12,10,2,0,1,1,0,1,1
06588407,3,0,3,0,0,0,0,0,1
06588628,10,6,4,0,1,1,0,0,1
06588633,5,0,5,0,1,1,0,1,1
06588742,17,4,13,0,2,2,0,2,1
06588765,9,2,7,0,0,0,0,0,1
06588815,8,2,6,0,0,0,0,0,1
06588856,7,2,5,0,0,0,0,0,1
06588903,16,1,15,0,1,1,0,1,1
06589053,22,9,13,0,0,0,0,0,0
06589585,6,4,2,0,3,3,0,0,0
06589595,10,0,10,0,0,0,0,0,1
06589734,10,0,10,0,0,0,0,0,1
06590251,10,0,10,0,0,0,0,0,1
06590356,3,3,0,0,2,2,0,0,0
06590541,10,0,10,0,0,0,0,0,1
06590543,5,0,5,0,0,0,0,0,1
06590790,10,4,6,0,1,1,0,1,0
06590880,23,2,21,0,1,1,0,1,1
06591460,8,1,7,0,1,1,0,0,0
06591644,7,4,3,0,3,3,0,0,1
06591673,7,3,4,0,2,2,0,0,1
06591742,8,0,8,0,1,1,0,1,1
06591796,2,2,0,0,1,1,0,0,1
06592090,5,1,4,0,1,1,0,0,1
06592092,3,1,2,0,1,1,0,0,1
06592155,14,3,11,1,2,1,1,2,1
06592162,13,3,10,1,2,1,1,2,1
06592198,6,2,4,0,0,0,0,0,1
06592342,5,0,5,0,3,2,1,0,1
06592478,4,0,4,0,1,1,0,1,1
06592512,29,3,26,0,1,1,0,1,1
06593414,4,3,1,0,1,1,0,0,1
06593839,11,3,8,0,1,1,0,1,1
06594186,9,0,9,0,1,1,0,0,0
06594314,7,5,2,0,2,2,0,0,1
06595264,3,1,2,0,1,1,0,0,0
06595861,42,10,32,0,0,0,0,0,1
06596080,1,1,0,0,1,1,0,0,0
06596258,40,19,21,0,0,0,0,0,0
06597071,9,0,9,0,0,0,0,0,1
06597679,7,4,3,1,2,2,0,2,1
06597685,6,0,6,0,0,0,0,0,1
06597883,4,1,3,0,1,1,0,0,0
06598543,7,3,4,0,1,1,0,1,1
06598842,5,2,3,0,2,2,0,0,0
06600115,16,3,13,0,1,1,0,0,1
06600224,5,3,2,0,1,1,0,0,0
06600533,32,0,32,0,0,0,0,0,1
06600824,15,0,15,0,0,0,0,0,1
06600828,15,0,15,0,0,0,0,0,1
06601129,4,3,1,0,2,2,0,0,0
06601144,3,3,0,0,1,1,0,0,0
06601656,5,1,4,0,1,1,0,0,1
06601741,7,4,3,0,2,2,0,0,1
06601851,3,3,0,0,2,2,0,0,0
06602016,3,1,2,0,0,0,0,0,1
06602021,13,2,11,0,1,1,0,1,1
06602475,8,2,6,0,0,0,0,0,0
06602677,2,1,1,0,1,1,0,0,1
06602910,2,1,1,0,1,1,0,0,0
06603454,4,3,1,0,1,1,0,0,0
06603645,8,2,6,0,2,2,0,0,0
06603693,19,4,15,0,2,2,0,2,1
06604765,5,3,2,0,2,2,0,0,0
06604901,5,0,5,0,0,0,0,0,0
06604908,9,0,9,0,1,1,0,1,1
06605151,3,2,1,0,0,0,0,0,0
06606117,5,3,2,0,2,1,1,0,1
06606153,3,3,0,0,1,1,0,0,1
06606641,8,3,5,0,1,1,0,0,1
06606718,16,8,8,0,6,5,1,0,1
06607049,5,4,1,0,1,1,0,0,0
06607073,3,0,3,0,0,0,0,0,0
06607104,21,10,11,0,0,0,0,0,1
06607611,3,3,0,0,2,2,0,0,0
06607841,20,0,20,0,1,1,0,1,1
06607986,2,2,0,0,0,0,0,0,0
06608439,10,3,7,0,0,0,0,0,1
06608568,15,7,8,0,6,6,0,0,0
06608953,9,6,3,0,0,0,0,0,0
06609244,4,2,2,0,2,2,0,0,0
06609335,6,3,3,0,1,1,0,0,1
06609401,18,7,11,0,1,1,0,1,1
06609579,1,1,0,0,1,1,0,0,0
06610235,2,2,0,0,1,1,0,0,0
06610329,2,1,1,0,1,1,0,1,1
06610415,10,3,7,0,1,1,0,1,1
06610865,25,12,13,0,0,0,0,0,1
06611453,40,11,29,0,0,0,0,0,0
06612185,3,3,0,0,2,2,0,0,1
06612259,37,12,25,0,0,0,0,0,1
06612268,1,0,1,0,0,0,0,0,1
06612358,4,0,4,0,0,0,0,0,1
06612556,11,0,11,0,0,0,0,0,1
06612791,11,3,8,0,1,1,0,1,1
06612844,14,4,10,0,5,5,0,0,1
06613143,13,3,10,0,2,2,0,0,1
06613354,10,6,4,0,0,0,0,0,1
06613399,27,5,22,0,1,1,0,1,1
06613589,26,13,13,0,0,0,0,0,1
06613722,27,5,22,0,1,1,0,1,1
06613842,6,0,6,0,1,1,0,1,1
06613925,4,1,3,0,1,1,0,1,1
06614285,9,6,3,0,0,0,0,0,1
06614532,12,0,12,0,0,0,0,0,1
06614883,16,3,13,0,1,1,0,1,1
06615249,10,6,4,0,2,1,1,1,1
06615302,7,1,6,0,1,1,0,0,1
06615303,10,5,5,0,1,1,0,1,1
06615306,25,4,21,0,1,1,0,1,1
06615310,12,2,10,0,1,1,0,0,1
06615359,1,1,0,0,1,1,0,0,1
06615803,5,1,4,0,2,2,0,0,1
06616197,8,0,8,0,0,0,0,0,1
06616423,5,3,2,0,2,2,0,0,0
06617595,6,0,6,0,1,1,0,0,0
06617617,18,0,18,0,0,0,0,0,1
06617637,6,3,3,0,3,1,2,1,0
06618246,3,0,3,0,0,0,0,0,1
06618303,4,0,4,0,0,0,0,0,1
06618951,4,2,2,0,3,2,1,1,0
06619032,7,0,7,0,0,0,0,0,1
06619263,2,2,0,0,2,2,0,0,0
06619373,5,0,5,0,0,0,0,0,1
06619489,3,2,1,0,2,2,0,0,0
06619981,19,7,12,0,0,0,0,0,1
06619987,6,0,6,0,0,0,0,0,1
06620405,3,2,1,0,1,1,0,0,0
06620459,5,3,2,0,2,2,0,0,1
06620665,19,1,18,0,1,1,0,1,1
06620678,3,2,1,0,1,1,0,0,0
06620693,11,1,10,0,1,1,0,1,1
06620874,15,0,15,0,1,1,0,1,1
06620884,8,2,6,0,3,1,2,1,1
06620941,12,8,4,0,0,0,0,0,1
06621056,5,3,2,0,2,1,1,1,1
06621503,6,4,2,0,3,3,0,0,1
06621599,8,5,3,0,1,1,0,0,1
06621820,22,10,12,0,0,0,0,0,1
06622131,20,4,16,0,1,1,0,0,0
06622266,2,0,2,0,0,0,0,0,1
06622939,5,3,2,0,2,2,0,0,0
06622963,3,3,0,0,2,2,0,0,1
06623799,10,8,2,0,3,3,0,0,1
06624101,14,5,9,0,0,0,0,0,1
06624303,6,0,6,0,1,1,0,1,1
06624632,23,4,19,0,1,1,0,1,1
06624684,17,4,13,0,1,1,0,1,1
06624724,2,2,0,0,1,1,0,0,0
06624729,21,3,18,0,0,0,0,0,0
06624948,35,12,23,0,0,0,0,0,1
02420044,10,8,2,0,1,1,0,1,1
02420048,3,3,0,0,2,2,0,0,1
02420160,8,0,8,0,1,1,0,1,1
02420282,33,0,33,0,0,0,0,0,1
02420411,80,10,70,0,0,0,0,0,1
02420426,14,0,14,0,0,0,0,0,1
02420498,46,9,37,0,1,1,0,1,1
02420633,11,3,8,0,3,2,1,0,1
02420881,13,6,7,0,0,0,0,0,1
02420882,11,4,7,0,1,1,0,1,1
02420895,20,3,17,0,0,0,0,0,1
02420928,11,2,9,0,0,0,0,0,0
02421112,26,4,22,0,1,1,0,1,1
02421236,21,5,16,0,1,1,0,1,1
02421407,30,3,27,0,1,1,0,1,1
02421511,23,0,23,0,1,1,0,1,1
02421516,21,4,17,0,1,1,0,1,1
02421530,8,2,6,0,0,0,0,0,1
02421779,42,0,42,0,0,0,0,0,1
02421808,3,2,1,0,1,1,0,1,1
02421826,11,0,11,0,0,0,0,0,1
02421891,26,0,26,0,0,0,0,0,1
02422007,26,0,26,0,0,0,0,0,1
02422152,8,2,6,0,1,1,0,0,1
02422198,51,0,51,0,1,1,0,1,1
02422310,51,0,51,0,1,1,0,1,1
02422326,109,63,46,0,0,0,0,0,0
02422401,132,12,120,0,0,0,0,0,1
02422654,48,3,45,0,1,1,0,1,1
02422757,22,3,19,0,1,1,0,1,1
02422773,4,3,1,0,1,1,0,0,1
02422813,79,15,64,0,0,0,0,0,1
02422843,12,5,7,0,2,2,0,0,1
02422878,9,3,6,0,2,2,0,0,0
02422890,74,11,63,0,0,0,0,0,1
02423219,90,22,68,0,0,0,0,0,1
02423881,9,1,8,0,0,0,0,0,0
02424035,46,3,43,0,1,1,0,1,1
02424232,25,0,25,0,1,1,0,1,1
02424275,27,8,19,0,2,2,0,0,1
02424495,17,4,13,0,0,0,0,0,1
02425361,17,2,15,0,1,1,0,1,0
02425548,15,3,12,0,2,1,1,1,1
02425966,29,0,29,1,0,0,0,0,1
02425976,28,0,28,0,0,0,0,0,1
02426011,33,4,29,0,1,1,0,1,1
02426069,2,2,0,0,0,0,0,0,1
02426112,34,0,34,0,0,0,0,0,1
02426132,32,7,25,0,1,1,0,1,1
02426155,34,4,30,0,1,1,0,1,1
02426156,44,5,39,0,1,1,0,1,1
02426166,31,3,28,0,1,1,0,1,1
02426169,34,5,29,0,1,1,0,1,1
02426198,25,4,21,0,0,0,0,0,1
02426353,32,5,27,0,1,1,0,1,1
02426471,10,6,4,0,2,2,0,0,0
02426502,22,0,22,0,0,0,0,0,1
02426838,12,1,11,0,1,1,0,0,0
02426865,31,5,26,0,4,4,0,0,1
02426885,35,3,32,0,1,1,0,0,0
02427172,62,0,62,0,1,1,0,1,1
02427199,62,0,62,0,0,0,0,0,1
02427215,19,5,14,0,3,1,2,2,1
02427411,40,3,37,0,1,1,0,0,1
02428371,41,1,40,0,1,1,0,1,1
02428384,16,3,13,0,1,1,0,1,0
02428514,8,2,6,0,2,2,0,1,0
02428648,11,6,5,0,1,1,0,1,1
02429401,11,2,9,0,7,1,6,1,1
02429760,32,4,28,0,1,1,0,1,1
02430235,22,3,19,0,2,2,0,2,1
02430319,28,0,28,0,1,1,0,1,1
02430468,24,0,24,0,1,1,0,1,1
02430594,24,4,20,0,0,0,0,0,0
02430661,10,2,8,0,1,1,0,0,0
02432167,8,0,8,0,0,0,0,0,1
02432592,30,7,23,0,1,1,0,1,1
02432789,14,1,13,0,1,1,0,0,1
02433029,18,0,18,0,1,1,0,1,1
02433198,10,7,3,0,1,1,0,0,1
02433281,6,3,3,0,1,1,0,0,1
02433594,11,2,9,0,0,0,0,0,1
02434613,5,0,5,0,0,0,0,0,1
02434739,20,4,16,0,0,0,0,0,1
02435027,13,2,11,0,1,1,0,1,1
02435678,51,5,46,0,2,1,1,2,1
02435701,24,13,11,0,1,1,0,0,1
02435730,24,13,11,0,1,1,0,0,1
02436060,43,9,34,0,0,0,0,0,1
02436440,28,5,23,0,1,1,0,0,1
02436550,30,8,22,0,1,1,0,1,1
02436612,23,2,21,0,1,1,0,1,1
02436644,83,7,76,0,0,0,0,0,0
02436687,20,3,17,0,1,1,0,1,1
02437205,34,3,31,0,1,1,0,1,1
02437296,18,0,18,0,0,0,0,0,1
02437321,31,4,27,0,1,1,0,1,1
02437338,0,0,0,0,0,0,0,0,1
02437385,27,0,27,0,0,0,0,0,1
02437440,22,3,19,0,1,1,0,0,1
02437605,21,5,16,0,0,0,0,0,0
02437760,8,2,6,0,1,1,0,0,1
02437917,21,7,14,0,0,0,0,0,1
02438036,9,3,6,0,1,1,0,0,0
02438126,45,4,41,0,1,1,0,1,1
02438132,6,0,6,0,1,1,0,0,1
02438136,53,5,48,0,1,1,0,1,1
02438500,18,0,18,0,0,0,0,0,1
02438534,21,8,13,0,0,0,0,0,1
02438671,19,3,16,0,1,1,0,1,1
02439258,26,4,22,0,1,1,0,1,1
02439431,32,0,32,0,0,0,0,0,1
02439846,0,0,0,0,0,0,0,0,0
02440084,33,3,30,0,0,0,0,0,1
02440168,15,4,11,0,1,1,0,0,1
02440348,30,2,28,0,2,1,1,2,1
02440469,12,1,11,0,1,1,0,1,1
02440858,11,4,7,0,1,1,0,1,1
02440899,90,16,74,0,0,0,0,0,1
02440916,3,0,3,0,1,1,0,0,1
02441203,9,3,6,0,4,2,2,2,0
02441269,23,3,20,0,0,0,0,0,1
02441302,20,5,15,0,0,0,0,0,1
02441306,38,4,34,0,1,1,0,0,1
02441313,5,3,2,0,1,1,0,0,0
02441624,18,4,14,0,1,1,0,1,1
02441757,20,3,17,0,0,0,0,0,0
02441908,3,2,1,0,2,1,1,0,0
02442064,19,0,19,0,0,0,0,0,1
02442069,27,0,27,0,0,0,0,0,1
02442269,38,0,38,0,1,1,0,1,1
02442383,6,0,6,0,0,0,0,0,1
02442408,6,2,4,0,2,2,0,0,0
02442460,25,0,25,0,1,1,0,1,1
02442603,4,0,4,0,0,0,0,0,0
02442855,27,0,27,0,0,0,0,0,1
02442913,58,9,49,0,9,7,2,0,1
02443087,11,3,8,0,1,1,0,1,1
02443126,11,3,8,0,4,1,3,2,1
02443175,16,0,16,0,1,1,0,1,1
02443741,62,3,59,0,2,1,1,2,1
02443847,10,0,10,0,1,1,0,1,1
02443911,125,12,113,0,0,0,0,0,1
02444036,19,3,16,0,2,2,0,2,1
02444138,1,1,0,0,0,0,0,0,1
02444187,18,0,18,0,0,0,0,0,1
02444202,31,0,31,0,0,0,0,0,1
02444254,68,9,59,0,1,1,0,1,1
02444282,26,0,26,0,0,0,0,0,1
02444360,10,5,5,0,1,1,0,1,1
02444438,60,14,46,0,0,0,0,0,1
02444517,11,4,7,0,0,0,0,0,1
02444520,41,10,31,0,0,0,0,0,1
02444701,13,4,9,0,1,1,0,1,1
02444843,11,2,9,0,2,2,0,0,1
02444941,19,3,16,0,1,1,0,1,1
02444970,38,5,33,0,0,0,0,0,1
02445496,29,3,26,0,1,1,0,1,1
02445793,4,0,4,0,0,0,0,0,0
02446027,10,4,6,0,1,1,0,1,1
02446362,7,4,3,0,3,3,0,0,1
02446501,44,5,39,0,0,0,0,0,1
02446748,17,0,17,0,0,0,0,0,1
02447182,84,4,80,0,0,0,0,0,1
02447393,25,11,14,0,1,1,0,0,1
02447478,0,0,0,0,0,0,0,0,0
02447548,24,0,24,0,0,0,0,0,1
02447761,22,4,18,0,0,0,0,0,1
02447790,30,0,30,0,0,0,0,0,1
02447875,48,8,40,0,1,1,0,1,1
02447900,91,18,73,0,0,0,0,0,1
02448075,11,5,6,0,3,3,0,0,1
02448086,38,0,38,0,0,0,0,0,1
02448095,13,3,10,0,1,1,0,1,1
02448340,56,3,53,0,1,1,0,1,1
02448361,13,5,8,0,5,1,4,1,1
02448385,9,0,9,0,0,0,0,0,1
02448459,45,4,41,0,1,1,0,1,1
02448776,11,3,8,0,0,0,0,0,1
02448784,10,4,6,0,1,1,0,0,1
02448835,40,5,35,0,1,1,0,1,1
02449056,4,4,0,0,1,1,0,0,0
02449397,34,5,29,0,2,2,0,0,1
02449576,2,2,0,0,2,2,0,0,0
02449706,8,0,8,0,0,0,0,0,1
02449715,18,0,18,0,0,0,0,0,1
02450048,11,0,11,0,0,0,0,0,1
02450180,26,8,18,0,1,1,0,1,1
02450365,46,0,46,0,0,0,0,0,1
02450654,12,0,12,0,1,1,0,1,1
02450719,15,4,11,0,2,2,0,2,1
02450755,8,5,3,0,2,2,0,0,0
02450936,38,3,35,0,4,3,1,0,1
02450947,42,5,37,0,0,0,0,0,1
02450962,30,1,29,0,3,0,3,0,0
02451155,39,2,37,0,1,1,0,1,1
02451177,55,4,51,0,1,1,0,1,1
02451428,25,0,25,0,0,0,0,0,1
02451677,80,8,72,0,1,1,0,1,1
02451879,28,3,25,0,3,3,0,3,1
02451999,23,4,19,0,1,1,0,1,1
02452071,35,3,32,0,1,1,0,1,1
02452274,23,4,19,0,1,1,0,1,1
02452453,20,0,20,0,0,0,0,0,1
02452534,8,5,3,0,2,2,0,0,0
02452595,17,2,15,0,1,1,0,1,1
02452909,25,3,22,0,1,1,0,1,1
02453664,13,5,8,0,2,2,0,0,1
02453860,20,3,17,0,1,1,0,1,1
02453874,19,0,19,0,0,0,0,0,1
02453881,16,0,16,0,0,0,0,0,1
02453889,0,0,0,0,0,0,0,0,0
02453957,38,9,29,0,0,0,0,0,1
02453983,55,9,46,0,0,0,0,0,1
02454207,6,3,3,0,1,1,0,0,1
02454345,24,6,18,0,1,1,0,1,1
02454379,36,0,36,0,0,0,0,0,1
02454385,37,0,37,0,0,0,0,0,1
02454507,48,7,41,0,1,1,0,0,1
02454554,56,11,45,0,0,0,0,0,1
02454600,18,2,16,0,2,1,1,0,0
02454638,4,2,2,0,1,1,0,0,0
02454830,53,3,50,0,1,1,0,0,1
02454857,6,2,4,0,0,0,0,0,0
02454898,24,4,20,0,2,2,0,1,1
02455041,9,2,7,0,1,1,0,0,1
02455289,14,2,12,0,0,0,0,0,1
02455347,106,7,99,0,3,3,0,3,1
02455356,15,2,13,1,0,0,0,0,1
02455572,16,8,8,0,6,5,1,0,1
02455576,21,1,20,0,1,1,0,1,0
02455577,16,8,8,0,6,5,1,0,1
02455631,51,3,48,0,1,1,0,1,1
02455726,36,0,36,0,0,0,0,0,1
02455943,21,2,19,0,1,1,0,1,1
02456101,6,0,6,0,0,0,0,0,1
02456172,48,10,38,0,0,0,0,0,0
02456268,16,0,16,0,0,0,0,0,0
02456291,34,3,31,0,0,0,0,0,1
02456305,39,3,36,0,1,1,0,1,1
02456358,7,4,3,0,1,1,0,1,1
02456393,47,11,36,0,0,0,0,0,1
02456403,14,5,9,0,1,1,0,0,1
02456473,30,6,24,0,1,1,0,1,1
02456608,11,3,8,0,1,1,0,1,0
02456671,76,8,68,0,2,2,0,2,1
02456712,21,2,19,0,1,1,0,1,1
02457120,7,3,4,0,2,1,1,2,1
02457122,28,5,23,0,1,1,0,1,1
02457380,22,2,20,0,1,1,0,1,1
02457525,57,5,52,0,1,1,0,1,1
02457543,16,0,16,0,0,0,0,0,1
02457735,31,0,31,0,0,0,0,0,1
02458104,8,0,8,0,0,0,0,0,1
02458109,40,9,31,0,4,2,2,4,1
02458260,62,0,62,0,1,0,1,0,1
02458387,7,3,4,0,2,2,0,0,1
02458694,41,0,41,0,0,0,0,0,1
02458951,27,6,21,0,0,0,0,0,1
08410098,9,5,4,0,1,1,0,1,1
08410538,1,1,0,0,0,0,0,0,0
08410734,3,2,1,0,2,1,1,0,0
08411169,3,0,3,0,0,0,0,0,1
08411261,4,1,3,0,1,1,0,0,1
08411407,8,3,5,0,1,1,0,1,1
08411510,3,0,3,0,0,0,0,0,0
08412018,1,1,0,0,1,1,0,0,0
08412116,6,2,4,0,1,1,0,1,1
08412118,5,0,5,0,0,0,0,0,1
08412389,6,2,4,0,1,1,0,1,1
08412502,2,1,1,0,1,1,0,0,0
08412510,2,1,1,0,1,1,0,0,1
08412608,2,2,0,0,1,1,0,0,0
08413101,10,2,8,0,0,0,0,0,1
08413278,7,4,3,0,1,1,0,1,0
08413330,23,11,12,0,0,0,0,0,1
08413342,9,8,1,0,0,0,0,0,0
08413415,5,0,5,0,4,1,3,0,0
08413568,16,3,13,0,1,1,0,1,1
08413587,12,2,10,0,2,1,1,2,1
08413597,2,2,0,0,2,2,0,0,0
08413664,17,7,10,0,0,0,0,0,0
08413969,12,7,5,0,1,1,0,1,1
08414031,2,2,0,0,2,2,0,0,0
08414055,15,3,12,0,2,1,1,0,0
08414380,4,4,0,0,2,2,0,0,1
08415007,3,0,3,0,0,0,0,0,0
08415038,5,4,1,0,0,0,0,0,1
08415088,10,2,8,0,0,0,0,0,1
08415214,2,0,2,0,0,0,0,0,1
08415422,5,0,5,0,0,0,0,0,1
08415470,3,3,0,0,1,1,0,1,0
08415561,1,1,0,0,1,1,0,0,0
08415657,5,0,5,0,0,0,0,0,1
08415696,4,2,2,0,1,1,0,0,1
08416037,2,0,2,0,0,0,0,0,1
08416073,2,1,1,0,1,1,0,0,0
08416082,11,0,11,0,0,0,0,0,0
08416148,1,1,0,0,0,0,0,0,0
08416359,4,2,2,0,3,3,0,0,0
08416876,1,0,1,0,0,0,0,0,0
08417306,12,7,5,0,0,0,0,0,1
08417981,1,1,0,0,1,1,0,0,0
08418222,2,1,1,0,1,1,0,0,0
08418325,3,2,1,0,0,0,0,0,1
08418402,1,0,1,0,0,0,0,0,0
08418948,1,1,0,0,1,1,0,0,0
08419102,1,1,0,0,1,1,0,0,0
08419581,30,12,18,0,1,1,0,1,1
08419643,3,0,3,0,0,0,0,0,1
08419980,2,2,0,0,2,2,0,0,0
08420243,12,6,6,0,0,0,0,0,1
08420688,1,1,0,0,1,1,0,0,1
08420845,5,0,5,0,0,0,0,0,0
08421033,9,1,8,0,3,1,2,0,0
08421125,2,2,0,0,2,2,0,0,0
08421270,2,2,0,0,2,2,0,0,0
08421351,1,1,0,0,1,1,0,0,1
08422054,2,2,0,0,1,1,0,1,1
08422310,1,1,0,0,1,1,0,0,0
08422512,4,3,1,0,3,2,1,0,0
08422643,2,2,0,0,2,2,0,0,0
08422703,8,4,4,0,1,1,0,0,1
08422783,2,2,0,0,3,1,2,1,0
08422967,3,2,1,0,2,2,0,0,0
08423050,3,2,1,0,1,1,0,0,0
08423199,2,2,0,0,1,1,0,1,0
08423421,8,3,5,0,1,1,0,1,1
08423540,12,0,12,0,0,0,0,0,1
08423935,3,1,2,0,1,1,0,0,0
08424277,4,4,0,0,1,1,0,0,0
08424592,6,0,6,0,2,2,0,0,1
08425080,2,0,2,0,1,1,0,0,1
08425103,1,0,1,0,0,0,0,0,1
08425336,3,0,3,0,0,0,0,0,1
08425363,9,5,4,0,1,1,0,1,1
08425400,2,1,1,0,1,1,0,0,0
08425449,4,0,4,0,0,0,0,0,1
08425695,3,2,1,0,2,2,0,0,0
08425879,5,0,5,0,0,0,0,0,1
08425929,4,0,4,0,0,0,0,0,0
08426248,2,2,0,0,2,2,0,0,0
08426322,6,3,3,0,1,1,0,1,1
08426341,3,2,1,0,2,2,0,0,1
08426354,2,2,0,0,2,1,1,0,0
08426357,2,1,1,0,1,1,0,0,0
08426375,6,3,3,0,1,1,0,1,1
08426731,1,1,0,0,1,1,0,0,0
08426967,28,12,16,0,0,0,0,0,1
08427465,2,1,1,0,1,1,0,0,0
08427496,3,1,2,0,1,1,0,0,0
08427974,2,2,0,0,1,1,0,0,0
08428337,5,1,4,0,3,2,1,1,1
08428351,5,1,4,0,2,1,1,2,1
08428751,3,2,1,0,0,0,0,0,1
08429193,4,2,2,0,1,1,0,0,0
08429274,10,4,6,0,2,2,0,2,1
08429424,4,3,1,0,3,3,0,0,0
08429596,1,1,0,0,1,1,0,0,0
08429606,2,0,2,0,0,0,0,0,1
08429813,7,5,2,0,0,0,0,0,1
08429864,4,1,3,0,1,1,0,0,1
08429896,9,5,4,0,1,1,0,1,1
08430112,5,0,5,0,3,3,0,0,1
08430140,5,3,2,0,1,1,0,1,1
08430154,9,0,9,0,0,0,0,0,1
08430305,7,2,5,0,0,0,0,0,0
08430616,1,0,1,0,0,0,0,0,1
08430642,1,1,0,0,1,1,0,0,0
08430689,2,2,0,0,2,2,0,0,0
08430937,6,4,2,0,1,1,0,1,1
08431235,2,0,2,0,0,0,0,0,1
08431364,2,2,0,0,1,1,0,0,0
08431680,2,0,2,0,2,2,0,0,1
08431890,3,3,0,0,1,1,0,0,0
08432412,4,4,0,0,0,0,0,0,1
08432435,15,10,5,0,0,0,0,0,0
08432891,2,2,0,0,0,0,0,0,0
08432971,5,3,2,0,3,2,1,1,1
08433110,3,0,3,0,0,0,0,0,1
08433192,3,1,2,0,1,1,0,0,0
08433671,12,6,6,1,0,0,0,0,0
08433699,1,1,0,0,1,1,0,0,0
08433928,1,0,1,0,1,1,0,0,1
08434041,5,4,1,0,1,1,0,1,0
08434439,4,0,4,0,0,0,0,0,1
08434494,2,2,0,0,2,2,0,0,0
08435374,2,2,0,0,2,2,0,0,0
08435555,2,0,2,0,1,1,0,0,0
08435709,1,0,1,0,1,1,0,0,1
08436016,6,3,3,0,3,1,2,1,1
08436383,3,3,0,0,2,2,0,0,0
08436608,5,4,1,0,2,2,0,0,1
08436737,2,2,0,0,1,1,0,0,1
08436746,2,2,0,0,1,1,0,0,1
08436800,2,2,0,0,1,1,0,0,1
08437029,1,0,1,0,1,1,0,0,0
08437326,2,2,0,0,1,1,0,0,0
08437447,1,1,0,0,1,1,0,0,0
08438262,2,0,2,0,0,0,0,0,0
08438686,36,12,24,0,1,1,0,0,1
08438737,2,2,0,0,2,2,0,0,0
08438935,8,3,5,0,0,0,0,0,0
08438958,5,0,5,0,0,0,0,0,1
08438970,12,4,8,0,2,2,0,2,1
08439027,3,3,0,0,0,0,0,0,0
08439418,2,0,2,0,0,0,0,0,0
08439475,1,1,0,0,2,1,1,1,1
08440486,5,0,5,0,0,0,0,0,1
08440798,10,9,1,0,0,0,0,0,0
08440808,19,7,12,0,1,1,0,1,1
08440958,3,2,1,0,1,1,0,0,0
08441080,7,3,4,0,1,1,0,1,1
08441190,16,5,11,0,0,0,0,0,1
08441243,1,1,0,0,1,1,0,0,0
08441254,2,0,2,0,0,0,0,0,0
08441279,6,2,4,0,1,1,0,1,1
08441383,12,1,11,0,2,0,2,0,1
08441385,12,11,1,0,2,1,1,1,1
08441563,4,0,4,0,0,0,0,0,1
08441660,1,0,1,0,0,0,0,0,1
08441765,6,4,2,0,1,1,0,1,1
08442200,2,0,2,0,0,0,0,0,1
08442541,3,2,1,0,1,1,0,0,0
08442579,16,5,11,0,0,0,0,0,0
08442585,2,0,2,0,0,0,0,0,1
08442645,2,1,1,0,1,1,0,0,0
08442841,2,2,0,0,2,2,0,0,0
08443068,10,7,3,0,1,1,0,0,1
08443419,5,4,1,0,1,1,0,1,1
08443465,6,3,3,0,1,1,0,1,1
08443835,5,2,3,0,1,1,0,1,1
08443929,1,1,0,0,1,1,0,0,1
08444109,2,1,1,0,1,1,0,0,1
08444596,3,3,0,0,2,2,0,0,1
08444641,1,1,0,0,1,1,0,0,0
08445077,3,3,0,0,4,4,0,0,0
08445158,14,7,7,0,0,0,0,0,0
08445248,1,1,0,0,1,1,0,0,0
08445420,3,3,0,0,2,2,0,0,0
08445524,1,1,0,0,1,1,0,0,0
08445776,11,10,1,0,5,5,0,0,1
08445851,2,2,0,0,1,1,0,0,0
08445947,1,1,0,0,1,1,0,0,1
08446161,6,3,3,0,1,1,0,1,1
08446337,16,9,7,0,0,0,0,0,1
08446668,3,1,2,0,3,1,2,0,1
08446725,1,0,1,0,0,0,0,0,1
08446738,4,1,3,0,2,1,1,0,0
08446764,2,2,0,0,1,1,0,1,1
08447006,15,4,11,0,0,0,0,0,1
08447096,20,3,17,0,1,1,0,1,1
08447330,5,1,4,3,2,1,1,0,1
08447331,17,12,5,0,0,0,0,0,0
08447479,2,2,0,0,2,1,1,0,0
08447573,2,2,0,0,1,1,0,0,0
08447779,1,1,0,0,1,1,0,0,0
08448212,4,2,2,0,1,1,0,0,0
08448687,1,1,0,0,1,1,0,0,0
08448753,3,0,3,0,2,2,0,0,0
08448792,2,2,0,0,2,2,0,0,0
08449024,1,1,0,0,1,1,0,0,0
08449027,2,1,1,0,1,1,0,1,0
08449267,3,0,3,0,0,0,0,0,1
08449299,1,1,0,0,1,1,0,0,1
08449344,15,4,11,0,1,1,0,1,1
08450211,2,1,1,0,1,1,0,0,1
08450229,2,1,1,0,1,1,0,0,1
08450237,3,1,2,0,1,1,0,0,1
08450775,1,1,0,0,1,1,0,0,1
08451196,1,0,1,0,0,0,0,0,0
08451340,2,0,2,0,0,0,0,0,0
08451346,6,5,1,0,0,0,0,0,1
08451366,1,1,0,0,1,1,0,0,0
08451514,1,1,0,0,1,1,0,0,0
08451521,1,0,1,0,0,0,0,0,0
08451746,7,4,3,0,1,1,0,1,1
08451815,1,1,0,0,1,1,0,0,0
08451858,5,4,1,0,0,0,0,0,0
08451905,2,1,1,0,1,1,0,1,1
08452212,5,2,3,0,1,1,0,1,1
08452449,8,4,4,0,1,1,0,0,1
08452584,1,1,0,0,1,1,0,0,0
08452707,8,8,0,0,1,1,0,0,1
08452799,5,3,2,0,3,1,2,2,1
08452822,3,1,2,0,1,1,0,0,0
08453448,4,0,4,0,0,0,0,0,0
08453494,6,5,1,0,0,0,0,0,1
08453844,1,0,1,0,1,1,0,1,0
08454141,5,3,2,0,2,2,0,0,1
08454161,1,0,1,0,1,1,0,0,0
08454233,3,0,3,0,1,1,0,0,1
08454323,3,1,2,0,1,1,0,0,0
08454473,3,1,2,0,1,1,0,0,0
08454709,1,1,0,0,1,1,0,0,1
08454733,2,0,2,0,0,0,0,0,1
08454790,3,3,0,0,1,1,0,0,1
08454816,5,3,2,0,2,1,1,1,1
08455129,6,0,6,0,0,0,0,0,1
08455416,2,2,0,0,1,1,0,0,0
08455723,13,6,7,0,1,1,0,1,1
08455933,3,3,0,0,1,1,0,0,0
08455969,6,0,6,0,0,0,0,0,1
08455995,48,12,36,0,0,0,0,0,1
08456001,3,2,1,0,1,1,0,0,0
08456230,15,6,9,0,1,1,0,0,0
08456543,2,2,0,0,2,2,0,0,0
08456655,3,2,1,0,2,2,0,0,1
08457411,23,12,11,0,0,0,0,0,1
08457528,2,2,0,0,2,2,0,0,1
08457584,7,6,1,0,1,1,0,0,0
08457593,7,3,4,0,1,1,0,1,1
08457744,4,3,1,1,1,1,0,1,1
08457973,3,0,3,0,0,0,0,0,1
08458139,3,3,0,0,2,2,0,0,1
08458188,3,3,0,0,2,2,0,0,1
08458345,6,4,2,0,3,3,0,1,0
08458625,30,5,25,0,0,0,0,0,0
08458686,30,5,25,0,0,0,0,0,0
08458805,2,1,1,0,1,1,0,0,0
08458959,1,0,1,0,1,1,0,0,0
08458989,1,0,1,0,1,1,0,0,1
08459718,16,7,9,0,1,1,0,1,1
08459722,3,0,3,0,1,1,0,0,0
08459753,3,2,1,0,2,2,0,0,0
08459906,28,8,20,0,0,0,0,0,1
08460100,15,4,11,0,2,2,0,2,1
08460346,2,2,0,0,1,1,0,0,0
08461002,19,6,13,0,0,0,0,0,0
08461113,8,0,8,0,0,0,0,0,1
08461441,4,4,0,0,0,0,0,0,1
08461769,2,2,0,0,1,1,0,0,0
08461778,1,0,1,0,0,0,0,0,0
08462085,1,0,1,0,0,0,0,0,1
08462121,1,1,0,0,1,1,0,0,0
08462184,2,1,1,0,1,1,0,0,1
08462254,6,5,1,0,0,0,0,0,0
08462257,6,4,2,0,1,1,0,0,1
08462274,2,1,1,0,1,1,0,0,1
08462362,2,1,1,0,1,1,0,0,1
08462691,12,6,6,0,6,5,1,0,1
08462759,1,1,0,0,1,1,0,0,0
08462930,2,2,0,0,1,1,0,1,0
08463158,5,4,1,0,1,1,0,1,0
08463187,12,3,9,0,1,1,0,1,0
08463225,3,2,1,0,3,3,0,0,1
08463308,3,0,3,0,0,0,0,0,1
08463596,2,2,0,0,2,2,0,0,0
08463808,2,2,0,0,2,2,0,0,0
08463903,2,2,0,0,0,0,0,0,1
08463984,13,4,9,0,1,1,0,1,1
00100316,20,4,16,0,1,1,0,1,0
00100449,39,4,35,0,1,1,0,1,1
00100453,19,0,19,0,0,0,0,0,1
00100500,48,6,42,0,0,0,0,0,0
00100674,41,5,36,0,1,1,0,1,1
00100691,51,3,48,0,1,1,0,1,1
00100995,16,4,12,0,1,1,0,1,1
00101266,16,3,13,0,1,1,0,1,1
00101352,19,4,15,0,1,1,0,1,1
00101760,331,25,306,0,2,1,1,0,1
00102194,54,5,49,0,1,1,0,1,1
00102236,41,9,32,0,2,1,1,0,1
00102611,14,0,14,0,1,1,0,1,1
00102630,61,3,58,0,1,1,0,1,1
00103161,43,3,40,0,4,4,0,0,1
00103472,9,4,5,0,1,0,1,0,0
00103548,45,11,34,0,0,0,0,0,1
00103844,47,3,44,0,1,1,0,1,1
00103858,44,10,34,0,12,9,3,1,0
00103941,43,3,40,0,1,1,0,1,0
00104118,159,8,151,0,0,0,0,0,1
00104194,39,4,35,0,1,1,0,1,0
00104394,31,0,31,0,0,0,0,0,1
00105486,21,3,18,0,1,1,0,1,1
00105511,136,3,133,0,0,0,0,0,1
00105680,169,11,158,0,0,0,0,0,1
00105819,51,11,40,0,0,0,0,0,0
00105911,95,12,83,0,0,0,0,0,1
00106294,65,4,61,0,2,1,1,2,1
00106300,47,0,47,0,0,0,0,0,1
00106691,48,5,43,0,3,1,2,0,1
00106966,24,3,21,0,1,1,0,1,1
00107021,16,10,6,0,0,0,0,0,0
00107165,12,5,7,0,2,1,1,0,1
00107202,35,2,33,0,1,1,0,1,1
00107582,43,3,40,0,1,1,0,1,1
00108191,31,6,25,0,2,1,1,2,1
00108260,151,23,128,0,0,0,0,0,1
00108690,29,0,29,0,1,1,0,1,1
00109057,18,0,18,0,0,0,0,0,1
00109150,90,24,66,0,0,0,0,0,1
00109201,50,10,40,0,0,0,0,0,0
00109234,8,0,8,0,0,0,0,0,1
00109305,23,5,18,0,0,0,0,0,1
00109354,32,4,28,0,1,1,0,1,1
00109365,27,3,24,0,0,0,0,0,1
00109442,171,19,152,0,0,0,0,0,1
00109974,32,6,26,0,1,1,0,1,1
00110100,29,9,20,0,0,0,0,0,0
00110117,48,5,43,0,1,1,0,1,1
00110145,9,6,3,0,0,0,0,0,0
00110410,61,5,56,0,1,1,0,1,1
00110433,41,3,38,0,5,2,3,2,1
00110768,27,5,22,0,1,1,0,1,1
00111019,32,6,26,0,0,0,0,0,0
00111209,18,3,15,0,1,1,0,1,1
00111449,17,4,13,0,1,1,0,1,1
00111454,7,4,3,0,1,1,0,0,0
00111524,21,2,19,0,1,1,0,1,1
00111673,109,13,96,0,1,1,0,0,1
00111982,51,13,38,0,0,0,0,0,1
00112134,67,9,58,0,0,0,0,0,0
00112286,24,3,21,0,1,1,0,1,1
00112396,43,4,39,0,1,1,0,1,1
00112626,19,4,15,0,2,1,1,2,1
00112955,48,9,39,0,0,0,0,0,1
00112981,17,6,11,0,0,0,0,0,0
00113496,144,21,123,0,0,0,0,0,1
00113882,19,3,16,0,1,1,0,1,1
00114099,13,5,8,0,0,0,0,0,0
00115408,72,23,49,0,0,0,0,0,1
00115834,18,4,14,0,1,1,0,1,1
00116476,21,8,13,0,0,0,0,0,0
00116604,22,7,15,0,1,1,0,0,0
00116784,48,13,35,0,0,0,0,0,1
00116788,38,5,33,0,3,1,2,1,1
00116800,7,3,4,0,1,1,0,1,1
00117289,37,7,30,0,0,0,0,0,1
00117413,53,3,50,0,2,1,1,2,1
00117441,17,9,8,0,8,8,0,0,0
00117548,32,0,32,0,0,0,0,0,1
00118047,26,8,18,0,0,0,0,0,0
00118183,17,6,11,0,0,0,0,0,0
00118295,16,4,12,0,1,1,0,1,1
00118651,22,4,18,0,2,1,1,2,1
00118788,63,1,62,0,1,1,0,0,0
00119609,39,5,34,0,1,1,0,1,1
00120076,83,10,73,0,0,0,0,0,1
00120271,36,2,34,0,1,1,0,1,1
00120936,70,9,61,0,0,0,0,0,0
00121299,42,4,38,0,1,1,0,1,1
00121323,18,7,11,0,0,0,0,0,0
00121454,15,10,5,0,3,3,0,0,0
00121666,11,8,3,0,0,0,0,0,0
00122105,124,11,113,0,0,0,0,0,0
00122164,23,0,23,0,0,0,0,0,1
00122230,15,7,8,0,3,3,0,0,0
00122842,143,9,134,0,1,1,0,0,1
00122953,49,4,45,0,1,1,0,1,1
00122959,51,9,42,0,1,1,0,1,0
00123434,18,3,15,0,2,1,1,2,1
00124299,15,6,9,0,0,0,0,0,0
00124683,67,12,55,0,0,0,0,0,0
00124723,47,4,43,0,2,2,0,2,1
00124842,29,9,20,0,0,0,0,0,1
00124855,42,6,36,0,0,0,0,0,1
00125041,20,5,15,0,1,1,0,1,1
00125150,45,3,42,0,1,1,0,1,1
00125431,10,0,10,0,0,0,0,0,1
00125476,12,0,12,0,0,0,0,0,1
00125575,45,8,37,0,0,0,0,0,1
00125784,89,11,78,0,1,1,0,0,0
00125787,29,1,28,0,0,0,0,0,1
00126107,16,6,10,0,0,0,0,0,1
00126320,60,12,48,0,0,0,0,0,1
00127842,22,4,18,0,1,1,0,1,1
00128058,28,4,24,0,0,0,0,0,1
00128165,13,5,8,0,0,0,0,0,0
00128414,12,3,9,0,1,1,0,1,1
00128500,21,9,12,0,1,1,0,1,1
00128920,141,10,131,0,1,1,0,0,1
00128986,131,11,120,0,1,1,0,0,1
00129430,14,1,13,0,0,0,0,0,0
00129494,46,4,42,0,0,0,0,0,0
00129632,60,4,56,0,1,1,0,0,1
00129649,27,3,24,0,1,1,0,1,1
00129784,8,4,4,0,1,1,0,1,0
00130377,89,14,75,0,0,0,0,0,1
00130588,73,6,67,0,1,1,0,1,1
00131211,15,9,6,0,0,0,0,0,0
00131273,22,0,22,0,0,0,0,0,1
00131805,33,4,29,0,1,1,0,1,1
00131942,70,0,70,0,0,0,0,0,1
00132310,129,22,107,0,0,0,0,0,1
00132492,28,7,21,0,1,1,0,1,1
00132501,31,4,27,0,1,1,0,1,1
00132583,54,3,51,0,1,1,0,1,1
00132792,37,3,34,0,1,1,0,1,1
00132823,21,0,21,0,0,0,0,0,1
00133095,120,15,105,0,1,1,0,0,1
00133527,25,3,22,0,1,1,0,1,1
00133540,45,5,40,0,2,2,0,2,1
00133558,106,27,79,0,1,1,0,1,1
00133804,35,12,23,0,2,2,0,0,1
00133850,60,11,49,0,0,0,0,0,1
00133936,9,4,5,0,1,1,0,1,1
00134210,38,4,34,0,2,2,0,2,1
00134396,106,22,84,0,0,0,0,0,1
00134530,39,13,26,0,1,1,0,0,0
00134549,60,11,49,0,0,0,0,0,1
00134550,127,4,123,0,0,0,0,0,0
00134561,25,0,25,0,0,0,0,0,1
00134594,19,3,16,0,6,3,3,0,0
00134606,30,3,27,0,1,1,0,1,1
00134835,50,0,50,0,0,0,0,0,1
00135063,25,4,21,0,1,1,0,1,1
00135234,36,11,25,0,0,0,0,0,0
00135252,24,3,21,0,0,0,0,0,1
00135476,30,7,23,0,1,1,0,1,1
00135519,235,48,187,0,0,0,0,0,1
00135577,52,8,44,0,0,0,0,0,0
00135683,9,4,5,0,1,1,0,1,0
00135934,92,18,74,0,1,1,0,1,1
00136293,70,6,64,0,1,1,0,1,1
00136413,0,0,0,0,0,0,0,0,1
00136563,15,3,12,0,2,2,0,0,1
00137013,53,11,42,0,0,0,0,0,1
00137113,119,15,104,0,0,0,0,0,1
00137338,16,4,12,0,1,1,0,1,1
00138006,21,4,17,0,1,1,0,1,1
00138691,37,8,29,0,1,1,0,1,1
00139113,94,13,81,0,0,0,0,0,1
00139166,14,5,9,0,1,1,0,1,1
00139516,14,0,14,0,0,0,0,0,1
00139557,241,29,212,0,0,0,0,0,1
00139677,26,10,16,0,0,0,0,0,0
00139876,32,5,27,0,1,1,0,1,1
00139914,30,2,28,0,1,1,0,1,1
00140141,82,10,72,0,1,1,0,1,1
00140248,109,25,84,0,0,0,0,0,1
00140656,161,20,141,0,0,0,0,0,1
00140697,28,3,25,0,1,1,0,1,1
00141748,56,5,51,0,2,1,1,1,1
00141982,16,2,14,0,1,1,0,1,1
00142215,25,3,22,0,1,1,0,1,1
00142234,29,2,27,0,4,2,2,1,1
00142418,10,0,10,0,0,0,0,0,1
00142711,26,0,26,0,0,0,0,0,1
00143439,20,4,16,0,1,1,0,0,1
00143447,213,2,211,0,1,1,0,1,1
00143633,33,2,31,0,1,1,0,1,1
00143907,16,4,12,0,1,1,0,1,1
00144814,24,0,24,0,0,0,0,0,1
00144888,58,7,51,0,0,0,0,0,1
00145083,4,0,4,0,0,0,0,0,1
00145122,130,20,110,0,0,0,0,0,1
00145205,30,5,25,0,1,1,0,1,1
00145454,69,12,57,0,0,0,0,0,1
00145638,14,0,14,0,1,1,0,1,1
00145670,17,4,13,0,0,0,0,0,0
00145746,15,0,15,0,0,0,0,0,1
00145906,19,2,17,0,1,1,0,1,0
00145932,47,6,41,0,0,0,0,0,1
00145990,50,6,44,0,5,3,2,0,1
00146091,62,4,58,0,1,1,0,1,1
00146309,103,15,88,0,0,0,0,0,1
00146336,22,0,22,0,4,2,2,1,1
00146575,45,10,35,0,1,1,0,1,1
00147271,55,4,51,0,2,2,0,2,1
00147445,9,0,9,0,0,0,0,0,1
00148449,61,14,47,0,0,0,0,0,1
00148498,24,3,21,0,1,1,0,1,0
00148635,33,3,30,0,1,1,0,1,1
00148636,51,11,40,0,12,7,5,0,1
03936011,8,0,8,0,0,0,0,0,1
03936065,23,5,18,0,0,0,0,0,1
03936068,10,7,3,0,4,4,0,1,1
03936084,11,3,8,0,2,2,0,2,1
03936560,57,6,51,0,0,0,0,0,1
03936571,21,3,18,0,1,1,0,1,1
03936645,75,13,62,0,1,1,0,1,1
03936658,35,0,35,0,1,1,0,1,1
03936713,7,2,5,0,2,2,0,0,1
03936830,12,2,10,0,1,1,0,1,1
03937073,19,8,11,0,0,0,0,0,1
03937149,15,3,12,0,1,1,0,0,1
03937213,10,3,7,1,1,1,0,0,1
03937377,6,2,4,0,1,1,0,0,1
03937398,9,5,4,0,2,2,0,0,1
03937421,6,3,3,0,1,1,0,1,1
03937466,35,6,29,0,0,0,0,0,1
03937576,41,8,33,0,10,7,3,0,1
03937682,8,1,7,0,1,1,0,0,1
03937785,13,1,12,0,1,1,0,1,1
03937898,8,1,7,0,1,1,0,0,1
03937912,8,1,7,0,1,1,0,0,1
03938070,7,0,7,0,2,2,0,0,1
03938265,9,0,9,0,0,0,0,0,1
03938288,44,8,36,0,4,3,1,4,1
03938296,10,4,6,0,1,1,0,1,1
03938301,8,2,6,0,0,0,0,0,1
03939015,3,0,3,0,2,2,0,0,1
03939262,7,3,4,0,0,0,0,0,1
03939332,59,11,48,0,0,0,0,0,1
03939828,18,0,18,0,1,1,0,0,1
03939840,33,3,30,0,1,1,0,1,1
03940267,11,3,8,0,2,2,0,0,0
03940587,4,2,2,0,1,1,0,0,0
03941136,36,6,30,0,1,1,0,0,1
03941320,6,0,6,0,0,0,0,0,1
03941439,8,3,5,0,1,1,0,0,1
03941446,8,3,5,0,1,1,0,0,1
03941486,7,0,7,0,1,1,0,1,1
03941660,18,4,14,0,2,2,0,0,1
03941910,21,3,18,0,1,1,0,1,1
03941988,26,0,26,0,0,0,0,0,1
03942183,42,7,35,0,1,1,0,1,1
03942260,6,2,4,0,1,1,0,0,1
03942526,8,2,6,0,0,0,0,0,1
03942532,11,0,11,0,0,0,0,0,1
03942734,10,1,9,0,1,1,0,0,1
03943048,47,11,36,0,1,1,0,1,1
03943677,28,5,23,0,0,0,0,0,0
03943678,51,2,49,0,1,1,0,1,1
03943927,19,4,15,0,1,1,0,1,1
03943958,16,0,16,0,0,0,0,0,1
03944213,20,5,15,0,0,0,0,0,1
03944240,34,6,28,0,0,0,0,0,1
03944449,52,0,52,0,0,0,0,0,1
03944917,7,5,2,0,2,2,0,0,1
03945269,6,0,6,0,1,1,0,1,0
03945382,20,0,20,0,1,1,0,1,1
03945443,45,5,40,0,1,1,0,1,1
03945507,4,1,3,0,1,1,0,0,0
03946280,57,15,42,0,2,2,0,0,0
03946374,8,3,5,0,1,1,0,0,0
03946380,4,2,2,0,1,1,0,0,0
03946444,18,0,18,0,0,0,0,0,1
03946529,19,10,9,0,0,0,0,0,1
03946731,76,16,60,0,2,1,1,0,0
03946755,32,2,30,0,1,1,0,1,1
03946785,16,3,13,0,0,0,0,0,1
03946970,6,2,4,0,1,1,0,1,0
03947512,5,0,5,0,1,1,0,0,1
03947514,7,3,4,0,2,1,1,0,1
03947517,5,0,5,0,1,1,0,0,1
03948774,11,0,11,0,1,1,0,1,1
03948792,5,0,5,0,0,0,0,0,1
03948898,18,9,9,0,0,0,0,0,1
03948922,8,5,3,0,0,0,0,0,1
03949032,30,3,27,0,1,1,0,0,1
03949246,12,6,6,2,0,0,0,0,0
03949250,7,3,4,0,2,2,0,0,0
03949356,8,1,7,0,0,0,0,0,1
03949453,8,0,8,0,1,1,0,0,1
03949454,8,1,7,0,0,0,0,0,1
03949457,9,1,8,0,0,0,0,0,1
03949536,10,5,5,0,1,1,0,1,1
03949597,28,6,22,0,1,1,0,1,1
03949607,8,2,6,0,2,1,1,0,1
03949697,21,2,19,0,1,1,0,1,1
03949707,31,5,26,0,2,2,0,0,1
03949824,7,2,5,0,1,1,0,0,0
03949843,28,4,24,0,1,1,0,1,1
03950078,30,1,29,0,0,0,0,0,1
03950671,24,0,24,0,0,0,0,0,1
03950700,27,4,23,0,1,1,0,1,1
03950701,23,3,20,0,1,1,0,1,1
03950708,29,4,25,0,1,1,0,1,1
03950747,33,8,25,0,0,0,0,0,0
03950830,30,8,22,0,0,0,0,0,1
03951117,6,2,4,0,1,1,0,0,1
03951148,6,2,4,0,1,1,0,0,1
03951157,6,2,4,0,1,1,0,0,1
03951260,34,7,27,0,1,1,0,1,1
03951288,33,0,33,0,0,0,0,0,1
03951306,22,5,17,0,1,1,0,1,1
03951476,13,0,13,0,0,0,0,0,1
03951833,21,0,21,0,0,0,0,0,1
03951860,46,6,40,0,1,1,0,1,1
03951895,11,2,9,0,1,1,0,0,1
03951899,17,3,14,0,2,2,0,0,1
03952034,7,2,5,0,2,1,1,0,1
03952526,9,2,7,0,1,1,0,1,1
03952910,10,3,7,0,3,1,2,0,0
03952958,19,0,19,0,1,1,0,1,1
03953195,47,11,36,0,0,0,0,0,0
03953229,67,14,53,0,0,0,0,0,1
03953443,5,2,3,0,1,1,0,0,0
03953699,4,1,3,0,1,1,0,0,1
03954263,5,3,2,0,1,1,0,0,0
03954390,26,0,26,0,0,0,0,0,1
03954514,6,3,3,0,2,2,0,0,0
03954779,8,5,3,0,0,0,0,0,1
03954867,17,4,13,0,1,1,0,1,1
03955104,27,3,24,0,2,2,0,0,1
03955179,17,3,14,0,1,1,0,0,1
03955206,24,5,19,0,0,0,0,0,1
03955482,12,2,10,0,2,2,0,2,1
03955516,13,5,8,0,1,1,0,1,1
03955537,11,2,9,0,0,0,0,0,1
03955559,24,5,19,0,0,0,0,0,1
03955576,40,10,30,0,0,0,0,0,1
03955855,7,0,7,0,1,1,0,0,1
03955861,41,4,37,0,1,1,0,1,1
03956184,34,2,32,0,0,0,0,0,1
03956390,5,1,4,0,1,1,0,1,1
03956433,46,9,37,0,1,1,0,1,1
03956724,29,0,29,0,0,0,0,0,1
03956741,5,3,2,0,2,2,0,0,1
03956993,7,3,4,0,1,1,0,1,1
03957249,12,5,7,0,0,0,0,0,0
03957322,14,2,12,0,2,2,0,0,1
03957668,16,2,14,0,2,1,1,0,1
03957722,24,4,20,0,1,1,0,1,1
03957786,13,5,8,0,1,1,0,1,1
03957858,42,9,33,0,0,0,0,0,1
03957974,31,4,27,0,0,0,0,0,1
03958091,8,3,5,0,2,2,0,0,1
03958116,11,0,11,0,0,0,0,0,1
03958217,26,3,23,0,2,1,1,2,1
03958363,9,3,6,0,3,3,0,0,0
03958412,22,2,20,0,1,1,0,1,1
03958429,13,0,13,0,0,0,0,0,1
03958448,4,1,3,0,1,1,0,0,0
03958484,27,7,20,0,0,0,0,0,1
03958533,17,3,14,0,1,1,0,1,1
03958596,9,3,6,0,1,1,0,0,1
03958793,30,13,17,0,0,0,0,0,0
03958925,6,2,4,0,0,0,0,0,1
03959159,48,4,44,0,13,1,12,1,1
03959649,49,11,38,0,0,0,0,0,1
03959712,7,3,4,0,0,0,0,0,1
03959835,7,2,5,0,1,1,0,1,0
03960462,20,4,16,0,1,1,0,1,1
03960511,16,3,13,0,1,1,0,1,1
03960576,12,3,9,0,0,0,0,0,1
03960727,25,0,25,0,1,1,0,1,1
03960826,14,0,14,0,0,0,0,0,1
03961155,11,0,11,0,0,0,0,0,1
03961169,9,3,6,0,1,1,0,1,1
03961698,7,2,5,0,0,0,0,0,1
03961972,5,1,4,0,1,1,0,0,1
03962001,24,4,20,0,2,1,1,2,1
03962228,23,3,20,0,1,1,0,1,1
03962410,36,2,34,0,1,1,0,1,1
03963348,10,3,7,0,0,0,0,0,0
03963352,10,3,7,0,0,0,0,0,0
03963360,30,13,17,0,0,0,0,0,1
03963402,5,3,2,0,2,2,0,0,1
03963889,18,3,15,0,0,0,0,0,1
03963921,20,3,17,1,1,1,0,1,1
03963982,4,0,4,0,0,0,0,0,1
03964024,15,3,12,0,0,0,0,0,0
03964044,5,0,5,0,0,0,0,0,1
03964186,45,5,40,0,0,0,0,0,1
03964238,6,4,2,0,2,2,0,0,0
03964274,6,1,5,0,1,1,0,0,1
03964432,13,5,8,0,0,0,0,0,0
03964469,8,0,8,0,0,0,0,0,0
03964494,7,0,7,0,0,0,0,0,1
03964578,4,1,3,0,2,2,0,0,0
03964801,18,0,18,0,1,1,0,1,1
03964835,9,0,9,0,1,1,0,1,1
03964960,4,2,2,0,2,2,0,0,0
03965670,18,6,12,0,1,1,0,0,1
03966333,28,4,24,0,1,1,0,1,1
03966381,29,4,25,0,1,1,0,1,1
03966443,18,3,15,0,1,1,0,1,1
03966643,53,0,53,0,0,0,0,0,1
03966743,11,3,8,0,1,1,0,0,1
03966886,20,0,20,0,0,0,0,0,1
03966925,15,2,13,0,1,1,0,1,1
03966947,20,3,17,0,1,1,0,1,1
03966966,7,4,3,0,2,2,0,0,1
03967077,43,10,33,0,0,0,0,0,1
03967275,8,4,4,0,1,1,0,0,1
03967676,23,4,19,0,0,0,0,0,0
03967680,21,5,16,0,5,3,2,1,1
03967717,37,4,33,0,5,1,4,5,1
03967878,25,0,25,0,0,0,0,0,1
03967882,26,0,26,0,0,0,0,0,1
03967914,16,0,16,0,0,0,0,0,1
03967922,16,0,16,0,0,0,0,0,1
00280220,31,6,25,0,1,1,0,1,1
00280474,3,3,0,0,2,2,0,0,0
00281055,39,1,38,0,1,1,0,1,1
00281132,32,5,27,0,0,0,0,0,1
00281685,17,3,14,0,0,0,0,0,0
00281728,66,6,60,0,1,1,0,1,1
00281992,28,7,21,0,1,1,0,1,1
00282122,20,3,17,0,1,1,0,1,1
00282391,22,4,18,0,1,1,0,1,1
00282555,135,13,122,0,0,0,0,0,1
00283027,20,3,17,0,1,1,0,1,1
00283121,18,0,18,0,0,0,0,0,1
00283556,55,3,52,0,1,1,0,1,1
00284151,30,0,30,0,0,0,0,0,1
00284340,30,4,26,0,1,1,0,1,1
00284448,25,2,23,0,1,1,0,1,1
00285257,23,5,18,0,1,1,0,1,1
00285372,12,3,9,0,1,1,0,1,0
00285519,34,3,31,0,1,1,0,1,1
00285630,105,4,101,0,0,0,0,0,0
00285957,20,3,17,0,1,1,0,0,0
00286146,17,10,7,2,3,3,0,0,1
00286222,39,3,36,0,1,1,0,1,1
00286385,16,5,11,0,4,3,1,0,0
00286608,4,3,1,0,0,0,0,0,0
00286773,45,8,37,0,0,0,0,0,1
00286939,21,4,17,0,0,0,0,0,1
00287299,26,6,20,0,1,1,0,0,0
00287916,11,6,5,0,5,5,0,0,0
00287958,16,0,16,0,0,0,0,0,1
00288008,26,5,21,0,2,1,1,2,1
00288105,65,17,48,0,0,0,0,0,1
00288553,63,3,60,0,1,1,0,1,1
00289123,20,0,20,0,0,0,0,0,1
00289787,70,13,57,0,4,3,1,0,1
00290029,14,6,8,0,1,1,0,0,0
00290076,26,2,24,0,1,1,0,1,1
00290277,36,5,31,0,1,1,0,1,1
00290792,22,5,17,0,0,0,0,0,1
00290803,47,5,42,0,3,2,1,2,1
00291646,73,14,59,0,0,0,0,0,1
00291686,46,5,41,0,1,1,0,1,1
00291848,64,3,61,0,1,1,0,1,1
00291902,23,0,23,0,0,0,0,0,1
00291940,17,0,17,0,0,0,0,0,1
00292254,32,8,24,0,1,1,0,0,0
00292689,220,5,215,0,1,1,0,1,1
00292732,22,3,19,0,1,1,0,1,1
00293154,10,2,8,0,1,1,0,0,0
00293260,27,4,23,0,1,1,0,1,1
00293262,35,9,26,0,0,0,0,0,1
00293382,14,5,9,0,1,1,0,1,0
00293397,42,5,37,0,1,1,0,1,1
00293547,25,5,20,0,1,1,0,0,1
00293671,6,4,2,0,1,1,0,0,0
00293857,33,8,25,0,0,0,0,0,1
00293972,29,2,27,0,1,1,0,1,1
00294469,16,3,13,0,1,1,0,1,1
00294490,36,5,31,0,1,1,0,1,1
00294704,49,0,49,0,0,0,0,0,1
00294789,72,13,59,0,0,0,0,0,1
00294980,16,3,13,0,1,1,0,1,1
00295012,5,2,3,0,4,3,1,0,0
00295482,53,4,49,0,1,1,0,1,1
00295632,18,3,15,0,1,1,0,1,1
00295894,117,11,106,0,0,0,0,0,0
00296531,12,4,8,0,0,0,0,0,1
00296602,18,3,15,0,1,1,0,1,1
00296805,53,10,43,0,0,0,0,0,1
00297155,7,0,7,0,0,0,0,0,0
00297801,29,4,25,0,1,1,0,1,1
00297895,3,0,3,0,0,0,0,0,0
00298211,18,0,18,0,0,0,0,0,1
00298761,8,3,5,0,2,1,1,0,0
00298836,6,3,3,0,1,1,0,0,0
00298945,32,6,26,0,1,1,0,1,1
00299435,16,5,11,0,1,1,0,1,1
00299760,16,4,12,0,1,1,0,1,1
00300000,20,3,17,0,1,1,0,1,0
00300002,66,10,56,0,1,1,0,1,1
00300062,19,3,16,0,1,1,0,1,1
00300433,185,17,168,0,0,0,0,0,0
00300573,25,4,21,0,1,1,0,1,1
00300679,6,3,3,0,2,2,0,0,1
00300714,20,5,15,0,1,1,0,1,1
00301095,7,3,4,0,1,1,0,1,0
00301096,33,0,33,0,0,0,0,0,1
00301188,21,2,19,0,1,1,0,1,1
00301279,16,4,12,0,1,1,0,1,1
00301291,28,3,25,0,0,0,0,0,0
00301324,62,9,53,0,0,0,0,0,1
00301641,0,0,0,0,0,0,0,0,0
00301725,24,3,21,0,1,1,0,1,1
00301857,12,3,9,0,1,1,0,0,1
00302132,159,13,146,0,0,0,0,0,1
00302798,23,2,21,0,0,0,0,0,1
00303039,21,3,18,0,1,1,0,1,1
00303062,39,7,32,1,0,0,0,0,1
00303275,10,3,7,0,0,0,0,0,1
00303301,24,4,20,0,1,1,0,1,1
00303386,21,2,19,0,1,1,0,1,1
00303542,9,4,5,0,0,0,0,0,1
00303665,16,2,14,0,1,1,0,1,1
00304766,34,3,31,0,1,1,0,1,1
00305034,7,4,3,0,2,2,0,0,0
00305345,6,4,2,0,0,0,0,0,1
00305430,32,1,31,0,1,1,0,1,1
00305557,7,5,2,0,1,1,0,0,1
00305723,27,0,27,0,0,0,0,0,1
00305759,23,3,20,0,1,1,0,1,1
00306107,34,7,27,0,0,0,0,0,0
00306511,10,4,6,0,1,1,0,0,1
00306672,20,3,17,0,1,1,0,1,1
00306718,33,9,24,0,0,0,0,0,1
00306721,14,4,10,0,1,1,0,1,1
00306828,71,17,54,0,0,0,0,0,1
00306924,135,18,117,0,3,2,1,0,1
00306977,43,7,36,0,0,0,0,0,1
00307291,31,5,26,0,1,1,0,1,1
00307468,32,7,25,0,1,1,0,1,1
00307812,47,4,43,0,1,1,0,1,1
00308066,10,6,4,0,1,1,0,0,0
00308372,51,4,47,0,0,0,0,0,1
00308632,66,11,55,0,0,0,0,0,1
00308855,19,4,15,0,1,1,0,1,1
00308933,22,4,18,0,3,3,0,0,0
00308999,12,4,8,0,0,0,0,0,1
00309329,66,10,56,0,0,0,0,0,1
00309463,0,0,0,0,0,0,0,0,0
00309615,7,4,3,0,1,1,0,0,0
00309627,23,2,21,0,1,1,0,1,0
00310105,13,4,9,0,0,0,0,0,1
00311036,32,9,23,0,11,9,2,0,0
00311210,43,0,43,0,1,1,0,1,1
00311238,35,5,30,0,0,0,0,0,1
00311255,14,5,9,0,0,0,0,0,0
00311608,72,2,70,0,0,0,0,0,1
00311950,9,3,6,0,2,2,0,1,0
00312045,1,1,0,0,0,0,0,0,1
00312076,21,2,19,0,1,1,0,1,1
00312083,30,3,27,0,1,1,0,1,1
00312129,20,0,20,0,0,0,0,0,1
00312202,28,3,25,0,0,0,0,0,1
00312375,11,6,5,0,1,1,0,1,1
00312636,48,3,45,0,1,1,0,1,1
00313105,64,13,51,0,1,1,0,0,1
00313307,18,4,14,0,1,1,0,1,1
00313430,31,3,28,0,1,1,0,1,1
00313746,13,3,10,0,1,1,0,1,0
00313761,52,4,48,0,1,1,0,1,1
00313983,9,2,7,0,1,1,0,0,1
00313993,23,4,19,0,1,1,0,1,1
00314205,53,8,45,0,1,1,0,1,1
00314230,6,0,6,0,0,0,0,0,1
00314349,21,4,17,0,1,1,0,1,0
00314534,16,3,13,0,1,1,0,0,0
00314592,28,4,24,0,1,1,0,1,1
00314683,9,0,9,0,0,0,0,0,1
00314747,35,3,32,0,0,0,0,0,1
00314979,17,3,14,0,1,1,0,1,1
00315076,43,3,40,0,1,1,0,1,1
00315097,7,0,7,0,0,0,0,0,1
00315140,11,3,8,0,1,1,0,0,1
00315158,40,5,35,0,1,1,0,1,1
00315280,37,6,31,0,0,0,0,0,1
00315671,33,0,33,0,0,0,0,0,1
00315841,241,8,233,0,1,1,0,1,1
00316229,19,7,12,0,1,1,0,0,1
00316584,14,7,7,0,0,0,0,0,0
00316731,3,3,0,0,0,0,0,0,0
00317241,32,4,28,0,2,1,1,2,1
00317267,24,5,19,0,2,2,0,0,1
00317560,82,12,70,0,0,0,0,0,1
00317732,12,4,8,0,1,1,0,1,1
00318460,29,4,25,0,1,1,0,1,1
00319092,35,1,34,0,1,1,0,1,1
00319437,94,9,85,0,0,0,0,0,1
00319704,37,4,33,0,1,1,0,1,1
00319970,43,10,33,0,0,0,0,0,1
00320694,13,4,9,0,4,4,0,0,1
00320739,21,4,17,0,2,1,1,2,1
00320784,76,11,65,0,0,0,0,0,1
00320949,13,4,9,0,1,1,0,1,1
00321153,5,0,5,0,0,0,0,0,1
00321509,81,13,68,0,2,1,1,0,1
00321643,61,4,57,0,1,1,0,1,1
00321992,45,4,41,0,1,1,0,1,1
00322137,48,5,43,0,1,1,0,1,1
00322305,5,3,2,0,2,2,0,0,0
00322528,251,15,236,0,0,0,0,0,1
00322663,10,0,10,0,0,0,0,0,1
00323204,147,19,128,0,0,0,0,0,1
00323261,29,3,26,0,1,1,0,1,1
00323279,40,0,40,0,0,0,0,0,1
00323541,30,10,20,0,1,1,0,0,1
00323551,9,3,6,0,1,1,0,0,1
00323575,170,17,153,0,0,0,0,0,1
00323678,19,0,19,0,0,0,0,0,1
00323690,36,3,33,0,1,1,0,1,1
00323778,29,8,21,0,1,1,0,1,1
00324340,56,5,51,0,1,1,0,1,1
00324456,25,3,22,0,1,1,0,1,1
00324504,45,3,42,0,1,1,0,1,1
00324601,0,0,0,0,0,0,0,0,0
00324647,41,4,37,0,1,1,0,1,1
00324769,9,3,6,0,1,1,0,0,1
00324968,13,4,9,0,1,1,0,0,0
00325282,61,23,38,0,0,0,0,0,1
00326864,27,2,25,0,1,1,0,1,1
00326945,11,3,8,0,2,2,0,2,1
00326974,28,3,25,0,1,1,0,1,1
00326995,9,3,6,0,1,1,0,1,1
00327068,11,4,7,0,0,0,0,0,0
00327208,24,4,20,0,1,1,0,1,1
00327694,13,2,11,0,0,0,0,0,0
00327847,44,8,36,0,1,1,0,1,1
00328081,6,3,3,0,2,2,0,0,1
00328206,29,5,24,0,1,1,0,1,1
00328322,4,4,0,0,0,0,0,0,1
00328538,81,3,78,0,1,1,0,1,1
00328813,25,4,21,0,1,1,0,1,1
00328933,62,5,57,0,1,1,0,1,1
00329175,14,2,12,0,1,1,0,0,1
00329379,45,11,34,0,0,0,0,0,1
00329435,43,1,42,0,1,1,0,1,1
00329717,12,1,11,0,0,0,0,0,1
00329741,19,3,16,0,1,1,0,1,1
00331126,27,5,22,0,1,1,0,1,1
00331349,7,3,4,0,2,2,0,0,1
00331602,6,6,0,0,2,2,0,0,1
00332137,15,4,11,0,1,1,0,1,0
00332450,18,7,11,0,1,1,0,0,0
00333188,26,8,18,0,1,1,0,0,1
00333313,29,6,23,0,1,1,0,0,1
00333581,36,4,32,0,0,0,0,0,0
00333593,23,3,20,0,0,0,0,0,1
00333713,57,8,49,0,1,1,0,0,1
00334594,9,2,7,0,3,1,2,1,1
00335231,7,2,5,0,4,4,0,1,1
00335444,33,4,29,0,1,1,0,1,1
00335458,203,11,192,0,0,0,0,0,1
00335659,24,9,15,0,0,0,0,0,1
00335699,33,1,32,0,2,1,1,0,1
00337004,75,5,70,0,1,1,0,1,1
00337663,45,6,39,0,1,1,0,1,1
00337803,16,4,12,0,2,1,1,2,1
00338515,34,0,34,0,1,1,0,1,1
00338658,10,2,8,0,0,0,0,0,1
00338786,38,0,38,0,0,0,0,0,1
00339016,15,0,15,0,0,0,0,0,1
00339276,40,0,40,0,0,0,0,0,1
00339590,39,0,39,0,0,0,0,0,1
00339785,23,7,16,0,0,0,0,0,0
00340611,62,9,53,0,1,1,0,1,1
00340744,30,3,27,0,1,1,0,1,1
00340931,37,6,31,0,1,1,0,1,1
00341010,89,14,75,0,0,0,0,0,1
00341786,100,8,92,0,0,0,0,0,0
00341813,36,7,29,0,1,1,0,1,1
00342778,33,3,30,0,1,1,0,1,1
00342798,13,9,4,0,8,8,0,0,1
00342856,35,2,33,0,1,1,0,1,1
00343124,25,0,25,0,0,0,0,0,1
00343329,9,0,9,0,1,1,0,1,1
00343544,159,3,156,0,1,1,0,1,1
00343625,31,0,31,0,0,0,0,0,1
00343727,0,0,0,0,0,0,0,0,0
00344359,35,8,27,0,1,1,0,1,1
00344823,35,5,30,0,1,1,0,1,1
00345218,65,2,63,0,2,2,0,0,0
00345261,80,7,73,0,9,7,2,0,0
00345645,35,3,32,0,1,1,0,1,1
00345902,25,5,20,0,2,2,0,0,1
00346268,57,3,54,0,1,1,0,1,1
00346570,42,0,42,0,0,0,0,0,1
00346625,6,3,3,0,1,1,0,0,0
00346680,18,0,18,0,0,0,0,0,1
00346933,12,3,9,0,1,1,0,1,0
00346959,16,5,11,0,1,1,0,1,1
00346999,18,13,5,0,1,1,0,1,1
00347271,27,2,25,0,1,1,0,1,1
00347417,58,11,47,0,0,0,0,0,1
00347453,40,3,37,0,1,1,0,1,1
00347455,108,8,100,0,1,1,0,1,1
00347823,15,2,13,0,1,1,0,1,1
00348312,38,2,36,0,1,1,0,1,1
00348987,30,0,30,0,0,0,0,0,1
00349244,11,6,5,0,1,1,0,0,1
00349259,16,5,11,0,1,1,0,1,1
00349367,8,4,4,0,1,1,0,0,0
00349408,99,13,86,0,0,0,0,0,1
00350164,39,4,35,0,1,1,0,1,0
00350333,13,0,13,0,0,0,0,0,1
00350383,49,15,34,0,0,0,0,0,0
00350433,38,11,27,0,0,0,0,0,1
00350729,26,6,20,0,1,1,0,1,1
00351127,36,0,36,0,0,0,0,0,1
00351210,13,0,13,0,0,0,0,0,1
00351295,27,5,22,0,1,1,0,1,1
00351689,30,13,17,0,0,0,0,0,1
00352735,10,0,10,0,0,0,0,0,1
00352808,21,3,18,0,1,1,0,1,1
00352991,10,3,7,0,1,1,0,1,1
00353278,21,7,14,0,0,0,0,0,0
00353402,20,3,17,0,1,1,0,1,1
00354883,67,3,64,0,2,2,0,2,1
00355272,34,3,31,0,0,0,0,0,1
00355318,4,2,2,0,0,0,0,0,1
00356027,19,5,14,0,1,1,0,1,1
00356443,55,10,45,0,0,0,0,0,1
00357042,16,0,16,0,0,0,0,0,1
00357121,10,0,10,0,1,1,0,1,1
00357357,10,4,6,0,3,3,0,0,0
00357393,7,3,4,0,2,2,0,0,0
00357816,16,0,16,0,0,0,0,0,1
00357825,9,1,8,0,1,1,0,1,1
00357963,30,11,19,0,0,0,0,0,1
00358003,5,5,0,0,0,0,0,0,0
00358109,17,0,17,0,0,0,0,0,1
00358588,57,10,47,0,1,1,0,0,1
00358948,33,8,25,0,0,0,0,0,1
00359459,51,5,46,0,1,1,0,1,1
00359473,13,5,8,0,2,2,0,0,1
00359564,23,3,20,0,1,1,0,1,1
00359567,32,5,27,0,1,1,0,1,1
00359586,28,3,25,0,1,1,0,1,1
00360174,15,5,10,0,0,0,0,0,0
00360190,4,2,2,0,1,1,0,0,0
00360624,120,12,108,0,5,3,2,0,0
00360917,9,4,5,0,1,1,0,0,0
00360964,33,5,28,0,1,1,0,1,1
00360993,7,2,5,0,1,1,0,0,1
00362421,27,0,27,0,0,0,0,0,1
00362504,13,2,11,0,2,2,0,0,1
00362847,47,4,43,0,2,2,0,2,1
00363197,56,16,40,0,0,0,0,0,1
00363313,11,0,11,0,0,0,0,0,1
00364401,23,4,19,0,0,0,0,0,1
00364456,91,16,75,0,0,0,0,0,1
00364610,6,5,1,0,0,0,0,0,1
00364890,10,7,3,0,1,1,0,1,1
00364962,35,4,31,0,2,2,0,0,1
00365787,6,3,3,0,0,0,0,0,1
00365812,45,9,36,0,0,0,0,0,1
00366054,19,11,8,0,9,9,0,0,1
00366927,15,0,15,0,0,0,0,0,1
00367135,32,5,27,0,1,1,0,1,1
00367180,17,5,12,0,1,1,0,1,1
00367326,49,0,49,0,0,0,0,0,1
00367551,56,4,52,0,1,1,0,1,1
00367806,30,4,26,0,1,1,0,1,1
00368194,20,3,17,0,0,0,0,0,1
00368248,21,4,17,0,2,2,0,2,1
00368387,5,2,3,0,1,1,0,0,0
00368590,9,1,8,0,2,1,1,1,0
00368654,11,0,11,0,0,0,0,0,1
00369150,6,2,4,0,1,1,0,0,1
00369294,6,3,3,0,6,3,3,0,1
00369593,19,4,15,0,1,1,0,1,1
00369927,24,0,24,0,0,0,0,0,1
00370721,51,6,45,0,2,1,1,2,1
00370987,11,2,9,0,1,1,0,1,1
00371040,17,2,15,0,0,0,0,0,0
00371044,4,0,4,0,0,0,0,0,0
00371217,39,5,34,0,1,1,0,1,1
00371448,11,5,6,0,2,2,0,1,1
00371511,20,6,14,0,0,0,0,0,1
00371601,29,5,24,0,1,1,0,1,1
00371602,27,5,22,0,2,2,0,2,1
00371615,44,12,32,0,0,0,0,0,1
00371825,6,0,6,0,0,0,0,0,0
00372490,36,6,30,0,0,0,0,0,1
00372862,31,1,30,0,0,0,0,0,1
00372956,23,0,23,0,0,0,0,0,1
00373440,23,4,19,0,1,1,0,1,1
00373894,10,3,7,0,0,0,0,0,1
00373964,23,3,20,0,1,1,0,1,1
00373984,110,8,102,0,0,0,0,0,1
00374375,13,5,8,0,0,0,0,0,0
00374634,29,3,26,0,1,1,0,1,1
00375006,0,0,0,0,0,0,0,0,0
00375121,16,0,16,0,0,0,0,0,1
00375155,6,3,3,0,1,1,0,0,0
00375364,53,5,48,0,3,2,1,0,1
00375564,49,2,47,0,1,1,0,1,1
00375770,61,10,51,0,1,1,0,1,1
00376104,5,2,3,0,1,1,0,0,0
00376458,15,6,9,0,5,3,2,0,1
00376684,11,3,8,0,2,2,0,0,0
00376920,30,2,28,0,1,1,0,1,1
00377015,21,3,18,0,1,1,0,1,1
00377108,48,14,34,0,0,0,0,0,1
00377242,24,2,22,0,1,1,0,1,1
00377443,9,7,2,0,0,0,0,0,0
00377786,32,6,26,0,1,1,0,1,1
00377936,34,5,29,0,1,1,0,1,1
00378180,27,0,27,0,0,0,0,0,1
00378282,9,3,6,0,1,1,0,1,1
00379493,16,5,11,0,1,1,0,1,1
00379733,13,4,9,0,1,1,0,1,1
00379944,26,4,22,0,0,0,0,0,1
08678112,3,3,0,0,1,1,0,0,1
08678178,1,1,0,0,1,1,0,0,0
08678222,16,11,5,0,0,0,0,0,1
08678419,2,2,0,0,2,2,0,0,0
08678533,2,0,2,0,0,0,0,0,0
08679764,7,3,4,0,1,1,0,1,1
08680036,4,2,2,0,3,2,1,0,0
08680081,5,5,0,0,1,1,0,1,1
08680130,3,3,0,0,1,1,0,0,0
08680136,1,1,0,0,1,1,0,0,0
08680319,7,6,1,0,1,1,0,0,1
08680377,4,3,1,0,1,1,0,0,1
08680406,14,7,7,0,0,0,0,0,0
08680864,5,0,5,0,1,1,0,1,1
08680996,1,0,1,0,1,1,0,0,1
08681146,6,3,3,0,0,0,0,0,1
08681214,1,1,0,0,0,0,0,0,0
08681239,2,2,0,0,2,2,0,0,0
08681332,1,1,0,0,1,1,0,0,0
08681375,1,1,0,0,1,1,0,0,0
08682579,6,0,6,0,0,0,0,0,1
08682697,8,3,5,0,1,1,0,1,1
08682766,1,1,0,0,1,1,0,0,0
08682855,1,1,0,0,1,1,0,0,0
08683015,8,7,1,0,2,2,0,0,1
08683577,10,8,2,0,1,1,0,1,1
08683978,1,0,1,0,0,0,0,0,0
08684284,5,4,1,0,0,0,0,0,0
08684474,18,6,12,0,1,1,0,1,1
08684541,3,3,0,0,2,2,0,0,1
08684593,2,2,0,0,2,2,0,0,1
08684629,4,0,4,0,2,2,0,0,0
08684953,2,0,2,0,0,0,0,0,0
08685063,1,1,0,0,1,1,0,0,1
08685505,7,5,2,0,1,1,0,1,1
08686547,1,0,1,0,1,1,0,0,0
08686818,4,0,4,0,0,0,0,0,0
08687066,2,1,1,0,1,1,0,0,1
08687207,2,2,0,0,2,2,0,0,1
08687223,18,9,9,0,0,0,0,0,1
08687841,2,2,0,0,2,2,0,0,0
08688046,10,5,5,0,0,0,0,0,1
08688588,1,1,0,0,2,1,1,0,0
08688637,7,2,5,0,1,1,0,0,0
08688689,5,3,2,0,1,1,0,0,0
08688934,3,3,0,0,2,2,0,0,0
08688976,2,2,0,0,2,2,0,0,1
08689109,1,1,0,0,1,1,0,0,0
08689676,2,2,0,0,1,1,0,0,0
08689975,1,1,0,0,1,1,0,0,1
08690064,4,1,3,0,1,1,0,1,1
08690077,9,5,4,0,1,1,0,1,1
08690205,1,0,1,0,0,0,0,0,0
08690664,1,1,0,0,1,1,0,0,0
08690906,2,0,2,0,0,0,0,0,0
08690952,1,1,0,0,1,1,0,0,0
08691304,5,4,1,0,1,1,0,1,0
08691839,2,2,0,0,1,1,0,1,1
08692381,1,0,1,0,0,0,0,0,1
08692442,7,5,2,0,1,1,0,1,1
08692768,3,1,2,0,1,1,0,0,1
08693025,1,0,1,0,0,0,0,0,0
08693063,3,1,2,0,1,1,0,0,1
08694353,2,2,0,0,1,1,0,0,0
08694373,14,7,7,0,1,1,0,1,1
08694514,3,2,1,0,1,1,0,0,1
08694680,2,2,0,0,2,0,2,0,0
08694760,2,2,0,0,1,1,0,0,1
08695158,4,2,2,0,2,2,0,0,0
08695321,3,2,1,0,2,2,0,0,0
08695480,3,0,3,0,1,1,0,0,0
08695910,6,4,2,0,1,1,0,1,1
08695950,4,2,2,0,1,1,0,1,1
08695998,8,0,8,0,1,1,0,0,1
08696068,2,0,2,0,0,0,0,0,1
08696102,2,0,2,0,0,0,0,0,1
08696113,6,2,4,0,4,2,2,0,1
08696232,1,1,0,0,1,1,0,0,0
08696249,3,3,0,0,1,1,0,0,1
08696271,5,4,1,0,1,1,0,0,1
08696283,13,4,9,0,7,1,6,1,1
08696539,3,2,1,0,1,1,0,0,0
08696603,1,1,0,0,1,1,0,0,0
08697555,2,2,0,0,2,2,0,0,0
08697906,3,3,0,0,1,1,0,0,0
08698059,12,6,6,0,0,0,0,0,1
08698486,2,1,1,0,1,1,0,0,0
08698621,1,1,0,0,1,1,0,1,1
08698667,1,1,0,0,1,1,0,0,0
08699027,1,1,0,0,1,1,0,0,0
08699036,1,1,0,0,1,1,0,0,0
08699428,8,5,3,0,0,0,0,0,1
08699882,3,2,1,0,1,1,0,0,1
08700209,1,1,0,0,1,1,0,0,0
08700698,40,14,26,0,1,1,0,1,1
08700746,1,1,0,0,1,1,0,0,0
08700766,9,5,4,0,2,1,1,1,1
08701853,9,3,6,0,1,1,0,1,1
08701922,2,2,0,0,1,1,0,0,1
08702629,1,1,0,0,1,1,0,0,0
08702833,1,0,1,0,0,0,0,0,1
08703170,7,3,4,0,1,1,0,1,1
08703248,3,2,1,0,1,1,0,0,1
08703455,1,1,0,0,1,1,0,0,0
08703483,2,2,0,0,2,2,0,0,0
08703722,1,1,0,0,1,1,0,0,0
08703897,2,2,0,0,2,2,0,0,0
08704006,13,6,7,0,1,1,0,1,0
08704112,3,2,1,0,3,2,1,0,0
08704239,2,2,0,0,3,3,0,0,0
08704695,1,1,0,0,1,1,0,0,0
08705141,4,3,1,0,1,1,0,1,0
08705142,1,1,0,0,1,1,0,0,0
08705658,4,3,1,0,1,1,0,1,0
08705984,2,2,0,0,1,1,0,0,0
08706007,2,0,2,0,0,0,0,0,1
08706064,9,5,4,0,4,1,3,4,1
08706112,9,5,4,0,1,1,0,1,1
08706188,2,1,1,0,2,1,1,0,0
08706219,1,1,0,0,1,1,0,0,0
08706249,8,6,2,1,0,0,0,0,0
08706689,2,2,0,0,1,1,0,0,1
08706806,2,0,2,0,0,0,0,0,1
08706956,2,2,0,0,1,1,0,0,1
08707053,2,2,0,0,1,1,0,1,1
08707113,2,0,2,0,1,1,0,1,1
08707114,2,0,2,0,1,1,0,1,1
08707131,2,0,2,0,1,1,0,1,1
08707134,2,0,2,0,1,1,0,1,1
08707244,3,2,1,0,1,1,0,0,0
08707246,2,2,0,0,1,1,0,0,0
08707621,2,2,0,0,1,1,0,0,0
08707909,14,9,5,0,0,0,0,0,1
08708014,8,0,8,0,0,0,0,0,1
08708748,2,0,2,0,1,1,0,1,1
08709018,2,2,0,0,1,1,0,0,0
08709414,6,2,4,0,0,0,0,0,1
08709619,6,3,3,0,1,1,0,0,1
08709626,1,1,0,0,2,2,0,0,0
08709666,3,2,1,0,0,0,0,0,1
08709690,3,0,3,0,2,2,0,0,0
08709827,1,1,0,0,1,1,0,0,1
08709881,5,2,3,0,3,2,1,0,1
08710277,2,0,2,0,1,1,0,1,1
08710533,2,0,2,0,1,1,0,1,1
08710565,2,0,2,0,1,1,0,1,1
08710771,3,2,1,0,1,1,0,0,0
08711102,3,0,3,0,1,1,0,0,1
08711420,7,6,1,0,1,1,0,0,1
08711599,5,3,2,0,1,1,0,1,1
08711738,4,4,0,0,0,0,0,0,0
08712232,5,3,2,0,3,1,2,3,1
08712250,2,2,0,0,1,1,0,0,0
08712541,7,6,1,0,0,0,0,0,1
08712611,7,7,0,0,2,2,0,0,0
08713270,2,1,1,0,1,1,0,1,0
08713386,1,0,1,0,0,0,0,0,1
08713438,2,0,2,0,0,0,0,0,1
08713503,2,0,2,0,0,0,0,0,1
08713566,2,0,2,0,0,0,0,0,1
08713590,2,0,2,0,0,0,0,0,1
08713604,2,0,2,0,0,0,0,0,1
08713677,2,2,0,0,1,1,0,0,0
08713681,2,0,2,0,0,0,0,0,1
08714244,14,7,7,0,8,8,0,8,1
08714589,1,0,1,0,0,0,0,0,0
08714720,5,0,5,0,0,0,0,0,1
08714873,4,2,2,0,1,1,0,1,1
08714915,3,0,3,0,0,0,0,0,0
08715265,5,3,2,0,4,4,0,0,1
08715540,6,2,4,0,1,1,0,1,1
08715747,2,2,0,0,1,1,0,1,1
08716444,3,1,2,0,2,1,1,0,0
08716501,2,0,2,0,0,0,0,0,1
08716571,2,1,1,0,2,1,1,1,0
08716686,7,3,4,0,3,2,1,0,1
08717705,3,3,0,0,1,1,0,0,0
08717879,4,3,1,0,0,0,0,0,1
08717981,2,2,0,0,1,1,0,0,0
08718002,4,0,4,0,0,0,0,0,1
08719412,3,2,1,0,1,1,0,1,1
08719529,6,0,6,0,0,0,0,0,1
08719563,7,3,4,0,3,3,0,1,1
08719700,1,0,1,0,1,1,0,0,0
08719717,3,3,0,0,2,2,0,0,0
08720654,6,0,6,0,0,0,0,0,1
08720781,1,1,0,0,1,1,0,0,0
08721484,2,2,0,0,1,1,0,0,0
08721508,2,2,0,0,2,2,0,0,0
08721621,11,7,4,0,2,2,0,0,1
08722012,1,0,1,0,0,0,0,0,1
08722187,3,2,1,0,2,2,0,0,0
08722294,11,3,8,0,1,1,0,1,1
08722858,1,1,0,0,1,1,0,0,0
08723278,10,8,2,0,0,0,0,0,0
08723476,7,3,4,0,1,1,0,1,1
08723530,3,0,3,0,0,0,0,0,1
08723534,8,5,3,0,0,0,0,0,0
08723860,6,4,2,0,0,0,0,0,0
08723875,1,1,0,0,1,1,0,0,0
08724181,4,3,1,0,2,2,0,2,0
08724301,2,1,1,0,1,1,0,0,0
08724834,3,3,0,0,1,1,0,0,0
08724854,5,3,2,0,3,3,0,1,0
08725477,2,2,0,0,1,1,0,0,0
08725553,2,2,0,0,2,2,0,0,1
08727098,7,3,4,0,1,1,0,1,1
08728074,3,0,3,0,0,0,0,0,1
08728191,5,1,4,0,4,1,3,0,0
08728895,9,7,2,0,0,0,0,0,0
08729214,13,6,7,0,1,1,0,1,0
08729267,14,8,6,0,1,1,0,1,1
08729334,6,4,2,0,1,1,0,1,1
08729562,2,0,2,0,1,1,0,0,1
08729761,10,2,8,0,1,1,0,0,1
08729900,4,0,4,0,1,1,0,0,0
08730339,3,3,0,0,1,1,0,1,1
08731048,6,1,5,0,4,1,3,0,0
08731079,3,0,3,0,1,1,0,0,0
08731237,1,1,0,0,1,1,0,0,0
08731813,1,1,0,0,1,1,0,0,0
08732038,8,3,5,2,3,2,1,2,0
08732579,1,1,0,0,1,1,0,0,0
08732736,2,1,1,0,2,1,1,1,0
08732916,3,2,1,0,2,2,0,0,0
08733487,3,0,3,0,2,2,0,0,1
08733692,6,3,3,0,1,1,0,1,1
08733836,14,8,6,0,3,1,2,3,1
08733918,12,7,5,0,1,1,0,1,1
08733920,12,7,5,0,1,1,0,1,1
08734034,1,0,1,0,0,0,0,0,0
08734096,9,6,3,0,1,1,0,1,1
08734933,2,1,1,0,1,1,0,0,0
08735211,18,7,11,0,4,1,3,0,1
08735320,7,3,4,0,2,0,2,0,1
08735437,5,0,5,0,0,0,0,0,1
08735568,1,1,0,0,1,1,0,0,0
08735589,2,2,0,0,2,2,0,0,0
08735830,2,0,2,0,1,1,0,0,1
08736168,1,0,1,0,0,0,0,0,0
08736418,2,1,1,0,2,1,1,0,0
08736454,2,1,1,0,2,1,1,0,0
08736485,5,4,1,0,1,1,0,0,0
08736583,9,6,3,0,2,0,2,0,1
08736617,6,2,4,0,1,1,0,0,0
08736622,1,0,1,0,0,0,0,0,1
08736857,5,2,3,0,1,0,1,0,0
08737177,2,1,1,0,2,1,1,0,1
08737354,3,3,0,0,1,1,0,0,0
08737412,20,9,11,0,1,1,0,1,1
08737618,3,2,1,0,2,2,0,0,1
08737966,3,3,0,0,2,1,1,0,1
08738180,1,0,1,0,0,0,0,0,0
08738304,3,0,3,1,0,0,0,0,0
08738521,4,0,4,0,1,1,0,0,0
08738852,8,7,1,0,0,0,0,0,1
08739049,2,0,2,0,1,1,0,0,1
08740015,2,2,0,0,2,2,0,0,0
08740219,2,1,1,0,1,1,0,0,0
08740397,29,9,20,0,2,2,0,2,1
08740682,1,0,1,0,0,0,0,0,1
08741604,1,0,1,0,0,0,0,0,1
08741629,5,2,3,0,1,1,0,1,1
08741661,9,2,7,0,1,1,0,1,1
08741699,3,0,3,0,0,0,0,0,1
08741710,4,0,4,0,1,0,1,0,1
08741793,5,0,5,0,0,0,0,0,1
08742193,2,2,0,0,1,1,0,0,0
08742592,1,0,1,0,0,0,0,0,0
08742645,3,3,0,0,1,1,0,1,1
08742780,10,3,7,0,1,1,0,1,1
08742945,2,2,0,0,2,2,0,0,1
08743407,8,6,2,0,6,6,0,0,0
08743417,7,0,7,0,0,0,0,0,1
08743493,9,6,3,0,1,1,0,1,1
08743518,9,6,3,0,1,1,0,1,1
08744066,9,6,3,0,1,1,0,1,1
04768146,7,0,7,0,0,0,0,0,1
04768253,15,0,15,0,0,0,0,0,1
04768495,45,13,32,0,0,0,0,0,1
04768755,24,6,18,0,0,0,0,0,1
04768767,5,0,5,0,2,2,0,0,1
04768800,17,5,12,0,1,1,0,1,1
04768804,14,0,14,0,0,0,0,0,1
04768822,14,2,12,0,1,1,0,1,1
04768918,7,2,5,0,1,1,0,0,1
04768921,30,8,22,0,1,1,0,1,1
04768974,8,0,8,0,0,0,0,0,1
04769220,40,5,35,0,0,0,0,0,1
04769772,38,0,38,0,0,0,0,0,1
04769905,4,2,2,0,1,1,0,0,1
04770256,27,0,27,0,0,0,0,0,1
04770497,4,0,4,0,0,0,0,0,0
04770945,38,8,30,0,0,0,0,0,1
04771018,5,0,5,0,0,0,0,0,1
04771281,19,0,19,0,0,0,0,0,1
04771859,4,3,1,0,1,1,0,0,1
04772116,7,2,5,0,4,1,3,1,0
04772363,6,4,2,0,3,3,0,0,0
04772453,4,3,1,0,1,1,0,0,0
04772547,26,3,23,0,1,1,0,1,1
04773023,10,2,8,0,0,0,0,0,1
04773031,14,5,9,0,0,0,0,0,1
04773061,17,4,13,0,2,1,1,0,0
04773127,12,5,7,0,1,1,0,1,1
04773131,18,3,15,0,1,1,0,1,1
04773192,7,0,7,0,2,2,0,0,1
04773695,44,7,37,0,1,1,0,1,1
04773848,7,3,4,0,2,2,0,0,0
04773856,4,0,4,0,1,1,0,0,1
04774277,24,6,18,0,1,1,0,0,1
04774601,26,8,18,0,0,0,0,0,1
04774825,3,3,0,0,2,2,0,0,0
04774947,5,0,5,0,0,0,0,0,1
04775835,17,5,12,0,0,0,0,0,1
04777182,5,1,4,0,1,1,0,0,0
04777565,7,3,4,0,0,0,0,0,0
04777649,12,4,8,0,1,1,0,0,0
04778043,3,2,1,0,1,1,0,0,1
04778206,13,6,7,0,0,0,0,0,1
04778508,15,0,15,0,0,0,0,0,0
04778512,25,0,25,0,0,0,0,0,1
04778599,21,5,16,0,1,1,0,0,1
04778645,13,4,9,0,0,0,0,0,1
04778776,4,2,2,0,3,2,1,0,0
04778901,4,2,2,0,0,0,0,0,0
04779288,28,6,22,0,1,1,0,1,1
04779376,7,3,4,0,2,2,0,0,1
04779433,24,4,20,0,0,0,0,0,0
04779763,9,2,7,0,2,1,1,0,1
04779767,13,3,10,0,1,1,0,1,1
04779872,30,0,30,0,0,0,0,0,1
04779891,5,2,3,0,1,1,0,0,1
04779960,11,4,7,0,1,1,0,1,1
04780514,17,0,17,0,0,0,0,0,1
04780713,18,0,18,0,0,0,0,0,0
04780788,16,7,9,0,2,2,0,1,1
04780948,6,4,2,0,1,1,0,0,0
04781126,5,3,2,0,2,2,0,0,0
04781264,8,0,8,0,0,0,0,0,1
04781346,4,2,2,0,1,1,0,0,1
04781697,3,0,3,0,0,0,0,0,1
04781705,3,0,3,0,0,0,0,0,1
04781727,22,0,22,0,1,1,0,1,1
04781745,25,2,23,0,2,1,1,2,1
04781921,30,5,25,0,1,1,0,0,0
04782008,15,3,12,0,0,0,0,0,1
04782079,4,0,4,0,2,2,0,0,1
04782333,15,1,14,0,0,0,0,0,1
04782680,29,7,22,0,0,0,0,0,0
04782684,5,3,2,0,2,2,0,0,0
04783263,22,2,20,0,1,1,0,1,1
04783303,4,2,2,0,1,1,0,0,1
04783484,5,3,2,0,2,2,0,0,0
04783873,9,5,4,0,0,0,0,0,0
04784128,26,3,23,0,1,1,0,1,1
04784136,26,3,23,0,1,1,0,1,1
04784399,5,3,2,0,2,2,0,0,0
04784471,5,2,3,0,1,1,0,0,1
04784500,15,3,12,0,1,1,0,0,1
04784781,6,4,2,0,2,2,0,0,1
04784895,13,2,11,0,2,1,1,1,0
04784905,7,0,7,0,2,2,0,0,0
04785037,4,2,2,0,1,1,0,0,0
04785053,8,1,7,0,0,0,0,0,0
04785238,7,0,7,0,0,0,0,0,1
04785670,12,3,9,0,1,1,0,1,1
04785712,52,16,36,0,0,0,0,0,1
04785828,17,2,15,0,1,1,0,1,1
04786133,2,0,2,0,0,0,0,0,0
04786973,56,14,42,0,0,0,0,0,1
04787006,16,2,14,0,1,1,0,1,1
04787029,13,0,13,0,0,0,0,0,1
04787097,50,16,34,0,0,0,0,0,1
04787104,22,0,22,0,1,1,0,1,1
04787107,18,4,14,0,1,1,0,1,1
04787139,10,3,7,0,1,1,0,0,1
04787172,25,7,18,0,1,1,0,1,1
04787262,11,2,9,0,1,1,0,1,1
04787558,26,0,26,0,0,0,0,0,1
04787574,6,3,3,0,1,1,0,1,0
04787576,4,2,2,0,2,2,0,0,0
04787589,19,5,14,0,1,1,0,1,0
04787594,24,5,19,0,1,1,0,1,0
04787639,58,13,45,0,0,0,0,0,1
04788113,5,2,3,0,1,1,0,0,1
04788277,4,2,2,0,3,3,0,0,0
04788426,21,6,15,0,0,0,0,0,1
04788507,5,2,3,0,2,2,0,0,0
04788746,21,7,14,0,0,0,0,0,1
04789236,8,0,8,0,0,0,0,0,1
04789569,32,6,26,0,0,0,0,0,1
04789582,5,3,2,0,1,1,0,0,1
04789632,36,1,35,0,2,2,0,1,1
04789656,3,3,0,0,1,1,0,0,1
04790236,19,0,19,0,0,0,0,0,1
04790426,17,7,10,0,1,1,0,1,1
04790769,4,0,4,0,0,0,0,0,1
04791136,29,11,18,0,3,2,1,0,1
04791212,29,24,5,0,1,0,1,0,1
04791283,24,4,20,0,0,0,0,0,1
04791302,17,4,13,0,1,1,0,0,1
04791393,5,3,2,0,0,0,0,0,0
04791438,3,2,1,0,0,0,0,0,0
04791445,5,3,2,0,2,2,0,0,0
04791889,5,2,3,0,1,1,0,0,0
04792098,23,5,18,0,1,1,0,1,0
04792101,23,5,18,0,1,1,0,1,0
04792413,4,1,3,0,1,1,0,0,0
04792523,9,3,6,0,3,3,0,0,1
04793085,54,0,54,0,0,0,0,0,1
04793167,17,7,10,0,1,1,0,1,1
04793510,12,1,11,0,2,1,1,2,0
04793696,10,5,5,0,1,1,0,1,1
04793729,20,3,17,1,1,1,0,1,1
04793815,32,6,26,0,2,2,0,2,1
04793921,12,0,12,0,0,0,0,0,1
04794094,20,3,17,0,1,1,0,1,1
04794099,15,3,12,0,1,1,0,1,1
04794165,15,2,13,0,1,1,0,0,1
04794530,7,3,4,0,1,1,0,0,0
04794682,17,5,12,1,0,0,0,0,0
04794744,19,2,17,0,2,1,1,0,1
04794805,5,3,2,0,3,3,0,0,0
04794957,11,0,11,0,0,0,0,0,1
04795026,4,2,2,0,1,1,0,0,0
04795028,4,1,3,0,1,1,0,0,1
04795154,17,4,13,0,1,1,0,1,0
04795357,11,8,3,0,0,0,0,0,0
04795377,3,2,1,0,1,1,0,0,0
04795474,7,3,4,0,1,1,0,0,1
04795756,36,0,36,0,1,1,0,1,1
04795760,10,3,7,0,0,0,0,0,1
04796012,5,3,2,0,1,1,0,0,1
04796268,44,5,39,0,1,1,0,1,1
04796282,45,5,40,0,1,1,0,1,1
04796603,14,3,11,0,0,0,0,0,1
04797154,5,3,2,0,1,1,0,0,1
04797158,11,2,9,0,0,0,0,0,0
04797230,4,2,2,0,1,1,0,0,1
04797277,11,0,11,0,1,1,0,1,1
04797346,20,5,15,0,1,1,0,1,1
04797936,7,2,5,0,1,1,0,0,1
04797993,12,3,9,0,1,1,0,0,1
04798250,5,0,5,0,0,0,0,0,1
04798383,23,6,17,0,0,0,0,0,1
04798389,12,3,9,0,0,0,0,0,0
04798513,6,0,6,0,1,1,0,1,1
04799067,8,2,6,0,1,1,0,1,0
04799099,10,4,6,0,0,0,0,0,0
04799242,6,2,4,0,1,1,0,0,0
04800251,5,2,3,0,1,1,0,0,0
04800349,5,2,3,0,1,1,0,0,0
04800489,26,7,19,0,0,0,0,0,1
04800773,4,2,2,0,2,2,0,0,1
04800794,4,2,2,0,1,1,0,0,1
04801204,10,2,8,1,1,1,0,0,1
04801432,25,4,21,0,3,1,2,1,1
04801730,12,4,8,0,0,0,0,0,1
04801859,4,2,2,0,1,1,0,0,0
04801879,6,4,2,0,3,3,0,0,1
04802025,4,2,2,0,1,1,0,0,0
04802321,0,0,0,0,0,0,0,0,1
04802737,31,8,23,0,0,0,0,0,1
04802888,5,0,5,0,0,0,0,0,1
04802912,4,2,2,0,1,1,0,0,0
04802918,2,2,0,0,1,1,0,0,0
04802988,9,5,4,0,1,1,0,1,1
04803221,6,2,4,0,1,1,0,1,1
04803976,5,3,2,0,1,1,0,0,1
04804114,3,2,1,0,2,2,0,2,1
04804443,8,2,6,0,1,1,0,0,0
04804475,5,5,0,0,3,1,2,1,0
04804648,5,5,0,0,3,1,2,1,0
04804835,19,6,13,0,1,1,0,0,0
04804945,14,2,12,0,2,2,0,0,1
04804948,4,0,4,0,0,0,0,0,1
04804966,28,6,22,0,0,0,0,0,1
04804985,11,0,11,0,0,0,0,0,1
04805105,8,1,7,0,3,1,2,0,1
04805373,20,8,12,0,1,1,0,1,1
04805440,8,0,8,0,1,1,0,1,1
04805444,22,6,16,0,0,0,0,0,1
04805445,13,3,10,0,1,1,0,1,1
04805781,20,3,17,1,1,1,0,1,1
04806012,10,3,7,0,1,1,0,0,1
04806128,44,15,29,0,1,1,0,1,1
04806230,5,0,5,0,0,0,0,0,1
04806322,5,3,2,0,2,2,0,0,0
04806503,29,8,21,0,1,1,0,1,1
04806841,33,5,28,0,1,1,0,1,1
04806891,9,0,9,0,0,0,0,0,1
04807064,32,7,25,0,0,0,0,0,0
04807286,4,0,4,0,0,0,0,0,1
04807288,11,5,6,0,0,0,0,0,1
04807610,7,3,4,0,2,2,0,0,1
04807756,17,4,13,0,1,1,0,1,1
04807904,30,5,25,0,1,1,0,1,1
04807951,21,4,17,0,2,1,1,2,1
04808121,40,17,23,0,0,0,0,0,1
04808151,5,3,2,0,2,2,0,0,0
04808208,10,4,6,0,1,1,0,1,1
04808335,5,0,5,0,0,0,0,0,1
04808420,8,2,6,0,1,1,0,0,1
04808580,5,3,2,0,2,2,0,0,0
04808835,10,2,8,0,1,1,0,0,1
04808853,7,0,7,0,0,0,0,0,1
04808994,6,0,6,0,1,1,0,1,1
04809107,21,0,21,0,0,0,0,0,1
04809335,11,2,9,0,1,1,0,1,1
04810436,25,5,20,0,5,5,0,0,0
04810832,4,0,4,0,0,0,0,0,1
04810835,5,0,5,0,0,0,0,0,1
04810893,6,1,5,0,1,1,0,0,0
04811118,8,0,8,0,0,0,0,0,1
04811451,4,1,3,0,1,1,0,0,0
04811789,16,6,10,0,0,0,0,0,0
04811967,20,0,20,0,0,0,0,0,1
04812204,21,7,14,0,0,0,0,0,0
04812208,6,3,3,0,1,1,0,1,0
04812240,4,2,2,0,1,1,0,0,0
04812278,7,3,4,0,0,0,0,0,1
04812575,4,3,1,0,1,1,0,0,1
04813101,27,2,25,0,1,1,0,1,1
04813141,14,7,7,0,0,0,0,0,1
04813599,28,6,22,0,3,1,2,2,1
04813638,40,6,34,0,0,0,0,0,1
04813750,18,3,15,0,1,1,0,1,1
04814024,3,2,1,0,1,1,0,1,0
04814072,2,1,1,0,2,2,0,0,0
04814086,4,0,4,0,0,0,0,0,0
04814350,42,9,33,0,1,1,0,1,1
04815067,4,2,2,0,2,2,0,0,1
04815181,43,14,29,0,0,0,0,0,0
04815365,6,3,3,0,2,1,1,0,0
04815525,6,2,4,0,0,0,0,0,0
04815526,11,3,8,0,1,1,0,0,0
04815885,31,6,25,0,0,0,0,0,0
04815973,81,18,63,0,0,0,0,0,1
04580590,7,2,5,0,2,2,0,0,0
04580593,6,3,3,0,2,2,0,0,1
04581054,5,0,5,0,0,0,0,0,0
04581366,5,1,4,0,1,1,0,0,0
04581379,12,4,8,0,3,2,1,0,1
04582142,3,0,3,0,1,1,0,0,0
04582381,15,7,8,0,1,1,0,0,1
04582419,36,8,28,0,1,1,0,0,0
04582496,14,4,10,0,0,0,0,0,1
04582777,59,8,51,0,0,0,0,0,0
04582826,4,0,4,0,0,0,0,0,1
04583030,17,0,17,0,0,0,0,0,1
04583139,18,0,18,0,1,1,0,1,1
04583297,13,3,10,0,1,1,0,1,1
04583581,4,2,2,0,2,2,0,0,1
04583645,68,17,51,0,0,0,0,0,0
04583851,17,0,17,0,0,0,0,0,1
04583942,8,2,6,0,3,3,0,0,0
04583966,29,0,29,0,0,0,0,0,1
04584018,3,2,1,0,1,1,0,0,1
04584196,18,0,18,0,0,0,0,0,1
04584362,7,0,7,0,0,0,0,0,0
04584575,6,3,3,0,2,2,0,0,1
04585094,5,3,2,0,2,2,0,0,0
04585133,10,3,7,0,0,0,0,0,1
04585210,14,0,14,0,1,1,0,1,1
04585620,9,2,7,0,2,1,1,0,0
04585632,16,4,12,0,1,1,0,0,1
04585663,3,1,2,0,1,1,0,0,0
04585892,17,0,17,0,4,4,0,4,1
04586150,12,3,9,0,2,1,1,1,1
04586182,13,2,11,0,2,2,0,0,1
04586430,4,3,1,0,2,2,0,0,0
04586432,4,3,1,0,1,1,0,0,0
04586444,4,2,2,0,2,2,0,0,1
04586484,10,0,10,0,0,0,0,0,0
04586515,43,2,41,0,1,1,0,1,1
04586538,4,2,2,0,2,2,0,0,0
04586800,6,2,4,0,0,0,0,0,1
04586941,34,11,23,0,0,0,0,0,1
04587118,5,2,3,0,2,2,0,0,1
04587220,25,9,16,0,0,0,0,0,1
04587563,10,0,10,0,0,0,0,0,1
04587831,7,6,1,0,3,1,2,1,0
04588047,5,2,3,0,2,2,0,0,1
04588183,29,9,20,0,1,1,0,0,1
04588433,8,2,6,0,1,1,0,0,1
04588465,9,4,5,0,1,1,0,0,0
04588640,16,0,16,0,0,0,0,0,1
04588758,7,0,7,0,0,0,0,0,1
04588810,2,0,2,0,2,2,0,0,1
04589036,5,3,2,0,2,2,0,0,1
04589046,5,3,2,0,2,2,0,0,1
04589075,5,2,3,0,2,2,0,0,1
04589122,4,3,1,0,2,2,0,0,0
04589294,4,2,2,0,2,1,1,0,1
04589315,13,4,9,0,2,1,1,1,1
04589451,19,6,13,0,0,0,0,0,1
04589874,8,3,5,0,1,1,0,0,1
04590040,7,2,5,0,1,1,0,1,1
04590255,5,3,2,0,1,1,0,0,0
04590344,5,3,2,0,1,1,0,0,0
04590889,9,0,9,0,0,0,0,0,1
04591053,9,5,4,0,3,3,0,1,1
04591066,11,2,9,0,1,1,0,1,1
04591268,6,3,3,0,1,1,0,0,0
04591518,10,0,10,0,0,0,0,0,1
04591994,5,3,2,0,2,2,0,0,0
04592923,4,2,2,0,1,1,0,0,1
04593131,5,0,5,0,1,1,0,0,0
04593332,8,2,6,0,2,1,1,0,0
04593379,12,0,12,0,0,0,0,0,0
04593407,27,5,22,0,0,0,0,0,1
04593467,15,4,11,0,3,3,0,0,1
04593529,8,2,6,0,1,1,0,0,0
04594179,52,7,45,0,0,0,0,0,1
04594311,5,3,2,0,1,1,0,0,0
04594332,5,0,5,0,0,0,0,0,1
04594480,8,1,7,0,1,1,0,0,0
04594550,6,2,4,0,1,1,0,0,0
04594558,48,5,43,0,2,1,1,2,1
04594640,5,2,3,0,1,1,0,0,0
04594654,2,2,0,0,1,1,0,0,1
04594670,14,6,8,0,1,0,1,1,1
04594876,3,2,1,0,1,1,0,0,0
04594990,4,2,2,0,1,1,0,0,1
04595426,8,3,5,0,1,1,0,1,1
04595789,5,2,3,0,1,1,0,0,1
04595825,12,3,9,0,2,2,0,0,1
04595950,11,5,6,0,1,1,0,1,1
04595977,11,0,11,0,1,1,0,1,1
04596016,5,3,2,0,2,2,0,0,1
04596021,5,3,2,0,2,2,0,0,1
04596133,5,1,4,0,1,1,0,0,0
04596483,21,4,17,0,0,0,0,0,0
04596678,7,0,7,0,1,1,0,1,1
04597026,8,3,5,0,1,1,0,1,1
04597193,7,2,5,0,1,1,0,0,1
04597195,10,2,8,0,1,1,0,0,1
04597236,9,3,6,0,4,1,3,1,0
04597315,17,8,9,0,0,0,0,0,1
04597339,13,5,8,0,2,1,1,1,1
04597359,12,0,12,0,0,0,0,0,1
04597369,12,2,10,0,1,1,0,1,1
04597373,12,0,12,0,0,0,0,0,1
04597382,13,5,8,0,1,1,0,1,1
04597583,7,6,1,0,2,2,0,1,0
04597788,5,3,2,0,2,2,0,0,0
04597829,13,6,7,0,1,0,1,1,1
04598033,5,0,5,0,0,0,0,0,1
04598044,5,0,5,0,0,0,0,0,1
04598321,22,5,17,1,0,0,0,0,1
04598465,7,2,5,0,1,1,0,0,1
04598476,7,3,4,0,3,3,0,1,0
04598550,8,2,6,0,2,1,1,0,0
04598802,18,2,16,0,1,1,0,1,1
04598955,16,3,13,0,2,1,1,2,1
04599319,5,4,1,0,2,2,0,0,0
04599525,20,3,17,0,2,1,1,2,1
04599696,11,2,9,0,0,0,0,0,1
04599763,6,4,2,0,1,1,0,0,0
04599784,12,4,8,0,1,1,0,1,1
04599914,4,2,2,0,1,1,0,0,1
04600514,79,13,66,0,0,0,0,0,1
04600525,20,7,13,0,0,0,0,0,1
04601394,16,3,13,0,1,1,0,1,1
04601497,11,0,11,0,0,0,0,0,1
04601560,22,6,16,0,1,1,0,0,1
04601572,14,3,11,0,3,1,2,3,1
04601591,5,1,4,0,0,0,0,0,0
04601936,6,3,3,0,2,1,1,0,0
04602111,22,5,17,0,0,0,0,0,1
04602184,21,5,16,0,0,0,0,0,0
04602656,8,0,8,0,0,0,0,0,1
04602865,9,2,7,0,1,1,0,0,1
04603060,5,2,3,0,1,1,0,0,1
04603099,21,6,15,0,2,1,1,2,1
04603307,8,0,8,0,0,0,0,0,1
04603355,9,4,5,0,1,1,0,0,1
04603381,21,0,21,0,0,0,0,0,1
04603568,18,0,18,0,0,0,0,0,0
04603613,16,5,11,0,1,1,0,1,1
04604385,15,6,9,0,0,0,0,0,1
04604522,3,2,1,0,1,1,0,0,0
04604605,3,0,3,0,0,0,0,0,1
04604670,9,3,6,0,1,1,0,1,1
04604702,7,0,7,0,0,0,0,0,1
04604778,18,4,14,0,1,1,0,1,1
04604866,25,3,22,0,0,0,0,0,1
04604984,5,2,3,0,2,2,0,0,1
04605025,11,1,10,0,0,0,0,0,1
04605042,11,1,10,0,0,0,0,0,1
04605410,5,3,2,0,2,2,0,0,0
04605535,6,2,4,0,1,1,0,0,0
04605704,5,2,3,0,1,1,0,0,0
04606229,23,5,18,0,1,1,0,1,1
04606615,30,3,27,0,1,1,0,1,1
04606967,6,0,6,0,0,0,0,0,0
04607141,26,4,22,0,1,1,0,1,1
04607292,15,5,10,0,0,0,0,0,1
04607884,7,3,4,0,1,1,0,0,1
04608134,24,7,17,0,1,1,0,1,1
04608290,6,3,3,0,1,1,0,0,1
04608410,4,2,2,0,1,1,0,0,0
04608483,10,3,7,0,3,3,0,0,1
04608905,29,6,23,0,1,1,0,1,1
04609024,10,3,7,0,2,2,0,0,1
04609066,7,0,7,1,0,0,0,0,1
04609232,6,0,6,0,0,0,0,0,1
04609277,8,0,8,0,0,0,0,0,1
04609579,43,9,34,0,0,0,0,0,1
04609584,5,3,2,0,2,2,0,0,0
04610062,5,3,2,0,2,2,0,0,0
04610249,7,4,3,0,1,1,0,0,1
04610510,17,2,15,0,1,1,0,1,1
04610618,16,2,14,0,1,1,0,1,0
04610636,6,2,4,0,1,1,0,0,1
04610679,10,1,9,0,1,1,0,0,1
04610776,18,0,18,0,1,1,0,1,1
04611149,31,6,25,0,2,2,0,2,1
04611251,10,3,7,0,1,1,0,1,1
04611401,12,0,12,0,0,0,0,0,1
04611513,9,0,9,0,1,1,0,0,1
04611579,26,10,16,0,1,1,0,0,1
04611706,6,0,6,0,1,1,0,0,0
04611757,20,0,20,0,0,0,0,0,1
04611781,11,0,11,0,0,0,0,0,1
04611845,13,6,7,0,0,0,0,0,1
04612074,4,4,0,0,2,2,0,0,0
04612136,11,0,11,0,0,0,0,0,1
04612141,37,10,27,0,0,0,0,0,1
04612199,9,0,9,0,0,0,0,0,1
04612307,15,0,15,0,0,0,0,0,1
04612311,4,0,4,0,0,0,0,0,0
04612474,6,3,3,0,2,2,0,0,1
04612568,13,0,13,0,0,0,0,0,1
04612691,9,0,9,0,0,0,0,0,0
04612701,7,3,4,0,2,1,1,0,1
04613034,5,1,4,0,1,1,0,0,1
04613075,15,2,13,0,1,1,0,1,1
04613458,5,1,4,0,1,1,0,0,1
04613510,36,7,29,0,0,0,0,0,1
04613573,19,0,19,0,0,0,0,0,1
04613623,11,0,11,0,0,0,0,0,1
04613951,20,3,17,0,0,0,0,0,1
04613979,39,8,31,0,2,1,1,0,1
04614200,6,3,3,0,1,1,0,0,1
04614285,27,8,19,0,1,1,0,1,1
04614291,8,1,7,0,2,1,1,0,0
04614307,13,0,13,0,0,0,0,0,1
04614767,18,0,18,0,1,1,0,1,1
04614816,28,4,24,0,4,3,1,1,1
04614851,4,2,2,0,1,1,0,0,1
04615376,11,5,6,0,1,1,0,1,1
04615819,10,3,7,0,1,1,0,1,1
04615904,14,6,8,0,0,0,0,0,1
04615993,19,4,15,0,2,2,0,0,1
04616045,4,2,2,0,1,1,0,0,0
04616498,11,0,11,0,0,0,0,0,1
04616526,19,8,11,0,0,0,0,0,1
04616702,5,3,2,0,2,2,0,0,0
04616709,48,12,36,0,0,0,0,0,0
04616755,8,3,5,0,1,1,0,0,0
04617006,18,4,14,0,1,1,0,1,1
04617169,9,3,6,0,1,1,0,0,0
04617267,5,3,2,0,0,0,0,0,1
04617384,14,0,14,0,0,0,0,0,1
04617453,11,2,9,0,1,1,0,1,1
04617481,21,5,16,0,0,0,0,0,0
04617696,4,1,3,0,1,1,0,0,0
04618219,4,2,2,0,2,2,0,2,1
04618485,12,4,8,0,0,0,0,0,1
04618487,59,0,59,0,2,1,1,2,1
04618530,8,2,6,0,2,2,0,0,0
04618589,6,1,5,0,1,1,0,0,0
04618606,34,4,30,0,0,0,0,0,1
04618780,6,0,6,0,1,1,0,0,0
04619120,6,0,6,0,0,0,0,0,0
04619148,5,0,5,0,0,0,0,0,1
04619361,17,0,17,0,0,0,0,0,1
04619793,30,11,19,0,0,0,0,0,0
04619849,15,3,12,0,2,1,1,0,1
04619884,5,2,3,1,0,0,0,0,1
04620161,6,0,6,0,0,0,0,0,1
04620404,8,4,4,0,3,3,0,0,1
04620422,8,3,5,0,1,1,0,0,0
04620732,7,0,7,0,1,0,1,1,0
04620872,6,3,3,0,3,2,1,0,0
04620880,27,13,14,0,1,1,0,1,1
04620973,34,3,31,0,1,1,0,1,1
04621135,18,6,12,0,4,1,3,1,1
04621401,9,1,8,0,0,0,0,0,0
04621805,4,0,4,0,0,0,0,0,1
04621850,5,2,3,0,1,1,0,0,1
04621869,13,2,11,0,1,1,0,1,1
04621916,18,8,10,0,1,1,0,0,0
08130158,38,15,23,0,0,0,0,0,1
08130286,2,2,0,0,2,2,0,0,0
08130397,10,7,3,0,1,1,0,0,0
08130468,31,12,19,0,5,1,4,1,0
08130713,13,7,6,0,0,0,0,0,0
08130916,2,1,1,0,1,1,0,0,0
08130964,2,0,2,0,0,0,0,0,1
08131129,3,3,0,0,1,1,0,0,0
08131191,7,3,4,0,1,1,0,0,1
08131526,3,2,1,0,3,2,1,0,1
08131727,1,1,0,0,1,1,0,0,0
08131881,1,1,0,0,1,1,0,0,0
08131942,3,3,0,0,2,2,0,0,0
08132021,2,0,2,0,2,2,0,0,0
08132276,12,4,8,0,1,1,0,1,1
08132572,8,4,4,0,1,1,0,1,1
08132673,1,0,1,0,1,1,0,0,1
08133075,1,1,0,0,1,1,0,0,0
08133692,9,4,5,0,0,0,0,0,1
08133694,8,4,4,0,1,1,0,1,1
08133703,34,12,22,0,10,3,7,0,1
08133708,2,0,2,0,1,1,0,0,1
08133716,6,0,6,0,2,1,1,0,1
08133729,8,5,3,0,0,0,0,0,1
08133831,5,4,1,0,2,2,0,0,0
08134594,2,0,2,0,0,0,0,0,1
08134798,10,3,7,0,1,1,0,1,1
08134897,2,1,1,0,0,0,0,0,0
08134971,20,7,13,0,1,0,1,0,1
08135114,2,2,0,0,3,3,0,0,0
08135274,2,2,0,0,1,1,0,0,0
08135420,2,2,0,0,1,1,0,0,0
08135501,5,3,2,0,1,1,0,0,0
08135830,6,5,1,0,2,2,0,0,1
08135868,32,14,18,0,1,1,0,0,1
08135988,15,7,8,0,2,1,1,2,1
08136022,1,1,0,0,1,1,0,0,0
08136025,4,2,2,0,2,2,0,0,0
08136088,3,2,1,0,2,1,1,0,0
08136122,10,3,7,0,2,1,1,2,1
08136632,2,0,2,0,0,0,0,0,1
08136682,1,0,1,0,1,1,0,0,0
08136750,3,0,3,0,0,0,0,0,1
08137088,8,5,3,0,0,0,0,0,0
08137161,1,0,1,0,1,1,0,0,1
08137200,8,7,1,2,3,1,2,1,0
08137440,8,4,4,0,1,1,0,1,1
08137505,3,2,1,0,3,2,1,0,0
08137563,3,2,1,0,0,0,0,0,1
08137706,1,0,1,0,0,0,0,0,1
08137960,1,1,0,0,1,1,0,0,0
08138345,4,4,0,0,0,0,0,0,0
08138672,6,6,0,0,0,0,0,0,1
08139012,16,6,10,0,0,0,0,0,1
08139121,3,3,0,0,0,0,0,0,1
08139363,9,0,9,0,0,0,0,0,1
08139375,14,7,7,0,2,2,0,2,1
08139411,6,4,2,0,1,1,0,0,0
08139590,10,2,8,0,0,0,0,0,1
08139668,5,3,2,0,2,2,0,0,1
08139782,2,2,0,0,1,1,0,0,1
08139821,8,0,8,0,0,0,0,0,1
08139956,3,3,0,0,3,3,0,0,0
08140064,7,7,0,0,0,0,0,0,0
08140332,2,2,0,0,2,2,0,0,1
08140381,1,1,0,0,1,1,0,0,0
08140747,29,9,20,0,8,3,5,0,0
08141116,4,0,4,0,1,1,0,0,0
08142572,25,8,17,0,0,0,0,0,0
08142578,4,3,1,0,2,2,0,0,0
08142832,20,8,12,0,2,1,1,0,1
08143113,2,2,0,0,3,3,0,0,0
08143964,5,3,2,0,2,2,0,0,1
08144132,6,3,3,0,2,2,0,0,1
08144271,29,0,29,0,1,1,0,0,0
08144408,3,2,1,0,1,1,0,0,0
08144486,1,1,0,0,1,1,0,1,1
08144492,1,0,1,0,0,0,0,0,0
08144558,8,7,1,0,2,1,1,2,1
08144725,5,1,4,0,0,0,0,0,0
08144743,21,10,11,0,0,0,0,0,1
08144797,3,0,3,0,1,1,0,0,0
08144871,8,4,4,0,1,1,0,1,1
08144906,8,3,5,0,0,0,0,0,1
08145589,2,0,2,0,2,1,1,0,0
08145797,2,2,0,0,2,2,0,0,0
08145807,4,0,4,0,0,0,0,0,1
08145852,9,4,5,0,1,1,0,0,0
08146018,2,2,0,0,1,1,0,0,0
08146223,3,3,0,0,0,0,0,0,1
08146349,17,5,12,0,1,1,0,1,1
08146532,3,3,0,0,0,0,0,0,1
08146548,3,3,0,0,2,2,0,0,1
08146661,28,16,12,0,0,0,0,0,1
08147205,2,0,2,0,0,0,0,0,1
08147651,6,0,6,0,2,2,0,2,1
08147697,3,1,2,0,1,1,0,0,0
08147954,5,4,1,0,4,4,0,1,0
08148188,2,1,1,0,3,1,2,0,0
08148504,5,4,1,0,1,1,0,1,1
08148663,16,7,9,0,0,0,0,0,1
08148932,10,8,2,0,1,1,0,1,1
08148983,1,0,1,0,0,0,0,0,0
08149175,3,3,0,0,0,0,0,0,0
08149277,3,2,1,0,1,1,0,0,1
08149439,14,4,10,0,1,1,0,1,1
08149440,14,4,10,0,1,1,0,1,1
08149867,1,0,1,0,0,0,0,0,0
08150106,36,9,27,0,0,0,0,0,0
08150137,3,3,0,0,2,2,0,0,1
08150702,1,1,0,0,1,1,0,0,0
08150786,12,3,9,0,1,1,0,1,1
08150876,8,2,6,0,2,2,0,0,1
08150883,3,0,3,0,0,0,0,0,1
08151041,20,17,3,0,1,1,0,0,1
08151176,2,2,0,0,1,1,0,0,0
08151209,17,8,9,0,0,0,0,0,0
08151389,2,2,0,0,1,1,0,0,0
08151616,1,0,1,0,0,0,0,0,0
08151832,2,0,2,0,0,0,0,0,1
08151905,5,4,1,0,1,1,0,1,1
08152053,1,1,0,0,1,1,0,0,0
08152157,3,3,0,0,1,1,0,0,0
08152190,1,1,0,0,1,1,0,0,0
08152384,7,5,2,0,1,1,0,1,1
08152826,2,1,1,0,1,1,0,1,0
08153063,4,2,2,0,0,0,0,0,0
08153177,45,12,33,0,0,0,0,0,0
08153349,4,4,0,0,2,2,0,0,1
08153716,15,0,15,0,2,2,0,0,1
08153920,1,0,1,0,0,0,0,0,0
08154155,1,1,0,0,1,1,0,0,0
08154815,3,1,2,0,1,1,0,1,0
08154932,22,11,11,0,0,0,0,0,1
08154998,2,2,0,0,5,2,3,1,0
08155114,18,6,12,0,0,0,0,0,1
08155241,3,2,1,0,1,1,0,0,1
08155300,10,3,7,0,2,1,1,1,1
08155302,8,2,6,0,1,1,0,0,1
08155306,7,2,5,0,1,1,0,0,1
08155362,15,4,11,0,1,1,0,1,1
08155976,5,0,5,0,0,0,0,0,1
08156535,37,20,17,0,4,4,0,4,1
08156759,27,12,15,0,1,1,0,1,1
08156927,29,14,15,0,0,0,0,0,1
08157095,2,2,0,0,2,2,0,0,0
08157269,1,0,1,0,0,0,0,0,0
08157294,2,2,0,0,1,1,0,0,0
08157544,8,3,5,0,1,1,0,1,1
08157557,7,0,7,0,2,2,0,0,1
08157580,5,4,1,0,1,1,0,0,0
08157619,7,0,7,0,2,2,0,0,1
08157677,7,0,7,0,2,2,0,0,1
08158217,3,1,2,0,1,1,0,0,0
08158259,5,3,2,0,1,1,0,1,1
08158264,13,8,5,0,0,0,0,0,1
08158543,33,8,25,0,0,0,0,0,1
08159024,3,2,1,0,3,2,1,1,0
08159095,6,4,2,0,0,0,0,0,0
08159263,5,4,1,0,0,0,0,0,1
08159339,2,2,0,0,2,2,0,0,1
08159423,3,1,2,0,2,2,0,0,0
08159521,3,3,0,0,2,2,0,0,1
08159595,5,5,0,0,1,1,0,0,1
08160062,1,1,0,0,1,1,0,0,1
08160110,2,2,0,0,2,2,0,0,0
08160251,5,2,3,0,2,2,0,0,0
08160314,4,0,4,0,0,0,0,0,1
08160488,2,2,0,0,2,2,0,0,0
08160508,1,0,1,0,1,1,0,0,0
08160521,1,0,1,0,0,0,0,0,1
08161020,18,9,9,0,11,0,11,0,0
08161162,1,0,1,0,0,0,0,0,1
08161261,3,1,2,0,2,2,0,0,1
08161468,28,6,22,0,9,4,5,1,0
08161588,3,0,3,0,2,2,0,0,1
08161708,1,0,1,0,0,0,0,0,1
08161843,5,3,2,0,2,2,0,2,1
08161893,2,2,0,0,2,2,0,0,1
08162498,2,2,0,0,2,2,0,0,1
08162556,1,0,1,0,0,0,0,0,1
08162661,4,3,1,0,1,1,0,0,1
08163158,2,2,0,0,2,2,0,0,0
08163433,19,0,19,0,0,0,0,0,0
08163598,1,0,1,0,0,0,0,0,1
08163620,10,9,1,0,0,0,0,0,0
08163696,5,3,2,0,1,1,0,1,0
08164092,3,0,3,0,0,0,0,0,1
08164609,12,5,7,0,1,1,0,1,1
08165698,1,1,0,0,1,1,0,0,0
08165824,1,0,1,0,0,0,0,0,0
08165910,3,0,3,0,0,0,0,0,1
08166357,1,1,0,0,1,1,0,0,0
08166560,1,1,0,0,2,2,0,0,0
08167089,6,5,1,0,0,0,0,0,0
08167175,3,0,3,0,0,0,0,0,1
08167359,3,0,3,0,0,0,0,0,0
08167361,4,3,1,0,2,2,0,0,0
08167403,3,3,0,0,3,3,0,0,0
08167525,11,3,8,0,1,1,0,1,1
08167684,19,6,13,0,0,0,0,0,1
08167738,2,2,0,0,2,2,0,0,0
08168420,4,1,3,0,2,2,0,0,0
08168458,6,1,5,0,4,4,0,0,1
08168548,2,2,0,0,1,1,0,0,1
08168932,10,6,4,0,0,0,0,0,0
08169302,3,1,2,0,3,1,2,1,0
08169487,4,3,1,0,1,1,0,0,0
08169571,7,0,7,0,1,1,0,1,0
08169784,1,1,0,0,1,1,0,0,0
08170276,2,1,1,0,1,1,0,0,0
08170294,2,2,0,0,1,1,0,0,0
08170406,8,4,4,0,0,0,0,0,1
08170475,2,2,0,0,2,2,0,0,1
08170768,14,9,5,0,0,0,0,0,0
08171068,46,21,25,0,3,2,1,0,1
08171223,1,1,0,0,1,1,0,0,0
08171280,11,6,5,0,1,1,0,1,1
08171309,8,7,1,0,0,0,0,0,1
08171372,9,6,3,0,0,0,0,0,0
08171446,1,0,1,0,1,1,0,0,0
08171467,1,1,0,0,1,1,0,0,0
08171795,5,1,4,0,1,1,0,0,1
08171841,10,0,10,0,0,0,0,0,0
08172028,1,1,0,0,1,1,0,0,0
08172435,3,3,0,0,3,3,0,0,1
08172554,3,3,0,0,2,2,0,0,0
08172579,3,2,1,0,1,1,0,0,0
08172622,3,2,1,0,1,1,0,1,1
08172730,2,0,2,0,1,1,0,0,1
08172777,2,1,1,0,1,1,0,0,0
08172788,1,1,0,0,2,2,0,0,0
08173179,6,0,6,0,0,0,0,0,1
08173415,2,0,2,0,1,1,0,0,0
08173770,4,3,1,0,3,3,0,0,0
08173965,2,0,2,0,0,0,0,0,0
08174184,1,0,1,0,0,0,0,0,0
08174195,3,0,3,0,0,0,0,0,1
08174978,1,1,0,0,1,1,0,0,0
08175282,1,0,1,0,0,0,0,0,0
08175402,40,10,30,0,0,0,0,0,0
08175447,1,1,0,0,2,2,0,0,0
08175562,2,2,0,0,3,3,0,0,0
08176060,3,0,3,0,0,0,0,0,1
08176203,4,3,1,0,1,1,0,0,1
08176617,5,1,4,0,1,1,0,1,1
08176788,1,1,0,0,2,2,0,0,1
08176825,1,0,1,0,0,0,0,0,0
08177641,23,12,11,0,0,0,0,0,1
08177657,23,3,20,0,0,0,0,0,0
08177918,1,0,1,0,0,0,0,0,1
08177922,8,0,8,0,0,0,0,0,1
08178308,11,3,8,0,2,2,0,2,1
08178309,19,5,14,0,2,2,0,0,1
08179391,6,3,3,0,3,3,0,0,1
08179448,4,4,0,0,2,2,0,0,0
08179498,17,12,5,0,3,3,0,0,0
08179574,5,3,2,0,2,2,0,0,0
08180071,6,3,3,0,0,0,0,0,1
08180474,13,4,9,0,1,1,0,1,1
08180646,6,3,3,0,0,0,0,0,1
08180871,3,3,0,0,2,2,0,0,0
08181167,20,7,13,0,1,1,0,1,1
08181398,5,4,1,0,1,1,0,0,1
08181983,6,0,6,0,0,0,0,0,0
08182032,1,1,0,0,1,1,0,0,0
08182262,1,1,0,0,1,1,0,1,0
08182327,1,1,0,0,1,1,0,1,0
08182332,1,1,0,0,1,1,0,1,0
08182419,2,2,0,0,2,2,0,0,0
08183007,2,2,0,0,2,2,0,0,0
08183046,6,4,2,0,1,1,0,0,1
08183195,1,1,0,0,2,2,0,0,1
08183462,4,2,2,0,0,0,0,0,0
08183558,17,10,7,0,0,0,0,0,1
08183618,12,5,7,0,0,0,0,0,0
08184012,5,2,3,0,2,2,0,0,1
08184260,1,1,0,0,1,1,0,0,0
08184270,3,0,3,0,1,1,0,0,1
08184466,6,2,4,0,1,1,0,1,1
08184628,1,1,0,0,1,1,0,0,0
08184662,6,0,6,0,0,0,0,0,1
08185191,11,3,8,0,3,3,0,3,1
08185204,2,1,1,0,1,1,0,0,1
08185428,2,1,1,0,1,1,0,0,0
08185742,2,2,0,0,0,0,0,0,1
08185864,2,2,0,0,0,0,0,0,1
08185983,1,1,0,0,1,1,0,0,0
08186083,6,3,3,0,1,1,0,0,0
08186630,1,1,0,0,1,1,0,0,0
08186697,1,1,0,0,1,1,0,0,0
08186831,4,0,4,0,0,0,0,0,0
08187098,2,0,2,0,0,0,0,0,1
08187123,11,0,11,0,0,0,0,0,1
08187233,18,9,9,0,0,0,0,0,1
08187406,10,8,2,0,1,0,1,0,1
08187567,1,1,0,0,1,1,0,0,0
08187950,3,2,1,0,2,2,0,0,1
08188395,2,0,2,0,0,0,0,0,0
08188550,2,0,2,0,2,2,0,0,1
08188744,2,0,2,0,0,0,0,0,1
08188751,1,1,0,0,1,1,0,0,0
08188754,1,0,1,0,0,0,0,0,1
08189798,15,4,11,0,1,1,0,1,1
08189893,9,0,9,0,1,1,0,0,1
08189994,7,0,7,0,0,0,0,0,1
08190142,8,6,2,0,1,0,1,1,1
08190145,10,2,8,0,1,1,0,1,1
08190147,5,3,2,0,1,1,0,0,1
08190148,17,4,13,0,2,2,0,2,1
08190241,5,5,0,0,1,1,0,1,1
08190258,1,1,0,0,1,1,0,0,1
08190259,5,5,0,0,1,1,0,1,1
08190642,3,1,2,0,1,1,0,0,0
08190778,2,2,0,0,2,2,0,0,1
08191122,2,2,0,0,1,1,0,0,0
08191269,4,3,1,0,1,1,0,1,1
08191383,2,1,1,0,1,1,0,0,1
08191399,3,1,2,0,2,1,1,0,0
08192239,10,2,8,0,1,1,0,1,1
08193314,4,0,4,0,0,0,0,0,1
08193373,4,0,4,0,0,0,0,0,1
08193475,10,5,5,0,0,0,0,0,1
08193482,4,4,0,0,1,1,0,0,0
08193859,3,2,1,0,1,1,0,0,0
01010548,9,0,9,0,0,0,0,0,1
01010787,51,5,46,0,1,1,0,1,1
01011189,38,3,35,0,0,0,0,0,0
01011549,19,2,17,0,0,0,0,0,0
01011570,22,2,20,0,1,1,0,1,1
01011637,93,16,77,0,1,1,0,1,1
01011867,37,4,33,0,1,1,0,1,1
01011870,21,0,21,0,1,1,0,1,1
01011907,35,1,34,0,0,0,0,0,1
01012247,11,5,6,0,1,1,0,1,1
01012363,25,6,19,0,1,1,0,0,1
01012629,9,4,5,0,1,1,0,0,0
01012675,30,8,22,0,0,0,0,0,1
01012768,72,28,44,0,0,0,0,0,1
01012778,28,0,28,0,1,1,0,1,1
01013245,37,4,33,0,1,1,0,1,1
01013406,25,5,20,0,1,1,0,1,1
01013414,6,3,3,0,2,2,0,0,0
01014555,50,1,49,0,2,1,1,0,1
01014876,0,0,0,0,0,0,0,0,0
01014982,10,3,7,0,1,1,0,1,1
01015160,33,2,31,0,1,1,0,1,1
01015501,4,2,2,0,1,1,0,0,1
01015628,28,0,28,0,1,1,0,1,1
01015644,8,4,4,0,1,1,0,1,1
01015675,31,7,24,0,1,1,0,1,1
01015687,11,2,9,0,1,1,0,1,1
01015851,35,0,35,0,1,1,0,1,1
01016094,25,0,25,0,0,0,0,0,1
01016104,7,3,4,0,0,0,0,0,0
01016152,10,0,10,0,1,1,0,1,1
01016261,103,18,85,0,0,0,0,0,1
01017417,29,0,29,0,1,1,0,1,1
01017666,10,5,5,0,1,1,0,1,0
01018204,8,2,6,0,1,1,0,1,0
01018235,20,0,20,0,0,0,0,0,1
01018794,8,7,1,0,1,1,0,0,0
01019263,107,16,91,0,0,0,0,0,1
01019748,47,4,43,0,1,1,0,1,1
01019858,52,15,37,0,0,0,0,0,1
01020115,3,3,0,0,2,2,0,0,0
01020347,42,4,38,0,1,1,0,1,1
01020385,39,0,39,0,0,0,0,0,1
01020949,52,5,47,0,0,0,0,0,1
01021212,40,6,34,0,3,3,0,3,1
01021478,11,5,6,0,1,1,0,1,1
01021637,87,9,78,0,0,0,0,0,1
01021901,11,5,6,0,1,1,0,0,1
01022035,5,1,4,0,1,1,0,0,1
01022122,10,9,1,0,2,2,0,0,1
01022656,24,5,19,0,0,0,0,0,1
01022924,17,9,8,0,0,0,0,0,1
01023529,6,4,2,0,1,1,0,0,1
01023742,181,3,178,0,1,1,0,1,1
01023979,0,0,0,0,0,0,0,0,0
01024618,43,10,33,0,1,1,0,1,1
01024821,6,3,3,0,1,1,0,0,0
01024895,35,0,35,0,0,0,0,0,1
01024934,26,2,24,0,0,0,0,0,0
01025419,9,0,9,0,0,0,0,0,1
01025431,15,0,15,0,0,0,0,0,1
01025547,31,5,26,0,1,1,0,0,1
01025757,27,0,27,0,1,1,0,1,1
01026167,102,10,92,0,1,1,0,1,1
01026749,15,4,11,0,0,0,0,0,1
01026986,80,10,70,0,0,0,0,0,1
01027015,7,3,4,0,0,0,0,0,1
01028004,21,4,17,0,0,0,0,0,0
01028803,24,5,19,0,1,1,0,1,1
01028976,7,0,7,0,0,0,0,0,1
01029423,4,2,2,0,2,2,0,0,0
01029563,86,8,78,0,1,1,0,0,1
01029814,5,2,3,0,1,1,0,0,0
01030135,28,3,25,0,2,2,0,2,1
01030861,4,2,2,0,2,2,0,0,0
01030964,2,1,1,0,0,0,0,0,0
01031129,24,0,24,0,0,0,0,0,1
01031254,18,0,18,0,1,1,0,1,1
01031342,31,7,24,0,1,1,0,1,1
01031348,50,12,38,0,0,0,0,0,1
01031464,14,3,11,0,0,0,0,0,1
01031535,4,4,0,0,1,1,0,0,1
01031815,32,4,28,0,1,1,0,1,1
01032104,28,3,25,0,1,1,0,1,1
01032278,10,6,4,0,5,5,0,1,1
01032360,32,4,28,0,2,1,1,1,1
01032371,7,0,7,0,0,0,0,0,1
01032395,23,2,21,0,1,1,0,1,1
01032948,3,2,1,0,1,1,0,0,0
01033029,41,4,37,0,1,1,0,1,1
01033109,5,2,3,0,1,1,0,0,0
01033336,45,0,45,0,1,1,0,1,1
01034035,5,3,2,0,2,2,0,0,0
01034552,4,3,1,0,3,3,0,0,1
01034653,49,4,45,0,1,1,0,1,1
01034654,38,3,35,0,1,1,0,1,1
01034680,22,3,19,0,1,1,0,1,1
01034798,27,0,27,0,0,0,0,0,1
01034972,75,10,65,0,0,0,0,0,1
01035097,25,2,23,0,1,1,0,1,1
01035198,85,11,74,0,1,1,0,1,1
01035500,22,0,22,0,1,1,0,1,1
01035796,6,5,1,0,3,3,0,0,0
01035991,23,8,15,0,1,1,0,0,1
01036291,40,2,38,0,1,1,0,1,1
01036298,50,8,42,0,1,1,0,1,1
01036616,30,7,23,0,0,0,0,0,0
01036682,25,0,25,0,0,0,0,0,1
01036926,41,7,34,0,4,2,2,1,1
01036947,33,5,28,0,1,1,0,1,1
01037314,7,5,2,0,1,1,0,0,1
01037345,8,2,6,0,1,1,0,0,0
01037437,7,3,4,0,3,3,0,1,0
01038028,0,0,0,0,0,0,0,0,0
01038133,92,11,81,0,0,0,0,0,1
01038403,23,4,19,0,1,1,0,1,1
01038785,4,2,2,0,2,2,0,0,0
01038899,28,4,24,0,1,1,0,1,0
01039007,24,3,21,0,1,1,0,1,1
01039085,4,3,1,0,2,2,0,1,1
01039351,33,4,29,0,1,1,0,1,1
01039465,50,0,50,0,0,0,0,0,1
01039582,149,16,133,0,0,0,0,0,1
01040067,25,2,23,0,1,1,0,1,1
01040104,6,0,6,0,0,0,0,0,0
01040329,0,0,0,0,0,0,0,0,0
01040354,4,1,3,0,1,1,0,0,0
01040505,85,8,77,0,0,0,0,0,0
01040609,5,2,3,0,2,2,0,0,1
01040814,20,5,15,0,1,1,0,1,1
01040923,3,3,0,0,0,0,0,0,0
01041697,21,5,16,0,1,1,0,1,1
01041726,20,0,20,0,1,1,0,1,1
01041776,20,0,20,0,1,1,0,1,1
01041946,67,9,58,0,13,8,5,0,0
01042193,9,3,6,0,0,0,0,0,1
01042759,13,5,8,0,1,1,0,1,1
01043563,32,3,29,0,1,1,0,1,1
01043647,4,3,1,0,2,2,0,0,0
01043868,18,0,18,0,0,0,0,0,1
01043869,7,0,7,0,0,0,0,0,0
01044063,41,4,37,0,1,1,0,1,1
01044089,183,113,70,0,0,0,0,0,1
01044097,6,5,1,0,2,2,0,1,1
01044129,17,4,13,0,1,1,0,1,1
01044190,107,9,98,0,0,0,0,0,0
01044436,38,2,36,0,1,1,0,1,1
01044479,11,3,8,0,2,2,0,0,1
01044692,8,3,5,0,5,5,0,0,0
01044810,17,1,16,0,0,0,0,0,1
01045271,16,3,13,0,0,0,0,0,0
01045631,13,5,8,0,3,3,0,0,0
01045793,23,2,21,0,0,0,0,0,1
01045895,9,2,7,0,3,1,2,1,1
01046019,55,4,51,0,1,1,0,1,1
01046499,8,0,8,0,0,0,0,0,1
01046873,47,4,43,0,1,1,0,1,1
01047151,7,2,5,0,1,1,0,0,0
01047287,54,14,40,0,0,0,0,0,1
01047490,29,3,26,0,2,1,1,2,1
01047586,16,0,16,0,0,0,0,0,1
01047690,22,7,15,0,0,0,0,0,1
01048050,14,3,11,0,1,1,0,0,1
01048307,20,0,20,0,0,0,0,0,0
01048339,17,5,12,0,0,0,0,0,0
01048465,56,11,45,0,0,0,0,0,1
01048511,16,8,8,0,0,0,0,0,1
01048591,49,2,47,0,1,1,0,1,0
01048834,20,0,20,0,1,1,0,1,1
01049038,5,1,4,0,1,1,0,1,0
01049197,27,3,24,0,0,0,0,0,0
01049236,57,10,47,0,2,2,0,1,1
01049384,4,2,2,0,1,1,0,0,0
01049501,47,5,42,0,1,1,0,0,1
01049704,38,2,36,0,2,1,1,2,1
01049793,29,0,29,0,1,1,0,1,1
01049873,19,0,19,0,0,0,0,0,1
01050368,5,2,3,0,1,1,0,1,0
01050676,44,0,44,0,0,0,0,0,0
01050732,43,13,30,0,0,0,0,0,1
01050948,24,3,21,0,1,1,0,1,1
01050970,26,8,18,0,1,1,0,1,1
01051111,10,6,4,0,2,1,1,0,1
01051118,26,6,20,0,0,0,0,0,1
01051162,0,0,0,0,0,0,0,0,0
01051510,55,0,55,0,0,0,0,0,1
01051538,5,1,4,0,1,1,0,0,0
01052098,51,2,49,0,3,1,2,0,1
01052150,15,0,15,0,0,0,0,0,1
01052827,13,3,10,0,1,1,0,0,1
01052856,26,3,23,0,0,0,0,0,0
01052871,6,5,1,0,3,3,0,0,0
01053470,23,2,21,0,1,1,0,1,1
01053499,48,9,39,0,2,2,0,0,1
01054993,25,0,25,0,1,1,0,1,1
01055334,26,11,15,0,1,1,0,1,1
01056008,32,6,26,0,3,3,0,1,1
01056119,68,0,68,0,0,0,0,0,1
01056582,14,0,14,0,0,0,0,0,1
01056769,27,4,23,0,1,1,0,1,1
01056774,45,2,43,0,2,1,1,2,1
01056801,88,2,86,0,1,1,0,1,1
01057459,6,5,1,0,0,0,0,0,1
01057583,23,3,20,0,2,1,1,2,1
01057636,111,11,100,0,0,0,0,0,0
01057984,68,10,58,0,0,0,0,0,1
01058023,16,3,13,0,1,1,0,1,1
01058215,17,6,11,0,1,1,0,0,1
01058223,6,2,4,0,1,1,0,0,1
01058358,131,3,128,0,1,1,0,1,1
01058418,4,3,1,0,2,2,0,0,1
01059497,7,3,4,0,1,1,0,0,0
01059510,37,4,33,0,0,0,0,0,1
01059606,61,7,54,0,1,1,0,1,1
01059663,14,4,10,0,1,1,0,1,1
01059707,81,14,67,0,0,0,0,0,1
01059992,28,9,19,0,1,1,0,0,0
01060073,10,0,10,0,0,0,0,0,1
01060163,5,3,2,0,1,1,0,0,0
01060213,6,1,5,0,1,1,0,1,1
01060802,146,2,144,0,0,0,0,0,1
01060956,37,8,29,0,0,0,0,0,1
01061193,5,3,2,0,2,2,0,0,0
01061217,6,4,2,0,3,2,1,0,0
01061863,57,5,52,0,1,1,0,1,1
01061978,7,2,5,0,4,3,1,2,0
01062168,23,0,23,0,0,0,0,0,1
01062385,20,4,16,0,1,1,0,1,1
01063129,18,3,15,0,1,1,0,1,1
01063495,20,9,11,0,2,1,1,2,1
01063523,8,0,8,0,0,0,0,0,0
01063539,71,8,63,0,1,1,0,1,1
01063633,37,11,26,0,1,1,0,1,1
01064095,21,4,17,0,1,1,0,1,1
01064239,126,20,106,0,0,0,0,0,1
01064349,24,4,20,0,1,1,0,1,1
01064622,4,2,2,0,1,1,0,1,0
01065002,15,4,11,0,1,1,0,1,1
01065384,44,6,38,0,1,1,0,1,1
01065393,46,0,46,0,0,0,0,0,1
01065578,6,5,1,0,1,1,0,0,0
01065637,7,2,5,0,2,1,1,0,0
01065661,3,2,1,0,1,1,0,0,0
01065887,9,2,7,0,1,1,0,1,1
01066085,29,3,26,0,2,1,1,2,1
01066608,9,6,3,0,0,0,0,0,0
01066747,20,5,15,0,1,1,0,1,1
01066757,105,15,90,0,0,0,0,0,1
01067309,23,9,14,0,1,1,0,0,1
01067316,4,0,4,0,1,1,0,1,0
01067398,23,0,23,0,0,0,0,0,1
01067419,13,5,8,0,2,2,0,1,1
01067704,11,2,9,0,2,2,0,0,1
01067999,6,3,3,0,3,1,2,1,0
01068035,21,10,11,0,0,0,0,0,0
01068143,4,0,4,0,2,2,0,0,1
01068364,8,4,4,0,0,0,0,0,0
00867065,29,8,21,0,0,0,0,0,1
00867281,48,4,44,0,1,1,0,1,1
00867622,17,0,17,0,0,0,0,0,1
00867637,18,4,14,0,1,0,1,1,1
00867825,15,5,10,0,1,1,0,0,0
00867849,22,2,20,0,1,1,0,0,1
00868273,93,17,76,0,1,1,0,1,1
00868637,16,4,12,0,0,0,0,0,0
00868820,96,20,76,0,1,1,0,0,1
00869208,53,5,48,0,1,1,0,1,1
00869558,8,3,5,0,0,0,0,0,1
00870030,14,5,9,0,1,1,0,1,1
00870199,50,5,45,0,1,1,0,1,1
00870262,40,6,34,0,1,1,0,1,1
00870425,20,3,17,0,2,2,0,2,1
00870509,19,2,17,0,1,1,0,0,1
00870649,37,3,34,0,1,1,0,1,1
00870851,53,13,40,0,1,1,0,1,0
00871113,4,3,1,0,3,2,1,0,1
00871669,43,7,36,0,1,1,0,1,1
00871934,9,4,5,0,1,1,0,1,0
00871957,6,4,2,0,1,1,0,0,0
00871965,22,5,17,0,1,1,0,1,1
00872110,36,5,31,0,1,1,0,1,1
00872198,27,4,23,0,3,3,0,0,0
00872442,20,3,17,0,1,1,0,1,1
00872828,67,13,54,0,1,1,0,1,1
00872948,45,7,38,0,1,1,0,1,1
00873093,35,9,26,0,2,1,1,2,1
00873094,9,3,6,0,2,2,0,0,0
00873179,52,6,46,0,1,1,0,1,1
00873396,24,6,18,0,1,1,0,1,1
00873405,24,4,20,0,1,1,0,1,1
00873463,26,5,21,0,1,1,0,1,1
00873557,1,1,0,0,0,0,0,0,1
00873711,6,0,6,0,0,0,0,0,1
00873769,64,13,51,0,1,1,0,0,1
00873950,17,2,15,0,0,0,0,0,1
00873958,10,0,10,0,0,0,0,0,1
00874176,31,4,27,0,1,1,0,1,0
00874301,5,2,3,0,1,1,0,0,0
00874618,26,4,22,0,2,1,1,2,1
00874639,41,5,36,0,1,1,0,1,1
00874870,20,3,17,0,1,1,0,1,1
00874950,20,3,17,0,1,1,0,1,1
00875534,38,4,34,0,1,1,0,1,1
00876179,48,17,31,0,1,1,0,0,1
00876811,33,9,24,0,0,0,0,0,1
00876959,14,0,14,0,0,0,0,0,1
00877096,25,4,21,0,1,1,0,1,1
00877136,8,3,5,0,1,1,0,0,0
00877137,9,6,3,0,1,1,0,0,0
00877214,15,3,12,0,1,1,0,1,1
00877728,52,3,49,0,1,1,0,1,1
00877761,7,4,3,0,1,1,0,0,0
00877859,65,8,57,0,0,0,0,0,1
00877920,7,5,2,0,6,4,2,1,0
00877923,39,4,35,0,1,1,0,1,1
00877987,79,6,73,0,7,2,5,0,1
00877991,7,5,2,0,5,5,0,0,0
00878006,29,3,26,0,1,1,0,1,1
00878611,12,3,9,0,0,0,0,0,0
00878667,74,1,73,0,3,1,2,0,0
00878804,118,10,108,0,0,0,0,0,0
00878838,23,6,17,0,1,0,1,0,1
00878934,56,21,35,0,0,0,0,0,0
00879039,30,5,25,0,0,0,0,0,1
00879148,5,2,3,0,3,1,2,0,0
00879315,25,3,22,0,1,1,0,1,1
00879531,43,6,37,0,0,0,0,0,1
00879589,13,6,7,0,2,1,1,1,1
00880371,34,8,26,0,1,1,0,1,1
00880686,17,0,17,0,0,0,0,0,1
00880754,60,8,52,0,0,0,0,0,1
00880975,19,0,19,0,0,0,0,0,1
00881195,38,0,38,0,0,0,0,0,1
00881518,18,0,18,0,0,0,0,0,1
00881580,26,4,22,0,0,0,0,0,1
00881605,23,0,23,0,0,0,0,0,1
00881854,7,5,2,0,1,1,0,0,1
00882427,21,3,18,0,0,0,0,0,1
00882644,16,0,16,0,1,1,0,1,1
00882956,18,0,18,0,1,1,0,1,1
00883021,34,5,29,0,2,2,0,2,1
00883094,61,11,50,0,0,0,0,0,1
00883131,51,7,44,0,1,1,0,1,1
00883443,21,2,19,0,1,1,0,1,1
00883563,24,7,17,0,0,0,0,0,0
00883958,7,2,5,0,1,1,0,0,0
00883985,30,3,27,0,1,1,0,1,1
00885054,12,4,8,0,1,1,0,1,1
00885058,23,0,23,0,0,0,0,0,1
00885456,26,2,24,0,1,1,0,1,1
00885496,28,3,25,0,2,1,1,1,1
00885699,32,0,32,0,0,0,0,0,1
00885913,6,0,6,0,0,0,0,0,0
00886182,0,0,0,0,0,0,0,0,0
00886458,38,15,23,0,0,0,0,0,0
00886466,21,3,18,0,1,1,0,1,1
00886488,14,5,9,0,0,0,0,0,1
00886606,22,3,19,0,1,1,0,1,1
00886768,0,0,0,0,0,0,0,0,1
00886774,3,0,3,0,0,0,0,0,1
00886919,10,5,5,0,1,1,0,1,1
00887078,5,2,3,0,4,3,1,0,0
00887094,34,3,31,0,1,1,0,1,1
00887221,12,2,10,0,2,1,1,1,1
00887319,14,2,12,0,1,1,0,1,1
00887353,44,8,36,0,0,0,0,0,1
00887719,45,11,34,0,0,0,0,0,1
00887737,20,2,18,0,1,1,0,1,1
00887808,37,4,33,0,1,1,0,1,1
00887900,79,3,76,0,1,1,0,1,1
00888020,11,0,11,0,1,1,0,1,1
00888435,62,8,54,0,0,0,0,0,1
00888499,50,19,31,0,0,0,0,0,1
00888568,26,6,20,0,1,1,0,1,1
00888664,12,4,8,0,1,1,0,1,1
00888875,7,3,4,0,4,3,1,0,1
00888883,3,2,1,0,1,1,0,0,0
00889000,52,0,52,0,0,0,0,0,1
00889002,15,2,13,0,2,1,1,2,1
00889226,14,6,8,0,1,1,0,0,1
00889363,16,2,14,1,1,1,0,1,1
00889424,50,12,38,0,0,0,0,0,1
00890342,20,4,16,0,1,1,0,1,1
00890443,31,3,28,0,1,1,0,1,1
00890446,25,6,19,0,0,0,0,0,1
00890637,29,7,22,0,0,0,0,0,1
00890683,17,3,14,0,1,1,0,1,1
00891070,25,3,22,0,0,0,0,0,1
00891095,7,3,4,0,2,2,0,0,1
00891336,28,2,26,0,1,1,0,1,1
00891554,147,12,135,0,1,1,0,1,1
00891935,24,6,18,0,2,1,1,2,1
00892018,35,3,32,0,1,1,0,1,1
00892077,36,5,31,0,0,0,0,0,1
00892449,23,3,20,0,0,0,0,0,1
00892693,19,5,14,0,4,3,1,0,1
00892716,6,2,4,0,1,1,0,0,0
00892796,91,14,77,0,0,0,0,0,1
00892812,30,2,28,0,1,1,0,1,1
00892851,106,41,65,0,0,0,0,0,1
00893086,28,2,26,0,0,0,0,0,1
00893197,5,3,2,0,1,1,0,0,0
00893526,12,0,12,0,0,0,0,0,1
00893662,19,3,16,0,0,0,0,0,1
00893784,6,2,4,0,0,0,0,0,0
00893949,26,5,21,0,1,1,0,1,1
00893985,56,14,42,0,0,0,0,0,1
00894054,41,13,28,0,0,0,0,0,1
00894243,40,0,40,0,1,1,0,1,1
00894309,73,10,63,0,1,1,0,0,1
00894552,13,4,9,0,1,1,0,0,0
00894638,35,3,32,0,1,1,0,1,1
00894655,4,4,0,0,2,2,0,0,0
00894685,53,9,44,0,1,1,0,1,1
00894694,15,3,12,0,1,1,0,1,1
00894719,39,13,26,0,0,0,0,0,1
00894979,31,6,25,0,0,0,0,0,0
00894992,33,5,28,0,1,1,0,1,1
00895208,58,9,49,0,0,0,0,0,1
00895810,33,3,30,0,1,1,0,1,1
00895924,79,4,75,0,0,0,0,0,1
00896298,10,2,8,0,1,1,0,0,1
00896322,9,3,6,0,3,3,0,0,1
00896430,152,3,149,0,1,1,0,0,1
00896433,3,2,1,0,0,0,0,0,1
00896672,40,4,36,0,1,1,0,1,1
00896747,14,4,10,0,1,1,0,1,1
00896815,23,4,19,0,1,1,0,0,0
00896821,45,6,39,0,1,1,0,1,1
00896866,5,2,3,0,1,1,0,1,0
00897405,59,4,55,0,1,1,0,0,1
00897489,7,3,4,0,1,1,0,1,1
00897631,112,5,107,0,4,3,1,0,1
00897899,16,2,14,0,1,1,0,1,1
00898129,62,6,56,0,1,1,0,1,1
00898166,72,6,66,0,1,1,0,1,1
00898171,36,5,31,0,0,0,0,0,1
00898213,35,0,35,0,0,0,0,0,1
00898539,48,12,36,0,0,0,0,0,1
00898551,14,4,10,0,1,1,0,1,1
00898567,10,6,4,0,1,1,0,0,1
00898651,107,11,96,0,0,0,0,0,1
00898687,22,7,15,0,1,1,0,0,0
00898922,13,0,13,0,0,0,0,0,1
00898941,32,3,29,0,1,1,0,1,1
00898953,13,4,9,0,1,1,0,1,0
00899317,64,9,55,0,0,0,0,0,0
00900023,30,0,30,0,0,0,0,0,1
00900164,25,5,20,0,1,1,0,0,1
00900361,56,16,40,0,0,0,0,0,0
00900529,25,3,22,0,1,1,0,1,1
00900811,15,4,11,0,0,0,0,0,1
00900907,16,5,11,0,1,1,0,0,1
00901063,33,14,19,0,0,0,0,0,0
00901282,33,7,26,0,1,1,0,1,1
00901623,58,9,49,0,1,1,0,1,1
00901654,15,0,15,0,1,1,0,1,1
00902136,70,9,61,0,12,9,3,0,1
00902438,40,5,35,0,0,0,0,0,1
00902624,34,6,28,0,0,0,0,0,0
00902711,11,4,7,0,1,1,0,1,1
00903458,79,25,54,0,0,0,0,0,1
00903680,71,8,63,0,0,0,0,0,0
00904034,6,3,3,0,1,1,0,1,0
00904212,12,0,12,0,0,0,0,0,0
00904293,50,12,38,0,0,0,0,0,1
00904769,33,6,27,0,1,1,0,1,1
00905963,88,16,72,0,0,0,0,0,1
00906355,106,4,102,0,1,1,0,1,1
00906511,10,6,4,0,1,1,0,1,1
00906906,10,4,6,0,0,0,0,0,1
00907452,8,0,8,0,0,0,0,0,1
00907598,23,4,19,0,1,1,0,1,1
00907700,28,3,25,0,1,1,0,1,1
00907949,29,4,25,0,2,1,1,0,1
00908359,4,3,1,0,1,1,0,0,0
00908396,57,4,53,0,1,1,0,1,1
00908417,38,5,33,0,1,1,0,1,1
00908470,11,3,8,0,1,1,0,0,0
00908495,41,8,33,0,8,5,3,0,1
00908524,6,3,3,0,1,1,0,0,0
00908565,20,3,17,0,1,1,0,1,1
00908743,35,3,32,0,1,1,0,1,1
00908758,151,16,135,0,1,0,1,0,1
00908979,30,7,23,0,1,1,0,1,1
00909018,86,11,75,0,0,0,0,0,1
00909366,20,0,20,0,0,0,0,0,1
00909553,27,2,25,0,1,1,0,1,1
00909558,39,4,35,0,1,1,0,1,1
00909943,23,0,23,0,0,0,0,0,1
00910010,39,10,29,0,3,1,2,1,1
00910355,31,5,26,0,1,1,0,1,1
00910380,110,12,98,0,2,1,1,0,0
00910443,24,10,14,0,1,1,0,0,0
00910564,6,3,3,0,2,2,0,0,0
00910754,32,6,26,0,0,0,0,0,1
00910829,14,3,11,0,1,1,0,1,1
00910968,26,3,23,0,0,0,0,0,1
00911235,47,10,37,0,1,1,0,1,1
00911657,32,3,29,0,0,0,0,0,1
00911736,7,0,7,0,0,0,0,0,1
00911855,17,0,17,0,1,1,0,1,1
00911924,79,16,63,0,0,0,0,0,1
00912022,41,10,31,0,0,0,0,0,1
00912191,34,0,34,0,0,0,0,0,1
00912211,56,3,53,0,1,1,0,1,1
00912265,53,12,41,0,0,0,0,0,1
00912603,14,4,10,0,1,1,0,1,0
00912624,42,6,36,0,2,2,0,2,1
00913062,37,10,27,0,0,0,0,0,0
00913439,33,3,30,0,1,1,0,1,1
00913450,42,5,37,0,1,1,0,1,1
00913760,35,4,31,0,1,1,0,1,0
00914138,19,5,14,0,0,0,0,0,0
00914205,18,0,18,0,0,0,0,0,1
00914413,6,2,4,0,1,1,0,0,0
00914422,28,0,28,0,0,0,0,0,1
00914771,19,3,16,0,1,1,0,1,1
00914963,57,7,50,0,0,0,0,0,1
00915636,24,0,24,0,1,1,0,1,1
00915882,27,5,22,0,0,0,0,0,0
00916059,58,6,52,0,0,0,0,0,1
00916302,14,5,9,0,0,0,0,0,1
00916378,9,0,9,0,0,0,0,0,1
00916634,82,4,78,0,1,1,0,1,1
00916658,10,3,7,0,1,1,0,1,1
00916699,18,3,15,0,0,0,0,0,0
00917082,15,3,12,0,1,1,0,1,1
00917083,21,3,18,0,2,2,0,2,1
00917085,15,3,12,0,1,1,0,1,1
00917116,117,15,102,0,0,0,0,0,1
00917262,7,4,3,0,4,3,1,0,1
00918067,56,4,52,0,2,2,0,2,1
00918479,9,1,8,0,1,1,0,0,1
00918560,69,10,59,0,0,0,0,0,1
00918596,31,3,28,0,1,1,0,1,1
00918616,26,6,20,0,2,1,1,2,1
00919424,19,4,15,0,1,1,0,1,1
00920592,8,2,6,0,2,2,0,0,0
00920880,69,5,64,0,1,0,1,1,1
00920943,5,3,2,0,2,2,0,0,0
00921271,30,0,30,0,0,0,0,0,1
00921333,0,0,0,0,0,0,0,0,1
00921417,36,4,32,0,0,0,0,0,1
00921639,19,10,9,0,1,0,1,0,1
00921900,41,6,35,0,0,0,0,0,0
00921909,64,18,46,0,0,0,0,0,1
00922139,9,3,6,0,0,0,0,0,1
00922509,8,4,4,0,2,2,0,1,1
00923259,26,0,26,0,0,0,0,0,1
00923382,6,0,6,0,0,0,0,0,1
00923707,56,13,43,0,0,0,0,0,0
00923726,8,1,7,0,4,1,3,1,0
00923975,36,9,27,0,0,0,0,0,1
00924113,33,5,28,0,1,1,0,0,1
00924318,33,5,28,0,1,1,0,1,1
00924401,96,18,78,0,3,2,1,0,1
00924430,62,3,59,0,1,1,0,1,1
00924565,46,9,37,0,0,0,0,0,0
00924581,31,2,29,0,1,1,0,1,1
00924601,19,4,15,0,1,1,0,1,1
00925220,28,3,25,0,1,1,0,1,1
00925279,178,9,169,0,1,1,0,1,1
00925468,25,8,17,0,1,1,0,0,0
00925581,67,15,52,0,0,0,0,0,1
00925912,26,4,22,0,1,1,0,1,0
00926028,24,3,21,0,1,1,0,1,1
00926158,177,12,165,0,0,0,0,0,1
00926236,81,0,81,0,0,0,0,0,1
00926307,36,3,33,0,1,1,0,1,1
00926330,41,4,37,0,1,1,0,1,1
00926398,12,0,12,0,1,1,0,1,1
00926604,34,6,28,0,1,0,1,1,1
00926655,40,2,38,0,1,1,0,1,1
00926722,28,2,26,0,1,1,0,1,1
00926785,37,1,36,0,1,1,0,1,1
00926947,10,3,7,0,2,1,1,2,1
00927203,76,13,63,0,0,0,0,0,1
00927218,14,0,14,0,0,0,0,0,1
00927539,95,10,85,0,1,1,0,0,1
00927601,9,0,9,0,2,2,0,0,1
00927680,43,7,36,0,0,0,0,0,1
00928316,7,0,7,0,0,0,0,0,1
00928424,33,0,33,0,0,0,0,0,1
00928520,50,9,41,0,0,0,0,0,1
00928562,65,5,60,0,1,1,0,1,1
00928659,57,13,44,0,3,1,2,0,0
00928842,8,3,5,0,2,1,1,1,1
00928922,25,3,22,0,1,1,0,1,1
00929027,107,17,90,0,0,0,0,0,1
00929034,6,0,6,0,2,1,1,0,0
00929139,7,4,3,0,0,0,0,0,1
00929369,10,4,6,0,2,1,1,0,0
00929427,17,3,14,0,2,2,0,0,0
00929650,35,4,31,0,1,1,0,1,1
00929655,56,0,56,0,0,0,0,0,1
00929735,24,0,24,0,1,1,0,1,1
00930051,27,4,23,0,1,1,0,1,1
00930144,12,4,8,0,1,1,0,1,1
00930261,20,4,16,0,1,1,0,1,1
00930345,20,3,17,0,1,1,0,1,1
00930726,10,2,8,0,1,1,0,0,1
00930776,167,10,157,0,0,0,0,0,1
00930809,3,3,0,0,1,1,0,0,1
00930931,6,3,3,0,1,1,0,0,0
00930965,40,4,36,0,1,1,0,1,1
00931036,2,1,1,0,0,0,0,0,1
00931322,16,5,11,0,1,1,0,1,1
00931357,18,0,18,0,0,0,0,0,1
00931636,12,4,8,0,1,1,0,1,1
00931883,14,4,10,0,1,1,0,1,1
00931954,60,5,55,0,2,1,1,2,1
00932111,57,3,54,0,1,1,0,1,1
00932254,100,14,86,0,0,0,0,0,1
00932266,21,4,17,0,1,1,0,0,1
00932385,41,7,34,0,1,1,0,0,1
00932584,52,10,42,0,1,1,0,1,1
00932590,127,19,108,0,2,1,1,0,1
00932598,30,4,26,0,8,3,5,1,1
00932632,0,0,0,0,0,0,0,0,0
00932738,4,3,1,0,1,1,0,1,0
00933388,5,4,1,0,1,1,0,1,1
00933426,8,4,4,0,1,1,0,1,1
00933880,31,2,29,0,1,1,0,1,1
00934101,6,2,4,0,1,1,0,0,0
00934278,19,0,19,0,0,0,0,0,1
00934454,9,3,6,0,0,0,0,0,0
00934528,40,6,34,0,1,1,0,1,1
00934595,29,3,26,0,1,1,0,1,1
00934859,29,5,24,0,1,1,0,1,1
00935048,26,4,22,0,2,2,0,2,1
00935108,55,5,50,0,1,1,0,0,0
00935434,6,2,4,0,2,1,1,2,1
00935526,19,4,15,0,1,1,0,1,1
00935741,29,0,29,0,0,0,0,0,1
00935949,32,6,26,0,1,1,0,1,1
00935973,6,3,3,0,3,3,0,2,1
00936052,33,0,33,0,0,0,0,0,0
00936149,14,3,11,0,2,1,1,1,1
00936569,53,4,49,0,2,1,1,0,1
00936622,40,5,35,0,1,1,0,0,1
00936838,54,14,40,0,0,0,0,0,1
00936855,79,7,72,0,1,1,0,0,1
00937007,5,3,2,0,2,2,0,0,0
00937216,34,0,34,0,0,0,0,0,1
00937254,18,4,14,0,0,0,0,0,1
00937554,54,14,40,0,0,0,0,0,1
00937964,6,3,3,0,0,0,0,0,0
00938121,51,2,49,0,1,1,0,1,1
00938188,45,7,38,0,1,1,0,1,1
00938261,17,2,15,0,1,1,0,1,1
00938345,14,0,14,0,0,0,0,0,1
00938440,76,11,65,0,1,1,0,1,1
00938553,8,3,5,0,1,1,0,0,1
00938592,62,11,51,0,0,0,0,0,1
00938787,30,4,26,0,1,1,0,1,1
00938798,39,0,39,0,1,1,0,1,1
00938909,45,4,41,0,0,0,0,0,1
00938937,74,6,68,0,1,1,0,1,1
00939028,39,7,32,0,1,1,0,1,1
00939290,21,1,20,0,1,1,0,1,1
00939480,42,3,39,0,1,1,0,1,1
00939506,34,2,32,0,0,0,0,0,1
00939510,30,8,22,0,0,0,0,0,1
00939565,29,3,26,0,2,2,0,1,1
00939886,33,0,33,0,0,0,0,0,1
03605059,46,8,38,0,2,2,0,2,1
03605151,23,3,20,0,2,2,0,2,1
03605160,13,0,13,0,0,0,0,0,1
03605247,13,2,11,0,1,1,0,1,1
03605293,13,2,11,0,1,1,0,1,1
03605347,20,6,14,0,2,1,1,0,1
03605570,9,0,9,0,0,0,0,0,0
03605698,9,2,7,0,4,1,3,1,1
03606524,7,5,2,0,1,1,0,0,0
03606750,24,11,13,0,1,1,0,1,1
03606940,66,7,59,0,0,0,0,0,1
03606954,37,4,33,0,1,1,0,1,1
03606968,13,4,9,0,0,0,0,0,1
03607077,6,4,2,0,0,0,0,0,1
03607209,7,0,7,0,0,0,0,0,0
03607764,22,0,22,0,1,1,0,1,1
03607835,12,4,8,0,2,1,1,1,1
03607854,5,3,2,0,1,1,0,0,0
03608065,77,10,67,0,0,0,0,0,1
03608329,20,3,17,0,1,1,0,1,1
03608496,49,17,32,0,0,0,0,0,1
03608555,8,0,8,0,1,1,0,0,1
03608684,10,3,7,0,1,1,0,0,1
03608886,17,0,17,0,0,0,0,0,1
03608910,17,2,15,0,2,1,1,0,1
03609466,5,0,5,0,0,0,0,0,1
03609558,16,0,16,0,0,0,0,0,1
03609582,15,2,13,0,1,1,0,1,1
03609673,3,2,1,0,1,1,0,0,0
03609834,7,4,3,0,3,1,2,0,1
03610035,8,5,3,0,0,0,0,0,0
03610100,54,12,42,0,0,0,0,0,1
03610137,7,4,3,0,0,0,0,0,1
03610185,8,0,8,0,0,0,0,0,1
03610855,24,9,15,0,1,1,0,1,1
03610881,81,0,81,0,0,0,0,0,1
03611319,9,2,7,0,2,2,0,1,1
03611374,38,7,31,0,2,1,1,0,1
03611426,50,3,47,0,1,1,0,1,1
03611430,9,0,9,0,0,0,0,0,0
03611801,22,5,17,0,2,1,1,2,1
03611802,9,3,6,0,2,2,0,0,1
03612012,22,0,22,0,1,1,0,1,1
03612017,18,0,18,0,0,0,0,0,1
03612096,23,3,20,0,1,1,0,1,1
03612468,33,9,24,0,0,0,0,0,1
03612719,24,5,19,0,3,1,2,1,1
03612746,34,4,30,0,1,1,0,1,1
03612765,29,0,29,0,0,0,0,0,1
03612779,16,7,9,0,0,0,0,0,1
03612963,12,7,5,0,0,0,0,0,0
03613050,17,2,15,0,1,1,0,1,1
03613056,39,6,33,0,1,1,0,0,1
03613532,32,0,32,0,0,0,0,0,1
03613709,11,0,11,0,1,1,0,1,1
03613914,7,3,4,0,1,1,0,0,1
03613919,17,2,15,0,0,0,0,0,1
03613935,32,4,28,0,3,1,2,3,1
03614258,7,0,7,0,1,1,0,1,1
03614426,15,7,8,0,0,0,0,0,0
03614661,20,9,11,0,4,2,2,4,1
03614841,10,4,6,0,1,1,0,0,1
03615141,28,6,22,0,0,0,0,0,0
03615293,6,2,4,0,2,2,0,0,1
03615728,10,4,6,0,1,1,0,1,1
03615942,11,0,11,0,0,0,0,0,1
03616068,20,5,15,0,0,0,0,0,1
03616127,11,3,8,0,2,2,0,1,0
03616229,13,2,11,1,0,0,0,0,1
03616400,31,5,26,0,0,0,0,0,0
03616409,51,6,45,0,0,0,0,0,0
03616635,9,3,6,0,1,1,0,1,1
03616665,42,7,35,0,0,0,0,0,1
03616766,22,4,18,0,1,1,0,1,1
03616797,24,3,21,0,0,0,0,0,0
03617876,15,0,15,0,0,0,0,0,1
03618559,35,0,35,0,1,1,0,1,1
03618736,40,9,31,0,0,0,0,0,1
03618899,14,3,11,0,3,2,1,1,1
03619009,12,2,10,0,1,1,0,0,1
03619021,20,0,20,0,0,0,0,0,1
03619022,19,0,19,0,0,0,0,0,1
03619054,11,2,9,0,1,1,0,0,1
03619088,22,0,22,0,0,0,0,0,1
03619486,60,4,56,0,2,2,0,2,1
03619752,54,9,45,0,2,2,0,2,1
03619811,10,5,5,1,2,1,1,0,1
03619867,7,3,4,0,2,1,1,2,1
03619869,10,5,5,1,1,1,0,1,1
03619870,8,0,8,0,1,1,0,0,1
03619894,11,1,10,0,1,1,0,0,1
03619980,9,0,9,0,1,1,0,0,1
03620981,5,2,3,0,1,1,0,0,1
03621443,12,3,9,0,1,1,0,1,0
03621541,5,2,3,0,1,1,0,0,0
03621552,5,2,3,0,3,3,0,0,0
03621571,29,10,19,0,0,0,0,0,0
03621649,6,3,3,0,1,1,0,0,0
03621726,19,7,12,0,1,1,0,0,0
03621745,15,4,11,0,1,1,0,1,1
03621755,18,4,14,0,1,1,0,1,1
03621756,7,5,2,0,3,1,2,1,0
03621805,5,0,5,0,0,0,0,0,1
03621999,42,3,39,0,1,1,0,1,1
03622388,24,0,24,0,0,0,0,0,1
03622447,14,5,9,0,0,0,0,0,1
03622490,35,4,31,0,1,1,0,1,1
03622770,25,2,23,0,1,1,0,1,1
03622955,12,0,12,0,0,0,0,0,1
03623229,11,0,11,0,0,0,0,0,1
03623235,16,3,13,0,1,1,0,1,1
03623292,6,2,4,0,1,1,0,0,1
03623316,39,2,37,0,0,0,0,0,1
03623581,18,4,14,0,0,0,0,0,1
03623613,7,5,2,0,2,2,0,0,0
03623704,5,3,2,0,2,2,0,2,1
03624029,9,3,6,0,1,1,0,1,1
03624524,38,4,34,0,1,1,0,1,0
03624718,10,3,7,0,1,1,0,1,1
03625063,74,16,58,0,0,0,0,0,1
03625138,41,6,35,0,1,1,0,1,1
03625145,33,4,29,0,1,1,0,1,1
03625177,10,3,7,0,3,3,0,2,1
03625199,23,10,13,0,0,0,0,0,1
03625281,9,8,1,0,3,3,0,0,1
03625288,5,2,3,0,1,1,0,1,1
03625454,5,2,3,0,1,1,0,1,1
03625464,8,0,8,0,0,0,0,0,1
03625469,5,2,3,0,1,1,0,1,1
03625532,25,7,18,0,0,0,0,0,1
03625706,6,2,4,0,2,2,0,0,0
03625708,5,5,0,0,3,3,0,0,1
03625928,21,0,21,0,1,1,0,1,1
03625937,13,0,13,0,0,0,0,0,1
03626005,38,3,35,0,0,0,0,0,0
03626007,8,0,8,0,1,1,0,1,1
03626135,28,3,25,0,1,1,0,1,1
03626139,65,14,51,0,0,0,0,0,1
03626184,11,0,11,0,2,2,0,2,1
03626214,7,0,7,0,0,0,0,0,1
03626688,9,1,8,0,1,1,0,0,1
03627057,5,4,1,0,2,2,0,0,0
03627088,9,0,9,0,2,2,0,0,1
03627152,43,0,43,0,0,0,0,0,1
03627264,9,2,7,0,2,2,0,0,1
03627335,21,6,15,0,1,1,0,1,1
03627626,4,4,0,0,1,1,0,0,1
03627630,54,12,42,0,0,0,0,0,1
03627749,6,1,5,0,1,1,0,0,1
03627773,5,5,0,0,3,3,0,0,1
03627794,16,4,12,0,0,0,0,0,0
03628204,15,1,14,0,0,0,0,0,1
03628231,51,10,41,0,0,0,0,0,0
03628343,29,7,22,0,1,1,0,1,1
03628490,14,3,11,0,2,2,0,0,1
03628806,36,5,31,0,1,1,0,1,1
03629038,14,4,10,0,1,1,0,0,0
03629046,6,1,5,0,2,2,0,0,1
03629093,17,7,10,0,1,1,0,0,0
03629209,5,2,3,0,1,1,0,0,1
03629729,7,2,5,0,2,2,0,0,1
03629773,16,4,12,0,1,1,0,1,0
03629823,12,3,9,0,1,1,0,1,1
03630140,22,3,19,0,0,0,0,0,1
03630697,5,0,5,0,0,0,0,0,1
03630733,9,3,6,0,2,2,0,0,1
03631109,6,2,4,0,1,1,0,0,1
03631231,10,2,8,0,1,1,0,0,1
03631298,18,2,16,0,3,2,1,1,1
03631559,8,2,6,0,1,1,0,0,1
03631672,24,3,21,0,0,0,0,0,0
03631999,6,2,4,0,2,2,0,0,1
03632315,7,3,4,0,1,1,0,0,1
03632420,10,3,7,0,2,1,1,2,1
03633308,6,2,4,0,2,2,0,0,1
03633516,53,0,53,0,0,0,0,0,1
03633621,41,17,24,0,0,0,0,0,1
03633950,30,4,26,0,1,1,0,1,1
03634573,12,3,9,0,1,1,0,1,1
03635172,5,3,2,0,2,2,0,0,1
03635466,31,2,29,0,2,1,1,1,1
03635563,7,1,6,0,1,1,0,0,1
03635611,10,3,7,0,1,1,0,0,1
03635625,5,2,3,0,2,2,0,1,1
03635626,5,2,3,0,2,2,0,1,1
03635685,4,2,2,0,1,1,0,0,1
03635787,5,2,3,0,1,1,0,0,0
03635868,9,2,7,0,1,1,0,0,1
03635879,14,0,14,2,1,1,0,0,1
03636004,6,3,3,0,2,2,0,0,1
03636028,9,0,9,0,1,1,0,1,1
03636078,27,8,19,0,0,0,0,0,1
03636102,11,0,11,0,0,0,0,0,1
03636116,10,3,7,0,2,2,0,0,1
03636230,17,4,13,0,0,0,0,0,1
03636369,14,1,13,0,1,1,0,1,1
03636406,6,1,5,0,0,0,0,0,1
03636607,8,4,4,0,1,1,0,1,1
03636769,67,9,58,0,1,0,1,0,1
03636789,34,12,22,0,0,0,0,0,1
03636967,4,2,2,0,1,1,0,0,0
03637201,25,8,17,0,0,0,0,0,1
03637616,23,0,23,0,1,1,0,1,1
03638227,21,0,21,0,0,0,0,0,1
03638247,5,2,3,0,1,1,0,0,1
03638250,19,2,17,0,0,0,0,0,0
03638730,3,3,0,0,2,2,0,0,0
03638834,11,3,8,0,1,1,0,0,0
03638842,25,10,15,0,0,0,0,0,1
03638987,11,0,11,0,0,0,0,0,1
03639380,5,0,5,0,0,0,0,0,1
03639589,29,4,25,0,1,1,0,1,1
03639612,6,2,4,0,2,2,0,0,0
03639975,31,0,31,0,1,1,0,1,1
01459052,19,0,19,0,0,0,0,0,1
01459151,19,0,19,0,0,0,0,0,1
01459292,43,5,38,0,0,0,0,0,1
01459436,3,3,0,0,2,2,0,0,1
01459479,7,3,4,0,1,1,0,1,1
01459745,30,3,27,0,2,2,0,2,1
01460019,11,1,10,0,1,1,0,1,1
01460377,44,2,42,0,1,1,0,0,1
01460716,13,3,10,0,1,1,0,1,1
01460766,12,4,8,0,1,1,0,1,0
01461021,25,3,22,0,1,1,0,1,1
01461176,19,3,16,0,1,1,0,1,1
01462773,7,4,3,0,0,0,0,0,1
01463229,20,0,20,0,0,0,0,0,1
01463527,0,0,0,0,0,0,0,0,0
01464068,3,3,0,0,0,0,0,0,0
01464134,18,5,13,0,0,0,0,0,1
01464447,32,6,26,0,1,1,0,1,1
01464587,32,4,28,0,1,1,0,1,1
01464835,97,3,94,0,1,1,0,1,1
01465099,7,3,4,0,4,1,3,1,1
01465721,5,3,2,0,2,2,0,0,1
01465823,106,22,84,0,0,0,0,0,1
01465827,4,2,2,0,1,1,0,0,1
01466019,22,4,18,0,0,0,0,0,0
01466217,44,2,42,0,1,1,0,1,1
01466398,6,4,2,0,1,1,0,0,1
01466580,6,4,2,0,1,1,0,1,0
01466710,6,4,2,0,0,0,0,0,0
01466872,17,5,12,0,1,1,0,0,1
01466890,4,2,2,0,2,2,0,0,0
01466898,37,8,29,0,1,1,0,1,1
01467080,20,3,17,0,0,0,0,0,0
01467155,49,7,42,0,0,0,0,0,1
01468134,23,3,20,0,1,1,0,1,1
01468159,3,0,3,0,0,0,0,0,1
01468380,44,3,41,0,0,0,0,0,1
01468528,24,4,20,0,1,1,0,1,1
01468532,22,0,22,0,1,1,0,1,1
01468589,32,2,30,0,0,0,0,0,1
01468659,13,4,9,0,1,1,0,1,1
01468693,49,10,39,0,4,3,1,0,1
01468817,98,10,88,0,0,0,0,0,1
01469230,3,2,1,0,2,2,0,0,1
01469259,20,0,20,0,0,0,0,0,1
01469541,38,2,36,0,2,1,1,2,1
01469979,7,3,4,0,1,1,0,1,0
01470151,59,12,47,0,0,0,0,0,1
01470183,18,0,18,0,0,0,0,0,1
01471587,104,4,100,0,1,1,0,1,1
01471836,7,3,4,0,2,1,1,0,1
01472055,15,7,8,0,1,1,0,0,1
01472210,35,9,26,0,1,1,0,0,0
01472379,4,0,4,0,1,1,0,0,1
01472689,5,2,3,0,1,1,0,0,0
01472949,37,8,29,0,1,1,0,0,1
01473316,23,0,23,0,1,1,0,1,1
01473453,55,10,45,0,9,9,0,0,1
01474061,91,33,58,0,0,0,0,0,1
01474282,47,13,34,0,0,0,0,0,1
01474522,17,0,17,0,0,0,0,0,1
01474782,4,3,1,0,1,1,0,0,0
01475006,30,0,30,0,0,0,0,0,1
01475009,53,9,44,0,1,1,0,1,1
01475237,37,6,31,0,1,1,0,0,1
01475376,26,0,26,0,0,0,0,0,1
01475555,23,4,19,0,1,1,0,1,0
01476250,28,2,26,0,1,1,0,1,1
01476692,18,3,15,0,2,2,0,2,1
01476705,31,3,28,0,1,1,0,1,1
01476836,4,3,1,0,2,2,0,1,1
01477869,7,0,7,0,0,0,0,0,1
01477909,15,5,10,0,1,1,0,1,1
01478287,4,4,0,0,1,1,0,0,1
01478819,29,3,26,0,1,1,0,1,1
01479160,41,3,38,0,1,1,0,1,1
01479228,17,8,9,0,1,1,0,1,1
01479779,0,0,0,0,0,0,0,0,0
01480047,32,2,30,0,1,1,0,1,1
01480350,31,3,28,0,1,1,0,0,1
01480710,9,4,5,0,1,1,0,1,1
01480930,5,1,4,0,1,1,0,0,1
01480955,7,6,1,0,1,1,0,0,1
01481063,13,4,9,0,5,4,1,1,0
01481831,14,12,2,0,1,1,0,0,0
01482158,16,5,11,0,0,0,0,0,1
01482392,13,2,11,0,1,1,0,1,1
01483021,38,6,32,0,1,1,0,1,1
01483032,24,5,19,0,1,1,0,0,1
01483043,21,0,21,0,0,0,0,0,1
01483113,62,8,54,0,1,1,0,0,0
01483448,11,4,7,0,0,0,0,0,0
01483591,22,6,16,0,0,0,0,0,1
01483650,21,8,13,0,1,1,0,1,1
01483687,27,3,24,0,1,1,0,1,1
01483729,51,0,51,0,0,0,0,0,1
01484038,21,0,21,0,0,0,0,0,1
01484061,19,4,15,0,0,0,0,0,1
01484062,5,4,1,0,2,2,0,0,1
01484598,24,2,22,0,1,1,0,1,1
01485104,60,3,57,0,1,1,0,1,1
01485287,65,9,56,0,0,0,0,0,1
01485413,15,8,7,0,3,2,1,0,1
01485777,19,5,14,0,1,1,0,1,0
01485831,20,2,18,0,2,1,1,2,1
01485890,45,4,41,0,1,1,0,1,1
01485961,14,0,14,0,0,0,0,0,0
01486048,5,3,2,0,2,2,0,0,0
01486408,207,0,207,0,0,0,0,0,1
01486701,10,5,5,0,3,2,1,0,1
01486914,24,3,21,0,1,1,0,1,1
01487359,70,9,61,0,1,1,0,1,1
01487502,4,3,1,0,3,3,0,0,1
01487647,13,0,13,0,0,0,0,0,1
01487774,285,14,271,0,0,0,0,0,1
01488156,29,4,25,0,1,1,0,1,1
01488252,24,6,18,0,1,1,0,0,1
01488490,48,3,45,0,2,1,1,2,1
01488690,47,4,43,0,0,0,0,0,1
01488725,6,2,4,0,1,1,0,0,1
01488786,70,12,58,0,0,0,0,0,1
01488969,35,3,32,0,1,1,0,1,1
01489243,13,3,10,0,0,0,0,0,0
01489455,16,3,13,0,1,1,0,1,1
01489764,16,0,16,0,0,0,0,0,1
01489884,8,4,4,0,2,1,1,1,0
01490051,5,2,3,0,1,1,0,0,1
01490100,79,8,71,0,0,0,0,0,1
01490238,33,8,25,0,0,0,0,0,1
01490454,8,6,2,0,1,1,0,0,0
01490769,3,3,0,0,1,1,0,0,0
01491005,21,3,18,0,0,0,0,0,1
01491154,61,5,56,0,0,0,0,0,0
01491604,28,2,26,0,0,0,0,0,1
01491788,28,4,24,0,1,1,0,1,1
01492207,37,2,35,0,1,1,0,1,1
01492302,54,6,48,0,1,1,0,1,1
01493058,8,4,4,0,0,0,0,0,1
01494221,37,6,31,0,0,0,0,0,0
01494742,21,2,19,0,1,1,0,1,1
01494840,19,0,19,0,0,0,0,0,1
01495009,20,4,16,0,1,1,0,1,1
01495407,14,4,10,0,1,1,0,1,1
01495543,41,11,30,0,0,0,0,0,1
01495766,21,5,16,0,0,0,0,0,1
01495927,46,11,35,0,0,0,0,0,1
01496333,59,7,52,0,0,0,0,0,1
01496521,0,0,0,0,0,0,0,0,0
01496838,18,5,13,0,0,0,0,0,1
01497102,51,4,47,0,1,1,0,0,1
01497453,14,1,13,0,1,1,0,0,1
01497647,23,0,23,0,0,0,0,0,1
01498182,8,2,6,0,4,3,1,1,0
01498275,16,5,11,0,0,0,0,0,0
01498800,39,12,27,0,0,0,0,0,0
01498884,17,3,14,0,1,1,0,1,1
01499116,29,3,26,0,0,0,0,0,0
01499119,16,0,16,0,0,0,0,0,1
01499490,6,1,5,0,1,1,0,1,0
01499655,88,10,78,0,0,0,0,0,1
01499846,83,12,71,0,2,2,0,0,1
01499927,62,6,56,0,0,0,0,0,0
01500044,35,0,35,0,0,0,0,0,1
01500217,38,2,36,0,2,1,1,2,1
01500648,38,2,36,0,1,1,0,1,1
01501342,9,4,5,0,2,2,0,0,1
01501370,11,0,11,0,0,0,0,0,1
01501552,6,6,0,0,2,2,0,0,1
01501563,9,6,3,0,1,1,0,1,1
01501750,0,0,0,0,0,0,0,0,0
01501894,13,4,9,0,0,0,0,0,0
01502435,16,4,12,0,0,0,0,0,1
01503717,49,6,43,0,1,1,0,1,1
01503727,50,4,46,0,4,1,3,4,1
01504855,13,4,9,0,1,1,0,1,1
01505179,9,4,5,0,1,1,0,0,1
01505228,16,4,12,0,0,0,0,0,1
01505382,49,2,47,0,1,1,0,1,1
01505482,6,2,4,0,1,1,0,0,0
01505753,65,12,53,0,0,0,0,0,1
01505817,27,3,24,0,1,1,0,1,1
01506034,55,2,53,0,1,1,0,1,1
01506576,31,8,23,0,0,0,0,0,1
01506975,34,0,34,1,0,0,0,0,1
01507019,28,0,28,0,0,0,0,0,1
01507274,98,12,86,0,1,1,0,1,1
01507280,13,0,13,0,0,0,0,0,1
01507397,51,5,46,0,1,1,0,1,1
01507543,15,0,15,0,0,0,0,0,1
01508017,49,8,41,0,0,0,0,0,1
01508030,52,3,49,0,1,1,0,1,1
01508095,49,5,44,0,0,0,0,0,1
01508295,28,4,24,0,1,1,0,1,1
01508388,54,10,44,0,0,0,0,0,1
01508543,11,6,5,0,1,1,0,1,0
01508577,18,4,14,0,1,1,0,1,1
01508838,23,3,20,0,1,1,0,1,0
01508849,12,5,7,0,2,2,0,0,1
01508943,4,0,4,0,0,0,0,0,1
01509185,14,0,14,0,0,0,0,0,1
01509262,4,2,2,0,2,2,0,0,0
01509313,52,12,40,0,2,1,1,0,1
01509344,29,3,26,0,1,1,0,1,1
01509608,10,2,8,0,1,1,0,0,1
01509922,20,2,18,0,1,1,0,1,1
01509979,4,2,2,0,1,1,0,0,1
01510438,9,5,4,0,1,1,0,1,0
01510521,46,11,35,0,3,1,2,0,1
01510535,18,5,13,0,0,0,0,0,1
01510788,9,3,6,0,1,1,0,1,0
01511228,17,2,15,0,0,0,0,0,1
01511367,32,7,25,0,0,0,0,0,1
01511411,20,4,16,0,0,0,0,0,1
01511512,11,10,1,0,1,1,0,0,1
01511731,8,0,8,0,0,0,0,0,1
01512032,6,1,5,0,1,1,0,0,1
01512831,6,2,4,0,1,1,0,0,0
01512980,41,5,36,0,1,1,0,1,1
01513010,71,8,63,0,1,0,1,0,1
01513851,17,2,15,0,1,1,0,1,1
01513975,21,0,21,0,1,1,0,1,1
01514460,15,3,12,0,0,0,0,0,1
01514483,18,6,12,0,1,1,0,1,1
01514496,22,2,20,0,1,1,0,1,1
01514558,15,3,12,0,1,1,0,0,1
01514995,4,3,1,0,2,2,0,0,0
01515003,46,12,34,0,0,0,0,0,0
01515655,30,0,30,0,1,1,0,1,1
01516344,9,1,8,0,3,1,2,1,1
01516607,4,2,2,0,2,0,2,0,0
01516780,21,3,18,0,5,2,3,1,1
01517230,31,11,20,0,0,0,0,0,0
01517766,17,3,14,0,4,1,3,2,1
01518014,24,4,20,0,4,3,1,4,1
01518295,19,2,17,0,1,1,0,1,1
01518375,41,4,37,0,2,1,1,2,1
01518396,28,6,22,0,0,0,0,0,0
01518680,7,0,7,0,0,0,0,0,1
01518707,43,4,39,0,1,1,0,1,1
01518970,32,3,29,0,1,1,0,1,1
01518983,198,21,177,0,0,0,0,0,1
01519003,34,5,29,0,0,0,0,0,0
01519364,32,4,28,0,0,0,0,0,1
01519749,31,6,25,0,1,1,0,1,1
01519769,4,2,2,0,1,1,0,0,0
01228109,75,8,67,0,1,1,0,1,1
01228157,50,6,44,0,2,2,0,2,1
01228309,29,3,26,0,1,1,0,1,1
01228315,8,3,5,0,0,0,0,0,1
01228574,32,7,25,0,0,0,0,0,1
01228634,8,5,3,0,1,1,0,1,1
01228770,25,3,22,0,1,1,0,1,1
01228879,6,0,6,0,0,0,0,0,1
01229010,11,4,7,0,1,1,0,1,0
01229083,29,8,21,0,0,0,0,0,1
01229214,21,2,19,0,1,1,0,1,1
01229676,40,8,32,0,1,1,0,1,1
01229741,35,9,26,0,0,0,0,0,1
01230123,13,3,10,0,2,2,0,2,1
01230372,11,3,8,0,0,0,0,0,0
01230808,14,0,14,0,1,1,0,1,1
01231169,24,3,21,0,1,1,0,1,1
01231725,69,12,57,0,0,0,0,0,1
01231818,6,3,3,0,2,2,0,0,1
01231909,54,15,39,0,0,0,0,0,1
01232182,63,13,50,0,0,0,0,0,1
01232328,6,3,3,0,2,2,0,0,0
01232696,18,3,15,0,0,0,0,0,1
01233034,33,9,24,0,0,0,0,0,1
01233201,34,6,28,0,1,1,0,1,1
01233403,5,0,5,0,0,0,0,0,1
01233832,24,0,24,0,0,0,0,0,1
01233960,33,3,30,0,0,0,0,0,1
01233997,23,4,19,0,1,1,0,1,1
01234360,62,0,62,0,1,1,0,1,1
01234734,11,4,7,0,5,2,3,0,1
01235124,39,4,35,0,1,1,0,1,1
01235144,9,4,5,0,1,1,0,0,0
01235198,14,4,10,0,1,1,0,0,1
01235583,30,3,27,0,2,1,1,2,1
01235675,16,3,13,0,0,0,0,0,1
01235732,40,9,31,0,0,0,0,0,1
01235763,25,7,18,0,0,0,0,0,1
01235774,2,2,0,0,1,1,0,0,0
01235951,25,2,23,0,1,1,0,1,1
01236062,16,4,12,0,1,1,0,1,1
01236348,4,2,2,0,0,0,0,0,0
01236501,4,2,2,0,1,1,0,0,0
01236884,41,0,41,0,0,0,0,0,1
01236973,40,4,36,0,2,1,1,2,1
01237167,62,3,59,0,1,1,0,1,1
01237555,25,3,22,0,1,1,0,1,1
01237716,37,2,35,0,0,0,0,0,1
01238274,64,6,58,0,1,1,0,1,1
01238636,12,6,6,0,3,1,2,3,1
01238923,28,6,22,0,1,1,0,1,1
01239211,52,12,40,0,13,13,0,0,1
01239748,44,8,36,0,2,1,1,0,1
01239974,13,5,8,0,2,2,0,0,1
01240273,7,5,2,0,2,1,1,0,0
01240677,47,4,43,0,1,1,0,1,1
01240835,44,3,41,0,1,1,0,0,1
01241108,44,6,38,0,0,0,0,0,0
01241117,22,0,22,0,0,0,0,0,1
01241118,35,0,35,0,0,0,0,0,1
01241267,23,0,23,0,0,0,0,0,1
01242271,17,2,15,0,0,0,0,0,1
01242502,15,3,12,0,2,1,1,1,1
01242768,9,4,5,0,0,0,0,0,1
01243489,11,0,11,0,1,1,0,1,1
01244052,121,17,104,0,0,0,0,0,1
01244084,26,4,22,0,1,1,0,1,1
01244377,40,6,34,0,1,1,0,0,1
01244831,35,2,33,0,1,1,0,1,1
01244848,15,4,11,0,1,0,1,0,0
01245009,7,4,3,0,2,2,0,1,0
01245065,28,2,26,0,0,0,0,0,1
01245304,50,7,43,0,1,1,0,1,1
01245325,9,0,9,0,0,0,0,0,1
01245534,29,4,25,0,1,1,0,1,1
01245626,9,0,9,0,0,0,0,0,1
01245757,6,2,4,0,1,1,0,1,0
01246047,3,3,0,0,1,1,0,0,0
01246789,14,3,11,0,0,0,0,0,0
01246837,13,3,10,0,3,3,0,0,1
01247052,10,4,6,0,1,1,0,1,1
01247285,51,7,44,0,0,0,0,0,1
01247541,89,14,75,0,1,1,0,1,1
01247797,79,12,67,0,0,0,0,0,1
01248144,23,0,23,0,0,0,0,0,1
01248617,19,7,12,0,0,0,0,0,1
01248622,36,5,31,0,1,1,0,1,1
01248819,36,8,28,0,0,0,0,0,0
01248899,90,22,68,0,0,0,0,0,1
01249128,6,2,4,0,1,1,0,1,1
01249134,23,0,23,0,0,0,0,0,1
01249266,8,4,4,0,1,1,0,1,1
01249444,7,2,5,0,0,0,0,0,0
01249842,155,16,139,0,0,0,0,0,1
01250558,23,5,18,0,1,1,0,1,1
01251091,17,0,17,0,0,0,0,0,0
01251156,9,3,6,0,1,0,1,0,0
01251222,14,4,10,0,1,1,0,1,1
01251298,18,2,16,0,1,1,0,1,1
01251408,26,4,22,0,0,0,0,0,1
01251457,4,4,0,0,0,0,0,0,0
01251949,27,3,24,0,1,1,0,1,1
01252225,30,3,27,0,0,0,0,0,1
01252250,22,0,22,0,0,0,0,0,1
01252595,78,18,60,0,1,1,0,0,1
01252688,25,2,23,0,1,1,0,1,1
01252772,14,6,8,0,0,0,0,0,1
01253305,22,0,22,0,0,0,0,0,1
01254110,46,5,41,0,0,0,0,0,1
01254429,6,3,3,0,1,1,0,0,0
01254818,2,2,0,0,2,2,0,0,0
01254833,58,5,53,0,1,0,1,0,1
01255150,24,0,24,0,1,1,0,1,1
01255762,36,11,25,0,0,0,0,0,1
01256051,18,3,15,0,1,1,0,1,1
01256111,18,5,13,1,0,0,0,0,1
01256316,34,3,31,0,0,0,0,0,0
01256710,8,5,3,0,0,0,0,0,1
01256779,30,9,21,0,0,0,0,0,0
01256821,9,4,5,0,1,1,0,1,1
01257038,43,0,43,0,1,1,0,1,1
01257836,13,0,13,0,0,0,0,0,1
01258241,24,0,24,0,0,0,0,0,1
01258450,21,2,19,0,1,1,0,1,1
01258656,40,7,33,0,0,0,0,0,1
01258925,3,2,1,0,1,1,0,0,1
01258930,26,0,26,0,0,0,0,0,1
01259720,11,3,8,0,2,2,0,2,1
01259900,20,11,9,0,0,0,0,0,1
01260160,12,3,9,0,0,0,0,0,1
01260275,57,4,53,0,1,1,0,1,1
01260333,4,2,2,0,1,1,0,0,0
01261717,47,3,44,0,0,0,0,0,0
01261826,5,1,4,0,2,1,1,0,0
01261902,34,3,31,0,1,1,0,1,1
01262027,25,3,22,0,2,2,0,2,1
01262100,87,7,80,0,0,0,0,0,1
01262387,36,14,22,0,0,0,0,0,1
01263157,5,3,2,0,1,1,0,0,0
01263250,22,4,18,0,0,0,0,0,0
01263305,28,0,28,0,1,1,0,1,1
01263446,64,3,61,0,3,2,1,1,1
01263539,12,0,12,0,1,1,0,0,1
01263540,371,13,358,0,0,0,0,0,1
01263586,24,7,17,0,1,1,0,1,1
01263742,278,19,259,0,0,0,0,0,1
01264006,10,3,7,0,3,3,0,0,0
01264044,3,2,1,0,1,1,0,0,0
01264330,34,3,31,0,1,1,0,1,1
01264385,59,3,56,0,1,1,0,1,1
01264522,43,3,40,0,1,1,0,1,1
01265825,38,15,23,0,0,0,0,0,1
01266292,15,4,11,0,1,1,0,1,1
01266357,18,4,14,0,1,1,0,1,1
01266862,12,3,9,0,1,1,0,0,1
01267122,53,0,53,0,0,0,0,0,1
01267231,59,2,57,0,1,1,0,1,1
01267496,32,5,27,2,1,1,0,1,1
01267959,36,0,36,0,0,0,0,0,1
01268436,59,7,52,0,0,0,0,0,1
01268762,0,0,0,0,0,0,0,0,0
01269004,37,7,30,0,0,0,0,0,0
01269407,6,3,3,0,2,2,0,0,1
01269507,44,12,32,0,0,0,0,0,1
01269693,7,3,4,0,2,2,0,0,0
01269766,10,5,5,0,4,4,0,0,0
01269848,70,20,50,0,2,2,0,0,1
01269937,116,10,106,0,0,0,0,0,1
01270381,28,0,28,0,1,1,0,1,1
01270675,44,10,34,0,0,0,0,0,1
01270770,26,7,19,0,0,0,0,0,1
01270826,7,5,2,0,2,2,0,0,0
01271552,36,4,32,0,1,1,0,1,1
01271767,9,3,6,0,2,2,0,0,1
01271920,17,3,14,0,1,1,0,1,1
01272079,5,5,0,0,1,1,0,1,0
01272126,9,3,6,0,1,1,0,1,1
01272537,22,3,19,0,1,1,0,1,1
01272556,20,0,20,0,0,0,0,0,1
01272557,21,0,21,0,0,0,0,0,1
01272585,21,0,21,0,2,1,1,2,1
01272781,14,2,12,0,1,1,0,0,1
01273462,40,6,34,0,0,0,0,0,1
01273531,50,12,38,0,0,0,0,0,1
01273543,3,3,0,0,2,2,0,0,0
01273790,25,4,21,0,1,1,0,1,1
01273848,32,2,30,0,0,0,0,0,1
01273880,19,4,15,0,0,0,0,0,0
01273969,18,3,15,0,1,1,0,0,1
01274280,96,8,88,0,0,0,0,0,1
01274384,5,1,4,0,1,1,0,0,0
01274806,17,3,14,0,2,2,0,2,1
01275155,22,0,22,0,0,0,0,0,1
01275302,23,0,23,0,0,0,0,0,1
01276102,5,4,1,0,1,1,0,0,0
01277502,46,0,46,0,1,1,0,1,1
01277722,15,4,11,0,1,1,0,1,1
01277972,9,1,8,0,2,2,0,0,1
01277975,14,1,13,0,0,0,0,0,1
01278058,19,0,19,0,1,1,0,1,1
01278131,28,3,25,0,1,1,0,1,0
01278181,14,4,10,0,4,2,2,0,1
01278322,3,2,1,0,1,1,0,0,0
01278356,17,3,14,0,2,2,0,0,0
01279045,8,0,8,0,0,0,0,0,1
01279056,32,4,28,0,0,0,0,0,1
01279230,11,3,8,0,1,1,0,1,1
01280113,0,0,0,0,0,0,0,0,0
01280142,49,2,47,0,2,1,1,2,1
01280214,4,2,2,0,1,1,0,0,0
01280228,15,4,11,0,1,1,0,1,1
01280324,8,2,6,0,1,1,0,1,1
01280372,16,0,16,0,0,0,0,0,1
01280586,5,2,3,0,2,2,0,1,0
01280778,29,5,24,0,1,1,0,1,1
01281232,44,2,42,0,1,1,0,1,1
01281440,136,0,136,0,0,0,0,0,1
01282453,26,0,26,0,1,1,0,1,1
01282692,8,3,5,0,2,2,0,0,1
01282829,20,2,18,0,1,1,0,1,1
01283174,0,0,0,0,0,0,0,0,1
01283275,10,3,7,0,1,1,0,1,0
01283845,16,3,13,0,1,1,0,1,1
04179291,14,5,9,0,0,0,0,0,1
04179374,7,0,7,0,0,0,0,0,1
04179465,34,3,31,0,1,1,0,1,1
04179503,29,6,23,0,1,1,0,1,1
04179505,8,3,5,0,1,1,0,1,1
04179678,8,3,5,0,1,1,0,0,1
04179687,4,0,4,0,0,0,0,0,1
04179747,18,9,9,0,0,0,0,0,0
04179797,16,5,11,0,1,1,0,1,1
04180022,4,2,2,0,1,1,0,0,1
04180163,44,12,32,0,0,0,0,0,1
04180256,10,4,6,0,1,1,0,0,1
04180295,4,1,3,0,2,2,0,0,1
04180478,42,2,40,0,1,1,0,0,1
04180520,8,0,8,0,0,0,0,0,1
04180731,13,1,12,0,0,0,0,0,1
04180826,10,2,8,0,1,1,0,0,0
04180838,6,2,4,0,0,0,0,0,0
04181121,14,6,8,0,0,0,0,0,0
04181288,9,5,4,0,0,0,0,0,0
04181366,18,6,12,0,1,1,0,1,1
04181384,38,4,34,0,2,1,1,2,1
04181593,53,11,42,0,1,1,0,0,1
04181656,5,3,2,0,2,2,0,0,1
04181662,13,3,10,0,1,1,0,0,1
04181890,13,0,13,0,1,1,0,1,1
04181928,17,4,13,0,2,1,1,2,1
04181937,19,3,16,0,1,1,0,1,1
04182449,25,3,22,0,1,1,0,1,1
04182567,50,8,42,0,0,0,0,0,1
04183050,40,7,33,0,0,0,0,0,1
04183102,29,11,18,0,0,0,0,0,1
04183314,17,4,13,0,0,0,0,0,1
04183580,14,6,8,0,0,0,0,0,1
04183599,14,3,11,0,2,2,0,1,1
04183686,6,3,3,0,2,2,0,0,0
04184611,13,1,12,0,1,1,0,1,1
04184699,15,2,13,0,0,0,0,0,1
04185110,21,3,18,0,1,1,0,1,1
04185171,20,0,20,0,2,1,1,2,1
04185230,18,3,15,0,2,1,1,2,1
04185316,104,23,81,0,0,0,0,0,1
04185643,16,4,12,0,0,0,0,0,1
04185784,5,2,3,0,2,2,0,0,1
04186076,6,2,4,0,1,1,0,0,1
04186093,8,2,6,0,2,2,0,0,0
04186148,7,3,4,0,1,1,0,0,1
04186543,15,0,15,0,0,0,0,0,1
04186544,18,6,12,0,1,1,0,0,1
04186547,5,2,3,0,1,1,0,0,1
04186733,17,0,17,0,0,0,0,0,1
04186739,10,0,10,0,0,0,0,0,1
04186887,4,2,2,0,2,2,0,0,0
04186902,15,3,12,0,1,1,0,1,1
04187040,37,5,32,0,1,1,0,1,1
04187042,14,4,10,0,1,1,0,1,1
04187052,10,0,10,0,0,0,0,0,1
04187057,15,6,9,0,0,0,0,0,1
04187071,5,1,4,0,1,1,0,0,1
04187081,31,7,24,0,4,1,3,0,1
04187128,15,0,15,0,0,0,0,0,1
04187205,7,2,5,0,1,1,0,0,1
04187209,4,2,2,0,1,1,0,0,1
04187226,7,2,5,0,0,0,0,0,1
04187346,36,3,33,0,1,1,0,1,1
04187398,4,2,2,0,1,1,0,0,0
04187692,4,2,2,0,1,1,0,0,1
04187858,4,2,2,0,1,1,0,0,1
04187957,8,1,7,0,1,1,0,0,0
04187979,11,4,7,0,1,1,0,1,0
04188005,4,2,2,0,1,1,0,0,1
04188053,5,2,3,0,2,2,0,0,0
04188073,25,0,25,0,0,0,0,0,1
04188152,23,9,14,0,0,0,0,0,1
04188159,17,0,17,0,1,1,0,1,1
04188402,20,3,17,0,2,1,1,2,1
04188434,28,4,24,0,0,0,0,0,1
04188445,5,3,2,0,1,1,0,0,0
04188491,19,7,12,0,1,1,0,1,1
04188497,4,1,3,0,1,1,0,0,1
04188591,50,16,34,0,0,0,0,0,1
04188657,6,2,4,0,1,1,0,0,1
04188929,5,3,2,0,2,2,0,0,1
04189044,27,10,17,0,0,0,0,0,1
04189211,11,3,8,0,2,2,0,0,1
04189239,12,0,12,0,0,0,0,0,1
04189502,9,0,9,0,0,0,0,0,1
04189531,9,3,6,0,1,1,0,0,1
04189754,5,3,2,0,2,2,0,0,1
04189876,27,5,22,0,1,1,0,0,0
04189976,29,3,26,0,1,1,0,1,1
04190151,16,0,16,0,0,0,0,0,1
04190153,17,0,17,0,0,0,0,0,1
04190170,15,0,15,0,0,0,0,0,1
04190179,16,0,16,0,0,0,0,0,1
04190230,49,8,41,0,0,0,0,0,1
04190486,6,3,3,0,0,0,0,0,0
04190624,26,9,17,0,0,0,0,0,1
04190662,13,4,9,0,1,1,0,1,1
04190816,52,12,40,0,0,0,0,0,1
04191122,50,14,36,0,1,1,0,1,1
04191312,10,4,6,0,2,2,0,0,1
04191340,4,2,2,0,2,2,0,0,1
04191520,7,3,4,0,1,1,0,0,0
04191670,5,3,2,0,2,2,0,0,0
04191744,11,2,9,0,0,0,0,0,1
04191756,10,2,8,0,0,0,0,0,1
04191927,15,3,12,0,1,1,0,1,1
04192035,7,2,5,0,3,2,1,0,1
04192358,8,2,6,0,2,2,0,0,0
04192424,22,9,13,0,0,0,0,0,1
04192918,7,2,5,0,2,2,0,1,1
04193099,6,2,4,0,1,1,0,0,1
04193536,13,3,10,0,1,1,0,1,1
04194085,17,3,14,0,0,0,0,0,0
04194155,5,0,5,0,0,0,0,0,0
04194208,71,16,55,0,0,0,0,0,1
04194542,43,10,33,0,0,0,0,0,1
04194548,25,7,18,0,1,0,1,1,1
04194827,40,8,32,0,0,0,0,0,1
04195114,17,0,17,0,0,0,0,0,1
04195141,7,2,5,0,1,1,0,0,1
04195146,13,5,8,0,0,0,0,0,1
04195386,11,4,7,0,0,0,0,0,1
04195554,23,6,17,0,3,3,0,0,1
04195561,24,5,19,0,0,0,0,0,1
04195591,10,3,7,0,0,0,0,0,1
04195617,28,2,26,0,1,1,0,1,1
04195718,35,0,35,0,0,0,0,0,1
04195775,7,2,5,0,1,1,0,0,0
04195832,7,2,5,0,0,0,0,0,1
04196040,46,9,37,0,0,0,0,0,1
04196341,34,9,25,0,2,2,0,2,1
04196519,24,2,22,0,1,1,0,1,1
04196848,6,4,2,0,3,3,0,0,0
04197067,31,1,30,0,0,0,0,0,1
04197416,19,4,15,0,1,1,0,1,0
04197633,20,2,18,0,1,1,0,1,1
04197837,16,4,12,0,1,1,0,1,1
04197934,53,10,43,0,0,0,0,0,1
04197941,8,4,4,0,1,1,0,1,0
04197951,12,3,9,0,1,1,0,1,1
04198076,8,0,8,0,0,0,0,0,0
04198197,18,0,18,0,0,0,0,0,1
04198280,15,6,9,0,1,1,0,1,1
04198561,12,3,9,0,0,0,0,0,0
04199190,6,0,6,0,0,0,0,0,1
04199191,6,2,4,0,1,1,0,1,1
04199485,5,1,4,0,2,1,1,1,1
04199539,21,2,19,0,1,1,0,1,1
04199588,15,3,12,0,1,1,0,1,1
04199651,27,4,23,0,1,1,0,1,1
04199668,10,4,6,0,0,0,0,0,0
04199982,16,4,12,0,0,0,0,0,1
04200150,9,3,6,0,2,2,0,0,1
04200178,7,4,3,0,1,1,0,0,1
04200292,15,0,15,0,0,0,0,0,1
04200301,14,7,7,0,0,0,0,0,1
04200476,11,3,8,0,1,1,0,1,1
04200777,10,0,10,0,0,0,0,0,1
04201099,59,0,59,0,0,0,0,0,1
04201236,22,4,18,0,0,0,0,0,1
04201533,5,3,2,0,2,2,0,0,0
04201601,10,2,8,0,2,2,0,0,0
04201625,6,3,3,0,1,1,0,1,0
04202349,6,0,6,0,0,0,0,0,1
04202454,9,4,5,0,1,1,0,1,1
04202574,10,3,7,0,2,1,1,0,1
04202692,9,2,7,0,1,1,0,0,1
04203203,11,9,2,0,1,1,0,0,0
04203472,3,2,1,0,0,0,0,0,0
04203924,7,3,4,0,2,2,0,0,1
04204105,10,0,10,0,0,0,0,0,1
04204261,8,0,8,0,1,1,0,0,1
04204475,31,8,23,0,1,1,0,1,1
04204480,17,6,11,0,0,0,0,0,1
04204490,39,10,29,0,0,0,0,0,1
04204701,14,0,14,1,0,0,0,0,1
04205140,10,3,7,0,0,0,0,0,0
04205243,4,2,2,0,3,1,2,1,1
04205283,6,3,3,0,2,2,0,0,1
04205449,7,2,5,0,1,1,0,1,1
04205548,16,7,9,0,1,1,0,1,1
04205579,33,9,24,0,0,0,0,0,1
04205768,40,5,35,0,0,0,0,0,1
04205923,8,0,8,0,0,0,0,0,1
04206516,7,3,4,0,2,2,0,0,1
04206540,8,4,4,0,1,1,0,1,1
04206737,16,0,16,0,0,0,0,0,1
04206774,4,2,2,0,3,3,0,1,0
04207020,30,11,19,0,0,0,0,0,1
04207068,17,3,14,0,2,1,1,2,1
04207344,15,2,13,0,0,0,0,0,0
04207414,15,2,13,0,1,1,0,1,1
04207420,14,2,12,0,2,1,1,2,1
04207663,22,3,19,0,3,2,1,3,1
04208059,11,3,8,0,1,1,0,1,1
04208144,10,2,8,0,1,1,0,1,1
04208160,10,2,8,0,1,1,0,1,1
04208220,21,0,21,0,0,0,0,0,1
04208280,5,2,3,0,1,1,0,0,1
04208899,8,2,6,0,1,1,0,1,1
04209474,5,1,4,0,1,1,0,1,1
04209738,10,2,8,0,1,1,0,0,0
04209890,8,5,3,0,2,2,0,2,1
04210289,5,2,3,0,1,1,0,0,1
04210407,4,2,2,0,1,1,0,0,0
04210506,4,2,2,0,1,1,0,0,0
04210523,40,8,32,0,0,0,0,0,1
04210532,4,2,2,0,1,1,0,0,1
04210572,4,2,2,0,1,1,0,0,1
04210887,17,3,14,0,2,2,0,2,1
04211077,6,3,3,0,2,2,0,0,0
04211094,38,11,27,0,1,1,0,1,1
04211308,29,3,26,0,1,1,0,1,1
04211364,35,9,26,0,1,0,1,0,1
04211417,15,0,15,0,1,1,0,1,1
04211637,19,7,12,0,2,2,0,1,1
04211655,7,1,6,0,4,2,2,2,1
04211688,21,12,9,0,0,0,0,0,1
04212171,7,0,7,0,0,0,0,0,0
04212523,25,4,21,0,1,1,0,1,1
04212563,36,8,28,0,0,0,0,0,1
04212642,31,4,27,0,1,1,0,1,1
04212647,17,0,17,0,0,0,0,0,1
04212651,8,3,5,0,1,1,0,0,1
04212859,31,0,31,0,0,0,0,0,1
04212946,30,11,19,0,0,0,0,0,1
04213003,8,1,7,0,2,2,0,1,1
04213107,7,2,5,0,1,1,0,0,1
04213132,26,15,11,0,1,0,1,0,1
04213735,10,0,10,0,0,0,0,0,1
04213764,15,0,15,0,1,1,0,1,1
04214058,29,7,22,0,0,0,0,0,1
04214139,20,7,13,0,0,0,0,0,1
04214259,19,0,19,0,0,0,0,0,1
04214272,14,0,14,0,0,0,0,0,1
04214280,6,0,6,0,0,0,0,0,1
04214296,14,0,14,0,0,0,0,0,1
04214370,5,3,2,0,1,1,0,0,0
04214556,16,5,11,0,1,1,0,1,1
04214688,25,9,16,0,0,0,0,0,1
04214736,5,0,5,0,0,0,0,0,1
04214777,5,2,3,0,1,1,0,0,1
04215049,5,3,2,0,2,2,0,0,0
04215425,8,4,4,0,1,1,0,0,1
04215444,10,4,6,0,1,1,0,1,0
04216253,18,2,16,0,0,0,0,0,0
04216368,24,0,24,0,0,0,0,0,1
04216523,10,4,6,0,2,2,0,0,1
04216645,16,6,10,0,1,1,0,1,1
04216648,10,6,4,0,1,1,0,1,1
04216782,20,0,20,0,0,0,0,0,1
04216809,20,0,20,0,0,0,0,0,1
04216823,34,1,33,0,3,1,2,3,1
04216858,34,1,33,0,3,1,2,3,1
04216868,34,1,33,0,3,1,2,3,1
04216881,34,1,33,0,3,1,2,3,1
04216938,33,4,29,0,2,1,1,2,1
04216956,8,5,3,0,1,1,0,0,1
04217058,7,0,7,0,0,0,0,0,1
04217267,18,0,18,0,0,0,0,0,1
04217293,8,0,8,0,0,0,0,0,1
04217356,3,1,2,0,0,0,0,0,1
04217374,3,1,2,0,0,0,0,0,1
04217385,3,1,2,0,0,0,0,0,1
04217393,3,1,2,0,0,0,0,0,1
04217406,3,1,2,0,0,0,0,0,1
04217412,3,1,2,0,0,0,0,0,1
04217518,10,0,10,0,0,0,0,0,1
04217608,20,3,17,0,1,1,0,1,1
04217637,11,0,11,0,0,0,0,0,1
04217708,4,2,2,0,1,1,0,0,1
04217719,22,0,22,0,0,0,0,0,1
04217819,6,0,6,0,1,1,0,1,1
04217916,21,6,15,0,1,1,0,1,1
04217941,31,3,28,0,1,1,0,1,1
04218015,12,0,12,0,0,0,0,0,1
04218234,38,6,32,0,1,1,0,1,1
04218258,15,4,11,0,1,1,0,0,1
04218513,8,0,8,0,0,0,0,0,1
04218701,18,7,11,0,0,0,0,0,1
04218721,33,0,33,0,1,1,0,1,1
04218999,3,1,2,0,0,0,0,0,1
04219007,3,1,2,0,0,0,0,0,1
04219008,3,1,2,0,0,0,0,0,1
04219022,3,1,2,0,0,0,0,0,1
04219047,19,0,19,0,0,0,0,0,1
04219485,28,5,23,0,1,1,0,1,0
04219556,25,3,22,0,1,1,0,0,1
04219663,18,5,13,0,0,0,0,0,0
04219710,15,10,5,0,1,1,0,0,1
04219828,7,1,6,0,1,1,0,1,0
04219952,7,2,5,0,1,1,0,1,1
04219956,6,2,4,0,2,2,0,0,1
04219995,3,1,2,0,0,0,0,0,1
04220161,8,2,6,0,2,2,0,0,1
04220217,3,1,2,0,0,0,0,0,1
04220226,3,1,2,0,0,0,0,0,1
04220231,3,1,2,0,0,0,0,0,1
04220381,28,6,22,0,1,1,0,1,1
04220587,52,12,40,0,0,0,0,0,1
04220623,7,3,4,0,2,2,0,0,0
04220628,5,2,3,0,2,2,0,0,1
04220649,30,8,22,0,1,1,0,0,1
04220818,5,0,5,0,2,1,1,0,1
04220996,16,3,13,0,0,0,0,0,1
04221080,41,0,41,0,0,0,0,0,1
04221347,23,0,23,0,0,0,0,0,1
04221429,109,12,97,0,0,0,0,0,1
04221621,5,0,5,0,0,0,0,0,1
04221720,10,0,10,0,0,0,0,0,1
04221822,44,13,31,0,0,0,0,0,1
04222000,5,3,2,0,2,2,0,0,0
04222109,17,2,15,0,3,1,2,1,1
04222161,5,2,3,0,1,1,0,0,0
04222730,39,3,36,0,1,1,0,1,1
04222989,6,3,3,0,1,1,0,0,1
04223070,12,0,12,0,0,0,0,0,1
04223199,20,0,20,0,0,0,0,0,1
04223618,5,2,3,0,0,0,0,0,1
04223635,11,2,9,0,1,1,0,1,1
04223669,12,5,7,0,0,0,0,0,1
04223757,12,0,12,0,0,0,0,0,1
04223875,13,0,13,0,0,0,0,0,1
04223927,17,5,12,0,0,0,0,0,1
04223972,7,1,6,0,1,1,0,0,1
04224010,17,5,12,0,1,1,0,1,1
04224024,10,0,10,0,0,0,0,0,1
04224586,11,0,11,0,0,0,0,0,1
04224861,15,3,12,0,0,0,0,0,1
04224877,6,3,3,0,2,2,0,0,0
04224891,27,7,20,0,0,0,0,0,1
04225238,6,0,6,0,0,0,0,0,1
04225307,18,10,8,0,0,0,0,0,1
04225842,8,3,5,0,2,2,0,0,1
04226264,13,6,7,0,0,0,0,0,1
04226824,13,3,10,0,1,1,0,1,1
04226902,9,1,8,0,1,1,0,0,1
04226919,7,2,5,0,1,1,0,0,1
04226978,4,1,3,0,1,1,0,0,0
04226986,13,4,9,0,1,1,0,1,1
04227200,5,3,2,0,2,2,0,0,0
04227452,20,0,20,0,0,0,0,0,1
04227520,27,0,27,0,0,0,0,0,1
04228155,25,0,25,0,0,0,0,0,1
04228706,34,10,24,0,1,1,0,1,1
04228843,30,9,21,0,0,0,0,0,1
04229324,26,8,18,0,0,0,0,0,1
04229509,20,15,5,0,3,1,2,1,1
04229621,9,3,6,0,1,1,0,1,1
04229646,7,0,7,0,0,0,0,0,1
04229671,5,2,3,0,1,1,0,0,1
04229819,26,0,26,0,0,0,0,0,1
04229861,6,2,4,0,2,2,0,0,1
04230126,16,0,16,0,0,0,0,0,0
04230439,31,0,31,0,0,0,0,0,1
04230694,7,1,6,0,0,0,0,0,0
04230864,8,2,6,0,1,1,0,0,0
04230906,31,6,25,0,1,1,0,1,1
04231155,27,7,20,1,1,1,0,1,1
04231189,6,3,3,0,2,2,0,0,0
04231260,24,5,19,0,0,0,0,0,1
04231910,23,0,23,0,0,0,0,0,1
04231944,3,1,2,0,0,0,0,0,1
04232045,13,0,13,0,0,0,0,0,1
04232069,7,2,5,0,0,0,0,0,1
04232378,7,3,4,0,4,4,0,1,0
04232403,20,0,20,0,0,0,0,0,1
04232573,8,5,3,0,1,1,0,0,1
04232748,14,3,11,0,3,1,2,1,1
04232750,19,6,13,0,1,1,0,1,1
04232789,21,2,19,0,1,1,0,1,1
04232990,6,3,3,0,1,1,0,0,1
04233033,28,0,28,0,0,0,0,0,1
04233175,5,3,2,0,2,2,0,0,1
04233181,14,2,12,0,1,1,0,0,1
04233263,18,5,13,0,0,0,0,0,0
04233392,15,8,7,0,1,1,0,0,0
04234153,18,5,13,0,1,1,0,1,1
04234803,6,2,4,0,1,1,0,1,1
04235039,11,0,11,0,1,1,0,1,1
04235180,12,2,10,0,1,1,0,1,1
04235308,7,2,5,0,2,2,0,0,0
04235613,44,4,40,0,1,1,0,1,1
04236050,23,4,19,0,0,0,0,0,1
04236083,14,5,9,0,1,1,0,1,1
04236414,32,6,26,0,0,0,0,0,1
04236536,13,2,11,0,1,1,0,1,1
04236630,4,1,3,0,2,2,0,0,1
04237072,9,3,6,0,0,0,0,0,0
04237091,7,6,1,0,1,1,0,1,0
04237115,10,0,10,0,0,0,0,0,1
04237146,38,0,38,0,0,0,0,0,1
04237327,36,6,30,0,1,1,0,1,1
04237587,35,7,28,0,1,1,0,1,1
04237897,16,4,12,0,1,1,0,1,1
04237917,4,3,1,0,2,2,0,0,1
04238102,15,0,15,0,0,0,0,0,1
04238273,12,2,10,0,3,2,1,0,0
04238474,5,4,1,0,0,0,0,0,1
04238475,5,0,5,0,0,0,0,0,1
04238980,3,1,2,0,0,0,0,0,1
04238984,3,1,2,0,0,0,0,0,1
04239148,4,2,2,0,1,1,0,0,0
04239718,10,1,9,0,2,1,1,0,0
04239737,25,9,16,0,1,1,0,0,1
04239895,6,4,2,0,3,3,0,0,0
04239982,10,0,10,0,0,0,0,0,1
04239993,5,2,3,0,1,1,0,0,1
04239994,20,3,17,0,2,2,0,2,0
04313359,8,2,6,0,1,1,0,0,1
04313537,17,0,17,0,0,0,0,0,1
04313833,18,0,18,0,0,0,0,0,1
04313890,27,5,22,0,1,1,0,1,1
04314083,15,3,12,0,2,1,1,0,1
04314287,9,0,9,0,0,0,0,0,1
04314323,9,3,6,0,2,2,0,0,1
04314425,7,0,7,0,0,0,0,0,1
04314427,6,0,6,0,0,0,0,0,1
04314432,31,6,25,0,1,1,0,1,1
04314436,4,0,4,0,0,0,0,0,1
04314538,26,7,19,0,0,0,0,0,0
04314586,8,2,6,0,1,1,0,0,0
04314611,14,0,14,0,0,0,0,0,1
04314612,17,6,11,0,3,3,0,0,1
04314638,12,6,6,0,1,1,0,1,1
04314655,14,0,14,0,0,0,0,0,1
04314690,14,0,14,0,0,0,0,0,1
04314703,16,6,10,0,3,3,0,0,1
04314893,10,4,6,0,0,0,0,0,1
04315417,0,0,0,0,0,0,0,0,1
04315794,5,3,2,0,0,0,0,0,1
04315974,7,0,7,0,0,0,0,0,1
04316368,18,6,12,0,0,0,0,0,0
04316482,4,2,2,0,3,3,0,0,1
04316510,13,3,10,0,1,1,0,1,1
04316530,10,3,7,0,3,3,0,0,1
04316800,34,4,30,0,1,1,0,1,1
04316888,33,0,33,0,0,0,0,0,1
04316892,14,2,12,0,3,2,1,0,1
04317421,25,3,22,0,1,1,0,1,1
04317778,5,0,5,0,0,0,0,0,1
04318066,17,0,17,0,0,0,0,0,1
04318120,22,2,20,0,2,1,1,2,1
04318122,22,0,22,0,0,0,0,0,1
04318197,7,3,4,0,2,2,0,0,0
04318494,27,3,24,0,1,1,0,1,1
04318770,14,2,12,0,2,2,0,0,1
04318796,8,5,3,0,0,0,0,0,1
04318810,31,7,24,0,2,1,1,0,1
04319146,11,2,9,0,1,1,0,1,0
04319327,23,0,23,0,1,1,0,1,1
04319481,10,0,10,0,0,0,0,0,1
04319668,21,0,21,0,0,0,0,0,1
04319675,29,0,29,0,0,0,0,0,1
04319768,5,0,5,0,0,0,0,0,1
04319827,11,2,9,0,1,1,0,0,1
04319979,10,0,10,0,0,0,0,0,1
04320125,24,3,21,0,7,4,3,1,1
04320201,30,4,26,0,2,1,1,2,1
04320338,4,2,2,0,2,2,0,0,1
04320421,8,2,6,0,1,1,0,0,1
04320565,7,0,7,0,1,1,0,0,1
04320596,6,2,4,0,1,1,0,0,1
04320643,41,4,37,0,1,1,0,1,1
04320686,10,2,8,0,2,2,0,0,1
04320696,29,4,25,0,1,1,0,1,1
04320871,22,0,22,0,0,0,0,0,0
04321173,34,7,27,0,10,8,2,0,0
04321205,9,3,6,0,1,1,0,0,0
04321231,12,5,7,0,0,0,0,0,1
04321288,5,3,2,0,1,1,0,1,1
04321292,5,3,2,0,1,1,0,1,1
04321342,16,4,12,0,4,4,0,0,1
04321397,18,5,13,0,0,0,0,0,1
04321466,16,2,14,0,1,1,0,0,1
04321566,4,2,2,0,1,1,0,0,1
04321630,4,2,2,0,1,1,0,0,1
04321657,31,3,28,0,1,1,0,1,1
04321726,9,2,7,0,1,1,0,1,1
04322101,42,11,31,0,0,0,0,0,0
04322304,7,3,4,0,1,1,0,1,0
04322336,7,3,4,0,2,2,0,0,1
04322721,18,4,14,0,1,1,0,1,1
04322751,19,0,19,0,1,1,0,1,1
04323296,40,8,32,0,1,1,0,0,1
04323337,5,1,4,0,1,1,0,0,1
04323362,12,0,12,0,0,0,0,0,1
04323423,5,2,3,0,1,1,0,0,1
04323645,31,9,22,0,0,0,0,0,1
04323776,10,4,6,0,1,1,0,1,1
04324021,10,4,6,0,1,1,0,0,1
04324049,17,2,15,0,1,1,0,1,1
04324062,13,2,11,0,2,2,0,0,1
04324065,11,5,6,0,1,1,0,0,1
04324156,13,0,13,0,0,0,0,0,1
04324182,6,1,5,0,1,1,0,0,1
04324211,11,5,6,0,1,1,0,0,1
04324632,34,14,20,0,0,0,0,0,1
04324874,18,0,18,0,0,0,0,0,1
04324875,4,0,4,0,1,1,0,0,0
04324937,16,4,12,0,0,0,0,0,1
04325104,5,2,3,0,1,1,0,0,1
04325234,73,13,60,0,0,0,0,0,1
04325272,58,11,47,0,0,0,0,0,1
04325287,45,9,36,0,0,0,0,0,1
04325289,12,2,10,0,1,1,0,1,0
04325521,15,4,11,0,0,0,0,0,1
04325854,9,3,6,0,4,1,3,1,0
04325961,30,8,22,0,1,1,0,1,1
04326018,7,3,4,0,2,1,1,1,1
04326098,18,0,18,0,0,0,0,0,1
04326135,12,0,12,0,0,0,0,0,1
04326231,43,10,33,0,0,0,0,0,1
04326525,6,2,4,0,1,1,0,0,1
04326560,35,5,30,0,1,1,0,1,1
04326612,20,4,16,0,0,0,0,0,1
04326998,10,5,5,0,0,0,0,0,0
04327065,9,4,5,0,1,1,0,1,1
04327286,10,3,7,0,1,1,0,1,1
04327377,9,3,6,0,1,1,0,0,0
04327411,4,2,2,0,1,1,0,0,0
04327504,13,2,11,0,0,0,0,0,1
04327554,27,8,19,0,0,0,0,0,0
04327699,35,7,28,0,0,0,0,0,1
04327718,5,1,4,0,1,1,0,0,1
04327725,14,2,12,0,4,2,2,0,1
04327762,11,2,9,0,1,1,0,0,1
04328020,8,3,5,0,2,2,0,0,1
04328138,12,5,7,0,1,1,0,1,1
04328242,26,4,22,0,1,1,0,1,1
04328307,5,3,2,0,2,2,0,0,1
04328430,19,5,14,0,1,1,0,0,1
04328881,7,3,4,0,1,1,0,0,1
04328885,21,5,16,0,1,1,0,1,1
04329225,11,2,9,0,1,1,0,0,0
04329355,29,6,23,0,0,0,0,0,1
04329399,15,0,15,0,1,1,0,1,1
04329558,48,12,36,0,0,0,0,0,0
04329570,10,2,8,0,2,2,0,0,0
04329682,30,5,25,0,0,0,0,0,0
04329806,9,4,5,0,1,1,0,1,1
04329816,9,2,7,0,1,1,0,1,1
04329826,9,2,7,0,1,1,0,1,1
04329853,6,3,3,0,2,2,0,0,1
04329938,4,0,4,0,1,1,0,0,0
04329960,25,0,25,0,0,0,0,0,1
04330018,50,12,38,0,1,1,0,1,1
04330122,29,0,29,0,0,0,0,0,1
04330144,33,11,22,0,1,1,0,1,1
04330148,22,0,22,0,0,0,0,0,1
04330235,24,5,19,0,1,1,0,1,1
04330322,33,11,22,0,1,1,0,1,1
04330346,7,0,7,0,0,0,0,0,1
04330424,8,2,6,0,1,1,0,1,0
04330671,13,0,13,0,1,1,0,0,1
04330748,17,0,17,0,0,0,0,0,0
04331102,7,1,6,0,1,1,0,0,1
04331329,4,4,0,0,0,0,0,0,1
04331526,4,2,2,0,2,2,0,0,1
04331618,4,2,2,0,1,1,0,0,0
04331797,14,3,11,0,0,0,0,0,1
04331916,28,9,19,0,2,2,0,0,1
04331949,30,3,27,1,1,1,0,1,1
04332473,15,10,5,0,0,0,0,0,1
04332557,5,3,2,0,2,2,0,0,0
04332699,12,5,7,0,3,3,0,0,0
04332799,21,3,18,0,1,1,0,0,1
04332858,40,0,40,0,0,0,0,0,1
04332902,12,0,12,0,0,0,0,0,0
04333030,7,0,7,0,2,2,0,0,0
04333368,5,0,5,0,0,0,0,0,1
04333558,7,4,3,0,1,1,0,0,1
04333820,8,1,7,0,1,1,0,0,1
04333875,46,10,36,0,0,0,0,0,1
04333963,48,12,36,0,0,0,0,0,1
04334042,16,3,13,0,1,1,0,1,1
04334246,4,2,2,0,1,1,0,0,1
04334432,45,5,40,0,0,0,0,0,1
04334488,29,10,19,0,0,0,0,0,1
04334495,24,2,22,0,0,0,0,0,1
04334966,19,2,17,0,1,1,0,0,1
04334975,23,5,18,0,0,0,0,0,1
04335114,17,0,17,0,0,0,0,0,1
04335331,31,8,23,0,4,4,0,4,1
04335353,7,0,7,0,0,0,0,0,1
04335715,46,14,32,0,0,0,0,0,1
04335757,11,0,11,0,1,1,0,1,1
04335980,5,3,2,0,2,2,0,0,0
04336052,33,12,21,0,0,0,0,0,1
04336208,24,8,16,0,0,0,0,0,1
04336314,20,5,15,0,0,0,0,0,0
04336357,5,3,2,0,2,2,0,0,0
04336719,34,8,26,0,0,0,0,0,1
04336738,62,12,50,0,1,1,0,1,1
04336899,27,8,19,0,0,0,0,0,1
04337394,35,0,35,0,0,0,0,0,0
04337597,4,0,4,0,0,0,0,0,1
04337649,14,0,14,0,0,0,0,0,1
04337817,5,1,4,0,2,1,1,0,0
04338129,18,3,15,0,1,1,0,0,0
04338144,13,0,13,0,0,0,0,0,1
04338151,13,0,13,0,0,0,0,0,1
04338525,17,7,10,0,0,0,0,0,1
04338560,26,0,26,0,0,0,0,0,1
04338561,20,1,19,0,6,1,5,1,1
04338639,23,6,17,0,0,0,0,0,1
04338767,13,0,13,0,0,0,0,0,1
04338807,12,0,12,0,0,0,0,0,1
04338893,23,0,23,0,0,0,0,0,0
04338898,12,3,9,0,3,3,0,0,1
04338908,23,0,23,0,0,0,0,0,0
04338968,8,3,5,0,1,1,0,0,1
04339039,11,1,10,0,1,1,0,1,1
04339062,18,0,18,0,0,0,0,0,1
04339103,9,0,9,0,0,0,0,0,0
04339125,13,3,10,0,1,1,0,0,1
04339390,21,3,18,0,1,1,0,1,1
04339422,13,5,8,0,0,0,0,0,0
04339455,7,0,7,0,0,0,0,0,1
04339567,7,2,5,0,2,2,0,0,1
04339696,19,1,18,0,1,1,0,1,1
04339730,35,5,30,0,2,2,0,2,1
04340266,20,0,20,0,1,1,0,1,1
04340468,14,0,14,0,1,1,0,1,1
04340801,14,0,14,0,1,1,0,1,1
04340937,13,4,9,0,1,1,0,1,1
04341097,26,3,23,0,1,1,0,1,1
04341232,19,3,16,0,1,1,0,1,1
04341233,17,3,14,0,1,1,0,1,1
04341296,26,2,24,0,2,1,1,2,1
04341342,15,0,15,0,0,0,0,0,1
04341437,19,4,15,0,1,1,0,1,1
04341532,10,4,6,0,2,2,0,0,1
04341592,40,8,32,0,1,1,0,1,1
04341841,17,8,9,0,2,2,0,2,1
04341940,8,2,6,0,1,1,0,0,1
04342007,4,1,3,0,1,1,0,0,1
04342230,26,3,23,0,1,1,0,1,1
04342462,7,2,5,0,2,2,0,0,0
04342600,51,9,42,0,3,2,1,0,0
04342659,12,0,12,0,1,1,0,1,0
04342771,16,2,14,0,0,0,0,0,1
04342786,12,0,12,0,0,0,0,0,1
04343147,19,3,16,0,2,2,0,2,1
04343332,22,3,19,0,3,1,2,2,1
04343622,10,1,9,0,1,1,0,0,1
04343623,6,1,5,0,1,1,0,0,1
04343747,10,0,10,0,0,0,0,0,1
04343829,55,18,37,0,1,1,0,0,0
04343856,6,4,2,0,2,2,0,0,1
04343988,51,7,44,0,4,3,1,0,1
04344046,11,2,9,0,1,1,0,1,1
04344089,32,0,32,0,0,0,0,0,1
04344100,30,11,19,0,0,0,0,0,0
04344573,13,0,13,0,2,2,0,2,1
04344676,28,2,26,1,3,1,2,1,1
04344764,19,3,16,0,1,1,0,1,1
04344952,20,8,12,0,1,1,0,1,1
04345023,38,3,35,0,1,1,0,1,1
04345190,7,3,4,0,1,1,0,0,1
04345267,14,0,14,0,0,0,0,0,1
04345321,9,2,7,0,2,2,0,0,1
04345323,7,0,7,0,1,1,0,1,1
04345335,14,0,14,0,2,2,0,2,1
04345459,28,9,19,0,0,0,0,0,1
04345584,11,4,7,0,1,1,0,1,0
04345658,4,1,3,0,1,1,0,0,1
04345727,3,0,3,0,1,1,0,0,0
04345747,18,3,15,0,1,1,0,1,1
04345823,6,0,6,0,0,0,0,0,1
04345857,39,0,39,0,0,0,0,0,1
04345919,22,3,19,0,1,1,0,1,1
04346412,19,0,19,0,0,0,0,0,1
04346440,10,5,5,0,2,2,0,0,1
04346502,19,0,19,0,0,0,0,0,1
04346523,19,0,19,0,0,0,0,0,1
04346660,8,3,5,0,0,0,0,0,0
04347051,4,1,3,0,1,1,0,0,1
04347402,19,3,16,0,2,1,1,2,1
04347535,4,2,2,0,2,2,0,0,1
04347937,27,6,21,0,1,1,0,0,1
04348162,7,0,7,0,0,0,0,0,1
04348168,29,12,17,0,1,1,0,0,1
04348175,8,5,3,0,1,1,0,0,0
04348393,13,6,7,0,0,0,0,0,1
04349156,14,2,12,0,0,0,0,0,1
04349637,14,4,10,0,0,0,0,0,1
04349673,5,3,2,0,1,1,0,0,1
04349722,17,4,13,0,1,1,0,1,1
04349983,25,0,25,0,1,1,0,0,0
04350005,12,3,9,0,0,0,0,0,0
04350616,7,3,4,0,2,2,0,0,1
04350916,27,0,27,0,0,0,0,0,1
04351175,35,9,26,0,11,8,3,0,0
04351337,4,2,2,0,1,1,0,0,0
04351565,3,2,1,0,1,1,0,0,0
04351593,7,0,7,0,0,0,0,0,1
04351673,5,1,4,0,1,1,0,0,1
04351814,19,3,16,0,1,1,0,1,1
04352211,11,2,9,0,1,1,0,0,1
04352216,10,2,8,0,1,1,0,0,1
04352550,23,5,18,0,1,1,0,1,1
04352615,15,2,13,0,0,0,0,0,1
04352678,5,3,2,0,2,2,0,0,1
04352760,8,4,4,0,3,3,0,0,1
04352761,59,6,53,0,0,0,0,0,0
04352788,48,10,38,0,0,0,0,0,0
04352872,42,9,33,0,0,0,0,0,1
04353249,21,7,14,0,1,1,0,1,1
04353349,5,3,2,0,2,2,0,0,0
04353390,28,0,28,0,0,0,0,0,1
04353734,34,10,24,0,0,0,0,0,1
04353735,6,3,3,0,2,2,0,0,1
04353797,14,2,12,0,0,0,0,0,1
04353971,10,1,9,0,1,1,0,0,0
04354197,22,0,22,0,0,0,0,0,1
04354366,30,9,21,0,0,0,0,0,1
04354472,22,11,11,0,3,3,0,0,1
04355005,8,2,6,0,1,1,0,1,0
04355170,51,0,51,0,0,0,0,0,1
04355437,17,6,11,0,0,0,0,0,1
04355465,13,1,12,0,1,1,0,1,1
04355552,13,1,12,0,1,1,0,1,1
04355606,60,13,47,0,0,0,0,0,1
04355616,30,6,24,0,1,1,0,1,1
04355627,6,3,3,0,1,1,0,0,1
04355631,28,6,22,0,1,1,0,1,1
04355648,7,0,7,0,1,1,0,0,1
04355890,7,0,7,0,1,1,0,0,1
04356029,4,1,3,0,1,1,0,0,1
04356031,29,6,23,0,1,1,0,0,0
04356678,13,1,12,0,1,1,0,1,1
04356715,16,0,16,0,1,1,0,1,1
04356788,5,3,2,0,1,1,0,0,0
04356933,55,10,45,0,1,1,0,1,1
04357051,4,1,3,0,1,1,0,0,1
04357343,9,0,9,0,0,0,0,0,1
04357710,5,0,5,0,0,0,0,0,0
04357838,4,0,4,0,0,0,0,0,1
04357877,30,10,20,0,0,0,0,0,0
04358049,32,2,30,0,2,1,1,2,1
04358163,5,2,3,0,1,1,0,0,0
04358261,7,1,6,0,2,2,0,0,1
04358273,28,3,25,0,1,1,0,1,1
04358438,8,2,6,0,1,1,0,0,1
04358528,16,0,16,0,0,0,0,0,1
04358614,83,11,72,0,0,0,0,0,1
04358718,32,8,24,0,2,2,0,2,1
04358827,5,1,4,0,1,1,0,0,1
04358938,22,2,20,0,1,1,0,1,1
04358946,7,1,6,0,1,1,0,0,1
04358960,23,0,23,0,0,0,0,0,1
04359355,6,0,6,0,2,2,0,0,1
04359440,14,0,14,0,1,1,0,1,1
04359528,4,1,3,0,1,1,0,0,0
04359537,7,5,2,0,3,1,2,1,0
04359576,15,7,8,0,0,0,0,0,1
04359578,13,2,11,0,0,0,0,0,1
04359590,6,4,2,0,2,2,0,0,0
04359715,7,2,5,0,3,2,1,3,0
04360133,37,10,27,0,0,0,0,0,1
04360246,12,1,11,0,1,1,0,0,1
04360254,6,1,5,0,1,1,0,0,1
04360319,10,0,10,0,0,0,0,0,1
04360536,6,0,6,0,0,0,0,0,0
04360738,5,1,4,0,1,1,0,0,0
04360928,9,0,9,0,0,0,0,0,1
04361009,55,15,40,0,0,0,0,0,1
04361020,25,0,25,0,0,0,0,0,1
04361255,22,8,14,0,1,1,0,1,1
04361479,52,26,26,0,0,0,0,0,0
04361627,67,10,57,0,0,0,0,0,1
04361684,24,6,18,0,1,1,0,1,1
04361688,22,0,22,0,0,0,0,0,1
04361870,13,4,9,0,0,0,0,0,0
04361908,4,1,3,0,1,1,0,0,0
04362060,12,0,12,0,1,1,0,1,1
04362134,21,5,16,0,0,0,0,0,1
04362208,6,2,4,0,1,1,0,0,1
04362229,5,3,2,0,2,2,0,0,0
04362306,32,6,26,0,0,0,0,0,1
04362328,5,2,3,0,1,1,0,0,0
04362452,4,2,2,0,1,1,0,0,1
04362495,6,2,4,0,1,1,0,1,1
04362595,6,0,6,0,0,0,0,0,1
04362659,44,10,34,0,9,0,9,0,1
04363128,8,0,8,0,0,0,0,0,1
04363173,20,6,14,0,0,0,0,0,0
04363348,12,5,7,0,1,1,0,1,1
04363485,6,1,5,0,2,1,1,0,1
04363962,15,3,12,0,1,1,0,1,1
04364285,17,7,10,0,1,1,0,1,1
04364318,26,3,23,0,0,0,0,0,1
04364446,4,2,2,0,1,1,0,0,1
04364624,17,2,15,0,2,1,1,2,1
04364731,11,2,9,0,0,0,0,0,1
04364894,42,0,42,0,1,1,0,1,0
04364915,8,0,8,0,2,2,0,2,1
04365051,41,6,35,0,1,1,0,0,0
04365125,4,2,2,0,1,1,0,0,1
04365192,8,0,8,0,1,1,0,1,1
04365519,27,3,24,0,1,1,0,1,1
04365607,35,6,29,0,0,0,0,0,0
04365825,11,1,10,0,1,1,0,1,1
04366055,98,13,85,0,0,0,0,0,1
04366252,13,6,7,0,1,1,0,0,1
04366294,6,2,4,0,1,1,0,0,1
04366399,17,4,13,0,1,1,0,1,1
04366481,21,5,16,0,1,1,0,1,1
04366523,26,0,26,0,0,0,0,0,1
04366596,29,7,22,0,0,0,0,0,1
04366724,12,2,10,0,1,1,0,0,1
04366807,6,0,6,0,0,0,0,0,1
04366815,18,0,18,0,0,0,0,0,1
04366970,14,0,14,0,1,1,0,0,1
04367043,9,0,9,0,0,0,0,0,1
04367489,39,3,36,0,1,0,1,1,1
04367597,5,3,2,0,2,2,0,0,0
04367720,7,0,7,0,0,0,0,0,1
04368235,5,1,4,0,1,1,0,0,1
04368660,6,3,3,0,1,1,0,0,0
04368844,20,0,20,0,0,0,0,0,1
04368877,5,2,3,0,0,0,0,0,1
04369238,6,3,3,0,1,1,0,0,0
04369766,13,2,11,0,2,1,1,2,1
04369967,5,0,5,0,1,1,0,0,0
R0000164,9,0,9,0,0,0,0,0,0
R0000187,22,5,17,0,0,0,0,0,0
R0000192,12,2,10,0,1,1,0,1,0
R0000390,14,3,11,0,2,2,0,2,1
R0000447,29,10,19,0,1,1,0,1,1
R0000460,13,4,9,0,1,1,0,1,0
R0000472,19,5,14,0,1,1,0,1,0
R0000557,34,12,22,0,0,0,0,0,0
R0000568,48,10,38,0,1,1,0,1,1
R0000592,3,3,0,0,2,2,0,0,0
R0000593,11,3,8,0,1,1,0,0,0
R0000733,83,17,66,0,1,1,0,1,1
RC000035,0,0,0,0,0,0,0,0,0
RC000087,0,0,0,0,0,0,0,0,0
RC000093,0,0,0,0,0,0,0,0,0
RC000168,0,0,0,0,0,0,0,0,0
RC000215,0,0,0,0,0,0,0,0,0
RC000217,0,0,0,0,0,0,0,0,0
RC000699,0,0,0,0,0,0,0,0,0
RS004005,0,0,0,0,0,0,0,0,0
RS004025,0,0,0,0,0,0,0,0,0
RS004075,0,0,0,0,0,0,0,0,0
RS004086,0,0,0,0,0,0,0,0,0
RS004087,0,0,0,0,0,0,0,0,0
RS004174,0,0,0,0,0,0,0,0,0
RS004189,0,0,0,0,0,0,0,0,0
RS004194,0,0,0,0,0,0,0,0,0
RS004197,0,0,0,0,0,0,0,0,0
RS004277,0,0,0,0,0,0,0,0,0
RS004329,0,0,0,0,0,0,0,0,0
RS004353,0,0,0,0,0,0,0,0,0
RS004378,0,0,0,0,0,0,0,0,0
RS004385,0,0,0,0,0,0,0,0,0
RS004405,0,0,0,0,0,0,0,0,0
RS004450,0,0,0,0,0,0,0,0,0
RS004495,0,0,0,0,0,0,0,0,0
RS004554,0,0,0,0,0,0,0,0,0
RS007007,0,0,0,0,0,0,0,0,0
RS007008,0,0,0,0,0,0,0,0,0
RS007081,0,0,0,0,0,0,0,0,0
RS007089,0,0,0,0,0,0,0,0,0
RS007108,0,0,0,0,0,0,0,0,0
RS007182,0,0,0,0,0,0,0,0,0
RS007192,0,0,0,0,0,0,0,0,0
RS007199,0,0,0,0,0,0,0,0,0
RS007218,0,0,0,0,0,0,0,0,0
RS007278,0,0,0,0,0,0,0,0,0
RS007327,0,0,0,0,0,0,0,0,0
RS007352,0,0,0,0,0,0,0,0,0
RS007381,0,0,0,0,0,0,0,0,0
RS007425,0,0,0,0,0,0,0,0,0
RS007427,0,0,0,0,0,0,0,0,0
RS007464,0,0,0,0,0,0,0,0,0
RS007465,0,0,0,0,0,0,0,0,0
RS007482,0,0,0,0,0,0,0,0,0
RS007493,0,0,0,0,0,0,0,0,0
RS007498,0,0,0,0,0,0,0,0,0
RS007503,0,0,0,0,0,0,0,0,0
RS007513,0,0,0,0,0,0,0,0,0
RS007527,0,0,0,0,0,0,0,0,0
RS007530,0,0,0,0,0,0,0,0,0
RS007531,0,0,0,0,0,0,0,0,0
RS007534,0,0,0,0,0,0,0,0,0
RS007550,0,0,0,0,0,0,0,0,0
RS007571,0,0,0,0,0,0,0,0,0
RS007577,0,0,0,0,0,0,0,0,0
RS007579,0,0,0,0,0,0,0,0,0
RS007584,0,0,0,0,0,0,0,0,0
RS007585,0,0,0,0,0,0,0,0,0
RS007591,0,0,0,0,0,0,0,0,0
RS007593,0,0,0,0,0,0,0,0,0
RS007597,0,0,0,0,0,0,0,0,0
RS007653,0,0,0,0,0,0,0,0,0
RS007674,0,0,0,0,0,0,0,0,0
RS007706,0,0,0,0,0,0,0,0,0
RS007712,0,0,0,0,0,0,0,0,0
RS007723,0,0,0,0,0,0,0,0,0
RS007730,0,0,0,0,0,0,0,0,0
RS007752,0,0,0,0,0,0,0,0,0
RS007757,0,0,0,0,0,0,0,0,0
RS007779,0,0,0,0,0,0,0,0,0
RS007783,0,0,0,0,0,0,0,0,0
RS007786,0,0,0,0,0,0,0,0,0
RS007794,0,0,0,0,0,0,0,0,0
RS007828,0,0,0,0,0,0,0,0,0
RS007829,0,0,0,0,0,0,0,0,0
RS007831,0,0,0,0,0,0,0,0,0
RS007832,0,0,0,0,0,0,0,0,0
RS007837,0,0,0,0,0,0,0,0,0
RS007847,0,0,0,0,0,0,0,0,0
RS007852,0,0,0,0,0,0,0,0,0
RS007854,0,0,0,0,0,0,0,0,0
RS007860,0,0,0,0,0,0,0,0,0
RS007874,0,0,0,0,0,0,0,0,0
RS007997,0,0,0,0,0,0,0,0,0
RS008041,0,0,0,0,0,0,0,0,0
RS008070,0,0,0,0,0,0,0,0,0
RS008077,0,0,0,0,0,0,0,0,0
RS008085,0,0,0,0,0,0,0,0,0
RS008109,0,0,0,0,0,0,0,0,0
RS07288C,0,0,0,0,0,0,0,0,0
SC000053,14,4,10,0,1,1,0,1,0
SC000268,20,4,16,0,0,0,0,0,0
SC000358,169,20,149,0,0,0,0,0,1
SC000364,12,3,9,1,2,2,0,2,1
SC000489,21,7,14,1,0,0,0,0,1
SC000750,78,8,70,0,1,1,0,1,1
SC000879,19,6,13,0,2,2,0,0,1
SC000934,27,4,23,0,1,1,0,1,1
SC001054,39,0,39,0,0,0,0,0,1
SC001082,61,9,52,0,3,3,0,0,0
SC001111,95,15,80,0,2,1,1,2,1
SC001281,14,3,11,1,7,1,6,1,1
SC001491,37,6,31,0,1,1,0,1,1
SC001645,32,5,27,0,1,1,0,1,1
SC001722,18,0,18,0,0,0,0,0,1
SC001731,43,7,36,0,0,0,0,0,1
SC001777,28,7,21,2,1,1,0,1,1
SC001827,19,0,19,0,0,0,0,0,1
SC001836,28,7,21,0,0,0,0,0,1
SC001878,39,0,39,0,1,1,0,1,1
SC002048,39,4,35,0,1,1,0,1,1
SC002101,20,8,12,0,1,1,0,0,1
SC002168,30,4,26,0,2,2,0,0,1
SC002180,14,3,11,0,1,1,0,1,1
SC002209,9,2,7,1,1,1,0,1,1
SC002260,7,4,3,0,0,0,0,0,0
SC002271,160,18,142,0,0,0,0,0,1
SC002431,11,2,9,0,1,1,0,1,1
SC002816,41,3,38,0,1,1,0,1,1
SC002871,37,4,33,0,2,2,0,2,1
SC002891,34,4,30,0,0,0,0,0,0
SC003146,16,9,7,0,1,1,0,1,1
SC003197,38,3,35,0,1,1,0,1,1
SC003264,33,5,28,0,2,1,1,0,0
SC003487,43,8,35,0,1,1,0,0,1
SC003490,8,0,8,0,0,0,0,0,1
SC003813,17,0,17,0,0,0,0,0,1
SC004220,5,2,3,0,1,1,0,0,1
SC004221,35,7,28,0,0,0,0,0,1
SC004249,28,3,25,0,1,1,0,1,1
SC004253,1,1,0,0,0,0,0,0,1
SC004348,65,3,62,0,2,1,1,2,1
SC004685,15,3,12,0,0,0,0,0,1
SC004703,174,22,152,0,0,0,0,0,1
SC004892,15,0,15,0,0,0,0,0,1
SC005417,46,6,40,0,0,0,0,0,1
SC005420,44,7,37,0,1,1,0,1,0
SC005530,14,3,11,0,1,1,0,1,1
SC005585,113,8,105,0,0,0,0,0,1
SC005653,28,12,16,0,0,0,0,0,1
SC005702,32,6,26,0,2,1,1,1,1
SC005804,42,10,32,0,1,1,0,1,1
SC005809,47,8,39,0,2,1,1,1,0
SC005854,63,7,56,0,11,10,1,0,1
SC005906,17,3,14,0,1,1,0,1,0
SC006176,24,7,17,0,0,0,0,0,1
SC006192,43,3,40,0,1,1,0,1,1
SC006373,18,1,17,0,1,1,0,1,1
SC006472,28,3,25,0,1,1,0,1,1
SC006637,47,3,44,0,1,1,0,1,1
SC006678,19,3,16,0,0,0,0,0,1
SC006728,86,10,76,0,0,0,0,0,1
SC006754,16,9,7,0,0,0,0,0,1
SC006873,44,9,35,1,0,0,0,0,0
SC006905,31,5,26,0,1,1,0,0,1
SC006944,8,0,8,0,0,0,0,0,1
SC007002,24,6,18,0,0,0,0,0,1
SC007139,50,8,42,0,1,1,0,1,1
SC007173,42,3,39,0,1,1,0,1,1
SC007252,4,2,2,0,0,0,0,0,1
SC007335,170,23,147,0,0,0,0,0,1
SC007424,43,9,34,0,0,0,0,0,1
SC007893,26,2,24,0,1,1,0,1,1
SC007906,20,4,16,0,1,1,0,1,1
SC008009,14,0,14,0,0,0,0,0,1
SC008140,39,0,39,0,0,0,0,0,1
SC008191,17,3,14,0,1,1,0,1,1
SC008287,144,8,136,0,0,0,0,0,1
SC008349,46,8,38,0,0,0,0,0,1
SC008397,4,4,0,0,1,1,0,1,1
SC008495,25,0,25,0,2,1,1,2,1
SC008553,34,0,34,0,0,0,0,0,1
SC008664,86,8,78,0,0,0,0,0,0
SC008669,14,5,9,0,0,0,0,0,1
SC008766,20,6,14,2,1,1,0,1,1
SC008838,86,16,70,0,0,0,0,0,0
SC009292,90,12,78,0,0,0,0,0,1
SC009331,23,7,16,0,3,1,2,1,0
SC009437,16,5,11,0,2,2,0,1,1
SC009529,17,4,13,0,1,1,0,1,1
SC009743,37,3,34,0,2,2,0,2,1
SC009838,17,0,17,0,0,0,0,0,1
SC010033,0,0,0,0,0,0,0,0,0
SC010170,19,5,14,0,2,2,0,0,1
SC010174,14,3,11,0,1,1,0,1,1
SC010309,14,6,8,0,1,1,0,0,0
SC010350,23,3,20,0,1,1,0,1,1
SC010612,51,7,44,0,1,1,0,0,1
SC010673,22,1,21,0,1,1,0,1,1
SC010795,46,4,42,0,0,0,0,0,1
SC010942,29,2,27,0,0,0,0,0,1
SC011313,108,13,95,0,18,14,4,0,1
SC011371,115,3,112,0,1,1,0,1,1
SC011580,47,7,40,0,0,0,0,0,1
SC011616,43,0,43,0,0,0,0,0,1
SC011691,34,0,34,0,0,0,0,0,1
SC011757,35,4,31,0,1,1,0,1,1
SC012020,11,2,9,0,2,2,0,0,1
SC012259,24,4,20,0,1,1,0,0,1
SC012282,14,3,11,0,1,1,0,1,1
SC012508,133,9,124,0,0,0,0,0,1
SC012585,72,11,61,0,0,0,0,0,1
SC012599,6,3,3,0,2,2,0,0,1
SC012698,12,3,9,0,3,2,1,1,1
SC012725,27,6,21,0,0,0,0,0,1
SC012767,17,7,10,0,1,1,0,1,1
SC013040,0,0,0,0,0,0,0,0,1
SC013284,20,3,17,0,1,1,0,1,1
SC013418,34,4,30,0,1,1,0,1,1
SC013654,35,3,32,0,1,1,0,1,1
SC013772,14,4,10,0,1,1,0,1,1
SC013871,33,2,31,0,1,1,0,1,1
SC013952,21,2,19,0,1,1,0,1,1
SC013987,72,8,64,0,0,0,0,0,1
SC014184,7,2,5,0,1,1,0,1,1
SC014244,120,3,117,0,1,1,0,1,1
SC014245,40,2,38,0,1,1,0,1,1
SC014265,66,15,51,0,0,0,0,0,1
SC014361,94,17,77,0,0,0,0,0,1
SC014450,6,3,3,0,1,1,0,0,0
SC014472,18,5,13,0,1,1,0,1,1
SC014477,53,5,48,1,1,1,0,1,1
SC014586,40,4,36,0,1,1,0,1,1
SC014692,16,3,13,0,0,0,0,0,1
SC015031,15,5,10,0,1,1,0,1,1
SC015076,14,3,11,0,1,1,0,1,1
SC015161,11,3,8,0,2,2,0,0,1
SC015346,12,0,12,0,0,0,0,0,1
SC015465,20,11,9,0,2,2,0,0,0
SC015467,17,2,15,0,2,2,0,0,1
SC015710,10,2,8,0,1,1,0,1,0
SC015861,8,3,5,0,1,1,0,0,1
SC016288,62,6,56,0,2,2,0,2,1
SC016360,8,4,4,0,2,1,1,1,0
SC016693,76,16,60,0,19,15,4,0,1
SC016856,63,9,54,0,12,9,3,0,1
SC017067,87,0,87,0,0,0,0,0,1
SC017244,25,7,18,0,1,1,0,1,1
SC017306,28,5,23,0,1,1,0,1,1
SC017951,24,2,22,0,1,1,0,1,1
SC018135,50,5,45,0,1,1,0,1,1
SC018271,11,0,11,0,0,0,0,0,1
SC018389,20,3,17,0,1,1,0,0,1
SC018411,30,5,25,0,1,1,0,1,1
SC018654,61,24,37,0,0,0,0,0,0
SC018714,48,10,38,0,0,0,0,0,1
SC018804,67,12,55,0,0,0,0,0,1
SC019038,31,5,26,0,1,1,0,1,1
SC019097,71,6,65,0,0,0,0,0,1
SC019124,8,4,4,1,3,3,0,0,0
SC019230,48,9,39,0,0,0,0,0,1
SC019354,15,4,11,0,1,1,0,1,1
SC019438,62,6,56,0,1,1,0,1,1
SC019593,28,3,25,0,1,1,0,1,1
SC019833,7,2,5,0,1,1,0,0,1
SC020074,46,2,44,0,1,1,0,1,1
SC020182,13,5,8,0,0,0,0,0,0
SC020286,9,0,9,0,0,0,0,0,1
SC020353,10,0,10,0,0,0,0,0,1
SC020439,8,3,5,0,1,1,0,0,1
SC020639,30,0,30,0,0,0,0,0,1
SC020914,12,2,10,0,1,1,0,1,1
SC020954,33,4,29,0,1,1,0,1,1
SC021018,86,39,47,1,1,1,0,1,1
SC021118,44,0,44,0,1,1,0,1,1
SC021183,10,3,7,0,1,1,0,0,1
SC021224,5,4,1,0,1,1,0,1,1
SC021244,51,6,45,0,1,1,0,1,0
SC021540,26,5,21,0,3,1,2,1,1
SC021856,110,9,101,0,0,0,0,0,1
SC022113,30,13,17,1,0,0,0,0,1
SC022163,64,10,54,1,2,1,1,2,1
SC022385,6,3,3,1,2,2,0,0,0
SC022553,24,9,15,0,2,2,0,0,1
SC022718,31,2,29,0,1,1,0,1,1
SC023085,23,2,21,0,1,1,0,1,0
SC023094,41,10,31,0,0,0,0,0,1
SC023206,15,5,10,0,3,3,0,0,1
SC023572,42,4,38,0,1,1,0,1,1
SC023577,61,9,52,0,0,0,0,0,1
SC023640,7,0,7,0,1,1,0,1,0
SC023910,25,2,23,0,1,1,0,1,1
SC024021,17,3,14,0,1,1,0,1,0
SC024047,19,7,12,0,1,1,0,1,1
SC024068,48,6,42,0,1,1,0,1,1
SC024081,33,9,24,0,1,1,0,1,1
SC024174,0,0,0,0,0,0,0,0,1
SC024243,81,11,70,0,0,0,0,0,1
SC024409,72,13,59,0,0,0,0,0,1
SC024463,3,2,1,0,1,1,0,0,0
SC024534,24,2,22,0,1,1,0,1,1
SC024542,17,3,14,0,1,1,0,1,1
SC024567,9,3,6,0,3,3,0,1,1
SC024572,8,2,6,0,1,1,0,0,0
SC024590,27,2,25,0,1,1,0,1,1
SC024591,112,0,112,0,0,0,0,0,1
SC024642,11,0,11,0,0,0,0,0,1
SC024724,124,15,109,0,0,0,0,0,1
SC024759,31,4,27,0,1,1,0,1,1
SC024766,133,11,122,0,0,0,0,0,1
SC024815,16,0,16,0,0,0,0,0,1
SC024858,3,3,0,0,0,0,0,0,0
SC024966,7,5,2,0,1,1,0,1,0
SC025025,6,0,6,1,0,0,0,0,1
SC025080,65,11,54,2,0,0,0,0,1
SC025744,60,8,52,0,0,0,0,0,1
SC025810,23,4,19,0,3,3,0,0,0
SC025875,7,0,7,1,1,1,0,1,0
SC026103,39,0,39,0,0,0,0,0,1
SC026184,44,3,41,0,2,1,1,2,1
SC026664,6,0,6,0,0,0,0,0,1
SC026752,38,5,33,0,2,2,0,2,1
SC026895,70,6,64,1,0,0,0,0,1
SC027389,35,7,28,0,1,1,0,1,1
SC027541,9,0,9,0,1,1,0,1,1
SC027809,147,18,129,0,0,0,0,0,1
SC027833,1,1,0,0,0,0,0,0,1
SC028085,14,2,12,0,1,1,0,1,1
SC028156,15,1,14,0,0,0,0,0,0
SC028281,19,4,15,0,1,1,0,1,1
SC028473,24,2,22,0,1,1,0,1,1
SC028668,12,1,11,0,1,1,0,1,1
SC028892,31,0,31,0,0,0,0,0,1
SC028957,47,11,36,1,0,0,0,0,1
SC028977,6,0,6,0,0,0,0,0,1
SC029199,68,12,56,0,0,0,0,0,1
SC029203,25,3,22,0,1,1,0,1,1
SC029243,63,14,49,0,0,0,0,0,1
SC029367,57,0,57,0,0,0,0,0,1
SC029382,0,0,0,0,0,0,0,0,1
SC029412,92,15,77,0,2,1,1,0,0
SC029826,31,0,31,0,1,1,0,1,0
SC030035,4,0,4,0,1,1,0,0,0
SC030053,11,2,9,0,1,1,0,0,1
SC030087,11,6,5,1,0,0,0,0,1
SC030207,16,4,12,0,1,1,0,1,1
SC030263,23,6,17,0,1,1,0,1,1
SC030711,3,1,2,0,1,1,0,0,0
SC030880,21,2,19,0,1,1,0,1,1
SC030916,7,2,5,0,1,1,0,0,1
SC030959,24,0,24,0,0,0,0,0,1
SC031124,20,0,20,0,0,0,0,0,1
SC031300,11,4,7,0,2,2,0,0,0
SC031331,1,0,1,0,0,0,0,0,1
SC031475,27,3,24,0,1,1,0,1,1
SC031624,6,2,4,1,1,1,0,0,1
SC031694,12,4,8,0,2,2,0,0,0
SC031999,28,0,28,0,0,0,0,0,1
SC032004,14,5,9,0,0,0,0,0,1
SC032244,11,2,9,0,1,1,0,1,1
SC032671,9,0,9,0,0,0,0,0,1
SC032698,8,0,8,0,1,1,0,1,1
SC032729,68,6,62,0,0,0,0,0,1
SC032734,10,4,6,0,0,0,0,0,1
SC032744,17,0,17,0,0,0,0,0,1
SC033061,52,0,52,0,1,1,0,1,1
SC033089,15,7,8,0,1,1,0,0,1
SC033273,4,4,0,0,1,1,0,0,0
SC033307,9,5,4,0,0,0,0,0,1
SC033480,10,0,10,0,0,0,0,0,1
SC033543,6,3,3,0,0,0,0,0,0
SC033738,25,2,23,0,1,1,0,1,1
SC033836,10,5,5,0,1,1,0,0,1
SC033868,9,3,6,0,2,2,0,0,0
SC033977,25,2,23,0,1,1,0,1,1
07890500,11,0,11,0,1,1,0,0,1
07890595,10,6,4,0,1,1,0,0,1
07890604,10,2,8,0,1,1,0,0,1
07891058,2,2,0,0,2,2,0,0,0
07891165,2,0,2,0,0,0,0,0,0
07891683,7,4,3,0,1,1,0,0,0
07891824,16,3,13,0,1,1,0,0,1
07892705,5,0,5,0,0,0,0,0,1
07893179,1,1,0,0,1,1,0,0,1
07893688,5,3,2,2,3,2,1,3,0
07894106,4,1,3,0,1,1,0,0,0
07894305,26,14,12,0,0,0,0,0,1
07894318,3,0,3,0,0,0,0,0,1
07894544,2,2,0,0,2,2,0,0,0
07894878,3,3,0,0,2,2,0,0,0
07895311,1,0,1,0,0,0,0,0,0
07895333,2,2,0,0,2,2,0,0,0
07895585,3,1,2,0,3,2,1,0,0
07896987,4,3,1,0,3,3,0,0,0
07897089,8,5,3,0,0,0,0,0,1
07897433,9,4,5,0,1,0,1,0,1
07898157,5,3,2,0,2,2,0,0,1
07898217,1,1,0,0,1,1,0,0,0
07898363,1,1,0,0,1,1,0,0,0
07898669,21,9,12,0,1,1,0,0,1
07899156,7,1,6,0,2,2,0,1,0
07899376,2,2,0,0,1,1,0,0,0
07900072,1,1,0,0,1,1,0,0,0
07900140,2,2,0,0,2,2,0,0,0
07900192,4,1,3,0,2,0,2,0,0
07900194,10,7,3,0,1,1,0,1,0
07900256,22,9,13,0,0,0,0,0,0
07900264,3,2,1,0,1,1,0,0,0
07900649,19,7,12,0,0,0,0,0,1
07900795,14,8,6,0,0,0,0,0,0
07901041,5,3,2,0,1,1,0,1,1
07901069,2,0,2,0,0,0,0,0,1
07901100,7,0,7,0,1,1,0,0,0
07901352,2,0,2,0,0,0,0,0,1
07901568,9,6,3,0,3,1,2,0,0
07901664,6,2,4,0,1,1,0,0,1
07901900,23,17,6,0,0,0,0,0,0
07902292,1,0,1,0,0,0,0,0,1
07902758,1,1,0,0,1,1,0,0,1
07903117,4,1,3,0,1,1,0,1,1
07903131,5,1,4,0,1,1,0,0,1
07903148,2,2,0,0,2,2,0,0,0
07903169,5,1,4,0,1,1,0,1,1
07903204,5,3,2,0,1,1,0,0,1
07903603,7,0,7,0,0,0,0,0,1
07903717,1,1,0,0,0,0,0,0,0
07904091,12,4,8,0,5,4,1,0,0
07904106,14,0,14,0,2,2,0,0,1
07904115,1,0,1,0,1,1,0,0,0
07904118,4,1,3,0,2,1,1,0,0
07904980,4,0,4,0,0,0,0,0,0
07904991,1,0,1,0,0,0,0,0,1
07905494,6,1,5,0,1,1,0,1,1
07906254,3,3,0,0,1,1,0,0,0
07906337,3,2,1,0,1,1,0,1,0
07906387,3,1,2,0,2,1,1,0,0
07906394,4,2,2,0,2,2,0,0,1
07906451,2,2,0,0,1,1,0,0,0
07906562,1,1,0,0,1,1,0,0,0
07906568,2,2,0,0,1,1,0,1,1
07906736,9,7,2,0,0,0,0,0,0
07907337,2,2,0,0,2,2,0,0,0
07907463,20,12,8,0,0,0,0,0,0
07907618,4,3,1,0,1,1,0,0,1
07907921,5,1,4,0,2,1,1,0,1
07908562,1,0,1,0,0,0,0,0,1
07908728,2,2,0,0,2,2,0,0,0
07908954,8,2,6,0,2,2,0,0,1
07909149,8,2,6,0,3,2,1,1,1
07909171,7,6,1,0,0,0,0,0,0
07909397,23,0,23,0,0,0,0,0,0
07909406,8,2,6,0,1,1,0,1,1
07909464,8,2,6,0,1,1,0,1,1
07909516,4,0,4,0,0,0,0,0,1
07909526,6,3,3,0,1,1,0,1,1
07909590,4,0,4,0,0,0,0,0,1
07909670,2,1,1,0,1,1,0,0,0
07909733,2,2,0,0,2,2,0,0,0
07909746,3,0,3,0,0,0,0,0,1
07909961,3,3,0,0,3,3,0,0,0
07910167,2,0,2,0,1,1,0,0,0
07910982,3,3,0,0,1,1,0,0,0
07910996,2,2,0,0,1,1,0,0,0
07911481,13,7,6,0,2,1,1,1,1
07911529,1,1,0,0,1,1,0,0,0
07911733,1,0,1,0,0,0,0,0,1
07912191,3,0,3,0,0,0,0,0,1
07912323,2,0,2,0,0,0,0,0,0
07912445,1,0,1,0,0,0,0,0,0
07912745,1,1,0,0,0,0,0,0,0
07913009,2,0,2,0,0,0,0,0,0
07913095,2,2,0,0,1,1,0,0,1
07913186,3,0,3,0,0,0,0,0,1
07913209,2,1,1,0,3,3,0,0,0
07913252,1,0,1,0,0,0,0,0,1
07913400,1,0,1,0,0,0,0,0,1
07913409,6,2,4,0,4,1,3,1,1
07913466,4,0,4,0,2,1,1,0,0
07913492,1,0,1,0,0,0,0,0,1
07914017,1,1,0,0,0,0,0,0,0
07914174,3,2,1,0,0,0,0,0,0
07914246,1,0,1,0,0,0,0,0,1
07914373,4,3,1,0,2,2,0,0,0
07914412,1,1,0,0,1,1,0,0,0
07914483,3,3,0,0,3,1,2,1,0
07914618,4,2,2,0,1,1,0,1,1
07914727,1,0,1,0,1,1,0,0,0
07914773,2,2,0,0,2,2,0,0,0
07915178,2,0,2,0,0,0,0,0,0
07915625,13,3,10,0,4,4,0,0,1
07915697,4,0,4,0,0,0,0,0,1
07916009,3,2,1,0,1,1,0,0,0
07916262,1,0,1,0,0,0,0,0,0
07916269,5,0,5,0,0,0,0,0,1
07916785,7,3,4,0,0,0,0,0,1
07916811,4,1,3,0,3,1,2,1,0
07917201,4,2,2,0,5,1,4,1,1
07917436,2,2,0,0,2,2,0,0,0
07917688,17,10,7,0,1,1,0,1,1
07917843,2,2,0,0,3,3,0,0,1
07917965,4,3,1,0,2,2,0,0,0
07918078,4,4,0,0,2,2,0,0,1
07918085,4,0,4,0,0,0,0,0,1
07918155,3,3,0,0,2,2,0,0,0
07918160,1,1,0,0,1,1,0,0,0
07918729,6,2,4,0,1,1,0,1,0
07918923,4,2,2,0,1,1,0,1,0
07919076,14,2,12,0,0,0,0,0,1
07919855,1,1,0,0,1,1,0,0,0
07920194,6,0,6,0,0,0,0,0,1
07920836,3,0,3,0,0,0,0,0,0
07920847,1,1,0,0,1,1,0,0,1
07920915,1,1,0,0,1,1,0,0,0
07921716,1,0,1,0,0,0,0,0,0
07921778,2,2,0,0,3,3,0,1,0
07922078,8,4,4,0,1,1,0,1,1
07922432,5,5,0,0,1,1,0,0,1
07922485,4,0,4,0,0,0,0,0,1
07922536,1,1,0,0,1,1,0,0,0
07922681,1,1,0,0,0,0,0,0,1
07923003,11,4,7,0,1,1,0,0,1
07923087,2,1,1,0,2,1,1,0,0
07923140,1,0,1,0,0,0,0,0,0
07923292,2,2,0,0,2,2,0,0,1
07923315,1,1,0,0,1,1,0,1,1
07923329,44,10,34,0,0,0,0,0,0
07923921,2,0,2,0,0,0,0,0,0
07924270,23,6,17,0,2,1,1,2,1
07924357,2,2,0,0,2,2,0,0,0
07924380,19,10,9,0,5,5,0,0,0
07924543,3,1,2,0,2,1,1,0,0
07924630,1,1,0,0,1,1,0,0,0
07924691,8,3,5,0,0,0,0,0,0
07924807,1,0,1,0,0,0,0,0,0
07925182,6,4,2,0,0,0,0,0,1
07925192,8,4,4,0,0,0,0,0,1
07925517,1,0,1,0,0,0,0,0,0
07925603,1,1,0,0,1,1,0,0,1
07926504,4,3,1,1,1,1,0,1,1
07926570,5,5,0,0,0,0,0,0,1
07927112,4,3,1,0,1,1,0,0,0
07927474,4,2,2,0,1,1,0,0,0
07928376,11,7,4,0,2,2,0,0,1
07928473,3,2,1,0,1,1,0,0,0
07928747,1,1,0,0,1,1,0,0,1
07929154,26,9,17,0,0,0,0,0,1
07929158,5,1,4,0,1,1,0,0,1
07929361,4,0,4,0,0,0,0,0,1
07929425,1,0,1,0,0,0,0,0,0
07929429,31,0,31,0,0,0,0,0,0
07929561,1,1,0,0,1,1,0,0,1
07929918,1,1,0,0,1,1,0,0,1
07929923,1,1,0,0,0,0,0,0,0
07930950,5,0,5,0,0,0,0,0,1
07931144,1,0,1,0,0,0,0,0,1
07931387,2,0,2,0,2,2,0,0,1
07931407,10,3,7,0,1,1,0,1,1
07931532,9,5,4,0,1,1,0,1,1
07931918,23,2,21,0,1,1,0,1,1
07932592,1,1,0,0,1,1,0,0,0
07932852,1,1,0,0,1,1,0,0,0
07933273,1,1,0,0,1,1,0,0,1
07933838,36,9,27,0,2,2,0,1,1
07934019,1,1,0,0,1,1,0,0,0
07934248,1,0,1,0,0,0,0,0,0
07934296,3,3,0,0,1,1,0,0,0
07934340,11,4,7,0,1,1,0,1,1
07934360,1,0,1,0,1,1,0,0,0
07934507,1,1,0,0,1,1,0,0,0
07935112,2,2,0,0,1,1,0,0,0
07935158,2,0,2,0,0,0,0,0,0
07935384,4,0,4,0,0,0,0,0,0
07935466,2,0,2,0,0,0,0,0,1
07935515,39,8,31,0,0,0,0,0,0
07935765,7,5,2,0,1,1,0,0,1
07935875,1,1,0,0,1,1,0,0,0
07936061,17,3,14,0,1,1,0,1,1
07936068,2,1,1,0,1,1,0,0,0
07936206,5,0,5,0,0,0,0,0,1
07936386,5,1,4,0,0,0,0,0,0
07936962,2,2,0,0,2,2,0,0,1
07937212,4,0,4,0,1,1,0,0,0
07937424,16,6,10,0,0,0,0,0,1
07938124,3,3,0,0,3,3,0,0,1
07938332,11,2,9,0,1,1,0,1,1
07938948,2,2,0,0,1,1,0,0,0
07939827,2,2,0,0,2,2,0,0,1
07939893,6,3,3,0,3,2,1,1,1
07940077,2,1,1,0,0,0,0,0,0
07940434,2,2,0,0,1,1,0,0,1
07940647,11,5,6,0,1,1,0,1,1
07940863,1,1,0,0,1,1,0,0,0
07940942,2,1,1,0,1,1,0,0,0
07940949,1,1,0,0,1,1,0,0,0
07940988,1,1,0,0,1,1,0,0,0
07941035,2,2,0,0,2,2,0,0,0
07941165,6,2,4,0,1,1,0,0,0
07941382,5,2,3,0,1,1,0,0,0
07941427,3,2,1,0,1,1,0,1,0
07941664,20,0,20,0,0,0,0,0,1
07941729,10,4,6,0,1,1,0,0,0
07941814,1,0,1,0,0,0,0,0,0
07943227,15,6,9,0,0,0,0,0,1
07943472,4,4,0,0,0,0,0,0,0
07943525,9,4,5,1,3,3,0,0,1
07943595,1,0,1,0,0,0,0,0,0
07943990,8,4,4,0,1,1,0,1,1
07944033,2,2,0,0,2,2,0,0,0
07944113,5,0,5,0,0,0,0,0,1
07944195,3,3,0,0,1,1,0,0,0
07944232,8,4,4,0,0,0,0,0,1
07944820,1,0,1,0,0,0,0,0,0
07944936,2,2,0,0,2,2,0,0,0
07945167,9,0,9,0,0,0,0,0,1
07945286,7,3,4,0,0,0,0,0,1
07945417,25,8,17,0,0,0,0,0,1
07945421,18,7,11,0,0,0,0,0,0
07945466,5,4,1,0,1,1,0,0,1
07945509,9,5,4,0,0,0,0,0,1
07945628,1,0,1,0,0,0,0,0,0
07945640,3,2,1,0,2,2,0,0,1
07945705,3,2,1,0,2,2,0,0,1
07945911,1,1,0,0,1,1,0,0,0
07945972,1,1,0,0,1,1,0,0,0
07946088,7,5,2,0,1,1,0,1,1
07946399,2,2,0,0,1,1,0,0,0
07946416,3,3,0,0,2,2,0,0,0
07946584,3,3,0,0,2,2,0,0,1
07946964,1,1,0,0,2,2,0,0,0
07947303,3,0,3,0,0,0,0,0,1
07947483,2,0,2,0,0,0,0,0,1
07947496,4,0,4,0,0,0,0,0,0
07947560,9,5,4,0,1,1,0,1,1
07947564,12,8,4,0,0,0,0,0,1
07947565,4,3,1,0,0,0,0,0,0
07947657,1,0,1,0,0,0,0,0,0
07947864,6,4,2,0,1,1,0,1,0
07947879,13,6,7,0,0,0,0,0,1
07947893,3,1,2,0,1,1,0,1,0
07947912,5,4,1,0,1,1,0,0,1
07947971,22,8,14,0,0,0,0,0,1
04976518,8,5,3,0,0,0,0,0,1
04976608,16,3,13,0,1,1,0,1,1
04976712,28,0,28,0,0,0,0,0,1
04976739,5,3,2,0,2,2,0,0,0
04976859,5,0,5,0,0,0,0,0,1
04976863,21,3,18,0,1,1,0,1,1
04976981,13,3,10,0,0,0,0,0,1
04976984,12,0,12,0,0,0,0,0,1
04977034,8,2,6,0,2,2,0,0,1
04977050,18,3,15,0,2,1,1,2,1
04977160,14,7,7,0,1,1,0,1,1
04977164,23,7,16,0,3,1,2,3,1
04977339,24,4,20,0,3,1,2,3,1
04977354,11,5,6,0,1,1,0,1,1
04977436,15,4,11,0,2,1,1,2,1
04977629,23,7,16,0,3,1,2,3,1
04977799,12,2,10,0,1,1,0,0,1
04977814,9,1,8,0,1,1,0,1,1
04978550,8,1,7,0,1,1,0,1,1
04979015,10,2,8,0,1,1,0,1,1
04979331,5,3,2,0,1,1,0,0,0
04979625,8,5,3,0,2,2,0,0,1
04979716,4,2,2,0,1,1,0,0,0
04979787,7,2,5,0,0,0,0,0,1
04980045,3,1,2,0,1,1,0,0,1
04980135,2,2,0,0,1,1,0,0,0
04980231,9,2,7,0,0,0,0,0,0
04980480,34,9,25,0,0,0,0,0,0
04980730,27,1,26,0,2,1,1,0,1
04980802,10,4,6,0,1,1,0,1,1
04980876,12,4,8,0,1,1,0,1,1
04980912,5,0,5,0,0,0,0,0,1
04980922,26,9,17,0,1,1,0,0,1
04981279,35,6,29,0,2,2,0,0,1
04981593,9,3,6,0,2,2,0,0,1
04981684,4,2,2,0,2,2,0,0,1
04981835,4,1,3,0,1,1,0,0,1
04982183,15,5,10,0,0,0,0,0,1
04982664,17,3,14,0,4,4,0,4,1
04983353,10,2,8,0,1,1,0,0,0
04983600,4,2,2,0,1,1,0,0,0
04983817,49,0,49,0,0,0,0,0,1
04983959,4,2,2,0,0,0,0,0,0
04984004,13,1,12,0,1,1,0,0,1
04984144,9,0,9,0,0,0,0,0,1
04984588,11,2,9,0,0,0,0,0,0
04984761,4,2,2,0,1,1,0,1,1
04985674,20,1,19,0,2,2,0,0,1
04985687,6,4,2,0,2,2,0,0,1
04985780,13,4,9,0,1,1,0,1,1
04986035,32,10,22,0,0,0,0,0,1
04986086,24,4,20,0,1,1,0,0,1
04986428,14,2,12,0,5,1,4,3,1
04986654,7,3,4,0,1,1,0,0,1
04986668,5,3,2,0,1,1,0,0,1
04986779,25,2,23,0,1,1,0,1,1
04986815,3,0,3,0,0,0,0,0,1
04987385,5,2,3,0,1,1,0,0,0
04987434,5,1,4,0,1,1,0,0,0
04987475,5,2,3,0,1,1,0,0,0
04987553,4,2,2,0,1,1,0,0,1
04987694,20,9,11,0,2,1,1,0,1
04987763,9,3,6,0,3,2,1,0,0
04987799,11,8,3,0,2,2,0,1,1
04987817,13,6,7,0,3,3,0,0,1
04988045,4,4,0,0,2,2,0,0,0
04988117,13,4,9,0,0,0,0,0,0
04988146,8,4,4,0,1,1,0,1,1
04988168,10,6,4,0,0,0,0,0,1
04988238,10,6,4,0,3,3,0,0,1
04988527,22,3,19,0,4,1,3,4,1
04990157,4,0,4,0,0,0,0,0,0
04990219,4,0,4,0,0,0,0,0,0
04990231,6,5,1,0,2,1,1,2,0
04990739,16,0,16,0,0,0,0,0,1
04991016,5,2,3,0,1,1,0,1,1
04991123,5,0,5,0,0,0,0,0,1
04991490,6,0,6,0,0,0,0,0,1
04991508,0,0,0,0,0,0,0,0,0
04991632,6,3,3,0,0,0,0,0,1
04992004,6,1,5,0,1,1,0,1,1
04992174,2,1,1,0,1,1,0,0,0
04992207,36,10,26,0,0,0,0,0,1
04992246,14,0,14,0,0,0,0,0,1
04992381,10,0,10,1,0,0,0,0,1
04992386,7,1,6,0,1,1,0,1,1
04992560,7,3,4,0,1,1,0,0,0
04992733,5,0,5,0,1,1,0,0,0
04992756,5,4,1,0,3,3,0,0,0
04992952,9,3,6,0,1,1,0,0,1
04992954,19,0,19,0,0,0,0,0,1
04993627,13,4,9,0,1,1,0,1,1
04994030,20,4,16,0,2,2,0,2,1
04994108,3,2,1,0,2,2,0,0,0
04994214,8,6,2,0,3,1,2,1,0
04994309,21,8,13,0,0,0,0,0,1
04994440,4,2,2,0,2,2,0,0,0
04994688,10,6,4,0,3,1,2,1,0
04994717,5,2,3,0,1,1,0,0,0
04995013,42,11,31,0,0,0,0,0,1
04995117,5,1,4,0,2,1,1,0,0
04995285,16,4,12,0,1,1,0,1,1
04995619,6,4,2,0,0,0,0,0,0
04996467,19,2,17,0,2,1,1,2,1
04996496,2,2,0,0,1,1,0,0,0
04996548,2,1,1,0,2,2,0,0,0
04996944,8,2,6,0,0,0,0,0,0
04997222,4,2,2,0,1,1,0,0,1
04997688,5,0,5,0,0,0,0,0,1
04997920,11,3,8,0,0,0,0,0,1
04998003,5,1,4,0,1,1,0,0,1
04998024,45,13,32,0,1,1,0,0,1
04998182,11,0,11,0,0,0,0,0,1
04998389,5,3,2,0,2,2,0,0,1
04998413,3,0,3,0,0,0,0,0,1
04998450,9,2,7,0,2,2,0,0,1
04998512,11,6,5,0,2,2,0,0,1
04998621,12,3,9,0,3,1,2,1,1
04998681,8,3,5,0,2,2,0,0,1
04998761,10,4,6,0,1,1,0,1,1
04998990,45,12,33,0,0,0,0,0,1
04999246,6,2,4,0,1,1,0,0,1
04999457,8,5,3,0,1,1,0,0,0
04999818,3,1,2,0,1,1,0,0,0
04999945,14,0,14,0,0,0,0,0,1
05000292,12,0,12,0,0,0,0,0,1
05000427,18,7,11,0,1,1,0,0,1
05000564,7,2,5,0,0,0,0,0,0
05000749,5,3,2,0,1,1,0,0,1
05000956,9,6,3,0,0,0,0,0,0
05001293,22,3,19,0,2,2,0,2,1
05001318,22,3,19,0,1,1,0,1,1
05001675,96,11,85,0,2,1,1,0,1
05001989,53,0,53,0,3,3,0,3,1
05002330,5,0,5,0,0,0,0,0,1
05002413,22,6,16,0,1,1,0,1,1
05002548,13,7,6,0,0,0,0,0,0
05002706,24,3,21,0,0,0,0,0,0
05002783,3,3,0,0,2,2,0,0,0
05002814,6,4,2,0,2,2,0,0,1
05002837,11,5,6,0,0,0,0,0,0
05003004,9,3,6,0,0,0,0,0,1
05003539,19,4,15,0,3,3,0,0,0
05003756,3,3,0,0,0,0,0,0,1
05003822,19,8,11,0,0,0,0,0,0
05003926,5,3,2,0,2,2,0,0,0
05004096,39,8,31,0,1,1,0,1,1
05004166,10,0,10,0,0,0,0,0,1
05004498,7,5,2,0,0,0,0,0,1
05004529,6,2,4,0,1,1,0,0,1
05004573,10,3,7,0,1,1,0,0,0
05004600,4,1,3,0,1,1,0,0,1
05004650,5,0,5,0,0,0,0,0,1
05004675,10,2,8,0,1,1,0,0,0
05004785,7,3,4,0,3,3,0,0,1
05004981,22,3,19,0,1,1,0,1,1
05005063,20,4,16,0,0,0,0,0,0
05005434,4,2,2,0,1,1,0,0,0
05005573,3,2,1,0,1,1,0,0,0
05005767,6,4,2,0,1,1,0,0,0
05006703,1,0,1,0,0,0,0,0,1
05007469,10,5,5,0,1,1,0,1,0
05007507,5,3,2,0,1,1,0,0,0
05008192,7,3,4,0,1,1,0,0,1
05008328,13,6,7,0,0,0,0,0,1
05008395,7,0,7,0,0,0,0,0,1
05008899,9,0,9,0,0,0,0,0,1
05009272,13,0,13,0,0,0,0,0,1
05009302,6,4,2,0,3,3,0,0,0
05009620,5,1,4,0,1,1,0,0,0
05009668,11,1,10,0,1,1,0,1,1
05009743,24,5,19,0,1,1,0,1,1
05010716,9,0,9,0,0,0,0,0,1
05010883,9,7,2,0,0,0,0,0,0
05010997,3,2,1,0,1,1,0,0,0
05011281,7,2,5,0,1,1,0,0,0
05011446,5,0,5,0,0,0,0,0,1
05011518,32,8,24,0,0,0,0,0,1
05012151,6,2,4,0,1,1,0,0,1
05012266,8,3,5,0,1,1,0,0,0
05012740,7,3,4,0,1,1,0,0,1
05012811,6,0,6,0,0,0,0,0,1
05012943,10,4,6,0,1,1,0,1,0
05013101,12,6,6,0,2,2,0,0,1
05013120,7,0,7,0,0,0,0,0,1
05013446,6,2,4,0,3,2,1,0,0
05013662,36,7,29,0,0,0,0,0,1
05013988,18,2,16,0,5,1,4,1,1
05014175,8,3,5,0,1,1,0,1,1
05014241,28,0,28,0,0,0,0,0,1
05014714,5,3,2,0,2,2,0,0,0
05014821,26,12,14,0,0,0,0,0,1
05014935,8,0,8,0,0,0,0,0,1
05014967,2,0,2,0,0,0,0,0,1
05015031,19,4,15,0,1,1,0,1,1
05015149,29,10,19,0,0,0,0,0,0
05015346,4,2,2,0,2,1,1,0,0
05015443,54,15,39,0,0,0,0,0,1
05015446,42,5,37,0,1,1,0,1,1
05015503,11,0,11,0,0,0,0,0,1
05015587,7,2,5,0,1,1,0,0,0
05015863,8,0,8,0,0,0,0,0,1
05016103,17,3,14,0,2,1,1,2,1
05016242,12,0,12,0,0,0,0,0,0
05016479,3,3,0,0,2,2,0,0,1
05016537,6,3,3,0,3,1,2,1,1
05016599,6,4,2,0,0,0,0,0,1
05016682,8,5,3,0,1,1,0,0,1
05017000,7,0,7,0,1,1,0,0,0
05017273,21,0,21,0,1,1,0,1,1
05017333,22,3,19,0,1,1,0,1,1
05017378,23,2,21,0,1,1,0,1,1
05018373,5,3,2,0,1,1,0,0,1
05018405,8,0,8,0,0,0,0,0,0
05018976,23,7,16,0,1,1,0,1,1
05018987,33,3,30,0,1,1,0,1,1
05019017,5,0,5,0,0,0,0,0,1
05019104,20,6,14,0,0,0,0,0,0
05019323,7,4,3,0,0,0,0,0,1
05019373,20,0,20,0,0,0,0,0,1
05019465,13,3,10,0,4,3,1,0,1
05019599,4,3,1,0,2,2,0,0,1
05019790,7,0,7,0,0,0,0,0,1
05019962,5,1,4,0,0,0,0,0,1
05020016,43,6,37,0,0,0,0,0,1
05020046,10,1,9,0,1,1,0,1,1
05020183,3,0,3,0,0,0,0,0,0
05020856,3,3,0,0,2,2,0,0,1
05021440,28,10,18,0,0,0,0,0,1
05021720,14,5,9,0,0,0,0,0,1
05021764,40,0,40,0,0,0,0,0,1
05021864,17,2,15,0,1,1,0,1,1
05022212,3,3,0,0,2,2,0,0,1
05022367,6,4,2,0,3,3,0,0,1
05022401,8,0,8,0,0,0,0,0,1
05022767,12,0,12,0,0,0,0,0,0
05023261,12,0,12,0,0,0,0,0,1
05023369,9,3,6,0,0,0,0,0,1
05024233,22,2,20,0,1,1,0,1,1
05024234,22,4,18,0,2,1,1,2,1
05024239,23,3,20,0,1,1,0,1,1
05024248,19,3,16,0,1,1,0,1,1
05024541,16,7,9,0,1,1,0,0,0
05024987,4,1,3,0,1,1,0,0,1
05024988,4,1,3,0,2,2,0,0,1
04435420,6,2,4,0,3,2,1,0,0
04435505,4,2,2,0,1,1,0,0,1
04435967,5,3,2,0,1,1,0,0,0
04435975,25,3,22,0,2,1,1,2,1
04436319,5,1,4,0,2,1,1,0,1
04436426,9,3,6,0,0,0,0,0,0
04436497,7,1,6,0,1,1,0,0,1
04436540,11,0,11,0,0,0,0,0,1
04436730,18,4,14,0,2,1,1,2,1
04436871,20,0,20,0,1,1,0,1,1
04436873,21,4,17,0,2,1,1,2,1
04437037,81,22,59,0,0,0,0,0,1
04437062,5,3,2,0,1,1,0,0,0
04437079,8,4,4,0,1,1,0,0,0
04437124,18,8,10,0,1,1,0,0,1
04437421,16,0,16,0,1,1,0,1,1
04437444,5,3,2,0,2,2,0,0,0
04437555,3,0,3,0,2,2,0,0,1
04438082,27,3,24,0,2,1,1,2,1
04438238,4,2,2,0,2,2,0,0,0
04438246,4,2,2,0,1,1,0,0,1
04438249,20,0,20,0,1,1,0,1,1
04438264,5,3,2,0,1,1,0,0,1
04438337,7,2,5,0,1,1,0,0,1
04438366,15,0,15,0,1,1,0,1,1
04438390,7,2,5,0,2,2,0,0,1
04438444,7,0,7,0,0,0,0,0,1
04438626,6,3,3,0,2,2,0,0,0
04438887,59,14,45,0,0,0,0,0,1
04438903,12,2,10,0,1,1,0,1,1
04438904,14,0,14,0,0,0,0,0,1
04438973,4,0,4,0,0,0,0,0,1
04439363,6,2,4,0,2,2,0,0,1
04439737,15,4,11,0,1,1,0,1,1
04439855,30,0,30,0,0,0,0,0,1
04439914,7,0,7,0,0,0,0,0,1
04440166,30,2,28,0,1,1,0,1,1
04440170,25,0,25,0,0,0,0,0,1
04440240,13,1,12,0,0,0,0,0,1
04440261,10,2,8,0,1,1,0,1,1
04440277,27,3,24,0,1,1,0,1,1
04440288,24,4,20,0,1,1,0,1,1
04440297,9,3,6,1,0,0,0,0,1
04440298,28,4,24,0,1,1,0,1,1
04440303,36,3,33,0,1,1,0,1,1
04440463,41,6,35,0,2,2,0,2,1
04440478,17,3,14,0,1,1,0,1,1
04440513,9,1,8,0,1,1,0,0,1
04440577,15,0,15,0,0,0,0,0,1
04440622,10,2,8,0,1,1,0,1,1
04440625,7,0,7,0,1,1,0,0,0
04440778,5,3,2,0,2,2,0,0,1
04440820,15,0,15,0,0,0,0,0,1
04440833,23,4,19,0,0,0,0,0,1
04440970,40,11,29,0,0,0,0,0,0
04441046,17,2,15,0,1,1,0,0,0
04441182,15,3,12,0,1,1,0,1,1
04441552,5,1,4,0,1,1,0,0,1
04442021,7,1,6,0,1,1,0,0,0
04442143,9,2,7,0,1,1,0,1,1
04442276,14,0,14,0,0,0,0,0,1
04442505,10,4,6,0,1,1,0,0,1
04442596,22,0,22,0,0,0,0,0,1
04442665,10,2,8,0,1,1,0,0,1
04442666,10,2,8,0,1,1,0,0,1
04442680,5,0,5,0,1,1,0,0,0
04442702,5,0,5,0,0,0,0,0,1
04442927,28,3,25,0,1,1,0,1,1
04442969,24,0,24,0,0,0,0,0,1
04443267,15,8,7,0,0,0,0,0,1
04443312,40,15,25,0,0,0,0,0,1
04443341,7,4,3,0,1,1,0,1,0
04443848,23,5,18,0,1,1,0,1,1
04443910,92,16,76,0,1,1,0,0,1
04443978,19,3,16,0,1,1,0,1,1
04444443,11,0,11,0,1,1,0,1,1
04444664,14,4,10,0,0,0,0,0,0
04444737,13,0,13,0,0,0,0,0,0
04444886,4,0,4,0,2,2,0,0,1
04444960,4,2,2,0,1,1,0,0,1
04445090,9,2,7,0,1,1,0,1,1
04445234,15,0,15,0,0,0,0,0,0
04445395,9,2,7,0,2,2,0,0,0
04445552,7,3,4,0,1,1,0,0,0
04445562,7,0,7,0,0,0,0,0,1
04446148,5,1,4,0,2,2,0,0,0
04446236,7,2,5,0,1,1,0,0,1
04446282,5,1,4,0,1,1,0,0,1
04446337,16,0,16,0,0,0,0,0,1
04446581,10,2,8,0,1,1,0,0,1
04446608,15,3,12,0,1,1,0,1,1
04446867,13,2,11,0,1,1,0,0,0
04447008,26,2,24,0,1,1,0,1,1
04447124,12,2,10,0,1,1,0,0,1
04447145,9,1,8,0,1,1,0,0,0
04447594,6,3,3,0,1,1,0,1,0
04447909,25,0,25,0,1,1,0,1,1
04448044,6,1,5,0,3,3,0,1,0
04448062,9,3,6,0,2,2,0,0,1
04448381,3,0,3,0,0,0,0,0,0
04448391,9,3,6,0,1,1,0,1,1
04448590,9,0,9,0,0,0,0,0,1
04448701,10,0,10,0,1,1,0,1,1
04448706,10,0,10,0,1,1,0,1,1
04448709,10,0,10,0,1,1,0,1,1
04448756,7,2,5,0,0,0,0,0,0
04449118,5,2,3,0,2,2,0,0,0
04449204,6,2,4,0,2,2,0,0,0
04449208,11,0,11,0,0,0,0,0,1
04449300,16,0,16,0,0,0,0,0,1
04449543,20,3,17,0,0,0,0,0,1
04449548,19,4,15,0,2,2,0,0,1
04449591,10,0,10,0,1,1,0,1,1
04449627,6,0,6,0,1,1,0,0,0
04449737,23,6,17,0,0,0,0,0,0
04449811,22,5,17,0,1,1,0,1,1
04449984,26,4,22,0,1,1,0,1,1
04450179,19,0,19,0,1,1,0,1,1
04450226,8,3,5,0,2,1,1,1,0
04450488,13,6,7,0,0,0,0,0,1
04450542,16,4,12,0,1,1,0,1,1
04450552,18,3,15,0,1,1,0,1,1
04450788,16,5,11,0,0,0,0,0,0
04450864,5,3,2,0,1,1,0,1,1
04450879,13,6,7,0,0,0,0,0,1
04450947,19,4,15,0,1,1,0,1,1
04451209,5,2,3,0,1,1,0,0,1
04451247,25,3,22,0,1,1,0,1,1
04451287,7,2,5,0,1,1,0,1,1
04451371,9,0,9,0,0,0,0,0,1
04451494,10,1,9,0,0,0,0,0,1
04451505,9,2,7,0,1,1,0,1,1
04451669,29,2,27,1,0,0,0,0,1
04451674,27,9,18,0,1,1,0,1,0
04451903,15,4,11,0,1,1,0,1,1
04452320,10,5,5,0,4,4,0,0,0
04452323,15,4,11,0,0,0,0,0,0
04452442,4,1,3,0,1,1,0,0,0
04452483,8,0,8,0,0,0,0,0,1
04452499,11,3,8,0,2,1,1,2,1
04452504,6,0,6,0,1,1,0,0,0
04452522,22,7,15,0,1,1,0,1,1
04452715,37,4,33,0,1,1,0,1,1
04452808,30,4,26,0,1,1,0,1,1
04452809,60,10,50,0,0,0,0,0,1
04452915,12,4,8,0,1,1,0,1,1
04453210,5,0,5,0,0,0,0,0,1
04453357,3,1,2,0,1,1,0,0,1
04453576,98,12,86,0,0,0,0,0,1
04453584,8,3,5,0,1,0,1,0,0
04453591,3,1,2,0,1,1,0,0,1
04454027,24,6,18,0,1,1,0,1,1
04454113,24,9,15,0,1,1,0,0,0
04454598,6,3,3,0,2,2,0,1,0
04454612,7,2,5,0,2,2,0,0,1
04454617,7,3,4,0,2,2,0,0,1
04454973,16,4,12,0,0,0,0,0,1
04455203,6,5,1,0,1,1,0,0,0
04455518,6,2,4,0,1,1,0,0,1
04455730,7,4,3,0,3,3,0,0,0
04455943,14,4,10,0,1,1,0,1,1
04455978,7,2,5,0,1,1,0,1,1
04456169,38,6,32,0,0,0,0,0,0
04456380,4,2,2,0,1,1,0,0,0
04456497,8,2,6,0,1,1,0,0,1
04456529,4,2,2,0,1,1,0,0,1
04456762,67,26,41,0,0,0,0,0,1
04456819,6,3,3,0,2,2,0,0,1
04457016,11,0,11,0,0,0,0,0,0
04457066,4,2,2,0,2,2,0,0,1
04457092,5,3,2,0,0,0,0,0,1
04457280,5,2,3,0,1,1,0,0,1
04457288,32,3,29,0,4,4,0,0,1
04457313,25,3,22,0,4,4,0,0,1
04457314,39,7,32,0,0,0,0,0,1
04457463,5,3,2,0,1,1,0,0,1
04457859,6,2,4,0,1,1,0,0,1
04457980,37,7,30,0,0,0,0,0,0
04458041,4,2,2,0,1,1,0,0,0
04458138,4,2,2,0,1,1,0,0,0
04458459,9,3,6,0,2,1,1,0,1
04458492,84,14,70,0,0,0,0,0,1
04458594,5,3,2,0,1,1,0,0,1
04458722,10,0,10,0,0,0,0,0,1
04459145,16,0,16,0,0,0,0,0,1
04459443,21,3,18,0,1,1,0,1,1
04459492,4,2,2,0,1,1,0,0,1
04459512,5,1,4,0,1,1,0,0,0
04459593,6,0,6,0,0,0,0,0,1
04459758,7,3,4,0,0,0,0,0,1
04459861,12,0,12,0,1,1,0,1,1
04459867,16,2,14,0,1,1,0,0,0
04460625,15,0,15,0,1,1,0,1,1
04460630,5,3,2,0,2,2,0,0,1
04460670,6,0,6,0,1,1,0,1,1
04461275,14,5,9,0,1,1,0,1,1
04461359,7,3,4,0,1,1,0,0,1
04461469,13,3,10,0,0,0,0,0,1
04461543,18,2,16,0,1,1,0,1,1
04461607,8,3,5,0,1,1,0,0,1
04461788,29,4,25,0,1,1,0,1,1
04462362,10,4,6,0,5,3,2,1,1
04462497,11,3,8,0,7,7,0,2,1
04462555,37,7,30,0,1,1,0,0,1
04462587,12,3,9,0,2,2,0,0,0
04462608,13,0,13,0,0,0,0,0,1
04462901,24,7,17,0,0,0,0,0,1
04462910,13,0,13,0,0,0,0,0,1
04463007,4,1,3,0,1,1,0,0,0
04463308,5,3,2,0,2,2,0,0,1
04463534,37,10,27,0,0,0,0,0,1
04463542,42,3,39,0,1,1,0,1,0
04463679,43,6,37,0,1,1,0,1,1
04463786,6,2,4,0,2,2,0,0,1
04463793,55,6,49,0,0,0,0,0,1
04464220,19,4,15,0,2,1,1,2,1
04464232,8,1,7,0,1,1,0,0,1
04464432,85,22,63,0,0,0,0,0,1
04464469,16,2,14,0,2,1,1,0,1
04464547,5,3,2,0,1,1,0,0,0
04464549,6,2,4,0,1,1,0,1,1
04464669,7,3,4,0,1,1,0,0,1
04464784,22,0,22,0,0,0,0,0,1
04464793,22,0,22,0,0,0,0,0,1
04464921,13,2,11,0,1,1,0,1,1
04464926,21,9,12,0,1,1,0,0,1
04464996,2,2,0,0,1,1,0,0,0
04465116,39,0,39,0,0,0,0,0,1
04465309,22,8,14,0,0,0,0,0,1
04465347,8,6,2,0,3,1,2,1,0
04465377,5,3,2,0,2,2,0,0,1
04465503,16,2,14,0,1,1,0,1,1
04465622,8,0,8,0,0,0,0,0,1
04465857,15,11,4,0,1,1,0,0,1
04466097,12,2,10,0,1,1,0,1,1
04466195,37,8,29,0,0,0,0,0,1
04466213,17,0,17,0,0,0,0,0,1
04466571,26,6,20,0,1,1,0,0,1
04466818,8,0,8,0,0,0,0,0,1
04466911,24,3,21,0,3,3,0,3,1
04467859,20,5,15,0,1,1,0,1,1
04468267,13,7,6,0,0,0,0,0,1
04468364,9,3,6,0,1,1,0,1,1
04468493,29,5,24,0,0,0,0,0,1
04469234,17,4,13,0,1,1,0,1,1
04469304,8,2,6,0,0,0,0,0,1
04469487,6,3,3,0,1,1,0,0,0
04469698,9,3,6,0,0,0,0,0,1
04470064,57,11,46,0,0,0,0,0,0
04470699,7,0,7,0,1,1,0,0,1
04471280,28,4,24,0,1,1,0,1,1
04471316,21,8,13,0,0,0,0,0,0
04471417,7,2,5,0,1,1,0,1,0
04471593,19,1,18,0,0,0,0,0,1
04471594,16,4,12,0,1,1,0,0,1
04471626,6,0,6,0,0,0,0,0,1
04471753,10,0,10,0,1,1,0,0,1
04471784,8,3,5,0,1,1,0,0,1
04471823,6,0,6,0,0,0,0,0,1
04471825,17,0,17,0,0,0,0,0,1
04471826,12,3,9,0,1,1,0,1,1
04472361,3,1,2,0,1,1,0,0,1
04472442,16,2,14,0,1,1,0,1,1
04472446,18,0,18,0,1,1,0,1,1
04472544,6,2,4,0,1,1,0,0,1
04472647,6,2,4,0,1,1,0,0,0
04473107,4,2,2,0,1,1,0,0,1
04473271,9,6,3,0,3,1,2,1,0
04473278,5,2,3,0,1,1,0,0,0
04473379,8,4,4,0,2,2,0,0,1
04473419,25,8,17,0,0,0,0,0,1
04473521,14,0,14,0,0,0,0,0,1
04473844,15,3,12,0,1,1,0,1,1
04473845,5,0,5,0,1,1,0,0,0
04474324,19,7,12,0,0,0,0,0,1
04475393,5,3,2,0,1,1,0,0,0
04475566,10,2,8,0,0,0,0,0,1
04476305,5,3,2,0,2,2,0,0,0
04476519,14,3,11,0,1,1,0,1,1
04476540,17,3,14,0,1,1,0,1,1
04476558,41,14,27,0,3,2,1,0,1
04476565,6,4,2,0,1,1,0,0,1
04476633,6,2,4,0,1,1,0,0,0
04476843,10,1,9,0,1,1,0,1,1
04477212,9,0,9,0,0,0,0,0,1
04477495,9,4,5,0,1,1,0,0,1
04477510,8,3,5,0,1,1,0,1,1
04477517,9,0,9,0,0,0,0,0,1
04477561,11,4,7,0,1,1,0,1,1
04477641,10,3,7,0,2,2,0,0,1
04477725,7,3,4,0,1,1,0,0,0
04477810,40,0,40,0,0,0,0,0,1
04477892,20,7,13,0,0,0,0,0,1
04478333,5,3,2,0,2,2,0,0,0
04478426,5,2,3,0,1,1,0,0,0
04478534,12,0,12,0,0,0,0,0,1
04478575,5,3,2,0,2,2,0,0,1
04478844,19,3,16,0,0,0,0,0,1
04479100,7,0,7,0,0,0,0,0,1
04479153,10,2,8,0,1,1,0,0,1
04479308,22,3,19,0,1,1,0,1,1
04479460,4,0,4,0,0,0,0,0,1
04479551,31,9,22,0,0,0,0,0,1
04479600,5,3,2,0,4,4,0,0,0
04479652,6,3,3,0,1,1,0,0,0
04480074,5,3,2,0,2,2,0,0,0
04480352,53,13,40,0,1,1,0,0,1
04480485,42,5,37,0,6,4,2,0,0
04480539,31,0,31,0,0,0,0,0,1
04480729,5,3,2,0,2,2,0,0,0
04480753,10,3,7,0,2,1,1,1,1
04480862,4,2,2,0,1,1,0,0,0
04480905,5,3,2,0,1,1,0,0,0
04480920,4,0,4,0,1,1,0,0,0
04480928,46,16,30,0,1,1,0,1,1
04480989,5,2,3,0,1,1,0,0,1
04481053,22,3,19,0,0,0,0,0,1
04481317,12,0,12,0,0,0,0,0,1
04481334,11,0,11,0,0,0,0,0,1
04481416,5,0,5,0,1,1,0,0,0
04481547,2,2,0,0,0,0,0,0,1
04481775,6,3,3,0,2,2,0,0,0
04481843,11,0,11,0,1,1,0,0,1
04482136,10,1,9,0,1,1,0,1,1
04482195,5,0,5,0,0,0,0,0,1
04482330,5,3,2,0,0,0,0,0,0
04482405,49,10,39,0,1,1,0,1,1
04482576,39,10,29,0,1,1,0,1,1
04483330,14,7,7,0,0,0,0,0,1
04483406,15,3,12,0,0,0,0,0,1
04483430,39,6,33,0,1,1,0,1,1
04483634,5,2,3,0,1,1,0,0,1
04483755,35,14,21,0,0,0,0,0,0
04484139,18,3,15,0,1,1,0,1,1
04484420,12,0,12,0,0,0,0,0,1
04484666,9,3,6,0,2,1,1,2,1
04484761,6,3,3,0,2,2,0,0,0
04485435,7,2,5,0,1,1,0,0,1
04485508,4,2,2,0,1,1,0,0,1
04485577,4,0,4,0,0,0,0,0,1
04485592,15,0,15,0,0,0,0,0,1
04485612,17,0,17,0,0,0,0,0,1
04485645,5,3,2,0,2,2,0,0,0
04485647,22,4,18,0,0,0,0,0,1
04485654,10,2,8,0,1,1,0,0,1
04485855,4,2,2,0,1,1,0,0,0
04485945,24,7,17,0,11,7,4,0,0
04485963,5,0,5,0,1,1,0,0,1
04487094,8,4,4,0,3,2,1,1,1
04487136,20,11,9,0,1,1,0,1,1
04487349,7,2,5,0,0,0,0,0,1
04487466,9,1,8,0,1,1,0,1,1
04487498,9,1,8,0,1,1,0,1,1
04487500,9,1,8,0,1,1,0,1,1
04487600,27,3,24,0,1,1,0,1,1
04487647,7,2,5,0,1,1,0,0,1
04488223,8,3,5,0,1,1,0,0,1
04488255,10,4,6,0,1,1,0,0,1
04488357,5,0,5,0,2,2,0,0,1
04488667,8,0,8,0,1,1,0,1,1
04488714,47,11,36,0,0,0,0,0,1
04488973,5,2,3,0,1,1,0,0,0
04488979,8,3,5,0,1,1,0,0,0
04489230,8,1,7,0,1,1,0,0,1
04489476,12,0,12,0,0,0,0,0,1
04489509,7,2,5,0,1,1,0,0,0
04489762,9,5,4,0,3,3,0,0,0
04489789,7,0,7,0,0,0,0,0,1
04489884,6,2,4,0,1,1,0,0,0
04489898,7,1,6,0,1,1,0,0,0
04489964,5,3,2,0,1,1,0,0,0
04490331,13,2,11,0,2,1,1,1,0
04490382,8,0,8,0,0,0,0,0,1
04490405,11,0,11,0,0,0,0,0,0
04490448,6,3,3,0,2,2,0,0,1
04490735,13,4,9,0,1,1,0,0,0
04491006,9,2,7,0,2,2,0,0,1
04491072,24,0,24,0,0,0,0,0,1
04491125,15,4,11,0,2,2,0,0,1
04491145,16,4,12,0,2,2,0,0,1
04491170,15,4,11,0,2,2,0,0,1
04491178,16,4,12,0,2,2,0,0,1
04491233,18,3,15,0,0,0,0,0,1
04491501,5,2,3,0,2,2,0,0,0
04491681,4,2,2,0,1,1,0,0,0
04491717,6,0,6,0,2,2,0,0,1
04491869,10,4,6,0,1,1,0,1,1
04492574,24,0,24,0,0,0,0,0,1
04492598,28,5,23,0,1,1,0,1,1
04492841,24,10,14,0,0,0,0,0,0
04492893,5,2,3,0,1,1,0,1,0
04493159,18,9,9,0,1,1,0,0,1
04493352,5,0,5,0,0,0,0,0,1
04493719,19,0,19,0,4,4,0,0,0
04493899,4,2,2,0,1,1,0,0,0
SC177136,6,2,4,0,1,1,0,0,1
SC177358,18,3,15,0,0,0,0,0,1
SC177361,8,3,5,0,2,2,0,0,1
SC177369,17,0,17,0,1,1,0,1,1
SC177390,5,4,1,0,2,2,0,0,1
SC177502,35,9,26,0,0,0,0,0,1
SC177553,44,10,34,0,0,0,0,0,1
SC177616,11,6,5,0,1,1,0,0,0
SC177637,19,4,15,2,1,1,0,1,1
SC177639,7,1,6,0,1,1,0,0,1
SC177682,24,2,22,0,1,1,0,1,0
SC177690,20,3,17,0,2,2,0,0,1
SC177720,16,4,12,0,2,1,1,0,0
SC177781,26,3,23,0,1,1,0,0,1
SC177822,33,0,33,0,0,0,0,0,1
SC177917,14,3,11,0,0,0,0,0,1
SC177926,24,2,22,0,2,1,1,2,1
SC177956,13,1,12,1,1,0,1,1,1
SC177984,4,1,3,0,0,0,0,0,0
SC178108,25,2,23,0,1,1,0,1,1
SC178109,20,4,16,0,2,1,1,2,1
SC178210,5,2,3,0,1,1,0,0,0
SC178214,28,9,19,0,11,0,11,0,0
SC178243,35,3,32,0,1,1,0,1,0
SC178606,5,4,1,1,2,2,0,0,0
SC178677,19,1,18,0,2,1,1,2,1
SC178837,23,5,18,0,0,0,0,0,1
SC178916,51,9,42,0,4,1,3,0,1
SC178991,4,3,1,0,2,2,0,0,0
SC179111,20,8,12,0,0,0,0,0,1
SC179215,9,2,7,0,1,1,0,1,1
SC179254,80,8,72,0,0,0,0,0,1
SC179346,9,1,8,0,1,1,0,0,1
SC179412,20,6,14,0,0,0,0,0,1
SC179415,32,8,24,0,0,0,0,0,1
SC179469,21,12,9,0,0,0,0,0,1
SC179504,10,4,6,0,3,3,0,0,1
SC179570,23,0,23,0,0,0,0,0,1
SC179716,5,0,5,0,0,0,0,0,1
SC179773,7,0,7,0,0,0,0,0,1
SC179907,13,5,8,0,1,1,0,1,1
SC179935,8,3,5,0,2,2,0,0,0
SC180005,5,4,1,0,2,2,0,0,0
SC180041,5,0,5,0,0,0,0,0,0
SC180107,90,39,51,1,0,0,0,0,1
SC180138,44,4,40,0,0,0,0,0,1
SC180199,17,0,17,0,1,1,0,1,1
SC180202,8,0,8,0,1,1,0,0,1
SC180266,24,2,22,0,0,0,0,0,1
SC180268,105,55,50,0,1,1,0,1,1
SC180417,4,2,2,0,1,1,0,0,1
SC180437,49,7,42,0,1,1,0,1,1
SC180485,12,4,8,0,1,1,0,0,1
SC180560,6,2,4,0,1,1,0,0,0
SC180852,11,0,11,0,0,0,0,0,1
SC180965,19,7,12,0,0,0,0,0,0
SC180966,12,4,8,0,0,0,0,0,1
SC181158,21,6,15,1,0,0,0,0,1
SC181197,6,2,4,0,1,1,0,0,1
SC181295,5,2,3,0,1,1,0,0,1
SC181305,7,0,7,0,0,0,0,0,1
SC181402,11,1,10,0,2,2,0,0,1
SC181465,5,0,5,0,0,0,0,0,1
SC181581,11,3,8,0,1,1,0,1,1
SC181656,12,0,12,0,0,0,0,0,1
SC181688,11,0,11,0,0,0,0,0,1
SC181709,62,12,50,0,0,0,0,0,1
SC181750,28,3,25,0,3,1,2,1,1
SC181751,15,4,11,0,1,1,0,0,1
SC181752,8,0,8,0,0,0,0,0,1
SC181843,9,3,6,0,2,2,0,0,1
SC181844,14,3,11,0,1,1,0,1,1
SC181845,7,3,4,0,1,1,0,0,1
SC182048,11,2,9,0,1,1,0,1,1
SC182054,13,4,9,0,0,0,0,0,0
SC182197,40,4,36,0,4,4,0,0,0
SC182337,15,0,15,0,0,0,0,0,1
SC182448,13,3,10,0,1,1,0,1,1
SC182496,23,1,22,0,2,2,0,0,1
SC182499,14,3,11,0,1,1,0,1,0
SC182553,7,3,4,0,1,1,0,0,0
SC182626,16,0,16,0,0,0,0,0,1
SC182822,47,5,42,0,2,1,1,2,1
SC182936,9,3,6,0,2,2,0,0,1
SC183076,9,0,9,0,0,0,0,0,1
SC183077,12,0,12,0,0,0,0,0,1
SC183230,5,0,5,0,2,2,0,0,0
SC183241,22,0,22,0,0,0,0,0,1
SC183267,53,9,44,0,2,2,0,2,1
SC183748,9,4,5,0,2,2,0,0,1
SC184082,12,4,8,0,1,1,0,1,1
SC184324,10,3,7,0,0,0,0,0,1
SC184382,7,5,2,0,1,1,0,0,0
SC184392,19,8,11,0,0,0,0,0,1
SC184406,13,4,9,0,1,1,0,0,1
SC184423,60,11,49,0,0,0,0,0,1
SC184443,40,8,32,0,0,0,0,0,0
SC184499,23,3,20,0,1,1,0,1,1
SC184567,6,0,6,0,0,0,0,0,0
SC184570,9,2,7,0,1,1,0,1,1
SC184712,17,6,11,0,3,3,0,0,0
SC184779,13,0,13,0,0,0,0,0,1
SC184821,45,8,37,0,0,0,0,0,1
SC184914,14,4,10,0,1,1,0,1,1
SC184953,34,11,23,0,1,1,0,1,1
SC184957,21,11,10,1,1,1,0,1,1
SC185200,19,5,14,0,2,2,0,2,1
SC185362,26,1,25,0,2,1,1,2,1
SC185425,44,11,33,0,1,1,0,0,1
SC185641,4,3,1,0,2,2,0,0,0
SC185657,22,4,18,0,1,1,0,1,1
SC185707,16,0,16,0,0,0,0,0,1
SC185887,15,8,7,0,1,1,0,0,0
SC185931,12,3,9,1,1,1,0,1,1
SC186247,35,3,32,0,3,1,2,3,1
SC186350,22,3,19,0,3,2,1,0,1
SC186520,16,3,13,0,1,1,0,1,1
SC186536,6,3,3,0,2,2,0,0,1
SC186537,5,2,3,0,2,2,0,0,1
SC186570,9,3,6,0,1,1,0,0,1
SC186663,45,10,35,1,0,0,0,0,1
SC186794,27,5,22,0,4,1,3,3,1
SC186816,27,12,15,0,1,1,0,0,0
SC186919,43,6,37,0,6,1,5,4,1
SC187000,22,0,22,0,0,0,0,0,0
SC187089,24,5,19,0,0,0,0,0,1
SC187212,23,3,20,0,1,1,0,1,1
SC187460,19,6,13,0,1,1,0,1,1
SC187462,9,0,9,0,0,0,0,0,1
SC187470,11,4,7,2,1,1,0,0,1
SC187607,7,5,2,0,1,1,0,1,1
SC187615,7,3,4,0,2,2,0,0,1
SC187732,37,8,29,0,0,0,0,0,0
SC187738,20,8,12,1,0,0,0,0,0
SC188241,35,12,23,0,0,0,0,0,0
SC188446,49,13,36,0,0,0,0,0,1
SC188672,5,3,2,0,2,2,0,0,1
SC188780,29,4,25,0,1,1,0,1,1
SC188819,83,4,79,0,0,0,0,0,1
SC188839,14,0,14,0,0,0,0,0,1
SC188877,16,2,14,0,4,4,0,1,1
SC189034,5,0,5,0,0,0,0,0,1
SC189060,9,0,9,0,1,1,0,1,1
SC189200,4,1,3,0,0,0,0,0,1
SC189253,27,10,17,0,2,0,2,0,1
SC189419,17,4,13,0,1,1,0,1,1
SC189451,14,4,10,0,1,1,0,1,1
SC189503,50,8,42,0,0,0,0,0,0
SC189639,32,3,29,0,1,1,0,1,1
SC189780,25,5,20,0,0,0,0,0,0
SC189859,31,13,18,0,0,0,0,0,1
SC190078,26,6,20,0,3,1,2,2,1
SC190392,17,0,17,0,0,0,0,0,1
SC190449,11,4,7,0,1,1,0,1,1
SC190498,29,8,21,0,1,1,0,0,1
SC190523,30,1,29,0,0,0,0,0,1
SC190544,5,0,5,0,0,0,0,0,1
SC190660,13,3,10,0,1,1,0,1,1
SC190785,34,0,34,0,0,0,0,0,1
SC190967,27,3,24,0,1,1,0,1,1
SC191010,12,0,12,0,0,0,0,0,1
SC191011,17,0,17,2,1,1,0,1,1
SC191119,10,3,7,0,2,2,0,0,1
SC191167,23,4,19,0,2,2,0,2,1
SC191372,8,4,4,0,2,2,0,0,1
SC191428,58,13,45,1,0,0,0,0,1
SC191537,7,2,5,0,0,0,0,0,1
SC191750,14,0,14,1,1,1,0,1,1
SC191763,12,0,12,0,0,0,0,0,1
SC191808,8,2,6,0,0,0,0,0,0
SC191911,5,3,2,0,2,2,0,0,0
SC191917,18,0,18,0,0,0,0,0,1
SC192082,10,5,5,0,2,2,0,2,1
SC192129,21,0,21,0,0,0,0,0,1
SC192142,32,10,22,0,3,3,0,3,1
SC192174,18,4,14,0,1,1,0,1,1
SC192335,6,0,6,0,0,0,0,0,0
SC192393,7,0,7,0,1,1,0,0,0
SC192450,32,0,32,0,0,0,0,0,1
SC192451,32,0,32,0,0,0,0,0,1
SC192452,32,0,32,0,0,0,0,0,1
SC192453,27,4,23,0,1,1,0,1,1
SC192454,25,0,25,0,0,0,0,0,1
SC192455,32,0,32,0,0,0,0,0,1
SC192456,32,0,32,0,0,0,0,0,1
SC192666,38,4,34,0,1,1,0,1,1
SC192710,9,0,9,1,0,0,0,0,1
SC192726,23,4,19,0,2,2,0,2,1
SC192745,5,3,2,0,1,1,0,1,0
SC192761,21,6,15,0,0,0,0,0,1
SC192894,7,3,4,1,2,2,0,0,1
SC192903,6,2,4,0,1,1,0,1,1
SC193107,5,2,3,2,1,1,0,1,1
SC193175,7,4,3,0,1,1,0,0,1
SC193477,4,0,4,0,0,0,0,0,1
SC193574,7,2,5,0,2,1,1,0,0
SC193701,6,3,3,0,2,2,0,0,0
SC193759,17,2,15,0,1,1,0,1,1
SC193760,12,1,11,0,0,0,0,0,1
SC193763,25,0,25,0,0,0,0,0,1
SC193765,45,7,38,0,2,2,0,2,1
SC193794,62,10,52,0,1,1,0,1,1
SC193806,6,0,6,0,0,0,0,0,1
SC193938,7,2,5,0,2,1,1,0,0
SC194012,18,3,15,0,1,1,0,1,1
SC194167,9,1,8,0,2,1,1,0,1
SC194342,11,0,11,0,1,1,0,1,1
SC194346,6,2,4,0,1,1,0,0,1
SC194348,11,2,9,0,2,1,1,1,1
SC194349,17,2,15,0,1,1,0,1,1
SC194401,14,5,9,0,1,1,0,1,0
SC194458,8,6,2,0,1,1,0,0,1
SC194537,25,6,19,1,2,2,0,0,1
SC194610,7,1,6,0,1,1,0,0,1
SC194613,5,3,2,0,1,1,0,1,0
SC194626,5,3,2,0,1,1,0,0,1
SC194714,5,0,5,1,0,0,0,0,1
SC194748,50,12,38,0,0,0,0,0,0
SC194750,12,0,12,0,0,0,0,0,1
SC194844,8,0,8,0,0,0,0,0,1
SC194893,57,7,50,0,0,0,0,0,1
SC194910,16,6,10,0,0,0,0,0,0
SC194959,5,2,3,0,1,1,0,0,0
SC194986,21,4,17,1,1,1,0,1,1
SC195087,24,3,21,0,1,1,0,1,1
SC195088,20,0,20,0,0,0,0,0,1
SC195315,53,16,37,1,0,0,0,0,1
SC195354,22,2,20,0,1,1,0,1,1
SC195710,5,2,3,0,1,1,0,0,1
SC195910,31,0,31,0,0,0,0,0,1
SC195923,24,9,15,0,1,1,0,0,1
SC195924,6,3,3,0,1,1,0,0,1
SC196090,26,7,19,0,1,1,0,1,1
SC196138,6,2,4,0,1,1,0,0,1
SC196197,31,6,25,0,1,1,0,0,0
SC196232,8,0,8,1,0,0,0,0,1
SC196328,30,3,27,0,2,2,0,2,1
SC196331,19,7,12,0,0,0,0,0,1
SC196364,23,2,21,0,1,1,0,1,1
SC196368,22,0,22,0,0,0,0,0,1
SC196411,21,3,18,0,1,1,0,0,1
SC196608,31,5,26,0,1,1,0,1,1
SC196652,6,0,6,0,0,0,0,0,0
SC196682,4,0,4,0,0,0,0,0,1
SC196706,16,0,16,0,0,0,0,0,1
SC196762,20,0,20,0,0,0,0,0,1
SC196780,26,0,26,0,0,0,0,0,1
SC196844,16,0,16,0,0,0,0,0,1
SC196872,7,3,4,1,3,3,0,0,1
SC197117,5,2,3,0,1,1,0,0,1
SC197734,11,4,7,0,5,5,0,1,1
SC197955,18,0,18,0,1,1,0,1,1
SC198034,13,2,11,0,1,1,0,1,1
SC198094,22,6,16,0,1,1,0,1,1
SC198254,31,4,27,0,1,1,0,1,1
SC198295,10,0,10,0,0,0,0,0,1
SC198349,15,0,15,0,3,3,0,0,0
SC198410,7,3,4,0,2,2,0,0,1
SC198443,12,7,5,0,0,0,0,0,0
SC198550,37,8,29,0,0,0,0,0,1
SC198644,20,8,12,0,1,1,0,0,0
SC198763,8,1,7,0,1,1,0,0,1
SC198780,45,8,37,0,0,0,0,0,1
SC198860,20,5,15,0,1,1,0,1,1
SC198914,46,22,24,0,1,1,0,1,1
SC198965,53,10,43,0,0,0,0,0,1
SC199079,18,3,15,0,1,1,0,1,1
SC199292,55,9,46,0,0,0,0,0,1
SC199335,16,0,16,0,0,0,0,0,1
SC199342,0,0,0,0,0,0,0,0,1
SC199355,19,2,17,0,3,1,2,3,1
SC199377,12,4,8,0,2,2,0,0,0
SC199419,10,3,7,1,4,2,2,0,1
SC199454,28,0,28,0,0,0,0,0,1
SC199503,20,7,13,0,3,3,0,1,1
SC199856,26,7,19,0,1,1,0,1,1
SC199910,8,3,5,0,2,2,0,2,0
SC199949,6,3,3,0,2,2,0,0,0
SC440087,8,3,5,0,1,1,0,1,1
SC440117,6,4,2,0,0,0,0,0,0
SC440122,2,2,0,0,2,2,0,0,0
SC440222,18,10,8,0,0,0,0,0,1
SC440402,3,0,3,0,3,3,0,0,0
SC440527,6,0,6,0,0,0,0,0,0
SC440693,4,2,2,0,2,2,0,0,0
SC440701,1,1,0,0,1,1,0,0,0
SC440784,9,4,5,0,1,1,0,1,1
SC440964,25,9,16,0,0,0,0,0,1
SC440985,1,1,0,0,2,2,0,0,0
SC440991,4,4,0,0,0,0,0,0,0
SC441084,1,0,1,0,0,0,0,0,0
SC441280,9,2,7,0,2,1,1,2,1
SC441300,3,1,2,0,1,1,0,0,1
SC441519,1,1,0,0,1,1,0,1,0
SC441520,2,1,1,0,1,1,0,0,0
SC441641,40,11,29,0,0,0,0,0,0
SC441787,2,2,0,0,1,1,0,0,0
SC441854,3,0,3,0,1,1,0,1,1
SC441933,3,0,3,0,0,0,0,0,0
SC442227,4,3,1,0,2,1,1,1,1
SC442497,1,1,0,0,1,1,0,0,1
SC442507,3,3,0,0,2,2,0,0,0
SC442508,1,0,1,0,0,0,0,0,1
SC442524,1,1,0,0,0,0,0,0,0
SC442724,11,7,4,0,0,0,0,0,1
SC442917,2,1,1,0,0,0,0,0,0
SC442985,2,2,0,0,2,2,0,0,1
SC442990,3,0,3,0,1,1,0,1,1
SC443035,1,0,1,0,0,0,0,0,1
SC443037,1,0,1,0,0,0,0,0,1
SC443233,13,10,3,0,0,0,0,0,1
SC443347,4,3,1,0,1,1,0,1,0
SC443370,5,0,5,0,0,0,0,0,1
SC443402,4,4,0,0,1,1,0,1,0
SC443461,2,0,2,0,0,0,0,0,0
SC443468,10,5,5,1,1,1,0,1,1
SC443486,6,0,6,0,0,0,0,0,1
SC443533,1,0,1,0,0,0,0,0,0
SC443673,2,2,0,0,1,1,0,0,0
SC443679,2,2,0,0,1,1,0,0,0
SC443895,27,8,19,0,1,1,0,1,1
SC444054,1,1,0,0,1,1,0,0,0
SC444207,2,0,2,0,0,0,0,0,1
SC444212,1,1,0,0,1,1,0,0,1
SC444275,2,2,0,0,1,1,0,0,0
SC444372,19,14,5,0,0,0,0,0,1
SC444427,2,2,0,0,1,1,0,0,1
SC444473,6,0,6,0,0,0,0,0,0
SC444545,6,0,6,0,0,0,0,0,1
SC444779,1,0,1,0,0,0,0,0,0
SC445138,2,2,0,0,2,2,0,0,0
SC445163,2,2,0,0,1,1,0,0,0
SC445192,4,1,3,0,0,0,0,0,0
SC445425,6,5,1,0,1,1,0,1,1
SC445431,2,1,1,0,1,1,0,0,0
SC445498,6,0,6,0,0,0,0,0,1
SC445499,6,3,3,0,2,2,0,0,1
SC445530,29,9,20,0,0,0,0,0,0
SC445629,2,1,1,0,2,1,1,0,0
SC445666,3,3,0,0,2,2,0,0,0
SC445814,3,3,0,0,4,3,1,0,0
SC445952,23,8,15,0,0,0,0,0,0
SC446125,2,0,2,0,0,0,0,0,0
SC446365,1,1,0,0,1,1,0,0,0
SC446422,2,2,0,0,2,2,0,0,0
SC446843,4,2,2,0,1,1,0,0,0
SC446872,1,1,0,0,0,0,0,0,0
SC447027,3,3,0,0,1,1,0,1,1
SC447227,6,6,0,0,3,3,0,0,1
SC447499,2,2,0,0,1,1,0,0,0
SC447500,3,3,0,0,2,2,0,1,0
SC447569,1,1,0,0,1,1,0,0,0
SC447591,1,1,0,0,1,1,0,0,0
SC447671,2,0,2,0,2,2,0,0,0
SC447672,1,1,0,0,0,0,0,0,0
SC447774,4,1,3,0,1,1,0,0,0
SC447877,3,2,1,0,2,1,1,0,0
SC447980,5,1,4,0,1,1,0,1,1
SC448058,2,1,1,0,2,1,1,1,0
SC448078,3,1,2,0,1,0,1,0,0
SC448322,4,2,2,0,2,2,0,0,1
SC448432,1,0,1,0,0,0,0,0,0
SC448434,5,3,2,0,1,1,0,1,0
SC448754,2,0,2,0,0,0,0,0,0
SC448821,1,0,1,0,0,0,0,0,1
SC448866,1,1,0,0,1,1,0,0,0
SC448880,3,0,3,0,1,1,0,0,0
SC448922,2,1,1,0,2,1,1,0,0
SC449151,5,3,2,0,1,1,0,1,0
SC449331,8,4,4,0,0,0,0,0,1
SC449343,5,2,3,0,2,2,0,0,0
SC449389,1,1,0,0,0,0,0,0,0
SC449482,1,0,1,0,0,0,0,0,1
SC449518,1,1,0,0,1,1,0,0,1
SC449563,2,2,0,0,1,1,0,0,0
SC449688,3,3,0,0,1,1,0,1,0
SC449920,7,3,4,0,1,1,0,1,1
SC450017,8,4,4,0,0,0,0,0,1
SC450041,2,2,0,0,1,1,0,0,0
SC450127,3,3,0,0,1,1,0,0,1
SC450189,19,7,12,0,1,1,0,1,1
SC450300,14,2,12,0,7,2,5,0,0
SC450415,1,1,0,0,1,1,0,0,0
SC450436,1,1,0,0,1,1,0,0,0
SC450465,7,3,4,0,2,2,0,0,1
SC451032,4,1,3,0,1,1,0,1,1
SC451088,1,1,0,0,1,1,0,0,0
SC451427,3,2,1,0,3,2,1,0,1
SC451539,4,2,2,0,1,1,0,1,1
SC451576,4,4,0,0,5,4,1,2,1
SC451757,1,1,0,0,1,1,0,0,0
SC451762,3,3,0,0,2,2,0,0,1
SC451777,1,0,1,0,1,1,0,0,0
SC451852,2,0,2,0,0,0,0,0,1
SC451890,3,2,1,0,2,2,0,0,0
SC452000,1,0,1,0,0,0,0,0,0
SC452088,3,1,2,0,1,1,0,0,0
SC452171,1,1,0,0,1,1,0,0,0
SC452330,2,2,0,0,2,2,0,0,0
SC452371,3,0,3,0,0,0,0,0,0
SC452433,4,1,3,0,1,1,0,0,1
SC452530,2,0,2,0,0,0,0,0,1
SC452534,1,1,0,0,1,1,0,0,0
SC452589,1,0,1,0,0,0,0,0,1
SC452764,2,2,0,0,2,2,0,0,0
SC453000,2,0,2,0,0,0,0,0,0
SC453031,1,0,1,0,1,1,0,0,0
SC453327,14,5,9,0,2,1,1,2,1
SC453333,3,1,2,0,1,1,0,0,0
SC453579,13,7,6,0,1,0,1,1,1
SC453585,2,1,1,0,1,1,0,0,0
SC453609,19,8,11,0,1,1,0,1,1
SC453661,3,3,0,0,0,0,0,0,0
SC453712,3,0,3,0,1,1,0,0,1
SC453767,2,2,0,0,2,2,0,0,0
SC453958,1,0,1,0,1,1,0,0,0
SC454222,3,3,0,0,2,0,2,0,1
SC454308,3,3,0,0,2,0,2,0,1
SC454461,1,1,0,0,1,1,0,0,1
SC454539,1,0,1,0,0,0,0,0,0
SC454706,6,4,2,1,2,1,1,1,1
SC454789,2,2,0,0,1,1,0,0,0
SC455097,1,0,1,0,0,0,0,0,1
SC455421,1,0,1,0,0,0,0,0,0
SC455513,8,0,8,1,0,0,0,0,1
SC455524,2,1,1,0,1,1,0,0,1
SC455527,3,3,0,0,3,3,0,0,1
SC455533,8,0,8,1,0,0,0,0,1
SC455612,12,5,7,0,1,1,0,0,1
SC456031,1,1,0,0,1,1,0,0,1
SC456095,1,1,0,0,1,1,0,0,0
SC456189,9,0,9,0,1,1,0,1,1
SC456247,3,0,3,0,2,1,1,0,0
SC456413,12,1,11,0,0,0,0,0,1
SC456812,8,3,5,0,1,1,0,1,1
SC456813,9,3,6,0,1,1,0,1,1
SC456877,11,2,9,0,0,0,0,0,0
SC457118,2,2,0,0,1,1,0,0,0
SC457664,3,3,0,0,1,1,0,0,1
SC457765,9,5,4,0,1,1,0,0,0
SC457916,5,2,3,1,0,0,0,0,1
SC457946,4,3,1,0,0,0,0,0,1
SC458083,2,0,2,0,0,0,0,0,0
SC458246,2,0,2,0,1,1,0,0,0
SC458292,3,3,0,0,3,0,3,0,1
SC458538,2,2,0,0,2,2,0,0,0
SC458756,4,0,4,0,0,0,0,0,1
SC458845,1,0,1,0,1,1,0,0,0
SC458849,7,3,4,1,1,1,0,0,1
SC458864,1,0,1,0,0,0,0,0,1
SC459116,2,2,0,0,2,1,1,0,0
SC459230,3,3,0,0,2,1,1,2,0
SC459407,4,2,2,0,1,1,0,1,1
SC459531,11,2,9,0,1,1,0,1,1
SC459537,1,0,1,0,0,0,0,0,0
SC459586,5,3,2,1,2,1,1,2,1
SC459685,1,0,1,0,0,0,0,0,0
SC459713,2,2,0,0,1,1,0,0,0
SC459934,3,2,1,0,1,1,0,1,0
SC460191,11,8,3,0,2,2,0,2,1
SC460240,10,5,5,0,4,2,2,2,1
SC460634,3,2,1,0,1,1,0,0,0
SC460842,5,4,1,0,0,0,0,0,1
SC460843,1,0,1,0,0,0,0,0,1
SC460916,22,5,17,0,1,1,0,0,0
SC460990,15,3,12,1,1,1,0,1,1
SC461017,6,0,6,0,0,0,0,0,1
SC461232,3,3,0,0,1,1,0,1,0
SC461242,28,11,17,0,0,0,0,0,1
SC461270,2,2,0,0,2,2,0,0,0
SC461573,2,0,2,0,0,0,0,0,0
SC461574,1,0,1,0,0,0,0,0,0
SC461588,5,2,3,0,2,2,0,0,1
SC461627,8,5,3,1,2,2,0,2,1
SC461643,5,0,5,0,2,2,0,2,0
SC461653,3,3,0,0,2,2,0,0,0
SC461655,10,0,10,1,1,1,0,1,1
SC461664,5,4,1,0,1,1,0,0,1
SC461697,1,1,0,0,1,1,0,0,0
SC461966,1,1,0,0,1,1,0,0,0
SC462042,2,2,0,0,2,2,0,0,0
SC462093,2,0,2,0,1,1,0,0,0
SC462151,3,3,0,0,2,1,1,0,1
SC462161,2,2,0,0,1,1,0,1,0
SC462162,2,2,0,0,1,1,0,1,0
SC462190,4,1,3,0,1,1,0,1,1
SC462191,6,0,6,1,0,0,0,0,1
SC462197,2,0,2,0,1,1,0,1,0
SC462198,4,1,3,0,1,1,0,1,1
SC462201,4,3,1,0,3,2,1,0,1
SC462213,1,1,0,0,1,1,0,0,0
SC462258,1,0,1,0,1,1,0,0,1
SC462672,8,5,3,0,2,2,0,0,1
SC462812,3,0,3,0,0,0,0,0,1
SC462954,6,2,4,1,1,1,0,1,1
SC463002,1,1,0,0,2,2,0,0,1
SC463030,1,1,0,0,1,1,0,0,0
SC463078,7,4,3,1,1,1,0,1,1
SC463080,6,3,3,0,4,4,0,0,1
SC463283,3,0,3,0,1,1,0,0,1
SC463366,2,2,0,0,1,1,0,0,1
SC463511,1,1,0,0,1,1,0,0,0
SC463512,4,4,0,0,0,0,0,0,1
SC463633,6,4,2,0,2,1,1,1,1
SC463668,7,4,3,1,1,1,0,1,1
SC463749,4,2,2,1,1,1,0,1,1
SC463798,11,4,7,0,2,2,0,2,1
SC463844,4,1,3,0,3,1,2,1,0
SC464033,13,5,8,0,1,1,0,1,1
SC464315,1,1,0,0,1,1,0,0,1
SC464376,5,4,1,0,0,0,0,0,1
SC464541,10,7,3,0,1,1,0,1,1
SC464558,4,3,1,0,1,1,0,1,1
SC464734,2,2,0,0,2,2,0,0,0
SC464762,4,2,2,0,1,1,0,0,0
SC464770,27,9,18,0,0,0,0,0,0
SC464805,8,4,4,0,1,1,0,1,0
SC464814,2,0,2,0,0,0,0,0,1
SC464818,2,0,2,0,0,0,0,0,1
SC464821,2,0,2,0,0,0,0,0,1
SC464876,6,2,4,0,2,1,1,1,0
SC464888,18,0,18,0,3,1,2,1,1
SC465085,3,1,2,0,2,1,1,0,0
SC465136,1,0,1,0,1,1,0,0,0
SC465243,1,0,1,0,0,0,0,0,0
SC465251,6,4,2,0,0,0,0,0,1
SC465256,2,2,0,0,2,2,0,0,0
SC465268,10,6,4,0,0,0,0,0,1
SC465275,4,1,3,0,1,1,0,0,0
SC465318,2,2,0,0,2,2,0,0,1
SC465320,5,4,1,0,2,1,1,1,1
SC465349,16,10,6,0,1,1,0,1,1
SC465462,2,1,1,0,1,1,0,0,0
SC465478,7,4,3,0,1,1,0,1,1
SC465628,2,2,0,0,2,2,0,0,0
SC465736,6,3,3,0,2,2,0,0,1
SC465793,2,2,0,0,3,3,0,0,0
SC465925,6,0,6,0,0,0,0,0,1
SC466084,1,1,0,0,1,1,0,0,0
SC466155,4,2,2,0,1,0,1,0,1
SC466184,7,1,6,0,2,1,1,1,1
SC466185,2,0,2,0,0,0,0,0,0
SC466582,3,1,2,0,1,1,0,0,0
SC466847,2,0,2,0,0,0,0,0,0
SC466914,1,1,0,0,1,1,0,0,0
SC467041,4,2,2,0,2,2,0,0,0
SC467137,3,0,3,0,1,1,0,0,0
SC467278,1,0,1,0,1,1,0,0,0
SC467395,2,2,0,0,1,1,0,0,0
SC467423,10,5,5,2,0,0,0,0,1
SC467511,3,1,2,0,1,1,0,0,0
SC467539,2,0,2,0,0,0,0,0,1
SC467624,4,3,1,0,2,1,1,0,0
SC467702,6,3,3,0,2,2,0,0,0
SC467801,1,0,1,0,0,0,0,0,0
SC467872,14,6,8,0,0,0,0,0,0
SC467978,1,1,0,0,1,1,0,0,0
SC468056,23,9,14,0,0,0,0,0,1
SC468121,6,0,6,0,0,0,0,0,0
SC468123,4,2,2,1,0,0,0,0,1
SC468375,4,0,4,1,0,0,0,0,1
SC468376,4,0,4,1,0,0,0,0,1
SC468400,5,3,2,0,1,1,0,0,0
SC468413,2,1,1,0,1,1,0,0,0
SC468486,8,0,8,1,0,0,0,0,1
SC468634,1,0,1,0,1,1,0,0,0
SC468667,16,15,1,0,0,0,0,0,1
SC468771,2,0,2,0,0,0,0,0,0
SC468862,5,4,1,0,3,3,0,0,0
SC468948,1,1,0,0,1,1,0,0,0
SC468962,2,2,0,0,1,1,0,1,0
SC469286,1,0,1,0,0,0,0,0,0
SC469338,1,0,1,0,0,0,0,0,0
SC469415,1,1,0,0,0,0,0,0,0
SC469596,2,2,0,0,2,2,0,0,1
SC469830,5,0,5,0,1,1,0,0,0
SC469922,5,4,1,0,1,1,0,0,1
SC470070,8,4,4,0,1,1,0,1,1
SC470319,9,4,5,0,1,1,0,1,1
SC470328,9,4,5,0,1,1,0,1,1
SC470394,12,10,2,0,0,0,0,0,1
SC470552,4,2,2,0,1,1,0,0,0
SC470663,1,0,1,0,0,0,0,0,0
SC470682,3,0,3,0,0,0,0,0,0
SC470970,2,1,1,0,1,1,0,0,0
SC471074,2,0,2,0,0,0,0,0,0
SC471181,2,2,0,0,2,2,0,0,0
SC471212,2,1,1,0,1,1,0,0,0
SC471274,3,3,0,0,3,3,0,0,1
SC471791,2,2,0,0,2,2,0,0,0
SC472048,11,4,7,0,2,2,0,2,1
SC472072,9,7,2,0,0,0,0,0,1
SC472094,3,0,3,0,0,0,0,0,1
SC472292,2,2,0,0,2,2,0,0,0
SC472397,5,0,5,0,0,0,0,0,1
SC472398,5,0,5,0,0,0,0,0,1
SC472399,4,0,4,0,0,0,0,0,1
SC472412,10,7,3,0,0,0,0,0,1
SC472682,12,8,4,0,1,1,0,1,1
SC472787,1,1,0,0,2,2,0,0,0
SC472800,13,7,6,0,0,0,0,0,0
SC472813,2,2,0,0,2,2,0,0,0
SC472854,3,0,3,0,0,0,0,0,1
SC472867,4,3,1,0,0,0,0,0,1
SC473224,1,0,1,0,0,0,0,0,1
SC473357,7,4,3,0,1,1,0,0,1
SC473376,1,1,0,0,0,0,0,0,0
SC473408,1,1,0,0,1,1,0,0,0
SC473673,3,3,0,0,2,2,0,0,1
SC473768,3,3,0,0,1,1,0,1,1
SC473769,2,2,0,0,1,1,0,0,0
SC473771,3,3,0,0,1,1,0,1,1
SC473852,2,2,0,0,1,1,0,0,0
SC474053,3,3,0,0,2,2,0,0,1
SC474125,2,2,0,0,0,0,0,0,1
SC474591,1,1,0,0,1,1,0,0,0
SC474743,1,0,1,0,0,0,0,0,0
SC474771,2,0,2,0,0,0,0,0,0
SC474773,4,3,1,0,2,2,0,0,0
SC474787,2,2,0,0,2,2,0,0,1
SC474851,3,3,0,0,1,1,0,0,1
SC475007,3,1,2,0,1,1,0,0,0
SC475345,10,6,4,0,1,1,0,1,0
SC475679,2,2,0,0,1,1,0,0,0
SC475828,7,0,7,0,0,0,0,0,0
SC475864,22,9,13,0,0,0,0,0,0
SC475949,1,1,0,0,1,1,0,0,1
SC476299,4,1,3,0,0,0,0,0,0
SC476342,3,0,3,0,1,1,0,0,0
SC476360,2,2,0,0,1,1,0,0,0
SC476494,1,0,1,0,0,0,0,0,0
SC476499,1,1,0,0,1,1,0,0,0
SC476529,2,2,0,0,2,2,0,0,1
SC476531,1,0,1,0,0,0,0,0,0
SC476713,3,1,2,0,1,1,0,0,1
SC476725,2,1,1,0,0,0,0,0,0
SC476780,16,10,6,0,2,2,0,0,0
SC476966,1,1,0,0,1,1,0,0,1
SC477050,1,1,0,0,1,1,0,0,0
SC477630,5,3,2,0,1,1,0,0,0
SC477724,2,2,0,0,2,2,0,2,1
SC477843,2,2,0,0,1,1,0,0,0
SC477902,2,2,0,0,2,2,0,0,0
SC477928,1,0,1,0,0,0,0,0,0
SC478026,1,0,1,0,0,0,0,0,1
SC478225,5,0,5,0,0,0,0,0,0
SC478278,3,0,3,0,0,0,0,0,1
SC478348,20,10,10,0,1,1,0,0,1
SC478440,3,2,1,0,1,1,0,0,0
SC478594,1,0,1,0,0,0,0,0,0
SC478595,1,1,0,0,1,1,0,0,0
SC478605,1,0,1,0,0,0,0,0,0
SC478633,2,2,0,0,1,1,0,0,0
SC478737,18,11,7,0,0,0,0,0,1
SC478866,17,10,7,0,0,0,0,0,0
SC478867,11,5,6,0,2,2,0,0,1
SC478995,2,2,0,0,3,3,0,1,1
SC479093,2,2,0,0,2,2,0,0,0
SC479214,23,0,23,0,3,3,0,0,0
SC479304,1,1,0,0,2,2,0,0,1
SC479802,1,1,0,0,2,2,0,0,0
SC479842,2,0,2,0,0,0,0,0,1
03230087,22,2,20,0,2,1,1,0,1
03230721,80,9,71,0,0,0,0,0,1
03230922,20,6,14,0,0,0,0,0,1
03231025,10,5,5,0,0,0,0,0,0
03231683,22,2,20,0,1,1,0,1,1
03231720,10,5,5,0,2,2,0,0,0
03231822,8,3,5,0,0,0,0,0,0
03231841,8,3,5,0,1,1,0,1,1
03231971,22,3,19,0,2,1,1,1,1
03232037,13,4,9,0,1,1,0,1,1
03232092,5,3,2,0,2,2,0,0,0
03232292,8,4,4,0,2,0,2,0,0
03232508,10,0,10,0,0,0,0,0,1
03232529,21,0,21,0,0,0,0,0,1
03232652,39,0,39,0,0,0,0,0,1
03232682,35,4,31,0,1,1,0,1,1
03232740,20,4,16,0,1,1,0,1,1
03232751,30,3,27,0,1,1,0,1,1
03232759,39,9,30,0,1,1,0,1,1
03232768,32,2,30,0,1,1,0,1,1
03232788,21,4,17,0,1,1,0,1,1
03232852,21,5,16,0,1,1,0,1,1
03232946,30,3,27,0,1,1,0,1,1
03232951,10,5,5,0,4,1,3,1,0
03232992,15,0,15,2,0,0,0,0,0
03233010,25,5,20,0,1,1,0,1,1
03233012,10,2,8,0,1,1,0,1,1
03233030,18,3,15,0,1,1,0,1,1
03233045,6,3,3,0,1,1,0,1,0
03233144,46,5,41,0,1,1,0,1,1
03233459,7,0,7,0,0,0,0,0,1
03233986,11,2,9,0,2,2,0,0,0
03234033,35,4,31,0,1,1,0,1,1
03234036,8,2,6,0,3,1,2,1,1
03234176,24,3,21,0,1,1,0,1,1
03234817,19,7,12,1,0,0,0,0,1
03234866,50,11,39,0,0,0,0,0,0
03234881,19,6,13,0,1,1,0,1,1
03235119,10,3,7,0,2,2,0,0,1
03235153,27,4,23,0,1,1,0,1,1
03235160,22,3,19,0,0,0,0,0,1
03235269,4,1,3,0,2,2,0,0,1
03235271,5,3,2,0,1,1,0,0,1
03235317,8,3,5,0,0,0,0,0,0
03235382,5,0,5,0,0,0,0,0,0
03235471,5,2,3,0,1,1,0,0,0
03235481,45,0,45,0,4,3,1,0,1
03235611,4,0,4,0,0,0,0,0,1
03236201,45,6,39,0,0,0,0,0,1
03236210,4,0,4,0,0,0,0,0,1
03236308,25,7,18,0,1,1,0,1,1
03236336,17,5,12,0,1,1,0,1,1
03236351,7,3,4,0,1,1,0,0,1
03236506,24,6,18,0,0,0,0,0,1
03236551,14,0,14,0,0,0,0,0,1
03236813,43,14,29,0,0,0,0,0,1
03236918,54,9,45,0,0,0,0,0,1
03237018,6,3,3,0,1,1,0,0,0
03237147,9,2,7,0,1,1,0,0,0
03237171,6,3,3,0,2,2,0,0,1
03237309,26,12,14,0,0,0,0,0,1
03237387,11,2,9,0,0,0,0,0,1
03237549,29,3,26,0,0,0,0,0,1
03237629,45,4,41,0,1,1,0,1,1
03237831,6,2,4,0,1,1,0,0,1
03237920,19,3,16,0,1,1,0,1,1
03237926,30,3,27,0,1,1,0,1,1
03238026,30,1,29,0,1,1,0,1,1
03238222,22,0,22,0,0,0,0,0,1
03238431,30,5,25,0,1,1,0,1,1
03238493,13,3,10,0,2,1,1,0,1
03238666,7,4,3,0,1,1,0,0,0
03238953,6,3,3,0,1,1,0,0,0
03239086,30,6,24,0,5,4,1,0,1
03239119,41,3,38,0,2,2,0,2,1
03239213,8,2,6,0,0,0,0,0,0
03239375,22,4,18,0,2,0,2,0,1
03239438,13,4,9,0,1,1,0,1,0
03239583,19,3,16,0,1,1,0,1,1
03239587,24,5,19,0,2,2,0,2,1
03239635,24,5,19,0,1,1,0,1,1
03239827,4,1,3,0,1,1,0,1,0
03239847,23,0,23,0,1,1,0,1,1
03239951,28,5,23,0,1,1,0,1,1
03239971,30,5,25,0,0,0,0,0,1
03239986,24,5,19,0,2,2,0,2,1
03240198,45,11,34,0,0,0,0,0,1
03240331,15,3,12,0,1,1,0,1,1
03240356,36,10,26,0,0,0,0,0,1
03240360,51,6,45,0,0,0,0,0,0
03240589,5,3,2,0,1,1,0,0,1
03240618,11,2,9,0,1,1,0,0,1
03241487,13,0,13,0,1,1,0,1,1
03241553,8,0,8,0,0,0,0,0,1
03242056,10,1,9,0,1,1,0,0,1
03242106,14,1,13,0,1,1,0,0,1
03242486,10,5,5,0,4,4,0,0,1
03242487,6,3,3,0,2,2,0,0,1
03242704,12,3,9,0,2,1,1,2,1
03242849,7,3,4,0,5,5,0,0,1
03242874,9,6,3,0,1,1,0,0,0
03242939,10,5,5,0,1,1,0,0,0
03243016,5,3,2,0,1,1,0,0,0
03243321,50,5,45,0,0,0,0,0,1
03243377,7,3,4,0,2,2,0,0,1
03243587,11,7,4,0,2,0,2,1,1
03243675,5,3,2,0,1,1,0,0,1
03243754,23,2,21,0,1,1,0,1,1
03243760,20,0,20,0,0,0,0,0,1
03243762,15,8,7,0,0,0,0,0,0
03244113,23,10,13,0,0,0,0,0,0
03244165,26,0,26,0,1,1,0,1,1
03244191,7,3,4,0,1,1,0,0,1
03244222,5,2,3,0,2,1,1,0,0
03244228,27,0,27,0,0,0,0,0,1
03244268,33,9,24,0,2,1,1,0,1
03244285,35,0,35,0,0,0,0,0,1
03244516,15,0,15,0,0,0,0,0,1
03244589,21,0,21,0,0,0,0,0,1
03244611,61,9,52,0,1,1,0,1,1
03244910,37,5,32,0,1,1,0,0,1
03245205,7,3,4,0,1,1,0,0,0
03245288,49,10,39,0,0,0,0,0,1
03245514,66,16,50,0,0,0,0,0,0
03245525,65,17,48,0,0,0,0,0,1
03245543,48,9,39,0,0,0,0,0,1
03245687,6,2,4,0,2,2,0,0,1
03246219,14,2,12,0,3,1,2,2,1
03246320,16,4,12,0,1,1,0,1,1
03246469,36,2,34,0,1,1,0,1,1
03246599,21,4,17,0,1,1,0,1,1
03246883,5,2,3,0,1,1,0,1,1
03246886,19,4,15,0,2,2,0,2,1
03246901,14,4,10,0,4,4,0,0,1
03246983,5,0,5,0,1,1,0,0,1
03247027,13,4,9,0,1,1,0,1,1
03247130,41,4,37,0,1,1,0,1,1
03247132,32,6,26,0,1,1,0,0,1
03247256,14,7,7,0,2,2,0,0,1
03247587,8,3,5,0,1,1,0,0,0
03247591,29,7,22,0,2,1,1,1,1
03247622,23,2,21,0,0,0,0,0,1
03247667,11,5,6,1,2,1,1,0,1
03247940,42,10,32,0,0,0,0,0,1
03248056,8,1,7,0,1,1,0,0,1
03248172,7,0,7,0,0,0,0,0,1
03248268,4,2,2,0,2,2,0,0,0
03248459,11,0,11,0,1,1,0,1,1
03248750,19,2,17,0,0,0,0,0,1
03248776,9,3,6,0,1,1,0,1,1
03248991,7,3,4,0,1,1,0,1,1
03249009,25,3,22,0,1,1,0,1,1
03249025,6,2,4,0,2,2,0,0,1
03249106,17,0,17,0,0,0,0,0,1
03249158,32,3,29,0,1,1,0,1,1
03249320,23,0,23,0,0,0,0,0,1
03249397,20,4,16,0,2,1,1,2,1
03249464,79,6,73,0,0,0,0,0,1
03249818,8,2,6,0,1,1,0,0,1
03249990,9,3,6,0,0,0,0,0,1
03250077,18,2,16,0,1,1,0,1,1
03250401,9,0,9,0,0,0,0,0,1
03250405,6,0,6,0,0,0,0,0,1
03250981,47,11,36,0,4,3,1,0,1
03251167,43,9,34,0,0,0,0,0,1
03251269,18,0,18,0,1,1,0,1,1
03251475,53,6,47,0,0,0,0,0,0
03251531,12,6,6,0,1,1,0,0,1
03251659,17,0,17,0,0,0,0,0,1
03251684,44,3,41,0,2,1,1,2,1
03251868,70,13,57,0,0,0,0,0,1
03252149,9,4,5,0,2,1,1,1,1
03252181,26,4,22,0,1,1,0,1,1
03252256,25,12,13,0,0,0,0,0,1
03252408,5,0,5,0,0,0,0,0,1
03252961,8,2,6,0,1,1,0,0,1
03253095,40,0,40,0,2,1,1,2,1
03253174,17,0,17,0,0,0,0,0,1
03253690,32,5,27,0,1,1,0,1,1
03253736,12,0,12,0,0,0,0,0,1
03253796,7,5,2,0,0,0,0,0,0
03254474,5,3,2,0,1,1,0,0,0
03254502,6,0,6,0,2,2,0,0,1
03254540,15,0,15,0,0,0,0,0,1
03255124,19,9,10,0,1,1,0,1,1
03255495,11,2,9,0,1,1,0,1,1
03255740,21,4,17,0,1,1,0,1,1
03255986,25,4,21,0,0,0,0,0,1
03256068,92,9,83,0,0,0,0,0,1
03256112,15,0,15,0,1,1,0,1,1
03256311,49,8,41,0,0,0,0,0,1
03256359,31,6,25,0,1,1,0,1,1
03256383,5,3,2,0,1,1,0,0,0
03256413,16,4,12,0,0,0,0,0,1
03256483,26,4,22,0,1,1,0,1,1
03256556,23,0,23,0,0,0,0,0,1
03256744,28,3,25,0,1,1,0,1,1
03256867,6,2,4,0,1,1,0,0,1
03256928,49,0,49,0,0,0,0,0,1
03257002,44,7,37,0,0,0,0,0,1
03257078,54,7,47,0,1,1,0,1,1
03257256,22,5,17,0,0,0,0,0,1
03257265,11,0,11,0,0,0,0,0,1
03257730,19,13,6,0,1,1,0,0,1
03258003,5,3,2,0,2,2,0,0,0
03258142,19,13,6,0,1,1,0,0,1
03258272,65,6,59,0,0,0,0,0,0
03258323,23,2,21,0,1,1,0,1,0
03258507,20,3,17,0,0,0,0,0,1
03258568,24,0,24,0,0,0,0,0,1
03258799,21,3,18,0,1,1,0,1,1
03258927,21,6,15,0,3,1,2,2,1
03258931,6,0,6,0,1,1,0,0,1
03258939,154,11,143,0,0,0,0,0,1
03258979,17,2,15,0,1,1,0,1,1
03259193,13,2,11,0,1,1,0,0,0
03259201,16,4,12,0,0,0,0,0,1
03259438,27,4,23,0,0,0,0,0,0
03259447,43,8,35,0,1,1,0,1,1
03259517,5,2,3,0,2,2,0,0,1
03259539,30,6,24,0,0,0,0,0,1
03259663,6,3,3,0,1,1,0,0,1
03259725,9,4,5,0,2,2,0,0,0
03259787,10,4,6,0,3,1,2,0,1
03259904,41,11,30,0,0,0,0,0,1
03259968,4,2,2,0,1,1,0,0,0
03260109,21,3,18,0,0,0,0,0,1
03260153,36,5,31,0,1,1,0,1,1
03260168,44,11,33,0,0,0,0,0,1
03260630,7,0,7,0,0,0,0,0,1
03260840,72,11,61,0,0,0,0,0,1
03261119,8,3,5,0,1,1,0,1,1
03261380,12,2,10,0,2,2,0,0,1
03261480,10,2,8,0,1,1,0,0,1
03261491,12,0,12,0,0,0,0,0,1
03261503,10,3,7,0,2,2,0,0,1
03261506,47,6,41,0,1,1,0,1,1
03261579,4,0,4,0,0,0,0,0,1
03261698,6,1,5,0,1,1,0,0,1
03261722,57,11,46,0,1,1,0,1,1
03261733,29,6,23,0,1,1,0,1,1
03261961,8,3,5,0,1,1,0,1,1
03262596,16,4,12,0,0,0,0,0,1
03262598,33,3,30,0,1,1,0,1,1
03262697,4,4,0,0,0,0,0,0,1
03262800,15,4,11,0,3,2,1,1,0
03263038,6,0,6,0,0,0,0,0,1
03263210,26,3,23,0,1,1,0,1,1
03263347,12,3,9,0,0,0,0,0,1
03263349,27,4,23,0,1,1,0,1,1
03263435,11,7,4,0,0,0,0,0,1
03263437,26,3,23,0,1,1,0,1,1
03263519,62,15,47,0,0,0,0,0,1
03263713,59,3,56,0,2,1,1,2,1
03263890,13,0,13,0,0,0,0,0,1
03263899,16,2,14,0,1,1,0,1,1
03263955,8,5,3,0,2,2,0,0,0
03264171,17,7,10,0,2,1,1,2,1
03264240,11,5,6,0,3,1,2,2,0
03264487,17,6,11,0,1,1,0,0,1
03264563,15,0,15,0,0,0,0,0,1
03264739,9,2,7,0,4,3,1,0,1
03264771,9,3,6,0,1,1,0,0,1
03264782,0,0,0,0,0,0,0,0,1
03264849,5,2,3,0,2,2,0,0,1
03264870,23,12,11,0,1,1,0,0,1
03265016,29,12,17,0,0,0,0,0,1
03265049,28,12,16,0,0,0,0,0,1
03265191,29,12,17,0,0,0,0,0,1
03265192,5,2,3,0,1,1,0,0,1
03265251,4,3,1,0,2,2,0,0,0
03265254,17,3,14,0,0,0,0,0,1
03265357,5,2,3,0,1,1,0,0,0
03265503,15,3,12,0,2,1,1,1,1
03265670,26,3,23,0,0,0,0,0,0
03265777,18,5,13,0,0,0,0,0,1
03265938,17,3,14,0,1,1,0,1,1
03266027,15,0,15,0,0,0,0,0,1
03266231,32,4,28,0,5,3,2,0,1
03266440,21,6,15,0,0,0,0,0,1
03266580,83,5,78,0,0,0,0,0,1
03266657,13,0,13,0,0,0,0,0,1
03266766,17,2,15,0,0,0,0,0,1
03266889,18,4,14,0,0,0,0,0,0
03266897,44,13,31,0,1,1,0,0,1
03268027,26,3,23,0,1,1,0,1,1
03268158,7,5,2,0,4,4,0,0,0
03268170,4,3,1,0,1,1,0,0,1
03268184,13,3,10,0,0,0,0,0,0
03268367,12,0,12,0,1,1,0,1,1
03268535,28,5,23,0,1,1,0,1,1
03268696,19,5,14,0,0,0,0,0,1
03268838,5,2,3,0,1,1,0,0,0
03268858,28,6,22,0,0,0,0,0,1
03269134,5,3,2,0,1,1,0,1,1
03269511,7,4,3,0,0,0,0,0,1
03269770,14,0,14,0,0,0,0,0,1
03269905,25,4,21,0,1,1,0,0,0
03269923,31,4,27,0,1,1,0,1,1
03269950,46,0,46,0,0,0,0,0,1
03270103,16,2,14,1,1,1,0,1,1
03270465,45,2,43,0,1,1,0,1,1
03270679,47,8,39,0,0,0,0,0,1
03270681,13,4,9,0,3,3,0,0,1
03270739,9,0,9,0,0,0,0,0,1
03270753,34,13,21,0,0,0,0,0,1
03270987,31,0,31,0,0,0,0,0,1
03271084,22,0,22,0,0,0,0,0,1
03271283,72,16,56,0,0,0,0,0,1
03271307,29,13,16,0,0,0,0,0,1
03271345,14,7,7,0,3,3,0,0,0
03271439,23,3,20,0,1,1,0,1,1
03271610,14,3,11,0,1,1,0,1,1
03271613,20,3,17,0,1,1,0,1,1
03271779,8,2,6,0,1,1,0,0,1
03271821,12,2,10,0,1,1,0,1,1
03271968,46,0,46,0,0,0,0,0,1
03271988,22,7,15,0,1,1,0,1,1
03272025,10,3,7,0,0,0,0,0,1
03272281,33,4,29,0,1,1,0,1,1
03272791,13,2,11,0,0,0,0,0,0
03273425,26,6,20,0,0,0,0,0,0
03273552,30,3,27,0,1,1,0,1,1
03273631,10,0,10,0,0,0,0,0,1
03273685,72,7,65,0,1,1,0,1,1
03273784,53,4,49,0,0,0,0,0,0
03273795,25,0,25,0,1,1,0,1,1
03274133,10,2,8,0,1,1,0,0,1
03274666,9,3,6,0,1,1,0,0,0
03274767,10,0,10,0,0,0,0,0,1
03275257,6,0,6,0,0,0,0,0,1
03275303,27,5,22,0,3,3,0,1,1
03275456,22,3,19,0,1,1,0,1,1
03275699,18,0,18,0,0,0,0,0,1
03275872,12,4,8,0,3,3,0,0,0
03276103,6,1,5,0,2,2,0,1,0
03276399,15,0,15,0,0,0,0,0,1
03276428,46,0,46,0,0,0,0,0,1
03276760,56,3,53,0,1,1,0,1,1
03276806,5,0,5,0,0,0,0,0,1
03276904,8,0,8,0,0,0,0,0,1
03276974,34,2,32,0,1,1,0,1,1
03276992,22,4,18,0,4,1,3,1,0
03277033,10,1,9,0,1,1,0,0,1
03277636,13,6,7,0,1,1,0,0,1
03277701,14,7,7,0,1,1,0,0,1
03277860,5,0,5,0,0,0,0,0,1
03277881,45,4,41,0,0,0,0,0,1
03277884,10,2,8,0,2,1,1,1,1
03277897,18,7,11,0,2,0,2,2,1
03277911,6,2,4,0,1,1,0,0,0
03277921,32,11,21,0,2,2,0,1,1
03277937,24,0,24,0,1,1,0,1,1
03278062,11,4,7,0,1,1,0,1,1
03278093,48,10,38,0,1,1,0,1,1
03278266,42,0,42,0,1,1,0,1,1
03278371,59,3,56,0,2,1,1,2,1
03278419,29,5,24,0,2,2,0,2,1
03278431,53,6,47,0,2,1,1,2,1
03278620,17,6,11,0,1,1,0,1,1
03278630,43,9,34,0,0,0,0,0,1
03278907,28,3,25,0,2,1,1,2,1
03279012,12,2,10,0,0,0,0,0,0
03279013,39,5,34,0,1,1,0,1,1
03279046,109,6,103,0,0,0,0,0,0
03279102,16,4,12,0,0,0,0,0,1
03279334,51,6,45,0,2,1,1,2,1
03279358,10,3,7,0,1,1,0,0,1
03279730,80,14,66,0,1,1,0,1,1
03279820,35,0,35,0,1,1,0,1,1
03279900,6,0,6,0,0,0,0,0,1
03280082,11,3,8,0,1,1,0,1,1
03280380,14,3,11,0,1,1,0,1,1
03280394,16,0,16,0,0,0,0,0,1
03280634,22,4,18,0,0,0,0,0,1
03280703,10,3,7,0,2,2,0,0,1
03280712,1,0,1,0,0,0,0,0,1
03280942,26,9,17,0,1,1,0,0,1
03281262,14,1,13,0,1,1,0,0,1
03281264,14,1,13,0,1,1,0,1,1
03281481,15,3,12,0,1,1,0,1,0
03281697,6,3,3,0,1,1,0,0,1
03281900,10,3,7,0,1,1,0,0,1
03282071,20,0,20,0,1,1,0,1,1
03282151,12,1,11,0,1,1,0,0,1
03282281,6,0,6,0,0,0,0,0,1
03282479,23,0,23,0,0,0,0,0,1
03282484,10,2,8,0,2,0,2,0,0
03282548,44,5,39,0,1,1,0,1,1
03282566,16,3,13,0,0,0,0,0,1
03282601,5,2,3,0,1,1,0,0,1
03282705,29,3,26,0,1,1,0,1,1
03282778,10,0,10,0,0,0,0,0,1
03282781,14,1,13,0,1,1,0,1,1
03282832,51,6,45,0,0,0,0,0,0
03282879,101,16,85,0,0,0,0,0,1
03282897,15,0,15,0,0,0,0,0,1
03282982,14,5,9,0,1,1,0,0,0
03283077,59,13,46,0,2,1,1,2,1
03283088,42,6,36,0,2,1,1,2,1
03283092,34,5,29,0,1,1,0,1,1
03283501,25,2,23,0,2,2,0,2,1
03283735,32,0,32,0,0,0,0,0,1
03283838,7,0,7,0,1,1,0,1,1
03283842,3,3,0,0,1,1,0,0,1
03284393,8,3,5,0,4,2,2,0,0
03284469,10,7,3,0,2,2,0,0,1
03284544,226,20,206,0,0,0,0,0,1
03284596,8,3,5,0,1,1,0,0,0
03284637,10,0,10,0,0,0,0,0,1
03284736,5,3,2,0,1,1,0,0,1
03284835,9,3,6,0,1,1,0,0,1
03284963,46,7,39,0,1,1,0,1,1
03285242,4,2,2,0,1,1,0,0,1
03285261,4,2,2,0,1,1,0,0,1
03285380,17,4,13,0,2,2,0,2,1
03285603,23,0,23,0,0,0,0,0,1
03285628,43,3,40,0,3,3,0,3,1
03285771,12,3,9,0,0,0,0,0,1
03285876,24,0,24,0,1,1,0,1,1
03476019,122,4,118,0,1,1,0,0,1
03476097,55,11,44,0,0,0,0,0,1
03476115,38,2,36,0,1,1,0,1,1
03476568,7,0,7,0,1,1,0,0,1
03476576,80,12,68,0,0,0,0,0,1
03476711,19,1,18,0,1,1,0,1,1
03476785,6,4,2,0,1,1,0,0,1
03476790,5,0,5,0,0,0,0,0,1
03476816,31,11,20,0,0,0,0,0,1
03476839,45,10,35,0,0,0,0,0,1
03477206,14,3,11,0,1,1,0,1,1
03477297,49,7,42,0,1,1,0,1,1
03477357,5,2,3,0,1,1,0,1,1
03477643,18,3,15,0,1,1,0,0,1
03477664,39,3,36,0,2,1,1,2,1
03477726,10,2,8,0,0,0,0,0,1
03477997,20,2,18,0,0,0,0,0,1
03478039,28,6,22,0,1,1,0,1,1
03478161,13,0,13,0,1,1,0,1,1
03478177,10,2,8,0,2,2,0,0,1
03478440,7,0,7,0,1,1,0,0,0
03478664,8,1,7,0,1,1,0,0,1
03478706,9,2,7,0,0,0,0,0,1
03478888,6,4,2,0,4,4,0,0,0
03478918,14,0,14,0,0,0,0,0,1
03479072,5,3,2,0,2,2,0,0,0
03479090,16,3,13,0,1,1,0,1,1
03479261,13,3,10,0,1,1,0,1,1
03479287,25,5,20,0,1,1,0,1,1
03479479,44,10,34,0,0,0,0,0,0
03479611,35,2,33,0,1,1,0,1,1
03479981,62,10,52,0,1,1,0,1,1
03479984,32,4,28,0,1,1,0,1,1
03479986,53,10,43,0,1,1,0,1,1
03480229,20,2,18,0,1,1,0,1,1
03480295,41,13,28,0,1,1,0,1,1
03480520,41,2,39,0,1,1,0,1,1
03480831,4,1,3,0,1,1,0,0,0
03480901,24,3,21,0,1,0,1,0,1
03481011,4,2,2,0,1,1,0,0,1
03481024,11,2,9,0,1,1,0,1,1
03481125,15,1,14,0,1,1,0,1,1
03481135,17,2,15,0,1,1,0,1,1
03481217,6,1,5,0,1,1,0,0,0
03481321,31,4,27,0,0,0,0,0,1
03481651,20,0,20,0,0,0,0,0,1
03481703,7,4,3,0,1,1,0,1,1
03481728,4,2,2,0,1,1,0,0,1
03482081,25,4,21,0,1,1,0,1,1
03482156,19,0,19,0,0,0,0,0,1
03482228,57,8,49,0,0,0,0,0,1
03482322,30,3,27,0,1,1,0,1,1
03482404,36,8,28,0,1,1,0,1,1
03482521,17,4,13,0,1,1,0,1,1
03482779,39,8,31,0,0,0,0,0,1
03482895,17,3,14,0,3,3,0,2,1
03482943,57,9,48,0,0,0,0,0,1
03483218,5,1,4,0,0,0,0,0,1
03483267,32,7,25,0,0,0,0,0,0
03483322,16,4,12,0,5,3,2,0,1
03483402,14,0,14,0,0,0,0,0,1
03483627,13,0,13,0,0,0,0,0,1
03483673,4,0,4,0,0,0,0,0,1
03484232,14,3,11,0,1,1,0,1,1
03484391,19,2,17,0,1,1,0,1,1
03484440,4,0,4,0,0,0,0,0,0
03484466,63,13,50,0,0,0,0,0,1
03484622,3,3,0,0,1,1,0,0,0
03484727,19,0,19,0,0,0,0,0,1
03484780,55,7,48,0,1,1,0,1,1
03484793,6,3,3,0,1,1,0,0,1
03485113,15,2,13,0,1,1,0,1,1
03485365,63,16,47,0,0,0,0,0,1
03485552,42,10,32,0,0,0,0,0,0
03485658,11,5,6,0,1,1,0,1,1
03485917,5,0,5,0,0,0,0,0,1
03486063,12,3,9,0,2,1,1,2,1
03486266,24,3,21,0,1,1,0,1,1
03486344,2,1,1,0,1,1,0,0,0
03486348,12,2,10,0,0,0,0,0,1
03486435,28,4,24,0,2,1,1,2,1
03486524,3,0,3,0,0,0,0,0,1
03486535,22,0,22,0,0,0,0,0,1
03486588,18,3,15,0,1,1,0,1,1
03486590,18,3,15,0,1,1,0,1,1
03486806,35,8,27,0,1,1,0,1,1
03486808,6,3,3,0,1,1,0,0,0
03486926,26,7,19,0,3,2,1,0,1
03487014,11,0,11,0,0,0,0,0,1
03487040,30,1,29,0,1,1,0,1,0
03487043,27,2,25,0,1,1,0,1,0
03487323,19,0,19,0,0,0,0,0,1
03487433,12,0,12,0,0,0,0,0,1
03487635,53,6,47,0,0,0,0,0,1
03487651,92,18,74,0,0,0,0,0,1
03487652,34,1,33,0,1,1,0,1,1
03487778,49,7,42,0,1,1,0,1,1
03487787,15,4,11,0,0,0,0,0,0
03488316,10,3,7,0,3,1,2,1,1
03488658,21,0,21,0,0,0,0,0,1
03488728,48,11,37,0,1,1,0,0,1
03488741,6,2,4,0,1,1,0,0,1
03488982,6,3,3,0,1,1,0,1,0
03489004,47,7,40,0,1,1,0,1,1
03489572,13,0,13,0,1,1,0,1,1
03489593,19,0,19,0,0,0,0,0,1
03489629,28,0,28,0,1,1,0,1,1
03489655,17,6,11,0,0,0,0,0,1
03489885,22,3,19,0,1,1,0,1,1
03490270,56,6,50,0,1,1,0,1,1
03490333,20,5,15,0,1,1,0,1,1
03490345,4,2,2,0,1,1,0,0,0
03490365,3,0,3,0,0,0,0,0,1
03490377,20,4,16,0,1,1,0,1,1
03490394,20,4,16,0,1,1,0,1,1
03490409,20,4,16,0,1,1,0,1,1
03490687,6,2,4,0,1,1,0,0,1
03491141,15,0,15,0,0,0,0,0,1
03491158,8,4,4,0,4,3,1,0,1
03491191,65,7,58,0,1,1,0,1,1
03491213,87,12,75,0,1,1,0,1,1
03491248,15,0,15,0,0,0,0,0,1
03491273,32,3,29,0,2,2,0,2,1
03491390,7,3,4,0,2,2,0,0,0
03491458,28,15,13,0,1,1,0,1,1
03491761,10,3,7,0,4,2,2,1,1
03491978,25,3,22,0,1,1,0,1,1
03492039,5,0,5,0,1,1,0,0,1
03492343,25,3,22,0,0,0,0,0,1
03492358,23,3,20,0,0,0,0,0,1
03492450,6,3,3,0,1,1,0,0,0
03492505,47,5,42,0,1,1,0,1,1
03492630,20,2,18,0,1,1,0,1,1
03492713,20,0,20,0,0,0,0,0,1
03492846,5,2,3,0,1,1,0,0,0
03492921,24,6,18,0,0,0,0,0,1
03492979,29,4,25,0,1,1,0,1,1
03493040,67,5,62,0,0,0,0,0,1
03493084,6,4,2,0,1,1,0,1,0
03493136,14,2,12,0,2,2,0,0,1
03493137,6,2,4,0,2,2,0,0,1
03493415,27,5,22,0,1,1,0,1,1
03493847,16,3,13,0,0,0,0,0,1
03493991,23,3,20,0,0,0,0,0,1
03494038,45,5,40,0,0,0,0,0,0
03494165,12,3,9,0,1,1,0,1,1
03494452,18,3,15,0,1,1,0,1,1
03494598,19,3,16,0,1,1,0,1,1
03494815,26,5,21,0,1,1,0,1,1
03495060,26,0,26,0,0,0,0,0,1
03495083,24,2,22,0,1,1,0,1,1
03495177,6,0,6,0,0,0,0,0,1
03495284,14,6,8,0,0,0,0,0,1
03495287,23,6,17,0,0,0,0,0,1
03495317,15,0,15,0,0,0,0,0,1
03495324,25,4,21,0,1,1,0,1,1
03495563,3,3,0,0,2,2,0,0,1
03495633,6,3,3,0,2,2,0,0,1
03495725,24,0,24,0,0,0,0,0,1
03495834,30,0,30,0,0,0,0,0,1
03495837,33,0,33,0,0,0,0,0,1
03495843,11,2,9,0,1,1,0,1,1
03495914,29,0,29,0,0,0,0,0,1
03496786,50,7,43,0,0,0,0,0,1
03496836,7,1,6,0,1,1,0,0,0
03496857,24,7,17,0,0,0,0,0,1
03497055,12,3,9,0,0,0,0,0,1
03497105,42,9,33,0,2,2,0,2,1
03497127,16,0,16,0,1,1,0,1,1
03497533,6,1,5,0,1,1,0,0,1
03498158,9,0,9,0,0,0,0,0,1
03498202,14,0,14,0,0,0,0,0,1
03498607,28,0,28,0,0,0,0,0,1
03498791,29,4,25,0,0,0,0,0,1
03498959,20,3,17,0,1,1,0,1,1
03499203,20,2,18,0,1,1,0,1,1
03499279,5,1,4,0,1,1,0,0,0
03499576,29,6,23,0,1,1,0,1,1
03499590,38,9,29,0,1,0,1,0,1
03500129,7,0,7,0,0,0,0,0,0
03500138,9,3,6,0,2,2,0,0,0
03500475,17,5,12,0,0,0,0,0,1
03500739,4,2,2,0,1,1,0,0,0
03500852,17,4,13,0,1,1,0,1,1
03501364,31,7,24,0,0,0,0,0,0
03501510,9,5,4,0,0,0,0,0,0
03501815,14,0,14,0,1,1,0,0,0
03501947,34,6,28,0,0,0,0,0,1
03501978,12,3,9,0,1,1,0,1,1
03502018,10,0,10,0,0,0,0,0,1
03502087,9,2,7,0,2,2,0,0,1
03502693,20,0,20,0,0,0,0,0,1
03502708,23,3,20,0,1,1,0,1,1
03502782,15,2,13,0,1,1,0,0,1
03503148,17,6,11,0,1,1,0,1,1
03503415,7,2,5,0,2,1,1,0,1
03503756,18,0,18,0,0,0,0,0,1
03503803,6,0,6,0,2,2,0,0,0
03504009,5,3,2,0,2,2,0,0,0
03504043,25,4,21,0,1,1,0,1,1
03504177,5,0,5,0,3,3,0,1,1
03504214,21,5,16,0,0,0,0,0,1
03504294,17,4,13,0,1,1,0,1,1
03504679,10,3,7,0,1,1,0,0,1
03504705,34,3,31,0,1,1,0,1,1
03504721,17,3,14,0,1,1,0,1,1
03504761,8,2,6,0,1,1,0,0,1
03504794,33,8,25,0,0,0,0,0,1
03504841,11,0,11,0,0,0,0,0,1
03505320,9,0,9,0,0,0,0,0,1
03505626,10,3,7,0,2,2,0,0,1
03505719,24,0,24,0,0,0,0,0,1
03505836,16,2,14,0,0,0,0,0,1
03506156,15,2,13,0,1,1,0,1,1
03506579,19,4,15,1,0,0,0,0,1
03506616,17,4,13,0,1,1,0,0,1
03506757,9,0,9,0,0,0,0,0,1
03506880,35,7,28,0,0,0,0,0,1
03506962,5,3,2,0,1,1,0,1,0
03506989,22,0,22,0,1,1,0,1,1
04816054,8,4,4,0,0,0,0,0,0
04816190,19,2,17,0,0,0,0,0,1
04816191,45,16,29,0,1,0,1,0,1
04816209,27,3,24,0,1,1,0,1,1
04816265,11,4,7,0,2,2,0,0,1
04816346,6,3,3,0,3,3,0,0,0
04816514,6,3,3,0,1,1,0,0,1
04816786,39,8,31,0,0,0,0,0,1
04817052,3,2,1,0,2,2,0,0,0
04817448,9,4,5,0,1,1,0,1,1
04817628,15,5,10,0,0,0,0,0,1
04817916,22,3,19,0,0,0,0,0,1
04818187,38,13,25,0,0,0,0,0,1
04818267,7,0,7,0,0,0,0,0,1
04818628,11,3,8,0,1,1,0,1,1
04818639,7,3,4,0,0,0,0,0,1
04818655,4,2,2,0,1,1,0,0,1
04818735,6,1,5,0,1,1,0,0,1
04818906,10,4,6,0,1,1,0,1,1
04819003,4,1,3,0,1,1,0,0,1
04819899,7,3,4,0,2,2,0,0,0
04819935,12,3,9,0,4,4,0,0,0
04820505,4,2,2,0,1,1,0,0,0
04820509,4,0,4,0,2,2,0,0,1
04820602,4,1,3,0,1,1,0,0,1
04820779,3,3,0,0,1,1,0,0,1
04821048,5,0,5,0,0,0,0,0,0
04821098,15,0,15,0,0,0,0,0,1
04821332,3,0,3,0,1,1,0,0,0
04821572,18,4,14,0,0,0,0,0,1
04821641,12,5,7,0,0,0,0,0,1
04821683,20,2,18,0,4,4,0,2,1
04821733,14,0,14,0,0,0,0,0,1
04821872,5,3,2,0,1,1,0,0,0
04822083,9,6,3,0,1,1,0,1,0
04822376,5,2,3,0,1,1,0,0,0
04822541,8,4,4,0,1,1,0,0,0
04822656,14,0,14,0,0,0,0,0,0
04822661,8,3,5,0,1,1,0,1,1
04822997,29,0,29,0,0,0,0,0,1
04823380,18,3,15,0,1,1,0,1,1
04823522,6,3,3,0,2,2,0,0,1
04823576,3,2,1,0,1,1,0,0,0
04823689,23,0,23,0,1,1,0,1,1
04823842,83,20,63,0,0,0,0,0,1
04824131,10,0,10,0,0,0,0,0,1
04824400,17,0,17,0,1,1,0,0,1
04824725,36,19,17,0,0,0,0,0,1
04824792,11,5,6,0,1,1,0,1,1
04824801,7,0,7,0,0,0,0,0,0
04825256,16,4,12,0,1,1,0,1,1
04825449,50,4,46,0,1,1,0,1,1
04825491,10,0,10,0,0,0,0,0,1
04825560,8,2,6,0,1,1,0,0,1
04826154,19,6,13,0,0,0,0,0,0
04826387,14,0,14,0,0,0,0,0,1
04826715,79,0,79,0,1,1,0,1,1
04826778,3,3,0,0,2,2,0,0,0
04826836,5,3,2,0,2,2,0,0,0
04826888,34,7,27,0,0,0,0,0,1
04826899,11,1,10,0,0,0,0,0,1
04826955,12,2,10,0,0,0,0,0,0
04827017,5,2,3,0,1,1,0,0,1
04827076,11,3,8,0,1,1,0,1,1
04827296,4,1,3,0,1,1,0,0,0
04827429,22,4,18,0,0,0,0,0,0
04827518,5,3,2,0,2,2,0,0,0
04827804,8,5,3,0,3,1,2,1,0
04827948,11,5,6,0,0,0,0,0,1
04828040,3,2,1,0,1,1,0,1,0
04828050,4,2,2,0,1,1,0,0,0
04828405,3,2,1,0,2,2,0,0,0
04828444,24,4,20,1,0,0,0,0,1
04828800,18,0,18,0,0,0,0,0,1
04829102,6,2,4,0,1,1,0,0,1
04829817,20,3,17,0,4,1,3,2,1
04829971,21,3,18,0,0,0,0,0,1
04830140,15,6,9,0,0,0,0,0,1
04830153,17,6,11,0,1,1,0,1,1
04830154,13,2,11,0,1,1,0,1,1
04830552,13,3,10,0,0,0,0,0,1
04830735,28,6,22,0,2,1,1,0,0
04830824,6,2,4,0,1,1,0,0,0
04831130,5,3,2,0,2,2,0,0,0
04831386,6,3,3,0,2,2,0,0,0
04831526,5,3,2,0,2,2,0,0,0
04831571,22,10,12,0,0,0,0,0,1
04831701,13,7,6,0,0,0,0,0,1
04832001,5,2,3,0,2,1,1,0,1
04832301,104,16,88,0,0,0,0,0,1
04832530,10,2,8,0,0,0,0,0,1
04832787,24,8,16,0,0,0,0,0,0
04833055,7,4,3,0,1,1,0,1,1
04833063,10,1,9,0,2,2,0,0,0
04833091,10,2,8,0,1,1,0,0,1
04833168,4,1,3,0,1,1,0,0,0
04833202,28,8,20,0,0,0,0,0,1
04833603,6,5,1,0,0,0,0,0,0
04833623,23,6,17,0,4,2,2,4,0
04834030,4,2,2,0,1,1,0,0,0
04834300,7,3,4,0,1,1,0,0,1
04834430,11,2,9,0,1,1,0,1,1
04834434,20,3,17,0,1,1,0,1,1
04834586,5,0,5,0,2,1,1,0,0
04834686,6,3,3,0,1,1,0,1,1
04834718,3,0,3,0,1,1,0,1,0
04835087,11,2,9,0,1,1,0,1,1
04835598,6,0,6,0,0,0,0,0,0
04835820,13,0,13,0,0,0,0,0,1
04835906,12,0,12,0,0,0,0,0,1
04835947,4,2,2,0,1,1,0,0,0
04836201,26,6,20,0,0,0,0,0,1
04836257,4,3,1,2,2,1,1,0,1
04836258,4,3,1,2,1,1,0,0,1
04836262,6,1,5,0,1,1,0,0,1
04836759,8,0,8,0,0,0,0,0,1
04836872,19,2,17,0,0,0,0,0,1
04837389,11,3,8,0,1,1,0,1,1
04837733,6,2,4,0,1,1,0,0,0
04837748,10,3,7,0,2,2,0,0,1
04837915,21,4,17,0,1,1,0,0,1
04838540,10,0,10,0,0,0,0,0,0
04838654,5,0,5,0,0,0,0,0,1
04838826,7,1,6,0,1,1,0,0,0
04839047,11,0,11,0,0,0,0,0,1
04839075,32,6,26,0,0,0,0,0,1
04839119,12,3,9,0,1,1,0,1,1
04839268,15,3,12,0,5,1,4,5,1
04839409,16,3,13,0,0,0,0,0,1
04839433,26,4,22,0,1,1,0,1,1
04839661,5,0,5,0,0,0,0,0,1
04839743,5,0,5,0,0,0,0,0,1
04839785,39,3,36,0,1,1,0,1,1
04840002,14,0,14,0,0,0,0,0,1
04840151,4,0,4,0,0,0,0,0,1
04840175,19,4,15,0,1,1,0,1,1
04840187,5,3,2,0,2,2,0,0,0
04840262,5,3,2,0,1,1,0,0,1
04840428,4,2,2,0,1,1,0,0,0
04840772,8,2,6,1,1,1,0,1,1
04842049,5,1,4,0,1,1,0,0,1
04842214,10,4,6,0,0,0,0,0,1
04842496,13,4,9,0,1,1,0,1,1
04842501,12,4,8,0,1,1,0,1,1
04842920,4,1,3,0,1,1,0,0,0
04843064,5,3,2,0,2,2,0,0,0
04843152,26,2,24,0,1,1,0,1,1
04843182,27,0,27,0,0,0,0,0,1
04843280,4,2,2,0,1,1,0,0,0
04844556,5,0,5,0,0,0,0,0,1
04844858,6,0,6,0,2,2,0,0,1
04844917,4,3,1,0,2,2,0,0,0
04844967,13,0,13,0,0,0,0,0,1
04844983,5,3,2,0,2,2,0,0,0
04846017,5,3,2,0,1,1,0,0,0
04846353,6,4,2,0,2,2,0,0,0
04846633,4,2,2,0,1,1,0,0,0
04847071,4,0,4,0,0,0,0,0,1
04847395,7,0,7,0,0,0,0,0,1
04847725,7,5,2,0,5,5,0,3,1
04847949,7,2,5,0,1,1,0,0,1
04848368,6,3,3,0,2,2,0,2,1
04848420,4,0,4,0,0,0,0,0,1
04849220,8,3,5,0,4,1,3,1,1
04849256,6,1,5,0,1,1,0,0,0
04849910,11,0,11,0,1,1,0,0,1
04849998,9,2,7,0,1,1,0,1,1
04850002,11,2,9,1,3,1,2,1,1
04850355,6,0,6,0,1,1,0,0,0
04850516,21,5,16,0,1,1,0,1,1
04850612,12,0,12,0,0,0,0,0,1
04851081,10,1,9,0,1,1,0,0,0
04851498,30,9,21,0,0,0,0,0,1
04851552,41,7,34,0,4,1,3,1,1
04851962,4,2,2,0,1,1,0,0,1
04852002,7,2,5,0,2,2,0,0,1
04852017,18,3,15,0,1,1,0,1,1
04852098,12,5,7,0,2,2,0,0,1
04852514,3,0,3,0,0,0,0,0,0
04852528,4,2,2,0,1,1,0,0,0
04852559,10,2,8,0,3,2,1,0,1
04852638,5,2,3,0,1,1,0,0,0
04852909,4,2,2,0,2,2,0,0,1
04852953,4,2,2,0,1,1,0,0,0
04852970,6,3,3,0,1,1,0,0,0
04853184,6,0,6,0,0,0,0,0,0
04853193,11,5,6,0,1,1,0,0,1
04853346,8,0,8,0,0,0,0,0,1
04854568,5,3,2,0,1,1,0,0,0
04855161,4,2,2,0,2,1,1,0,1
04855173,54,16,38,0,0,0,0,0,1
04855276,16,7,9,0,0,0,0,0,1
04855333,11,3,8,0,1,1,0,1,1
04855747,34,9,25,0,0,0,0,0,1
04856382,27,7,20,1,0,0,0,0,0
04856675,7,0,7,0,0,0,0,0,0
04857094,27,0,27,0,0,0,0,0,1
04857139,6,4,2,0,5,3,2,0,0
04857153,8,0,8,0,0,0,0,0,1
04857158,18,3,15,0,1,1,0,1,1
04857188,4,2,2,0,2,2,0,0,0
04857201,6,1,5,0,1,1,0,0,0
04857238,5,3,2,0,2,2,0,0,0
04857636,13,8,5,0,1,1,0,1,1
04857642,12,7,5,0,1,1,0,1,1
04857713,17,2,15,0,1,1,0,1,1
04858468,16,0,16,0,0,0,0,0,1
04858903,5,3,2,0,2,2,0,0,0
04858952,5,2,3,0,1,1,0,0,0
04859214,10,3,7,0,2,2,0,0,1
04859399,11,0,11,0,0,0,0,0,1
04859512,8,5,3,1,1,1,0,1,1
04859554,6,1,5,0,1,1,0,0,1
04859620,10,3,7,0,3,2,1,1,1
04859641,15,0,15,0,0,0,0,0,1
04860054,7,1,6,0,2,1,1,0,0
04860157,7,0,7,0,0,0,0,0,1
04860660,26,7,19,0,1,1,0,1,1
04860827,8,0,8,0,0,0,0,0,1
04860867,12,3,9,0,1,1,0,1,1
04861135,7,3,4,0,2,2,0,0,1
04861200,5,2,3,0,1,1,0,0,0
04861344,18,0,18,0,0,0,0,0,1
04861822,7,4,3,0,3,3,0,0,0
04862211,11,1,10,0,1,1,0,0,0
04862386,8,1,7,0,2,1,1,0,0
04862537,4,3,1,0,1,1,0,0,0
04862788,7,4,3,0,1,1,0,0,1
04863354,15,1,14,0,1,1,0,1,1
04863443,2,0,2,0,0,0,0,0,0
04863573,30,7,23,0,0,0,0,0,1
04863660,5,1,4,0,1,1,0,1,0
04863758,6,4,2,0,2,2,0,0,0
04864216,26,4,22,0,1,1,0,1,1
04864346,13,4,9,0,1,1,0,1,1
04864434,19,3,16,0,1,1,0,1,1
04865402,7,3,4,0,1,1,0,1,0
04865615,7,3,4,0,1,1,0,1,1
04865634,9,3,6,0,1,1,0,1,1
04865642,30,2,28,0,1,1,0,1,1
04865649,5,3,2,0,1,1,0,0,1
04865661,40,11,29,0,0,0,0,0,1
04865686,6,4,2,0,1,1,0,1,1
04865912,5,2,3,0,1,1,0,0,1
04866085,14,4,10,0,0,0,0,0,1
04866132,9,1,8,0,0,0,0,0,0
04866741,7,0,7,0,0,0,0,0,0
04867503,20,4,16,2,1,0,1,1,1
04867504,20,4,16,2,1,0,1,1,1
04867774,8,2,6,0,1,1,0,1,0
04867812,25,2,23,0,0,0,0,0,1
04868329,16,6,10,0,0,0,0,0,1
04868385,3,2,1,0,1,1,0,0,0
04868792,15,7,8,0,0,0,0,0,0
04868891,11,1,10,0,1,1,0,0,1
04869007,6,3,3,0,1,1,0,1,1
04869117,36,13,23,0,0,0,0,0,1
04869751,5,3,2,0,2,2,0,0,1
04869799,5,0,5,0,0,0,0,0,0
04869878,6,1,5,0,1,1,0,0,0
05240457,5,3,2,0,1,1,0,0,0
05240555,2,2,0,0,1,1,0,0,0
05240607,9,0,9,0,1,1,0,1,1
05240874,6,0,6,0,0,0,0,0,1
05240983,19,0,19,0,0,0,0,0,1
05241025,16,2,14,0,1,1,0,0,0
05241943,15,4,11,0,0,0,0,0,1
05242763,5,2,3,0,1,1,0,1,1
05242766,53,40,13,0,1,1,0,0,1
05242822,7,0,7,0,0,0,0,0,0
05242861,5,3,2,0,1,1,0,0,0
05242888,5,3,2,0,1,1,0,0,0
05242901,10,4,6,0,1,1,0,0,0
05243595,46,9,37,0,1,1,0,0,1
05243616,62,0,62,0,1,1,0,1,1
05243952,5,0,5,0,0,0,0,0,0
05244343,4,1,3,0,2,2,0,1,1
05244434,6,3,3,0,2,1,1,0,0
05244493,29,4,25,0,0,0,0,0,1
05244685,2,2,0,0,1,1,0,0,0
05244729,8,6,2,0,2,2,0,0,1
05244752,5,3,2,0,1,1,0,0,1
05244791,8,0,8,0,0,0,0,0,0
05245051,30,4,26,0,0,0,0,0,1
05245110,4,1,3,0,1,1,0,0,1
05245285,11,4,7,0,2,1,1,0,1
05245343,5,0,5,0,0,0,0,0,1
05245506,16,2,14,0,1,1,0,1,1
05245648,4,1,3,0,2,2,0,0,1
05245944,67,11,56,0,0,0,0,0,1
05245964,7,1,6,0,3,2,1,0,0
05246089,6,1,5,0,1,1,0,0,1
05246123,10,3,7,0,1,1,0,0,0
05246163,5,3,2,0,1,1,0,0,0
05246336,7,3,4,0,2,2,0,0,1
05246492,10,0,10,0,0,0,0,0,1
05246887,5,1,4,0,1,1,0,0,0
05246899,10,0,10,0,0,0,0,0,1
05246969,10,0,10,1,1,1,0,0,0
05246997,2,2,0,0,1,1,0,0,0
05247060,3,3,0,0,1,1,0,1,0
05247101,11,2,9,0,1,1,0,1,1
05247368,16,5,11,0,1,1,0,1,0
05247569,10,2,8,0,0,0,0,0,1
05247579,8,3,5,0,1,1,0,1,1
05247830,20,3,17,0,1,1,0,1,1
05247948,41,0,41,0,0,0,0,0,1
05247998,28,4,24,0,1,1,0,1,1
05248177,4,2,2,0,1,1,0,0,1
05248186,4,3,1,0,2,2,0,0,0
05248736,10,0,10,0,1,1,0,0,1
05248824,29,4,25,0,0,0,0,0,1
05249093,15,2,13,0,1,1,0,1,1
05249208,25,7,18,0,0,0,0,0,1
05249358,5,3,2,0,2,2,0,0,0
05249549,19,5,14,0,1,1,0,1,1
05250279,7,4,3,0,2,2,0,0,1
05250284,18,4,14,0,2,1,1,2,1
05250602,12,4,8,0,1,1,0,1,1
05250748,6,3,3,0,4,1,3,0,1
05250751,7,2,5,0,0,0,0,0,0
05250754,5,3,2,0,1,1,0,1,1
05250960,6,5,1,0,3,3,0,0,0
05251518,10,4,6,0,0,0,0,0,1
05251578,4,0,4,0,0,0,0,0,0
05251606,16,2,14,0,1,1,0,1,0
05251617,10,0,10,0,1,1,0,1,1
05251681,6,2,4,0,1,1,0,0,0
05251701,4,4,0,0,2,2,0,0,0
05251721,6,0,6,0,0,0,0,0,0
05251731,37,12,25,0,3,1,2,0,1
05251840,9,0,9,0,0,0,0,0,0
05251909,8,3,5,0,1,1,0,1,0
05252036,6,2,4,0,1,1,0,0,0
05252270,2,2,0,0,1,1,0,0,1
05252647,3,3,0,0,2,2,0,0,1
05254316,14,3,11,0,1,1,0,1,1
05254330,15,3,12,0,1,1,0,1,1
05254343,14,3,11,0,1,1,0,1,1
05254350,5,2,3,0,1,1,0,1,1
05254359,5,2,3,0,1,1,0,1,1
05254883,24,7,17,0,0,0,0,0,1
05256050,4,2,2,0,1,1,0,0,1
05256052,17,3,14,0,0,0,0,0,1
05256601,45,4,41,0,0,0,0,0,0
05256824,4,1,3,0,0,0,0,0,1
05256970,11,2,9,0,1,1,0,1,1
05257402,9,4,5,0,2,2,0,1,1
05257826,11,0,11,0,0,0,0,0,1
05257840,10,5,5,0,0,0,0,0,0
05258036,24,12,12,0,0,0,0,0,1
05258129,5,0,5,0,0,0,0,0,1
05258181,2,0,2,0,0,0,0,0,1
05258191,16,0,16,0,0,0,0,0,1
05258596,23,9,14,1,0,0,0,0,1
05258789,58,18,40,0,0,0,0,0,1
05259232,7,0,7,0,0,0,0,0,1
05259545,6,4,2,0,3,3,0,0,0
05259828,11,2,9,0,1,1,0,1,1
05260459,27,0,27,0,0,0,0,0,1
05260592,15,0,15,0,1,1,0,1,1
05260600,12,1,11,0,1,1,0,1,1
05260621,4,2,2,0,3,2,1,0,0
05260622,6,4,2,0,3,1,2,1,0
05260637,8,5,3,0,0,0,0,0,0
05260891,5,1,4,0,1,1,0,0,0
05260899,5,0,5,0,0,0,0,0,1
05261025,5,3,2,0,2,2,0,0,0
05261085,8,1,7,0,1,1,0,0,1
05261207,11,4,7,0,0,0,0,0,1
05261662,6,2,4,0,1,1,0,0,0
05261717,10,5,5,0,6,4,2,2,1
05261860,4,0,4,0,1,1,0,0,1
05262178,9,2,7,0,1,1,0,1,0
05262323,46,10,36,0,0,0,0,0,1
05262658,12,4,8,0,1,1,0,1,1
05262801,6,4,2,0,3,3,0,0,0
05262810,11,2,9,0,1,1,0,1,1
05262818,7,2,5,0,1,1,0,1,0
05263102,7,0,7,0,1,1,0,0,0
05263314,11,2,9,0,2,2,0,0,1
05263545,14,0,14,0,1,1,0,1,1
05263552,23,9,14,0,2,2,0,0,1
05263742,4,2,2,0,1,1,0,1,0
05264031,13,3,10,1,1,1,0,1,1
05264114,4,0,4,0,0,0,0,0,1
05264271,6,0,6,1,1,1,0,0,0
05264693,7,2,5,0,2,2,0,0,0
05265562,2,2,0,0,2,2,0,0,0
05266281,5,3,2,0,0,0,0,0,1
05266282,6,0,6,0,0,0,0,0,1
05266284,6,0,6,0,0,0,0,0,1
05266383,5,2,3,0,1,1,0,0,0
05266436,20,5,15,0,1,1,0,1,1
05266449,28,2,26,0,1,1,0,1,1
05267303,7,1,6,0,1,1,0,0,1
05267358,15,0,15,0,0,0,0,0,1
05267391,37,0,37,0,1,1,0,1,1
05267864,15,0,15,0,0,0,0,0,1
05267980,63,4,59,0,1,1,0,1,1
05268103,4,3,1,0,2,2,0,0,0
05268159,20,0,20,0,0,0,0,0,1
05268178,14,4,10,0,0,0,0,0,1
05268381,4,0,4,0,0,0,0,0,1
05268423,16,0,16,0,1,1,0,1,1
05268432,19,3,16,0,1,1,0,1,1
05268518,5,2,3,0,2,2,0,0,0
05269156,9,0,9,0,0,0,0,0,1
05269182,14,3,11,0,3,1,2,1,1
05269215,4,2,2,0,1,1,0,0,1
05269360,12,4,8,0,1,1,0,1,1
05269610,16,3,13,0,0,0,0,0,0
05269630,15,0,15,0,0,0,0,0,1
05269734,5,0,5,0,0,0,0,0,1
05269877,5,3,2,0,2,2,0,0,0
05269937,11,0,11,0,3,1,2,1,1
05269969,4,0,4,0,0,0,0,0,1
05270173,9,4,5,0,0,0,0,0,1
05270340,20,8,12,0,1,1,0,0,1
05270698,11,4,7,0,5,4,1,0,0
05270832,9,3,6,0,2,2,0,0,1
05270846,30,7,23,0,2,1,1,2,1
05271013,5,0,5,0,0,0,0,0,1
05271017,13,5,8,0,2,1,1,2,1
05271035,5,0,5,0,0,0,0,0,1
05271123,6,0,6,0,1,1,0,0,1
05271553,23,0,23,0,0,0,0,0,1
05272129,7,0,7,0,0,0,0,0,1
05272464,19,4,15,0,1,1,0,1,1
05272709,7,0,7,0,1,1,0,0,1
05272710,7,0,7,0,1,1,0,0,1
05272812,7,3,4,0,1,1,0,0,1
05273393,2,1,1,0,0,0,0,0,1
05273587,6,3,3,0,1,1,0,1,1
05273731,35,9,26,0,0,0,0,0,0
05273829,24,7,17,0,0,0,0,0,1
05273901,5,3,2,0,2,2,0,0,1
05274362,7,0,7,0,0,0,0,0,1
05274457,8,2,6,0,0,0,0,0,1
05274462,15,3,12,0,0,0,0,0,1
05274981,10,3,7,0,0,0,0,0,0
05275033,7,3,4,0,1,1,0,1,1
05275253,7,3,4,0,2,2,0,0,1
05275400,12,0,12,0,0,0,0,0,1
05275421,8,0,8,0,0,0,0,0,1
05275749,36,8,28,0,0,0,0,0,1
05275839,12,5,7,0,0,0,0,0,1
05276019,8,3,5,0,1,1,0,1,1
05276020,8,3,5,0,1,1,0,1,1
05276368,33,4,29,0,1,1,0,1,1
05276453,5,0,5,0,0,0,0,0,1
05276910,3,3,0,0,2,2,0,0,0
05276984,4,1,3,0,1,1,0,0,0
05277300,16,5,11,0,1,1,0,1,1
05277571,13,5,8,0,0,0,0,0,0
05277649,12,3,9,0,2,2,0,0,0
05277786,6,0,6,0,0,0,0,0,0
05277813,4,2,2,0,1,1,0,0,0
05278037,4,0,4,0,0,0,0,0,0
05278053,6,4,2,0,1,1,0,0,0
05278138,5,3,2,0,2,2,0,0,1
05278253,14,0,14,0,0,0,0,0,1
05278844,5,3,2,0,2,2,0,0,0
05278856,10,2,8,0,2,2,0,0,1
05279270,6,0,6,0,0,0,0,0,0
05279527,8,0,8,0,0,0,0,0,1
05279656,4,0,4,0,1,1,0,0,1
05279663,8,4,4,0,2,2,0,1,1
05279680,8,0,8,0,0,0,0,0,1
05279739,4,1,3,0,1,1,0,0,1
05280247,7,0,7,0,0,0,0,0,1
05280385,3,0,3,0,0,0,0,0,0
05280414,17,4,13,0,1,1,0,1,1
05280419,17,2,15,0,1,1,0,1,0
05280624,9,0,9,0,0,0,0,0,1
05281104,5,4,1,0,2,2,0,0,0
05281202,15,4,11,0,2,1,1,1,0
05281416,7,0,7,0,2,2,0,0,1
05281474,9,3,6,0,1,1,0,1,1
05281752,2,2,0,0,2,2,0,0,1
05282038,4,2,2,0,1,1,0,0,0
05282071,24,2,22,0,2,1,1,2,1
05282368,6,0,6,0,0,0,0,0,1
05282380,5,1,4,0,2,1,1,1,0
05282613,5,1,4,0,1,1,0,0,1
05282777,31,12,19,0,1,1,0,1,1
05282955,6,4,2,0,1,1,0,0,0
05283272,47,7,40,0,0,0,0,0,1
05283776,10,3,7,0,0,0,0,0,1
05283913,8,0,8,0,0,0,0,0,1
05284089,4,0,4,0,0,0,0,0,0
05284106,15,5,10,0,1,1,0,0,0
05284218,11,4,7,0,3,3,0,0,0
05284466,3,0,3,0,0,0,0,0,1
05284717,7,3,4,0,2,2,0,0,1
05284852,3,0,3,0,0,0,0,0,1
05284920,14,2,12,0,1,1,0,1,1
05285052,8,0,8,0,0,0,0,0,1
05285332,7,0,7,0,0,0,0,0,1
05285388,18,3,15,0,1,1,0,1,0
05285411,5,2,3,0,1,1,0,0,1
05285783,14,3,11,0,3,2,1,1,0
02540333,52,6,46,0,0,0,0,0,1
02540399,14,4,10,0,1,1,0,1,1
02541095,39,0,39,0,0,0,0,0,1
02541227,13,2,11,0,1,1,0,1,1
02541231,3,1,2,0,2,2,0,0,1
02541424,77,10,67,0,0,0,0,0,1
02542085,81,8,73,0,1,1,0,1,1
02542223,37,4,33,0,0,0,0,0,1
02542925,5,3,2,0,2,2,0,0,1
02543348,15,3,12,0,0,0,0,0,1
02543548,16,4,12,0,4,4,0,1,1
02543555,25,5,20,0,3,1,2,1,1
02543705,60,6,54,0,2,2,0,2,1
02543818,21,4,17,0,1,1,0,1,1
02544103,20,5,15,0,3,1,2,3,1
02544237,20,8,12,0,0,0,0,0,1
02544334,27,0,27,0,0,0,0,0,1
02544366,5,3,2,0,1,1,0,0,1
02544376,48,9,39,0,0,0,0,0,1
02544707,6,2,4,0,2,1,1,2,1
02544823,3,1,2,0,1,1,0,0,1
02544880,4,1,3,0,5,2,3,0,0
02545034,22,6,16,0,1,1,0,0,1
02545255,8,3,5,0,1,1,0,0,1
02545418,5,3,2,0,2,2,0,0,0
02545659,22,3,19,0,0,0,0,0,1
02545804,64,10,54,0,0,0,0,0,0
02545832,107,7,100,0,0,0,0,0,0
02546070,23,3,20,0,1,1,0,1,1
02546262,20,5,15,0,0,0,0,0,1
02546304,14,0,14,0,0,0,0,0,1
02546607,17,0,17,0,0,0,0,0,1
02546950,69,12,57,0,2,1,1,2,1
02547352,6,3,3,0,2,2,0,0,1
02547379,15,2,13,0,0,0,0,0,0
02547380,10,2,8,0,0,0,0,0,0
02547384,16,2,14,0,0,0,0,0,0
02547387,12,2,10,0,0,0,0,0,0
02547573,24,0,24,0,0,0,0,0,1
02547666,28,0,28,0,0,0,0,0,1
02547700,6,2,4,0,1,1,0,0,1
02547863,13,0,13,0,0,0,0,0,1
02548012,20,6,14,0,0,0,0,0,1
02548042,23,0,23,0,0,0,0,0,1
02548079,36,8,28,0,1,1,0,1,1
02548131,17,1,16,0,2,1,1,2,1
02548216,66,14,52,0,0,0,0,0,1
02548716,24,3,21,0,2,2,0,2,1
02548782,54,4,50,0,2,1,1,2,1
02549040,23,0,23,0,0,0,0,0,1
02549212,25,5,20,0,1,1,0,1,1
02549285,30,0,30,0,0,0,0,0,1
02549422,26,6,20,0,1,1,0,1,1
02549484,36,5,31,0,0,0,0,0,1
02549534,6,3,3,0,2,2,0,0,0
02549634,32,6,26,0,0,0,0,0,1
02549828,9,1,8,0,0,0,0,0,1
02550150,31,6,25,0,2,1,1,2,1
02550242,32,4,28,0,1,1,0,1,1
02550292,4,0,4,0,0,0,0,0,1
02550433,23,0,23,0,0,0,0,0,1
02550472,4,2,2,0,1,1,0,0,0
02550639,31,0,31,0,0,0,0,0,1
02550646,23,3,20,0,2,1,1,2,1
02550739,11,5,6,0,0,0,0,0,1
02550866,44,8,36,0,0,0,0,0,1
02550962,21,3,18,0,0,0,0,0,1
02551359,22,4,18,0,2,2,0,2,0
02552695,72,0,72,0,0,0,0,0,1
02552767,35,5,30,0,1,1,0,1,1
02553293,56,15,41,0,0,0,0,0,1
02553408,17,4,13,0,1,1,0,1,1
02553549,18,0,18,0,0,0,0,0,1
02553555,18,0,18,0,0,0,0,0,1
02553780,45,4,41,0,2,2,0,2,1
02553828,29,4,25,0,1,1,0,0,1
02553840,26,0,26,0,0,0,0,0,1
02553922,31,5,26,0,0,0,0,0,1
02554204,17,4,13,0,1,1,0,1,1
02554211,23,7,16,0,1,1,0,0,1
02554241,33,2,31,0,1,1,0,1,1
02554243,29,0,29,0,0,0,0,0,1
02554256,3,0,3,0,0,0,0,0,1
02554729,6,3,3,0,2,2,0,0,1
02554733,37,0,37,0,1,1,0,1,1
02554889,35,5,30,0,0,0,0,0,1
02555576,26,8,18,0,6,6,0,1,0
02555621,10,3,7,0,1,1,0,1,1
02555745,6,3,3,0,1,1,0,0,1
02556409,16,0,16,0,0,0,0,0,1
02556415,45,5,40,0,1,1,0,1,1
02556508,65,12,53,0,0,0,0,0,1
02556517,13,2,11,0,0,0,0,0,1
02556557,31,3,28,0,0,0,0,0,1
02556604,22,4,18,0,1,1,0,1,1
02556636,63,11,52,0,1,1,0,1,1
02557058,14,7,7,0,3,3,0,0,1
02557161,30,4,26,0,1,1,0,1,1
02557203,28,9,19,0,1,1,0,0,0
02557277,3,2,1,0,1,1,0,0,0
02557363,50,3,47,0,3,1,2,3,1
02557590,39,8,31,0,2,1,1,2,1
02557706,36,11,25,0,2,2,0,1,1
02557718,21,6,15,0,0,0,0,0,1
02557730,77,11,66,0,0,0,0,0,1
02558021,25,6,19,0,0,0,0,0,1
02558025,36,3,33,0,1,1,0,1,1
02558427,3,2,1,0,2,2,0,0,0
02558640,6,3,3,0,2,2,0,0,0
02558778,8,4,4,0,1,1,0,1,1
02558847,19,0,19,0,0,0,0,0,1
02558883,28,4,24,0,2,2,0,2,1
02559004,21,5,16,0,0,0,0,0,0
02559058,10,3,7,0,1,1,0,1,1
02559097,7,4,3,0,1,1,0,1,1
02559127,16,3,13,0,2,2,0,0,0
02559861,19,3,16,0,1,1,0,1,0
02559885,10,3,7,0,1,1,0,1,0
02560054,6,4,2,0,2,2,0,0,0
02560460,14,8,6,0,1,1,0,0,0
02560679,25,5,20,0,2,1,1,1,1
02560696,4,3,1,0,1,1,0,1,1
02560699,25,3,22,0,1,1,0,1,1
02560737,2,1,1,0,0,0,0,0,1
02561024,43,8,35,0,1,1,0,1,1
02561045,9,2,7,0,1,1,0,0,0
02561226,12,2,10,0,1,1,0,1,1
02561288,20,3,17,0,1,1,0,1,1
02561362,25,3,22,0,1,1,0,1,1
02561526,5,3,2,0,1,1,0,0,1
02561607,37,8,29,0,0,0,0,0,0
02561611,32,2,30,0,3,2,1,0,1
02561833,28,2,26,1,0,0,0,0,1
02561924,29,5,24,0,1,1,0,1,1
02562172,7,4,3,0,1,1,0,1,0
02562207,17,4,13,0,1,1,0,1,1
02562269,9,0,9,0,0,0,0,0,1
02562388,11,2,9,0,1,1,0,0,1
02562409,11,0,11,0,1,1,0,1,1
02562471,35,5,30,0,1,1,0,1,1
02562504,26,0,26,0,0,0,0,0,1
02562550,7,2,5,0,1,1,0,0,0
02563094,95,11,84,0,1,1,0,0,1
02563259,21,2,19,0,1,1,0,1,1
02563291,5,2,3,0,1,1,0,0,1
02563351,268,22,246,0,1,1,0,0,1
02563542,4,0,4,0,0,0,0,0,1
02563902,18,3,15,0,1,1,0,1,1
02563987,13,3,10,0,1,1,0,1,1
02564017,17,3,14,0,1,1,0,1,1
02564021,16,4,12,0,1,1,0,1,1
02564122,21,2,19,0,0,0,0,0,1
02564153,15,9,6,0,1,1,0,0,1
02564416,15,4,11,0,1,1,0,1,1
02564419,13,3,10,0,1,1,0,1,1
02564425,13,3,10,0,1,1,0,1,1
02564491,18,0,18,0,0,0,0,0,1
02564625,14,3,11,0,1,1,0,1,1
02564663,6,3,3,0,1,1,0,0,1
02564794,45,5,40,0,1,1,0,1,1
02564907,30,4,26,0,1,1,0,1,1
02565014,69,0,69,0,0,0,0,0,1
02565021,60,11,49,0,0,0,0,0,1
02565144,22,4,18,0,1,1,0,1,1
02565390,29,5,24,0,1,1,0,1,1
02566070,5,0,5,0,0,0,0,0,1
02566083,11,4,7,0,1,1,0,1,0
02566246,5,0,5,0,1,1,0,0,1
02566313,41,6,35,0,3,3,0,3,1
02566317,28,0,28,0,1,1,0,1,1
02566762,17,4,13,0,5,1,4,1,1
02566924,49,0,49,0,1,1,0,1,1
02567001,28,0,28,0,1,1,0,1,1
02567324,3,3,0,0,2,2,0,0,1
02567387,14,6,8,0,0,0,0,0,0
02567390,20,11,9,0,0,0,0,0,1
02567458,86,4,82,0,12,0,12,0,1
02567517,29,9,20,0,0,0,0,0,1
02567711,64,13,51,0,0,0,0,0,1
02567735,49,15,34,0,0,0,0,0,1
02567793,47,9,38,0,0,0,0,0,0
02567988,46,2,44,0,1,1,0,1,1
02568025,6,2,4,0,1,1,0,0,0
02568407,121,13,108,0,1,1,0,0,0
02568432,24,0,24,0,0,0,0,0,1
02568564,37,8,29,0,0,0,0,0,0
02568967,24,3,21,0,3,1,2,3,1
02569002,25,7,18,0,2,1,1,2,1
02569077,12,4,8,0,1,1,0,1,1
02569771,23,5,18,0,1,1,0,1,1
02569835,85,10,75,0,1,1,0,1,1
02569981,43,3,40,0,1,1,0,1,1
02570489,7,0,7,0,3,2,1,1,1
02570546,10,3,7,0,1,1,0,1,1
02570632,19,2,17,0,0,0,0,0,1
02570704,62,0,62,0,0,0,0,0,1
02570797,10,3,7,0,1,1,0,1,1
02570801,10,3,7,0,1,1,0,1,1
02570808,9,3,6,0,1,1,0,1,1
02570898,6,2,4,0,1,1,0,0,1
02570940,6,0,6,0,0,0,0,0,0
02571002,20,0,20,0,0,0,0,0,1
02571302,22,5,17,0,1,1,0,0,0
02571317,5,2,3,0,1,1,0,0,0
02571337,8,0,8,0,0,0,0,0,1
02571397,24,0,24,0,0,0,0,0,1
02571559,28,5,23,0,1,1,0,1,1
02571588,29,0,29,0,0,0,0,0,1
02571606,14,2,12,0,0,0,0,0,1
02571806,16,0,16,0,0,0,0,0,1
02571923,17,1,16,0,1,1,0,1,1
02571967,7,2,5,0,1,1,0,1,0
02571981,54,0,54,0,0,0,0,0,1
01069133,37,11,26,0,0,0,0,0,1
01069282,54,0,54,0,0,0,0,0,1
01070198,10,2,8,0,1,1,0,0,1
01070399,29,2,27,0,1,1,0,1,1
01070722,10,3,7,0,0,0,0,0,0
01070807,30,5,25,0,1,1,0,1,1
01071033,33,8,25,0,1,1,0,1,1
01071050,10,2,8,0,2,1,1,1,0
01071194,24,6,18,0,0,0,0,0,0
01071324,25,4,21,0,1,1,0,1,0
01072023,10,8,2,0,3,3,0,0,1
01072079,25,0,25,0,0,0,0,0,1
01072245,13,4,9,0,4,3,1,0,1
01072627,40,5,35,0,1,1,0,1,1
01072847,32,3,29,0,1,1,0,1,1
01072954,56,6,50,0,1,1,0,1,1
01073136,43,3,40,0,1,1,0,1,1
01073471,14,4,10,0,1,1,0,1,1
01073947,27,0,27,0,0,0,0,0,1
01074166,31,5,26,0,1,1,0,1,1
01074284,4,3,1,0,2,2,0,1,1
01074649,74,14,60,0,0,0,0,0,0
01074891,4,3,1,0,2,2,0,1,1
01075225,37,5,32,0,1,1,0,0,1
01075500,3,3,0,0,1,1,0,1,1
01075752,44,4,40,0,1,1,0,1,1
01076000,0,0,0,0,0,0,0,0,1
01076494,5,3,2,0,1,1,0,0,1
01076928,26,2,24,0,1,1,0,1,1
01077548,25,4,21,0,1,1,0,1,1
01078365,21,2,19,0,1,1,0,1,1
01079104,10,0,10,0,0,0,0,0,1
01079888,46,6,40,0,0,0,0,0,1
01079943,8,4,4,0,1,1,0,0,0
01080251,24,6,18,0,1,1,0,1,1
01080598,20,0,20,0,0,0,0,0,1
01080763,18,0,18,0,0,0,0,0,1
01080877,13,1,12,0,0,0,0,0,1
01080879,24,3,21,0,1,1,0,1,1
01081026,22,5,17,0,1,1,0,1,1
01081030,68,11,57,0,0,0,0,0,1
01081335,8,1,7,0,1,1,0,0,0
01081898,33,2,31,0,1,1,0,1,1
01081917,19,3,16,0,1,1,0,1,1
01082541,9,2,7,0,1,1,0,1,1
01082593,36,0,36,0,0,0,0,0,1
01082908,17,4,13,0,1,1,0,1,1
01083023,50,3,47,0,1,1,0,1,1
01083092,29,4,25,0,2,1,1,2,1
01083105,42,7,35,0,0,0,0,0,1
01083181,5,4,1,0,1,1,0,0,1
01083481,15,2,13,0,1,1,0,1,1
01083899,37,1,36,0,0,0,0,0,1
01084115,10,2,8,0,1,1,0,1,0
01084171,26,2,24,0,0,0,0,0,1
01085804,15,2,13,0,1,1,0,0,1
01085975,25,4,21,0,1,1,0,1,1
01085977,30,0,30,0,0,0,0,0,1
01086094,8,5,3,0,4,4,0,0,0
01086252,7,3,4,0,0,0,0,0,1
01086296,15,0,15,0,1,1,0,1,1
01086582,86,13,73,0,0,0,0,0,1
01086636,9,0,9,0,0,0,0,0,1
01088000,72,14,58,0,0,0,0,0,1
01088177,20,7,13,0,0,0,0,0,0
01088249,109,0,109,0,0,0,0,0,1
01089026,85,11,74,0,0,0,0,0,1
01089268,37,3,34,0,1,1,0,1,1
01089313,20,3,17,0,0,0,0,0,0
01089326,37,3,34,0,1,1,0,1,1
01089363,20,3,17,0,1,1,0,1,1
01089795,22,4,18,0,1,1,0,1,1
01089843,11,4,7,0,1,1,0,0,1
01089916,8,4,4,0,1,1,0,0,0
01089940,36,7,29,0,2,2,0,1,1
01090034,32,9,23,0,0,0,0,0,1
01090038,34,0,34,0,0,0,0,0,1
01090085,20,3,17,0,1,1,0,1,1
01090170,10,0,10,0,0,0,0,0,1
01090249,7,5,2,0,1,1,0,0,1
01090321,11,3,8,0,2,1,1,1,1
01090601,24,2,22,0,1,1,0,1,1
01090926,35,4,31,0,1,1,0,1,1
01091137,33,5,28,0,2,1,1,1,1
01091347,21,6,15,0,0,0,0,0,1
01091581,11,1,10,0,4,2,2,1,1
01092003,0,0,0,0,0,0,0,0,0
01092243,47,4,43,0,1,0,1,0,1
01092758,48,11,37,0,0,0,0,0,1
01092978,22,10,12,0,1,1,0,0,0
01093205,5,3,2,0,2,2,0,0,0
01093297,54,16,38,0,0,0,0,0,1
01093363,34,3,31,0,0,0,0,0,1
01093549,58,10,48,0,1,1,0,1,1
01093911,6,3,3,0,1,1,0,0,1
01094063,18,4,14,0,2,1,1,0,1
01094232,63,12,51,0,1,1,0,0,1
01094729,19,3,16,0,1,1,0,1,1
01095065,99,7,92,0,0,0,0,0,1
01095091,35,9,26,0,1,1,0,1,1
01095294,6,2,4,0,1,1,0,0,0
01096180,15,3,12,0,0,0,0,0,1
01096399,0,0,0,0,0,0,0,0,0
01096719,62,7,55,0,0,0,0,0,1
01097059,149,21,128,0,0,0,0,0,1
01097096,6,3,3,0,2,2,0,0,0
01097382,62,8,54,0,0,0,0,0,1
01097736,5,0,5,0,0,0,0,0,1
01098175,46,0,46,0,1,1,0,1,1
01099169,7,2,5,0,2,2,0,0,1
01099229,28,3,25,0,1,1,0,1,1
01099506,7,2,5,0,2,2,0,0,1
01099697,56,4,52,0,1,1,0,1,1
01100544,29,3,26,0,1,1,0,1,1
01100685,45,6,39,0,1,1,0,1,1
01100897,6,4,2,0,2,1,1,1,1
01101017,105,19,86,0,0,0,0,0,1
01101649,29,3,26,0,1,1,0,1,1
01101651,0,0,0,0,0,0,0,0,1
01101944,33,9,24,0,0,0,0,0,1
01102060,12,6,6,0,1,1,0,1,0
01102135,38,3,35,0,1,1,0,1,1
01102295,7,3,4,0,1,1,0,1,1
01102505,13,0,13,0,0,0,0,0,1
01102517,56,7,49,0,1,1,0,1,1
01102834,29,3,26,0,1,1,0,1,1
01102971,33,1,32,0,1,1,0,1,1
01103028,12,5,7,0,1,1,0,1,1
01103760,210,15,195,0,0,0,0,0,1
01103870,16,0,16,0,0,0,0,0,1
01104081,5,3,2,0,1,1,0,1,0
01104245,112,13,99,0,0,0,0,0,0
01104312,22,4,18,0,1,1,0,1,1
01104598,44,8,36,0,1,1,0,1,1
01104811,31,5,26,0,1,1,0,1,1
01105376,25,3,22,0,2,2,0,2,1
01105441,45,0,45,0,0,0,0,0,1
01105580,26,4,22,0,2,1,1,2,1
01105800,27,3,24,0,0,0,0,0,0
01105991,9,5,4,0,1,1,0,0,1
01106030,20,3,17,0,1,1,0,0,0
01106309,21,4,17,0,0,0,0,0,1
01106581,4,1,3,0,1,1,0,0,0
01106659,16,3,13,0,1,1,0,0,1
01106889,8,2,6,0,2,2,0,0,1
01107218,17,3,14,0,1,1,0,0,1
01107543,39,3,36,0,1,1,0,1,1
01107591,8,6,2,0,1,1,0,0,0
01107698,13,0,13,0,0,0,0,0,1
01107997,23,6,17,0,0,0,0,0,1
01108021,36,2,34,0,2,2,0,2,1
01108292,4,1,3,0,1,1,0,1,1
01108300,25,3,22,0,4,1,3,1,1
01108440,17,4,13,0,1,1,0,1,1
01108587,26,4,22,0,1,1,0,1,1
01108984,29,2,27,0,1,1,0,1,1
01109141,73,12,61,0,2,1,1,0,1
01109189,44,2,42,0,0,0,0,0,1
01109384,78,20,58,0,19,18,1,0,1
01109394,5,5,0,0,1,1,0,1,0
01109913,60,0,60,0,0,0,0,0,1
01109955,23,2,21,0,1,1,0,1,1
01110018,30,7,23,0,0,0,0,0,1
01110423,8,0,8,0,0,0,0,0,1
01110830,25,0,25,0,0,0,0,0,1
01111004,7,5,2,0,1,1,0,0,0
01111202,17,4,13,0,0,0,0,0,1
01111950,27,7,20,0,1,1,0,1,1
01112024,7,3,4,0,2,2,0,0,1
01112216,5,2,3,0,1,1,0,0,1
01112242,23,8,15,0,0,0,0,0,1
01112362,11,9,2,0,1,1,0,1,1
01112603,50,9,41,0,1,1,0,1,1
01113047,42,3,39,0,1,1,0,1,1
01113112,44,4,40,0,1,1,0,1,1
01113238,26,7,19,0,1,1,0,0,1
01113476,6,2,4,0,1,1,0,0,0
01113625,40,10,30,0,0,0,0,0,1
01113761,26,4,22,0,3,3,0,0,1
01113804,6,3,3,0,1,1,0,0,0
01114031,42,10,32,0,0,0,0,0,1
01114273,34,7,27,0,0,0,0,0,1
01114404,62,12,50,0,0,0,0,0,1
01114459,31,0,31,0,1,1,0,1,1
01114778,34,8,26,0,0,0,0,0,1
01114922,7,0,7,0,1,1,0,1,1
01115808,4,2,2,0,1,1,0,0,0
01116071,0,0,0,0,0,0,0,0,0
01116219,11,3,8,0,1,1,0,0,0
01116632,29,7,22,0,1,1,0,0,0
01116696,11,0,11,0,0,0,0,0,1
01117305,53,2,51,0,0,0,0,0,1
01117445,45,0,45,0,0,0,0,0,1
01117541,24,5,19,0,1,1,0,1,1
01117622,14,3,11,0,4,3,1,0,1
01117696,33,6,27,0,0,0,0,0,1
01118580,70,6,64,0,1,1,0,1,1
01118613,18,3,15,0,4,4,0,0,0
01118654,17,3,14,0,0,0,0,0,0
01118758,92,22,70,0,0,0,0,0,1
01119621,10,0,10,0,0,0,0,0,1
01119693,34,0,34,0,0,0,0,0,1
01119800,21,2,19,0,1,1,0,1,0
01119804,185,20,165,0,0,0,0,0,1
01119822,24,3,21,0,2,2,0,0,1
01120119,63,12,51,0,0,0,0,0,1
01120283,34,4,30,0,1,1,0,1,1
01120623,37,4,33,0,1,1,0,1,1
01121315,6,3,3,0,1,1,0,0,0
01121672,23,3,20,0,1,1,0,1,1
01121804,4,3,1,0,3,3,0,0,0
01122360,4,3,1,0,2,2,0,1,1
01122503,66,15,51,0,1,1,0,1,1
01123712,43,11,32,0,1,1,0,0,0
01123795,6,2,4,0,0,0,0,0,1
01125142,9,4,5,0,3,3,0,0,1
01125645,0,0,0,0,0,0,0,0,0
01125740,60,10,50,0,1,1,0,1,1
01126183,13,0,13,0,1,1,0,1,1
01126365,32,6,26,0,2,1,1,0,1
01126882,48,13,35,0,1,1,0,0,1
01127149,34,0,34,0,1,1,0,1,1
01127453,37,0,37,0,1,1,0,1,1
01127633,21,4,17,0,1,1,0,0,1
01128160,135,4,131,0,1,1,0,1,1
01128463,58,11,47,0,0,0,0,0,1
01128472,12,3,9,0,1,1,0,0,1
01128611,54,7,47,0,2,1,1,2,1
01128710,4,3,1,0,2,2,0,0,1
01128736,6,3,3,0,1,1,0,0,0
01128759,7,3,4,0,1,1,0,0,0
01128923,7,2,5,0,1,1,0,0,1
01129170,7,3,4,0,2,1,1,0,0
08871434,7,2,5,0,2,2,0,2,1
08871766,25,13,12,0,1,1,0,1,1
08871767,5,3,2,0,4,3,1,0,1
08871790,9,3,6,0,3,3,0,3,1
08871818,1,1,0,0,1,1,0,0,0
08871955,2,1,1,0,1,1,0,0,1
08872061,11,9,2,0,2,1,1,2,1
08872183,1,1,0,0,1,1,0,0,0
08872698,29,10,19,0,0,0,0,0,1
08872858,1,1,0,0,1,1,0,0,0
08873671,4,0,4,0,0,0,0,0,1
08873788,9,2,7,0,1,1,0,1,1
08873806,17,8,9,0,1,1,0,0,1
08873949,1,1,0,0,2,2,0,0,0
08874025,2,2,0,0,1,1,0,0,1
08874082,3,2,1,0,2,2,0,0,0
08874314,2,2,0,0,1,1,0,0,1
08874320,2,2,0,0,1,1,0,0,0
08874528,6,4,2,0,1,1,0,1,1
08874564,2,2,0,0,1,1,0,0,0
08874606,1,0,1,0,0,0,0,0,1
08874829,3,2,1,0,2,2,0,0,0
08874907,13,6,7,0,2,2,0,2,1
08875061,5,0,5,0,2,1,1,1,1
08875552,3,1,2,0,3,3,0,0,1
08875585,1,1,0,0,1,1,0,0,1
08875676,2,2,0,0,2,2,0,0,0
08875828,10,7,3,0,1,1,0,0,0
08875987,4,2,2,0,2,2,0,0,0
08876534,5,2,3,0,2,2,0,0,1
08876860,1,1,0,0,1,1,0,0,0
08877109,1,1,0,0,1,1,0,0,0
08877770,4,0,4,0,0,0,0,0,0
08877831,2,2,0,0,2,2,0,0,0
08878036,2,2,0,0,1,1,0,0,0
08878318,2,2,0,0,2,2,0,0,0
08878363,2,0,2,0,0,0,0,0,0
08878477,8,2,6,0,1,1,0,1,1
08878581,3,0,3,0,1,1,0,0,0
08878604,11,10,1,0,0,0,0,0,0
08878754,1,1,0,0,1,1,0,0,0
08879090,1,0,1,0,0,0,0,0,1
08879543,3,2,1,0,1,1,0,0,1
08879662,8,0,8,0,1,1,0,1,1
08880174,10,8,2,0,0,0,0,0,0
08880546,39,18,21,0,0,0,0,0,1
08880740,1,1,0,0,1,1,0,0,0
08880841,25,13,12,0,0,0,0,0,0
08881335,1,0,1,0,0,0,0,0,0
08881365,1,1,0,0,1,1,0,0,0
08881612,1,1,0,0,1,1,0,0,1
08881691,2,0,2,0,0,0,0,0,0
08882579,4,2,2,0,4,1,3,4,0
08883420,11,4,7,0,1,1,0,1,1
08883490,2,1,1,0,1,1,0,1,0
08883546,4,4,0,0,1,1,0,0,1
08884168,1,1,0,0,1,1,0,0,0
08884559,2,2,0,0,2,2,0,0,0
08885044,6,3,3,0,1,1,0,0,1
08885074,6,0,6,0,0,0,0,0,0
08885102,3,0,3,0,0,0,0,0,1
08885318,2,2,0,0,1,1,0,1,1
08885547,2,1,1,0,1,1,0,0,0
08885906,8,4,4,0,1,1,0,1,1
08885952,3,3,0,0,1,1,0,0,0
08886023,1,1,0,0,1,1,0,0,0
08886506,3,2,1,0,0,0,0,0,0
08887779,5,4,1,0,0,0,0,0,1
08888347,2,2,0,0,2,2,0,0,0
08889008,2,1,1,0,1,1,0,0,0
08889125,5,4,1,0,1,1,0,0,0
08889291,2,1,1,0,1,1,0,0,0
08889294,4,3,1,0,0,0,0,0,1
08890231,1,1,0,0,1,1,0,0,0
08890413,2,2,0,0,1,1,0,0,0
08890445,2,1,1,0,2,1,1,1,0
08891118,5,4,1,0,8,6,2,0,0
08891535,3,2,1,0,1,1,0,0,0
08891913,2,0,2,0,0,0,0,0,1
08892109,14,8,6,0,0,0,0,0,1
08892212,1,0,1,0,0,0,0,0,0
08892469,8,2,6,0,1,0,1,0,0
08892512,2,0,2,0,0,0,0,0,0
08892572,2,0,2,0,0,0,0,0,0
08892706,1,0,1,0,1,1,0,0,0
08893018,2,0,2,0,1,1,0,0,0
08893042,2,0,2,0,0,0,0,0,0
08893826,5,1,4,0,2,1,1,0,0
08893975,4,0,4,0,0,0,0,0,1
08894023,2,2,0,0,2,2,0,0,0
08894099,1,0,1,0,0,0,0,0,0
08894103,4,3,1,0,1,1,0,0,0
08894375,1,1,0,0,1,1,0,0,0
08894546,4,1,3,0,1,1,0,0,0
08894760,1,1,0,0,1,1,0,0,0
08894900,3,3,0,0,2,2,0,0,1
08895000,7,7,0,0,0,0,0,0,1
08895022,1,1,0,0,1,1,0,0,0
08895146,5,3,2,0,5,3,2,1,1
08895158,1,0,1,0,1,1,0,0,0
08895166,6,2,4,0,0,0,0,0,1
08895420,1,1,0,0,1,1,0,0,0
08895976,1,1,0,0,1,1,0,1,1
08896113,2,0,2,0,2,2,0,0,0
08896296,12,5,7,0,0,0,0,0,1
08897198,2,2,0,0,1,1,0,0,1
08898448,7,2,5,0,1,1,0,1,0
08898768,11,3,8,1,1,1,0,0,1
08898992,17,3,14,0,1,1,0,1,1
08899460,7,4,3,0,0,0,0,0,1
08899536,6,2,4,0,1,1,0,0,0
08899562,3,3,0,0,1,1,0,0,1
08899616,2,1,1,0,1,1,0,0,0
08899625,2,0,2,0,0,0,0,0,0
08899644,2,0,2,0,0,0,0,0,0
08899680,2,2,0,0,1,1,0,0,1
08899697,2,0,2,0,1,1,0,0,0
08899705,2,0,2,0,0,0,0,0,0
08899712,2,0,2,0,0,0,0,0,0
08899754,2,0,2,0,0,0,0,0,0
08900140,15,7,8,0,1,0,1,0,1
08900334,7,4,3,0,1,1,0,1,1
08900668,37,15,22,0,2,1,1,2,1
08900862,6,5,1,0,0,0,0,0,0
08900901,8,4,4,0,1,1,0,0,1
08900936,4,1,3,0,1,1,0,0,0
08901404,3,3,0,0,2,2,0,0,0
08901449,7,5,2,0,0,0,0,0,1
08901577,2,2,0,0,1,1,0,1,1
08902599,22,13,9,0,2,2,0,0,1
08902783,1,1,0,0,1,1,0,0,0
08902919,1,1,0,0,1,1,0,0,1
08903037,1,1,0,0,1,1,0,0,0
08903140,1,1,0,0,1,1,0,0,0
08903343,1,1,0,0,1,1,0,0,0
08903634,3,0,3,0,0,0,0,0,1
08903804,2,2,0,0,1,1,0,0,0
08903841,1,1,0,0,1,1,0,0,0
08904327,14,11,3,0,0,0,0,0,0
08904550,3,3,0,0,2,2,0,0,1
08904577,7,6,1,0,1,1,0,1,1
08904713,1,1,0,0,1,1,0,0,0
08904842,1,1,0,0,1,1,0,0,0
08905060,2,0,2,0,1,1,0,0,0
08905278,2,2,0,0,2,2,0,0,1
08905407,1,1,0,0,1,1,0,0,0
08905610,3,0,3,0,0,0,0,0,0
08905649,3,2,1,0,1,1,0,1,1
08905918,2,0,2,0,1,1,0,0,0
08905990,3,1,2,0,3,3,0,0,0
08906211,3,3,0,0,2,2,0,0,0
08906420,7,3,4,0,0,0,0,0,0
08906586,1,1,0,0,1,1,0,0,0
08906619,4,2,2,0,4,4,0,0,0
08906820,5,4,1,0,0,0,0,0,0
08906954,7,4,3,0,1,1,0,1,1
08906960,12,8,4,0,1,1,0,0,1
08907045,1,1,0,0,1,1,0,0,0
08907789,2,2,0,0,2,2,0,0,0
08908342,5,2,3,0,1,1,0,0,1
08908961,8,0,8,0,1,1,0,1,1
08908977,12,3,9,0,1,1,0,1,1
08908995,8,0,8,0,1,1,0,1,1
08908996,8,0,8,0,1,1,0,1,1
08909066,1,1,0,0,1,1,0,0,0
08909973,3,0,3,0,0,0,0,0,0
08910262,17,6,11,0,0,0,0,0,1
08910576,1,0,1,0,0,0,0,0,1
08910708,3,1,2,0,0,0,0,0,0
08910939,12,10,2,0,2,2,0,0,1
08911050,1,1,0,0,2,2,0,0,0
08911184,6,0,6,0,1,1,0,0,0
08911246,4,0,4,0,0,0,0,0,1
08911931,1,1,0,0,1,1,0,0,0
08912116,7,5,2,0,1,1,0,1,0
08912165,2,1,1,0,1,1,0,0,0
08912276,2,2,0,0,1,1,0,0,0
08912933,2,2,0,0,1,1,0,0,1
08913164,9,3,6,0,1,1,0,1,0
08913401,8,2,6,0,2,1,1,2,1
08913529,6,0,6,0,0,0,0,0,1
08913874,2,1,1,0,2,1,1,0,0
08914033,3,0,3,0,2,2,0,0,1
08915084,2,1,1,0,2,2,0,0,0
08915148,10,5,5,0,2,1,1,1,0
08915230,1,1,0,0,1,1,0,0,0
08915248,7,4,3,0,1,0,1,0,0
08915449,2,2,0,0,1,1,0,0,0
08915561,2,2,0,0,2,2,0,0,0
08915668,2,0,2,0,0,0,0,0,1
08915705,4,4,0,0,3,3,0,0,0
08915850,2,2,0,0,2,2,0,0,0
08916300,3,2,1,0,2,2,0,0,0
08916723,2,2,0,0,1,1,0,0,0
08916977,1,0,1,0,1,1,0,0,0
08917492,15,6,9,0,1,0,1,0,1
08917595,3,3,0,0,1,1,0,0,0
08917693,2,2,0,0,2,1,1,0,0
08917869,6,4,2,0,2,1,1,1,0
08918044,1,1,0,0,1,1,0,0,0
08918060,1,0,1,0,2,2,0,0,0
08918578,1,0,1,0,1,1,0,0,1
08918754,8,2,6,0,0,0,0,0,0
08918953,2,2,0,0,2,2,0,0,0
08919014,1,1,0,0,2,1,1,1,1
08919288,1,1,0,0,1,1,0,0,0
08919379,2,0,2,0,0,0,0,0,0
08919604,2,1,1,0,2,2,0,0,0
08919752,10,3,7,0,1,0,1,0,0
08919784,1,0,1,0,0,0,0,0,1
08920011,2,0,2,0,1,1,0,0,1
08920125,2,1,1,0,2,1,1,0,0
08920190,22,11,11,0,1,1,0,1,1
08920759,5,0,5,0,0,0,0,0,1
08920806,23,10,13,0,1,1,0,0,0
08921324,15,7,8,0,0,0,0,0,0
08922022,10,3,7,0,0,0,0,0,1
08922189,3,2,1,0,1,1,0,1,1
08922327,1,0,1,0,0,0,0,0,1
08922328,8,2,6,0,1,1,0,1,1
08922430,2,2,0,0,2,2,0,0,0
08922611,1,1,0,0,1,1,0,0,0
08923047,2,2,0,0,1,1,0,0,0
08923173,4,0,4,0,0,0,0,0,0
08923225,6,4,2,0,1,1,0,0,0
08923988,3,3,0,0,1,1,0,0,0
08924161,2,0,2,0,0,0,0,0,1
08924375,2,2,0,0,2,2,0,0,0
08924433,3,2,1,0,2,1,1,1,1
08924483,2,1,1,0,1,1,0,0,0
08924524,5,2,3,0,2,2,0,2,1
08924618,7,3,4,0,1,1,0,1,0
08924655,6,5,1,0,3,0,3,0,1
08924738,3,3,0,0,2,2,0,0,0
08924806,17,2,15,0,1,1,0,1,1
08924955,14,7,7,0,1,1,0,1,1
08925107,2,1,1,0,1,1,0,0,0
08925150,6,0,6,0,1,1,0,1,1
08925180,3,2,1,0,2,2,0,0,0
08925701,1,1,0,0,1,1,0,0,0
08925718,2,2,0,0,2,2,0,0,0
08925814,5,5,0,0,0,0,0,0,0
08925849,3,3,0,0,6,6,0,0,0
08925951,3,3,0,0,1,1,0,0,0
08925991,1,0,1,0,1,1,0,0,0
08925996,2,0,2,0,0,0,0,0,1
08926562,3,3,0,0,1,1,0,0,0
08926606,1,1,0,0,1,1,0,0,0
08926923,6,3,3,0,0,0,0,0,1
08926941,3,0,3,0,0,0,0,0,1
08927227,20,13,7,0,0,0,0,0,1
08927358,2,0,2,0,0,0,0,0,0
08927373,2,2,0,0,1,1,0,0,0
08927429,6,2,4,0,2,1,1,2,1
08927559,1,1,0,0,1,1,0,0,1
08927938,1,1,0,0,1,1,0,0,1
08928663,3,0,3,0,0,0,0,0,1
08928805,2,2,0,0,1,1,0,0,0
08928948,5,2,3,0,2,1,1,1,0
08928969,3,0,3,0,0,0,0,0,1
08928970,11,9,2,0,0,0,0,0,0
08928987,2,0,2,0,0,0,0,0,1
08928991,6,4,2,0,0,0,0,0,0
08928992,4,3,1,0,1,1,0,1,1
08928998,9,3,6,0,0,0,0,0,1
08929068,4,3,1,0,1,1,0,1,1
08929069,4,3,1,0,1,1,0,1,1
08929105,3,1,2,0,1,1,0,1,0
08929186,1,0,1,0,0,0,0,0,1
08929307,2,2,0,0,1,1,0,0,0
08929558,2,2,0,0,1,1,0,0,0
08929912,1,1,0,0,0,0,0,0,1
08930348,2,1,1,0,1,1,0,1,1
08930634,1,1,0,0,1,1,0,0,0
08931100,3,0,3,1,0,0,0,0,1
08931321,3,1,2,0,1,1,0,0,1
08931425,3,3,0,0,2,2,0,0,1
08931490,9,3,6,0,1,1,0,1,1
08931861,1,0,1,0,1,1,0,1,0
08932067,3,3,0,0,1,1,0,1,1
08932302,2,2,0,0,2,2,0,0,0
08932842,2,2,0,0,1,1,0,0,0
08933003,2,2,0,0,1,1,0,0,1
08933104,1,0,1,0,0,0,0,0,1
08933776,4,0,4,0,0,0,0,0,1
08933793,3,3,0,0,0,0,0,0,0
08933794,2,1,1,0,2,2,0,0,0
08933817,2,1,1,0,1,1,0,0,0
08933821,9,2,7,0,1,1,0,1,1
08933991,1,0,1,0,0,0,0,0,1
08934310,3,2,1,0,3,2,1,0,0
08934544,8,7,1,0,1,1,0,1,1
08934739,2,2,0,0,1,1,0,0,0
08934748,4,2,2,0,2,2,0,0,1
08935056,1,1,0,0,1,1,0,0,0
08935578,11,6,5,0,1,1,0,1,1
08935811,2,0,2,0,1,1,0,0,0
08935859,1,1,0,0,0,0,0,0,1
08935930,11,6,5,0,1,1,0,1,1
06516017,15,0,15,0,0,0,0,0,1
06516068,4,3,1,0,2,2,0,0,0
06516164,4,2,2,0,1,1,0,0,1
06516193,8,7,1,0,7,6,1,0,0
06516354,4,1,3,0,1,1,0,0,1
06516379,4,0,4,0,0,0,0,0,1
06516388,5,3,2,0,1,1,0,0,1
06516391,5,3,2,0,1,1,0,0,1
06516394,4,1,3,0,1,1,0,0,1
06516396,5,3,2,0,0,0,0,0,1
06516409,7,0,7,0,0,0,0,0,1
06516433,4,2,2,0,1,1,0,0,1
06516444,5,3,2,0,2,2,0,0,1
06516516,5,0,5,0,0,0,0,0,1
06516810,11,6,5,0,3,1,2,1,1
06516929,13,4,9,0,6,5,1,0,1
06516997,4,1,3,0,1,1,0,0,1
06517004,5,0,5,0,1,1,0,0,1
06517015,14,4,10,0,0,0,0,0,1
06517267,2,1,1,0,0,0,0,0,1
06517359,14,5,9,0,0,0,0,0,1
06517519,8,5,3,0,3,1,2,1,0
06517588,5,3,2,0,2,2,0,0,1
06517641,11,5,6,0,3,1,2,1,0
06517819,12,4,8,0,1,1,0,1,1
06518321,12,4,8,0,1,1,0,1,1
06518499,6,1,5,0,1,1,0,0,1
06518518,4,0,4,0,0,0,0,0,1
06518571,3,0,3,0,0,0,0,0,1
06518879,4,0,4,0,0,0,0,0,1
06519069,16,4,12,0,1,1,0,1,1
06519092,6,0,6,0,0,0,0,0,1
06519375,11,2,9,0,1,1,0,1,1
06519453,16,5,11,0,4,3,1,0,0
06519705,5,2,3,0,2,2,0,2,1
06519769,4,0,4,0,0,0,0,0,1
06520111,12,0,12,0,1,1,0,1,1
06520166,17,0,17,0,0,0,0,0,1
06520527,7,1,6,0,1,1,0,0,1
06521048,32,11,21,0,0,0,0,0,1
06521186,4,2,2,0,1,1,0,0,0
06521224,3,2,1,0,1,1,0,0,0
06521349,10,0,10,0,1,1,0,0,1
06521681,11,0,11,0,0,0,0,0,1
06521773,27,10,17,0,0,0,0,0,1
06521783,8,4,4,0,2,2,0,0,1
06521839,12,1,11,0,1,1,0,0,1
06521865,5,3,2,0,2,2,0,0,0
06522082,5,2,3,0,1,1,0,0,0
06522245,4,2,2,0,2,2,0,0,0
06522305,3,3,0,0,2,2,0,0,1
06522412,29,0,29,0,0,0,0,0,1
06522574,7,0,7,0,0,0,0,0,1
06522874,19,4,15,0,2,2,0,2,1
06522979,4,1,3,0,1,1,0,0,0
06522982,4,2,2,0,1,1,0,0,0
06523000,5,0,5,0,0,0,0,0,0
06523039,16,10,6,0,1,1,0,0,0
06523078,12,0,12,0,0,0,0,0,1
06523232,15,3,12,0,1,1,0,1,1
06523284,3,1,2,0,1,1,0,1,0
06523322,3,3,0,0,1,1,0,0,1
06523399,5,2,3,0,1,1,0,0,1
06523401,4,0,4,0,0,0,0,0,1
06523815,16,4,12,0,0,0,0,0,0
06523823,9,0,9,0,1,1,0,0,1
06524168,5,2,3,0,2,2,0,0,0
06524247,5,0,5,0,0,0,0,0,1
06524706,6,2,4,0,3,2,1,0,1
06524710,9,0,9,0,0,0,0,0,1
06524842,5,2,3,0,0,0,0,0,1
06524901,6,4,2,0,1,1,0,0,0
06525132,14,4,10,0,1,1,0,1,1
06525165,40,16,24,0,1,1,0,1,1
06525180,14,0,14,0,0,0,0,0,1
06525508,6,1,5,0,3,1,2,1,0
06525518,4,2,2,0,1,1,0,0,1
06525563,2,2,0,0,1,1,0,0,0
06525659,29,10,19,0,0,0,0,0,1
06526012,3,2,1,0,1,1,0,0,1
06526130,5,0,5,0,1,1,0,0,1
06526131,3,2,1,0,1,1,0,1,1
06526199,3,0,3,0,0,0,0,0,1
06526310,7,5,2,0,3,3,0,0,0
06526376,45,13,32,0,3,0,3,0,1
06526518,4,0,4,0,1,1,0,0,0
06526655,5,2,3,0,1,1,0,0,1
06526690,3,0,3,0,0,0,0,0,1
06526705,3,0,3,0,0,0,0,0,1
06526904,3,3,0,0,1,1,0,0,0
06527140,3,1,2,0,1,1,0,0,1
06527420,3,0,3,0,2,2,0,0,1
06527720,8,0,8,0,0,0,0,0,1
06527874,8,2,6,0,2,1,1,0,1
06527890,6,5,1,0,1,1,0,1,1
06527979,6,3,3,0,2,2,0,0,1
06528139,22,4,18,0,2,1,1,0,0
06528364,4,0,4,0,0,0,0,0,1
06528820,18,10,8,0,1,0,1,1,1
06528950,15,4,11,0,2,2,0,2,0
06529101,7,2,5,0,1,1,0,1,1
06529130,3,2,1,0,1,1,0,0,1
06529832,4,0,4,0,0,0,0,0,1
06530077,9,6,3,0,1,1,0,1,1
06530161,8,5,3,0,1,1,0,1,1
06530257,17,0,17,0,2,1,1,2,1
06530753,6,2,4,0,1,1,0,0,1
06530884,6,1,5,0,1,1,0,0,1
06530888,5,0,5,0,0,0,0,0,1
06530894,3,0,3,0,0,0,0,0,1
06531056,2,2,0,0,2,2,0,0,0
06531398,3,3,0,0,2,2,0,0,0
06531532,22,7,15,0,0,0,0,0,1
06531752,4,2,2,0,1,1,0,1,1
06531909,3,2,1,0,2,2,0,0,0
06532028,5,3,2,0,1,1,0,1,1
06532074,11,7,4,0,1,1,0,0,1
06532248,38,6,32,0,0,0,0,0,1
06532252,13,3,10,0,1,1,0,1,1
06532353,2,1,1,0,1,1,0,0,0
06532363,6,2,4,0,2,2,0,0,0
06532411,9,0,9,0,0,0,0,0,1
06532415,9,1,8,0,1,1,0,0,1
06532678,7,4,3,0,1,1,0,0,1
06532766,6,3,3,0,2,2,0,0,0
06532771,11,3,8,0,3,3,0,0,1
06532791,8,2,6,0,2,2,0,0,1
06532902,5,0,5,0,0,0,0,0,1
06533245,5,2,3,0,1,1,0,0,1
06533356,14,7,7,0,1,1,0,1,1
06533908,6,4,2,0,3,3,0,0,1
06533949,8,4,4,0,0,0,0,0,1
06534012,3,2,1,0,1,1,0,0,0
06534044,6,4,2,0,3,3,0,0,0
06534088,30,3,27,0,1,1,0,1,1
06534168,63,17,46,0,0,0,0,0,1
06534215,57,10,47,0,1,1,0,1,1
06534323,3,3,0,0,1,1,0,1,1
06534405,8,3,5,0,2,2,0,0,1
06534699,4,3,1,0,2,1,1,1,0
06534753,5,0,5,0,1,1,0,0,1
06535034,15,3,12,0,3,1,2,1,1
06535086,16,5,11,0,1,1,0,1,1
06535207,9,4,5,0,1,1,0,1,1
06535283,24,3,21,0,1,1,0,1,1
06535320,7,0,7,0,0,0,0,0,1
06535565,6,0,6,0,0,0,0,0,1
06535572,7,4,3,0,2,2,0,0,1
06535644,5,3,2,0,2,2,0,0,1
06535919,7,0,7,0,0,0,0,0,1
06535922,7,0,7,0,0,0,0,0,1
06536016,3,1,2,0,1,1,0,0,0
06536017,5,3,2,0,2,2,0,0,0
06536129,6,2,4,0,0,0,0,0,0
06536147,13,3,10,0,1,1,0,0,1
06536178,7,1,6,0,1,1,0,0,1
06536498,5,4,1,0,2,2,0,0,0
06536942,5,3,2,0,1,1,0,1,1
06536951,6,4,2,0,2,2,0,0,1
06536985,5,3,2,0,2,2,0,0,1
06537196,29,9,20,0,0,0,0,0,1
06537238,16,5,11,0,1,1,0,1,1
06537242,5,2,3,0,1,1,0,0,1
06537462,3,3,0,0,1,1,0,0,0
06537479,20,4,16,0,2,2,0,2,1
06537492,2,2,0,0,2,2,0,0,0
06537639,3,3,0,0,2,2,0,0,0
06537641,4,0,4,0,1,1,0,0,1
06537642,5,0,5,0,0,0,0,0,1
06537654,4,0,4,0,0,0,0,0,1
06537657,5,3,2,0,2,2,0,0,1
06537730,18,6,12,0,1,1,0,1,1
06537745,4,0,4,0,0,0,0,0,1
06537828,24,8,16,0,0,0,0,0,0
06537837,3,1,2,0,2,2,0,0,1
06537845,5,3,2,0,2,2,0,0,1
06537852,4,0,4,0,0,0,0,0,1
06537855,7,0,7,0,0,0,0,0,1
06537912,6,2,4,0,2,2,0,0,0
06537977,4,2,2,0,1,1,0,0,1
06537980,7,2,5,0,1,1,0,0,1
06538054,25,0,25,0,1,1,0,1,1
06538265,5,2,3,0,1,1,0,0,0
06538277,2,1,1,0,1,1,0,0,1
06538309,10,3,7,0,2,1,1,1,1
06538359,14,4,10,0,1,1,0,1,0
06538371,5,2,3,0,1,1,0,0,1
06538388,4,0,4,0,0,0,0,0,1
06538403,5,3,2,0,2,2,0,0,1
06538534,5,5,0,0,0,0,0,0,1
06538705,6,3,3,0,2,2,0,0,1
06538909,18,4,14,0,2,2,0,2,1
06539276,5,4,1,0,2,2,0,0,0
06539428,19,4,15,0,2,2,0,0,1
06539479,17,3,14,0,0,0,0,0,0
06539520,24,3,21,0,1,1,0,1,1
06539528,27,3,24,0,1,1,0,1,1
06540163,10,6,4,0,1,1,0,1,1
06540431,3,3,0,0,2,2,0,0,0
06540775,5,0,5,0,0,0,0,0,1
06540797,6,1,5,0,1,1,0,1,1
06540835,12,5,7,0,0,0,0,0,1
06540859,13,5,8,0,0,0,0,0,0
06540873,5,3,2,0,2,2,0,0,1
06540884,3,0,3,0,0,0,0,0,1
06541091,50,19,31,0,1,1,0,1,1
06541094,26,5,21,0,3,1,2,2,0
06541239,6,3,3,0,2,2,0,0,1
06541622,16,0,16,0,0,0,0,0,1
06541634,5,0,5,0,0,0,0,0,0
06542210,7,5,2,0,2,2,0,0,0
06542500,2,2,0,0,3,3,0,0,1
06542626,9,0,9,0,0,0,0,0,1
06543150,45,10,35,0,1,1,0,0,1
06543262,5,3,2,0,1,1,0,0,0
06543374,4,0,4,0,0,0,0,0,1
06543682,39,16,23,0,0,0,0,0,1
06543990,5,2,3,0,1,1,0,0,1
06544330,5,3,2,0,1,1,0,0,1
06544557,4,3,1,0,2,2,0,0,1
06544827,8,0,8,0,0,0,0,0,1
06545027,5,0,5,0,0,0,0,0,1
06545357,65,16,49,0,0,0,0,0,0
06545556,20,3,17,0,2,1,1,1,1
06545839,16,3,13,0,2,2,0,2,1
06545882,17,4,13,0,2,2,0,2,1
06546334,11,0,11,0,0,0,0,0,1
06546443,5,2,3,0,1,1,0,0,0
06546556,2,1,1,0,1,1,0,0,1
06546908,5,2,3,0,3,3,0,0,0
06546965,10,7,3,0,0,0,0,0,0
09514346,6,2,4,0,1,1,0,1,1
09514544,1,1,0,0,1,1,0,0,0
09514575,1,1,0,0,2,2,0,1,0
09514819,4,4,0,0,2,2,0,1,1
09515008,2,0,2,0,2,2,0,0,0
09515473,2,1,1,0,1,1,0,0,0
09515513,6,4,2,0,1,1,0,1,1
09515570,3,2,1,0,1,1,0,0,0
09515638,16,3,13,0,1,1,0,1,1
09515707,1,0,1,0,0,0,0,0,0
09515813,8,3,5,0,0,0,0,0,0
09515886,5,4,1,0,1,1,0,0,0
09515983,2,2,0,0,2,2,0,0,1
09516086,2,2,0,0,2,1,1,0,0
09516341,6,3,3,0,0,0,0,0,0
09516380,5,5,0,0,0,0,0,0,0
09516704,14,0,14,0,0,0,0,0,0
09516931,1,0,1,0,0,0,0,0,0
09517734,2,0,2,0,1,1,0,0,1
09517773,2,2,0,0,1,1,0,0,0
09517834,3,2,1,0,1,1,0,0,1
09517848,7,5,2,0,1,1,0,0,1
09518098,4,4,0,0,1,1,0,1,0
09518275,1,1,0,0,1,1,0,0,0
09518289,1,1,0,0,1,1,0,0,0
09518294,1,1,0,0,1,1,0,0,0
09518320,2,2,0,0,2,2,0,0,0
09518338,4,3,1,0,1,1,0,0,1
09518345,3,3,0,0,4,3,1,0,0
09518593,2,1,1,0,1,1,0,0,0
09518768,4,3,1,0,1,1,0,0,0
09518813,3,3,0,0,1,1,0,0,0
09518922,1,1,0,0,1,1,0,0,1
09519028,2,2,0,0,2,2,0,0,0
09519032,3,0,3,0,0,0,0,0,1
09519036,1,0,1,0,0,0,0,0,0
09519056,32,17,15,0,0,0,0,0,1
09519911,1,1,0,0,1,1,0,0,0
09519950,4,2,2,0,3,2,1,0,0
09520414,2,2,0,0,1,1,0,0,1
09520700,4,4,0,0,1,1,0,0,1
09520783,2,0,2,0,1,1,0,0,0
09520999,3,0,3,0,0,0,0,0,1
09521075,1,0,1,0,0,0,0,0,1
09521123,1,0,1,0,0,0,0,0,1
09521190,2,2,0,0,1,1,0,0,0
09521351,1,0,1,0,0,0,0,0,1
09521415,1,0,1,0,0,0,0,0,1
09521428,1,0,1,0,0,0,0,0,1
09521430,1,0,1,0,0,0,0,0,1
09521442,1,0,1,0,0,0,0,0,1
09521449,1,0,1,0,0,0,0,0,1
09521495,1,0,1,0,0,0,0,0,1
09521501,1,0,1,0,0,0,0,0,1
09521553,1,0,1,0,0,0,0,0,1
09521557,1,0,1,0,0,0,0,0,1
09521558,1,0,1,0,0,0,0,0,1
09521592,1,0,1,0,0,0,0,0,1
09521621,2,2,0,0,2,2,0,0,0
09521622,1,0,1,0,0,0,0,0,1
09521625,1,0,1,0,0,0,0,0,1
09521808,2,0,2,0,0,0,0,0,1
09521883,1,0,1,0,0,0,0,0,1
09521936,1,0,1,0,0,0,0,0,1
09521954,1,0,1,0,0,0,0,0,1
09521993,1,0,1,0,0,0,0,0,1
09522036,2,1,1,0,1,1,0,1,1
09522199,3,2,1,0,2,2,0,2,1
09522225,3,2,1,0,2,2,0,2,1
09522235,5,2,3,0,2,2,0,2,1
09522282,5,2,3,0,2,2,0,2,1
09522292,3,2,1,0,2,2,0,2,1
09522451,2,2,0,0,1,1,0,0,1
09522653,2,1,1,0,1,1,0,0,0
09522719,1,1,0,0,2,2,0,0,0
09523127,2,2,0,0,2,2,0,0,0
09523153,2,1,1,0,1,1,0,0,0
09523187,8,3,5,0,2,2,0,0,1
09523268,6,3,3,0,2,2,0,0,1
09523606,2,1,1,0,1,1,0,0,0
09523744,11,1,10,0,6,1,5,0,0
09524232,2,0,2,0,1,1,0,0,1
09524321,2,2,0,0,2,2,0,0,0
09524466,6,3,3,0,1,1,0,0,0
09524553,1,1,0,0,1,1,0,0,0
09524602,3,2,1,0,1,1,0,0,0
09524799,9,1,8,0,3,1,2,0,0
09524884,7,2,5,0,1,1,0,1,1
09525278,2,2,0,0,1,1,0,0,0
09525376,7,2,5,0,1,1,0,1,1
09525607,2,2,0,0,1,1,0,0,0
09525853,2,2,0,0,2,2,0,0,0
09526267,2,2,0,0,2,2,0,0,1
09527461,1,1,0,0,1,1,0,0,0
09527882,1,1,0,0,1,1,0,0,1
09527975,3,3,0,0,0,0,0,0,1
09528357,1,1,0,0,1,1,0,0,0
09530088,1,0,1,0,0,0,0,0,0
09530198,1,1,0,0,1,1,0,0,0
09530433,2,2,0,0,0,0,0,0,1
09530603,2,2,0,0,2,2,0,0,1
09530764,2,2,0,0,1,1,0,1,1
09531213,10,6,4,0,2,1,1,1,1
09531333,7,5,2,0,0,0,0,0,0
09532118,1,0,1,0,1,1,0,0,1
09532928,3,0,3,0,2,2,0,0,0
09533107,5,2,3,0,0,0,0,0,0
09533323,2,2,0,0,0,0,0,0,0
09533744,1,1,0,0,1,1,0,0,0
09534613,2,2,0,0,1,1,0,0,1
09534793,2,1,1,0,1,1,0,0,1
09534943,1,1,0,0,1,1,0,0,0
09535104,2,2,0,0,2,2,0,0,0
09535447,3,0,3,0,3,3,0,0,0
09536311,9,3,6,0,1,1,0,1,1
09536321,9,3,6,0,1,1,0,1,1
09536353,9,3,6,0,1,1,0,1,1
09536358,9,3,6,0,1,1,0,1,1
09536363,9,3,6,0,1,1,0,1,1
09536377,9,3,6,0,1,1,0,1,1
09536385,9,3,6,0,1,1,0,1,1
09536397,9,3,6,0,1,1,0,1,1
09536403,9,3,6,0,1,1,0,1,1
09536422,3,2,1,0,1,1,0,0,0
09536430,9,3,6,0,1,1,0,1,1
09536436,10,4,6,0,1,1,0,1,1
09536443,9,3,6,0,1,1,0,1,1
09536456,9,3,6,0,1,1,0,1,1
09537222,1,1,0,0,1,1,0,0,0
09537905,2,1,1,0,2,2,0,0,0
09538165,3,0,3,0,0,0,0,0,1
09538369,3,3,0,0,2,2,0,0,0
09539644,1,1,0,0,1,1,0,0,0
09539852,2,2,0,0,1,1,0,0,0
09540176,1,1,0,0,1,1,0,0,1
09540340,3,2,1,0,1,1,0,0,1
09540439,2,2,0,0,2,2,0,0,0
09540661,2,0,2,0,0,0,0,0,1
09540688,1,1,0,0,1,1,0,0,0
09540926,14,8,6,0,1,1,0,0,1
09540960,2,2,0,0,2,2,0,0,0
09541143,1,0,1,0,1,1,0,0,0
09541366,10,0,10,0,3,1,2,0,0
09541462,1,1,0,0,1,1,0,0,1
09541849,2,2,0,0,4,4,0,1,0
09542163,3,2,1,0,1,1,0,1,1
09542177,3,2,1,0,1,1,0,0,1
09542202,7,4,3,0,0,0,0,0,1
09542332,1,1,0,0,1,1,0,0,0
09542812,1,1,0,0,1,1,0,0,0
09543124,2,1,1,0,0,0,0,0,1
09543266,5,3,2,0,1,1,0,1,1
09543433,2,0,2,0,0,0,0,0,0
09543609,10,1,9,0,7,1,6,0,0
09543825,3,3,0,0,3,3,0,0,1
09544220,1,1,0,0,1,1,0,0,0
09544465,2,0,2,0,0,0,0,0,1
09545340,1,0,1,0,1,1,0,0,0
09545485,3,0,3,0,0,0,0,0,0
09545550,7,1,6,0,4,1,3,0,0
09545556,7,0,7,0,3,1,2,0,0
09545599,8,0,8,0,2,1,1,0,0
09545668,3,1,2,0,1,1,0,1,0
09545765,1,0,1,0,0,0,0,0,0
09545881,2,2,0,0,2,2,0,0,0
09546006,1,1,0,0,2,1,1,0,0
09546154,6,0,6,0,2,1,1,0,0
09547555,9,1,8,0,5,1,4,0,0
09547558,1,1,0,0,1,1,0,0,0
09547595,12,1,11,0,6,1,5,0,0
09547670,6,4,2,0,0,0,0,0,1
09548532,2,2,0,0,1,1,0,0,0
09548669,5,2,3,0,2,2,0,0,0
09548839,6,0,6,0,0,0,0,0,1
09548843,11,3,8,0,7,2,5,0,0
09548970,7,1,6,0,4,1,3,0,0
09549087,5,2,3,0,0,0,0,0,1
09549187,4,0,4,0,3,3,0,0,1
09549317,5,0,5,0,0,0,0,0,0
09549322,2,1,1,0,2,2,0,0,0
09549813,10,1,9,0,6,1,5,0,0
09549870,8,1,7,0,5,1,4,0,0
09549900,7,1,6,0,3,1,2,0,0
09550181,11,1,10,0,6,1,5,0,0
09550194,8,1,7,0,5,1,4,0,0
09550202,6,0,6,0,2,1,1,0,0
09551503,1,1,0,0,1,1,0,0,0
09551510,2,2,0,0,2,2,0,0,0
09551554,2,2,0,0,1,1,0,0,1
09551782,4,3,1,0,1,1,0,1,0
09551787,4,0,4,0,1,1,0,0,1
09551826,2,0,2,0,0,0,0,0,0
09551959,2,0,2,0,0,0,0,0,0
09552311,8,2,6,0,3,2,1,1,1
09552707,1,1,0,0,1,1,0,0,0
09552912,5,0,5,0,2,1,1,0,1
09553051,1,1,0,0,1,1,0,0,0
09553229,5,0,5,0,2,1,1,0,1
09553236,5,0,5,0,2,1,1,0,1
09553437,7,5,2,0,1,1,0,0,1
09553473,13,10,3,0,0,0,0,0,1
09553892,3,0,3,0,0,0,0,0,0
09553952,2,1,1,0,1,1,0,0,1
09554165,1,0,1,0,1,1,0,0,1
09554308,5,0,5,0,2,1,1,0,1
09554846,2,1,1,0,1,1,0,0,1
09555016,6,3,3,0,0,0,0,0,0
09555388,3,2,1,0,4,4,0,0,0
09555436,1,0,1,0,0,0,0,0,0
09555468,5,4,1,0,1,1,0,1,1
09555613,2,1,1,0,0,0,0,0,0
09555781,1,0,1,0,1,1,0,0,1
09556008,1,1,0,0,1,1,0,0,0
09556104,3,0,3,0,2,1,1,0,1
09556546,2,2,0,0,0,0,0,0,0
09557117,11,7,4,0,2,2,0,1,1
09557142,3,2,1,0,1,1,0,0,1
09557334,2,1,1,0,1,1,0,0,0
09557832,11,7,4,0,1,1,0,1,1
09558788,1,0,1,0,0,0,0,0,0
09558823,5,0,5,0,2,2,0,0,1
09559096,2,1,1,0,1,1,0,0,0
09559332,2,1,1,0,2,2,0,0,1
09559344,2,1,1,0,1,1,0,0,1
09559394,1,1,0,0,1,1,0,0,0
09559419,3,0,3,0,0,0,0,0,1
09559440,2,1,1,0,1,1,0,0,1
08464005,2,2,0,0,2,2,0,0,0
08464265,1,1,0,0,1,1,0,0,0
08464432,3,0,3,0,3,3,0,1,1
08464581,5,5,0,0,2,2,0,0,1
08464800,6,4,2,0,1,1,0,1,0
08464862,9,4,5,0,4,3,1,0,1
08464977,2,2,0,0,2,2,0,0,0
08465383,3,3,0,0,2,2,0,0,0
08465498,2,2,0,0,2,2,0,0,0
08465762,1,1,0,0,2,2,0,0,1
08465928,2,0,2,0,0,0,0,0,1
08466138,2,1,1,0,1,1,0,0,0
08466626,3,2,1,0,0,0,0,0,0
08466974,3,2,1,0,3,2,1,0,1
08467215,1,0,1,0,0,0,0,0,1
08467638,1,1,0,0,0,0,0,0,0
08467789,2,0,2,0,0,0,0,0,1
08468055,1,1,0,0,1,1,0,0,1
08468060,2,2,0,0,2,2,0,0,0
08468279,2,2,0,0,2,2,0,0,1
08469283,1,1,0,0,1,1,0,0,0
08469422,2,0,2,0,0,0,0,0,1
08469661,2,0,2,0,0,0,0,0,1
08469821,2,0,2,0,0,0,0,0,1
08469887,3,0,3,0,0,0,0,0,1
08470150,4,3,1,0,2,2,0,1,1
08470255,16,11,5,0,1,1,0,1,1
08470328,1,0,1,0,0,0,0,0,1
08470605,6,0,6,0,0,0,0,0,1
08471200,2,0,2,0,0,0,0,0,0
08471222,2,2,0,0,2,2,0,0,1
08471677,2,2,0,0,1,1,0,0,0
08471992,2,0,2,0,0,0,0,0,1
08472025,11,2,9,0,2,2,0,0,0
08472216,15,6,9,0,1,1,0,1,1
08472266,3,2,1,0,2,2,0,0,0
08472296,1,0,1,0,1,1,0,0,0
08472732,4,4,0,0,1,1,0,0,1
08473129,2,2,0,0,2,2,0,2,1
08474038,1,0,1,0,0,0,0,0,0
08474076,1,1,0,0,1,1,0,0,1
08474083,24,10,14,0,0,0,0,0,1
08474231,8,0,8,0,0,0,0,0,1
08474243,7,1,6,0,1,1,0,0,1
08474512,8,0,8,0,0,0,0,0,1
08474849,1,1,0,0,1,1,0,1,0
08475348,2,2,0,0,2,2,0,0,0
08475552,1,1,0,0,1,1,0,0,0
08475693,8,4,4,0,2,1,1,2,1
08475750,9,4,5,0,1,1,0,1,1
08475916,57,10,47,0,0,0,0,0,1
08476476,1,0,1,0,0,0,0,0,1
08476782,1,0,1,0,0,0,0,0,0
08477265,3,0,3,0,0,0,0,0,0
08477278,2,0,2,0,0,0,0,0,1
08477436,6,4,2,0,0,0,0,0,1
08477940,3,3,0,0,2,2,0,0,0
08478180,1,0,1,0,0,0,0,0,0
08478678,1,1,0,0,1,1,0,0,0
08478767,2,0,2,0,1,1,0,0,0
08478985,18,5,13,0,1,1,0,1,1
08479033,12,2,10,0,1,1,0,1,1
08479228,2,2,0,0,2,2,0,0,0
08479420,6,3,3,0,1,1,0,0,1
08480430,2,0,2,0,0,0,0,0,0
08480567,1,1,0,0,0,0,0,0,1
08480724,12,7,5,0,0,0,0,0,1
08481020,4,0,4,0,0,0,0,0,1
08481595,2,0,2,0,0,0,0,0,1
08482276,3,3,0,0,2,2,0,0,1
08483386,2,0,2,0,1,1,0,0,0
08483535,3,3,0,0,2,2,0,0,1
08483629,3,3,0,0,3,3,0,0,0
08483768,36,15,21,0,4,4,0,1,0
08484299,2,1,1,0,1,1,0,0,0
08484599,15,5,10,1,1,1,0,1,1
08484707,1,1,0,0,1,1,0,0,0
08485163,2,2,0,0,1,1,0,0,0
08485281,1,0,1,0,0,0,0,0,1
08485586,2,2,0,0,1,1,0,0,1
08486144,2,0,2,0,2,2,0,0,0
08486225,4,0,4,0,0,0,0,0,1
08486285,2,1,1,0,2,1,1,0,0
08486509,14,8,6,0,1,1,0,1,1
08486553,14,6,8,0,1,1,0,1,1
08486606,11,3,8,0,1,1,0,1,1
08486652,11,3,8,0,1,1,0,1,1
08486720,12,3,9,0,1,1,0,1,1
08486935,5,2,3,0,0,0,0,0,1
08486960,3,3,0,0,1,1,0,0,0
08487950,2,2,0,0,1,1,0,1,1
08487954,1,1,0,0,1,1,0,0,0
08488730,2,2,0,0,2,2,0,0,0
08488993,4,0,4,0,1,1,0,0,0
08489085,4,2,2,0,1,1,0,0,1
08489132,8,2,6,0,1,1,0,1,1
08489220,2,2,0,0,2,2,0,0,0
08489743,3,3,0,0,2,2,0,0,0
08489934,1,1,0,0,1,1,0,0,0
08489974,8,5,3,0,0,0,0,0,0
08490068,1,1,0,0,1,1,0,0,0
08490611,1,1,0,0,1,1,0,0,0
08490730,6,3,3,0,2,2,0,0,0
08491061,73,27,46,0,1,1,0,1,1
08491307,1,1,0,0,1,1,0,0,0
08491453,9,3,6,0,2,1,1,0,1
08491683,2,0,2,0,0,0,0,0,0
08491718,8,1,7,0,2,1,1,1,1
08492451,6,2,4,0,1,1,0,1,0
08492457,3,1,2,0,0,0,0,0,0
08492459,6,3,3,0,3,1,2,1,1
08492505,1,0,1,0,0,0,0,0,1
08492625,1,0,1,0,0,0,0,0,1
08492669,1,1,0,0,1,1,0,0,0
08492961,8,0,8,0,0,0,0,0,1
08493006,4,0,4,0,0,0,0,0,0
08493072,12,7,5,0,1,1,0,1,1
08493195,5,3,2,0,1,1,0,0,0
08493508,1,0,1,0,0,0,0,0,0
08493685,4,2,2,0,1,1,0,0,0
08493946,2,2,0,0,2,2,0,0,0
08494309,2,2,0,0,2,2,0,0,0
08494448,3,2,1,0,1,1,0,0,1
08494524,4,0,4,0,0,0,0,0,1
08494660,1,1,0,0,1,1,0,0,0
08494679,5,1,4,0,1,1,0,1,1
08495358,14,5,9,0,1,1,0,1,1
08495394,8,5,3,0,4,4,0,0,0
08495641,2,1,1,0,1,1,0,0,0
08495673,10,7,3,0,2,2,0,0,1
08495833,2,1,1,0,1,1,0,0,0
08496640,3,2,1,0,1,1,0,1,1
08497033,11,4,7,0,0,0,0,0,1
08497337,13,7,6,0,0,0,0,0,1
08497554,9,5,4,0,0,0,0,0,1
08497586,2,0,2,0,0,0,0,0,1
08498153,4,0,4,0,0,0,0,0,0
08498466,1,1,0,0,1,1,0,0,0
08498690,2,0,2,0,0,0,0,0,1
08498910,3,2,1,0,0,0,0,0,0
08499179,7,2,5,0,3,1,2,3,1
08499273,5,3,2,0,1,1,0,1,1
08499309,2,0,2,0,0,0,0,0,0
08499337,1,1,0,0,1,1,0,1,0
08499736,3,2,1,0,1,1,0,0,0
08499746,3,2,1,0,1,1,0,0,0
08499813,1,0,1,0,0,0,0,0,1
08500060,2,2,0,0,1,1,0,1,1
08500308,1,1,0,0,1,1,0,0,0
08500420,3,0,3,0,0,0,0,0,1
08500793,1,1,0,0,1,1,0,0,0
08500814,22,2,20,0,2,1,1,2,1
08500815,16,5,11,0,1,1,0,1,1
08500914,21,12,9,0,0,0,0,0,1
08501272,2,1,1,0,1,1,0,0,0
08501464,4,3,1,0,0,0,0,0,1
08501756,2,2,0,0,2,2,0,0,1
08501860,2,2,0,0,1,1,0,1,0
08501894,4,0,4,0,0,0,0,0,1
08502070,1,1,0,0,1,1,0,0,0
08502772,1,0,1,0,0,0,0,0,0
08502871,2,0,2,0,1,1,0,0,0
08502956,6,2,4,0,2,1,1,2,1
08503469,1,1,0,0,1,1,0,0,0
08504055,2,0,2,0,0,0,0,0,1
08504152,10,3,7,0,1,1,0,1,1
08504199,2,1,1,0,1,1,0,0,0
08504375,6,1,5,0,1,1,0,0,0
08504835,6,4,2,0,1,1,0,1,1
08504916,8,4,4,0,1,1,0,1,1
08504938,1,1,0,0,1,1,0,0,0
08505206,2,2,0,0,2,2,0,0,0
08505241,3,0,3,0,0,0,0,0,0
08505479,2,2,0,0,2,2,0,0,0
08505582,2,2,0,0,2,2,0,0,0
08505593,1,1,0,0,0,0,0,0,0
08505599,1,1,0,0,1,1,0,0,0
08505956,1,0,1,0,0,0,0,0,0
08506088,5,3,2,0,1,1,0,0,0
08506143,2,2,0,0,2,2,0,0,0
08506217,6,3,3,0,0,0,0,0,0
08506752,1,1,0,0,1,1,0,0,0
08506877,19,4,15,0,1,1,0,1,1
08507003,6,1,5,0,1,1,0,0,0
08507008,2,0,2,0,1,1,0,0,0
08507269,2,0,2,0,1,1,0,0,0
08507491,1,1,0,0,1,1,0,0,0
08507702,9,5,4,0,0,0,0,0,1
08508525,1,0,1,0,1,1,0,0,0
08508650,4,3,1,0,1,1,0,0,1
08508988,4,0,4,0,0,0,0,0,1
08509179,5,3,2,0,0,0,0,0,0
08509406,2,1,1,0,1,1,0,0,0
08509488,1,1,0,0,1,1,0,1,0
08509511,1,1,0,0,1,1,0,1,0
08509512,1,1,0,0,1,1,0,1,0
08509600,1,1,0,0,1,1,0,1,0
08509710,13,9,4,0,6,6,0,3,1
08509799,3,3,0,0,2,2,0,0,1
08510088,2,2,0,0,1,1,0,0,0
08510241,1,1,0,0,1,1,0,0,0
08510790,2,0,2,0,0,0,0,0,1
08510857,11,5,6,0,3,3,0,0,0
08510940,10,6,4,0,0,0,0,0,1
08511293,2,2,0,0,2,2,0,0,0
08511344,9,2,7,0,3,1,2,0,0
08511390,2,0,2,0,1,1,0,0,0
08511621,4,3,1,0,3,3,0,0,1
08512066,8,0,8,0,0,0,0,0,1
08512074,6,5,1,0,1,1,0,1,0
08512691,5,3,2,0,1,1,0,1,1
08512852,3,0,3,0,0,0,0,0,1
08513032,2,0,2,0,0,0,0,0,0
08513040,7,5,2,0,1,1,0,1,1
08513395,1,1,0,0,1,1,0,0,0
08513509,5,2,3,0,2,2,0,0,1
08513613,2,0,2,0,0,0,0,0,1
08514010,3,3,0,0,1,1,0,1,1
08514014,2,1,1,0,1,1,0,0,0
08514281,1,1,0,0,1,1,0,0,0
08514334,2,0,2,0,1,1,0,0,0
08514489,1,0,1,0,0,0,0,0,0
08514550,3,2,1,0,1,1,0,0,0
08514906,18,8,10,0,0,0,0,0,1
08514974,3,3,0,0,3,3,0,0,0
08515082,1,1,0,0,1,1,0,0,0
08515335,3,2,1,0,2,2,0,0,1
08515605,3,2,1,0,1,1,0,0,0
08515648,3,1,2,0,1,1,0,0,0
08516221,10,3,7,0,1,1,0,0,0
08516363,3,0,3,0,1,1,0,0,1
08516986,14,3,11,0,2,2,0,2,1
08517174,1,0,1,0,0,0,0,0,1
08517189,13,7,6,0,0,0,0,0,1
08517200,3,2,1,0,2,2,0,0,1
08517742,2,2,0,0,1,1,0,0,0
08518287,1,1,0,0,1,1,0,0,0
08518636,2,1,1,0,1,1,0,0,1
08518650,2,2,0,0,1,1,0,0,0
08520575,9,6,3,0,0,0,0,0,1
08520729,1,1,0,0,1,1,0,1,0
08521487,2,2,0,0,2,2,0,0,0
08521753,6,0,6,0,0,0,0,0,1
08522007,6,4,2,0,1,1,0,0,1
08522243,2,0,2,0,0,0,0,0,1
08522250,2,0,2,0,0,0,0,0,1
08522781,2,1,1,0,1,1,0,0,0
08522792,1,1,0,0,1,1,0,0,0
08522983,2,2,0,0,2,2,0,0,1
08523519,2,0,2,0,2,2,0,0,0
08524082,8,4,4,0,3,1,2,1,0
08524134,9,8,1,0,0,0,0,0,1
08524233,5,0,5,0,0,0,0,0,1
08524245,12,8,4,0,0,0,0,0,1
08524264,7,3,4,0,2,2,0,0,1
08524330,9,8,1,0,0,0,0,0,1
08524411,2,2,0,0,2,2,0,0,0
08524437,1,1,0,0,1,1,0,0,0
08524507,5,0,5,0,0,0,0,0,1
08524590,9,8,1,0,0,0,0,0,1
08524643,3,3,0,0,2,2,0,0,0
08524671,8,0,8,0,1,1,0,1,1
08524698,10,5,5,0,2,1,1,0,1
08524995,3,1,2,0,1,1,0,1,1
08525130,2,2,0,0,1,1,0,0,1
08525604,6,1,5,0,1,1,0,0,0
08526107,10,6,4,0,3,2,1,0,1
08526578,10,0,10,0,0,0,0,0,1
08526899,2,2,0,0,0,0,0,0,0
08526973,14,9,5,0,1,1,0,1,1
08527187,3,2,1,0,2,2,0,0,0
08527316,11,4,7,0,0,0,0,0,1
08527536,3,2,1,0,0,0,0,0,0
08527771,18,0,18,0,0,0,0,0,1
08528473,7,3,4,0,1,0,1,1,1
08528475,8,5,3,0,1,1,0,1,0
08528749,3,1,2,0,1,1,0,0,0
08529099,13,8,5,0,1,1,0,0,0
08529446,8,2,6,0,1,1,0,1,1
08529662,1,1,0,0,1,1,0,0,1
07835121,2,0,2,0,0,0,0,0,0
07835237,3,3,0,0,1,1,0,0,1
07835530,1,0,1,0,0,0,0,0,0
07835615,2,2,0,0,1,1,0,0,0
07835629,2,0,2,0,1,1,0,0,0
07835682,7,2,5,0,1,1,0,1,0
07836045,6,6,0,0,4,4,0,0,0
07836678,1,0,1,0,0,0,0,0,0
07836727,10,9,1,0,0,0,0,0,1
07836732,4,4,0,0,3,3,0,0,1
07836785,2,0,2,0,0,0,0,0,0
07837580,6,5,1,0,0,0,0,0,0
07837894,4,1,3,0,1,1,0,0,0
07838143,6,6,0,0,0,0,0,0,0
07839006,2,2,0,0,2,2,0,0,1
07839011,2,0,2,0,0,0,0,0,0
07839121,5,3,2,0,3,3,0,0,0
07839268,4,4,0,0,1,1,0,0,1
07839399,3,0,3,0,0,0,0,0,1
07839504,10,2,8,0,2,1,1,0,0
07839619,12,9,3,0,0,0,0,0,0
07840514,3,1,2,0,1,1,0,0,0
07841013,2,0,2,0,0,0,0,0,1
07841067,4,0,4,0,1,1,0,1,1
07841161,7,3,4,0,0,0,0,0,0
07841200,4,0,4,0,0,0,0,0,0
07841257,1,0,1,0,0,0,0,0,1
07841273,2,2,0,0,1,1,0,0,1
07841690,3,0,3,0,0,0,0,0,0
07841693,2,1,1,0,1,1,0,0,0
07841736,10,4,6,0,1,1,0,1,1
07841788,16,0,16,0,2,1,1,1,1
07841836,10,4,6,0,1,1,0,1,1
07841898,2,1,1,0,1,1,0,0,0
07842257,3,0,3,0,0,0,0,0,1
07842519,1,1,0,0,1,1,0,0,0
07842673,2,2,0,0,1,1,0,0,1
07842885,3,2,1,0,2,1,1,0,1
07843166,25,13,12,0,0,0,0,0,1
07843253,1,1,0,0,1,1,0,0,0
07843542,3,0,3,0,0,0,0,0,1
07843718,2,1,1,0,1,1,0,0,0
07844208,3,3,0,0,2,2,0,0,0
07844675,9,0,9,0,0,0,0,0,1
07844680,2,2,0,0,0,0,0,0,0
07844696,4,0,4,0,0,0,0,0,1
07844774,2,0,2,0,0,0,0,0,1
07844852,5,3,2,0,1,1,0,1,1
07845227,2,1,1,0,2,2,0,0,0
07845406,4,2,2,0,1,1,0,1,0
07845675,34,13,21,0,1,1,0,0,0
07845683,1,1,0,0,1,1,0,0,0
07845950,11,9,2,0,0,0,0,0,1
07846388,2,0,2,0,0,0,0,0,1
07846443,5,2,3,0,3,2,1,3,1
07846473,1,1,0,0,0,0,0,0,0
07846746,2,2,0,0,1,1,0,0,1
07846779,14,7,7,0,0,0,0,0,1
07846911,4,3,1,0,1,1,0,0,1
07847144,1,0,1,0,0,0,0,0,1
07847253,2,2,0,0,1,1,0,0,0
07847436,8,8,0,0,0,0,0,0,1
07848163,11,7,4,0,0,0,0,0,1
07848338,43,16,27,0,4,3,1,0,1
07848384,2,0,2,0,0,0,0,0,1
07848388,2,0,2,0,0,0,0,0,1
07848467,1,0,1,0,0,0,0,0,0
07848660,2,2,0,0,0,0,0,0,1
07849128,2,0,2,0,0,0,0,0,1
07849498,1,0,1,0,0,0,0,0,1
07849927,2,1,1,0,1,1,0,0,0
07850081,4,2,2,0,2,2,0,0,0
07850423,10,0,10,0,0,0,0,0,1
07850498,2,0,2,0,0,0,0,0,1
07850551,9,5,4,0,5,5,0,0,1
07850693,3,0,3,0,0,0,0,0,1
07850769,30,0,30,0,0,0,0,0,1
07850844,1,0,1,0,0,0,0,0,0
07850852,8,0,8,0,0,0,0,0,0
07851158,6,4,2,0,1,1,0,0,0
07851296,6,2,4,0,1,1,0,1,1
07851738,1,1,0,0,1,1,0,0,0
07851849,2,2,0,0,1,1,0,0,0
07851924,2,2,0,0,2,2,0,0,0
07852085,5,0,5,0,0,0,0,0,1
07852243,34,0,34,0,0,0,0,0,1
07852552,2,2,0,0,0,0,0,0,1
07852613,8,4,4,0,1,1,0,1,0
07852799,3,3,0,0,1,1,0,0,0
07852966,8,0,8,0,0,0,0,0,1
07853075,2,1,1,0,2,1,1,0,1
07853123,5,2,3,0,3,2,1,0,0
07853147,3,2,1,0,1,1,0,0,0
07854325,1,1,0,0,1,1,0,0,0
07854453,2,2,0,0,2,2,0,0,0
07855245,6,4,2,0,1,1,0,1,1
07855307,7,5,2,0,0,0,0,0,1
07855328,3,0,3,0,0,0,0,0,0
07855482,7,0,7,0,5,5,0,0,0
07855645,9,8,1,0,0,0,0,0,1
07856243,16,4,12,0,1,0,1,0,0
07856637,10,4,6,0,2,2,0,1,1
07856795,1,1,0,0,1,1,0,0,0
07856968,2,0,2,0,0,0,0,0,1
07857069,4,3,1,0,0,0,0,0,0
07857369,1,1,0,0,1,1,0,0,0
07857878,16,8,8,0,2,2,0,2,1
07857963,14,6,8,0,1,1,0,1,0
07858049,2,2,0,0,2,2,0,0,1
07858149,6,3,3,0,1,1,0,0,1
07858162,18,4,14,1,1,1,0,1,1
07858206,17,6,11,0,1,1,0,1,1
07858347,7,5,2,0,1,1,0,1,1
07858352,2,2,0,0,2,1,1,0,0
07858404,1,1,0,0,1,1,0,0,0
07858425,1,0,1,0,0,0,0,0,1
07858647,13,6,7,0,0,0,0,0,1
07858665,1,0,1,0,0,0,0,0,0
07860087,4,3,1,0,2,1,1,2,0
07860163,2,1,1,0,1,1,0,0,0
07860226,4,3,1,0,2,2,0,0,0
07860753,2,2,0,0,1,1,0,0,0
07861328,5,3,2,0,1,1,0,0,0
07861465,3,3,0,0,3,3,0,0,1
07861601,2,2,0,0,2,2,0,0,0
07861609,2,0,2,0,2,2,0,0,0
07861667,11,3,8,0,1,1,0,1,0
07861763,3,0,3,0,0,0,0,0,1
07862031,4,4,0,0,2,2,0,0,0
07862390,1,1,0,0,1,1,0,0,1
07862621,13,6,7,0,0,0,0,0,0
07862640,1,1,0,0,2,2,0,0,0
07862726,3,2,1,0,2,2,0,0,1
07862879,2,0,2,0,0,0,0,0,0
07863184,11,9,2,0,1,1,0,0,1
07863296,2,0,2,0,0,0,0,0,1
07863400,2,0,2,0,0,0,0,0,1
07863776,3,3,0,0,1,1,0,1,0
07864384,2,2,0,0,2,2,0,0,0
07864479,4,2,2,0,0,0,0,0,0
07864663,5,4,1,0,0,0,0,0,1
07864859,6,5,1,0,0,0,0,0,0
07865032,4,4,0,0,3,3,0,0,1
07865033,5,2,3,0,1,1,0,1,1
07865199,10,5,5,0,1,1,0,1,0
07865264,3,0,3,0,0,0,0,0,1
07865850,44,12,32,0,8,4,4,0,1
07866019,2,0,2,0,0,0,0,0,1
07866040,3,0,3,0,0,0,0,0,0
07866062,17,3,14,0,1,1,0,1,1
07866333,5,3,2,0,1,1,0,1,0
07866477,8,0,8,0,0,0,0,0,1
07866933,1,1,0,0,1,1,0,0,0
07867539,4,3,1,0,2,2,0,0,0
07867721,2,2,0,0,1,1,0,0,0
07867724,1,0,1,0,0,0,0,0,0
07867768,9,0,9,0,1,1,0,1,1
07867776,5,0,5,0,1,1,0,1,1
07869194,10,3,7,0,2,1,1,2,1
07869708,1,0,1,0,0,0,0,0,0
07869864,3,3,0,0,2,2,0,0,0
07870144,6,3,3,0,1,1,0,1,0
07870278,4,3,1,0,2,2,0,0,0
07870768,8,0,8,0,0,0,0,0,1
07870879,4,4,0,0,1,1,0,0,0
07871126,10,3,7,0,1,1,0,1,1
07871687,33,12,21,0,0,0,0,0,1
07871694,13,0,13,0,1,1,0,1,1
07871724,2,1,1,0,2,2,0,0,0
07871779,10,10,0,0,1,1,0,0,0
07871791,11,3,8,0,1,1,0,0,0
07872080,5,0,5,0,0,0,0,0,1
07872151,2,0,2,0,0,0,0,0,1
07872188,6,4,2,0,0,0,0,0,1
07872513,5,0,5,0,0,0,0,0,1
07872588,2,0,2,0,0,0,0,0,0
07872591,3,3,0,0,0,0,0,0,0
07872769,4,2,2,0,1,1,0,0,0
07872956,6,4,2,0,2,2,0,2,1
07873317,1,1,0,0,1,1,0,0,0
07873354,2,2,0,0,2,2,0,1,1
07873512,2,2,0,0,2,2,0,0,0
07873618,7,1,6,0,2,1,1,2,0
07873965,10,2,8,0,0,0,0,0,1
07874271,4,2,2,0,1,1,0,1,1
07874419,34,14,20,0,0,0,0,0,1
07874478,4,2,2,0,1,1,0,1,1
07874811,23,0,23,0,2,2,0,2,1
07874846,3,3,0,0,5,5,0,0,0
07875005,13,6,7,0,0,0,0,0,1
07875074,7,1,6,0,1,1,0,0,1
07875086,26,7,19,0,0,0,0,0,1
07875622,13,4,9,0,1,1,0,1,1
07876132,11,0,11,0,1,1,0,1,1
07876531,3,2,1,0,1,1,0,0,1
07876846,3,0,3,0,1,1,0,0,0
07877054,2,2,0,0,2,2,0,0,0
07877326,4,4,0,0,2,2,0,2,1
07877443,6,0,6,0,0,0,0,0,1
07877538,6,0,6,0,1,1,0,0,1
07877582,2,2,0,0,1,1,0,0,1
07877939,10,6,4,0,3,1,2,1,1
07878677,3,2,1,0,1,1,0,0,0
07878826,3,2,1,0,2,2,0,0,1
07878900,3,0,3,0,0,0,0,0,1
07879016,12,5,7,0,0,0,0,0,1
07879134,4,0,4,0,0,0,0,0,1
07879139,3,2,1,0,1,1,0,0,1
07879140,6,4,2,0,2,2,0,2,0
07879288,18,5,13,0,0,0,0,0,1
07879473,12,9,3,0,0,0,0,0,0
07879560,1,0,1,0,1,1,0,0,0
07879605,2,1,1,0,1,1,0,0,0
07879629,1,0,1,0,0,0,0,0,0
07879739,2,2,0,0,1,1,0,0,0
07879821,1,1,0,0,1,1,0,0,0
07879972,1,1,0,0,1,1,0,0,1
07880266,4,3,1,0,0,0,0,0,0
07880367,6,4,2,0,2,2,0,0,0
07880573,4,2,2,0,1,1,0,0,1
07880721,9,3,6,0,1,1,0,1,1
07880982,1,1,0,0,1,1,0,0,0
07881201,1,0,1,0,0,0,0,0,1
07881228,1,1,0,0,2,2,0,1,0
07881346,5,0,5,0,0,0,0,0,0
07881437,2,2,0,0,1,1,0,0,1
07881759,1,1,0,0,1,1,0,0,0
07881863,4,2,2,0,3,3,0,0,0
07881889,38,0,38,0,4,4,0,0,0
07881901,21,10,11,0,1,1,0,0,1
07882230,3,0,3,0,0,0,0,0,1
07882304,2,0,2,0,0,0,0,0,0
07882331,4,2,2,0,1,1,0,1,0
07882611,19,6,13,0,1,1,0,1,1
07882701,2,0,2,0,0,0,0,0,0
07882873,26,8,18,0,1,0,1,1,1
07883121,2,0,2,0,2,2,0,0,1
07883370,4,3,1,0,2,1,1,1,0
07883446,42,13,29,0,0,0,0,0,0
07883671,16,3,13,0,1,1,0,1,1
07883681,14,7,7,0,0,0,0,0,1
07883716,3,0,3,0,0,0,0,0,1
07883942,2,2,0,0,2,2,0,0,0
07884046,13,4,9,0,1,1,0,1,1
07884233,5,2,3,0,1,1,0,1,1
07884446,1,0,1,0,0,0,0,0,0
07884790,2,2,0,0,2,2,0,0,1
07884851,2,0,2,0,0,0,0,0,1
07884937,5,2,3,0,2,1,1,0,0
07884993,22,9,13,0,0,0,0,0,0
07885004,4,4,0,0,1,1,0,0,1
07885051,33,11,22,0,0,0,0,0,1
07885963,22,7,15,0,0,0,0,0,1
07886263,3,0,3,0,0,0,0,0,1
07886277,1,0,1,0,0,0,0,0,0
07886344,6,4,2,0,0,0,0,0,0
07886677,3,1,2,0,3,1,2,0,1
07886835,4,0,4,0,0,0,0,0,1
07886953,3,2,1,0,1,1,0,0,1
07887243,3,2,1,0,2,2,0,0,1
07887350,2,1,1,0,1,1,0,0,0
07887758,4,4,0,0,0,0,0,0,1
07887825,5,0,5,0,0,0,0,0,1
07887988,7,4,3,0,2,2,0,2,0
07888016,7,5,2,0,0,0,0,0,0
07888110,34,11,23,0,1,1,0,1,1
07888261,6,0,6,0,1,1,0,0,0
07888485,2,2,0,0,1,1,0,1,1
07889012,2,0,2,0,0,0,0,0,0
07889349,12,4,8,0,1,1,0,1,1
07889474,9,3,6,0,1,1,0,0,0
07889828,14,6,8,0,3,3,0,0,1
07889992,3,0,3,0,0,0,0,0,1
04278070,13,3,10,0,0,0,0,0,0
04278202,20,0,20,0,0,0,0,0,1
04278227,6,3,3,0,1,1,0,1,1
04278261,6,3,3,0,1,1,0,1,1
04278355,5,0,5,0,0,0,0,0,1
04278381,17,4,13,0,1,1,0,1,0
04278466,4,1,3,0,1,1,0,0,0
04278528,6,3,3,0,1,1,0,1,1
04278539,32,3,29,0,0,0,0,0,1
04278695,14,3,11,0,1,1,0,1,1
04278759,20,4,16,0,2,1,1,2,1
04278976,20,3,17,0,3,3,0,0,1
04279801,15,1,14,0,1,1,0,1,1
04279954,22,7,15,0,11,6,5,0,1
04279978,15,4,11,0,2,1,1,0,1
04280066,6,3,3,0,1,1,0,1,0
04280264,7,3,4,0,1,1,0,0,0
04280364,6,2,4,0,1,1,0,0,1
04280421,4,2,2,0,1,1,0,0,1
04280597,27,0,27,0,0,0,0,0,1
04280649,6,3,3,0,0,0,0,0,1
04280759,21,5,16,0,0,0,0,0,0
04281011,17,4,13,0,2,2,0,2,1
04281368,5,3,2,0,2,2,0,0,1
04281470,4,2,2,0,2,2,0,0,0
04281476,4,2,2,0,1,1,0,0,1
04281699,6,3,3,0,2,2,0,0,1
04281855,51,7,44,0,0,0,0,0,0
04282568,7,3,4,0,1,1,0,1,1
04282827,18,6,12,0,0,0,0,0,1
04283003,53,6,47,0,0,0,0,0,1
04283069,16,2,14,0,1,1,0,1,1
04283350,17,5,12,0,0,0,0,0,1
04283369,6,2,4,0,1,1,0,0,0
04283382,9,4,5,0,1,1,0,0,1
04283484,9,0,9,0,0,0,0,0,1
04284005,4,0,4,0,0,0,0,0,1
04284259,21,4,17,0,3,2,1,0,1
04284442,19,4,15,0,0,0,0,0,1
04284517,10,0,10,0,1,1,0,1,1
04284542,17,0,17,0,0,0,0,0,1
04284605,41,9,32,0,0,0,0,0,0
04284615,30,15,15,0,2,1,1,0,1
04284741,9,4,5,0,2,2,0,0,1
04285087,5,4,1,0,2,2,0,0,0
04285198,59,0,59,0,1,1,0,0,1
04285427,8,0,8,0,0,0,0,0,1
04285432,13,0,13,0,1,1,0,0,1
04285460,22,3,19,0,1,1,0,1,1
04285569,8,3,5,0,1,1,0,0,1
04285643,11,1,10,0,1,1,0,0,1
04285780,15,3,12,0,0,0,0,0,1
04285928,6,0,6,0,0,0,0,0,1
04285942,13,2,11,0,1,1,0,1,1
04285956,17,4,13,0,0,0,0,0,0
04286329,7,3,4,0,1,1,0,0,1
04286602,6,0,6,0,1,1,0,1,1
04286660,19,5,14,0,0,0,0,0,1
04286808,9,0,9,0,1,1,0,1,1
04286877,4,1,3,0,1,1,0,0,0
04286994,5,2,3,0,1,1,0,1,0
04287042,6,2,4,0,2,2,0,0,0
04287225,24,10,14,0,0,0,0,0,0
04287377,24,0,24,0,0,0,0,0,1
04287441,5,3,2,0,1,1,0,0,0
04287501,5,2,3,0,2,2,0,0,1
04287637,5,0,5,0,0,0,0,0,1
04287655,14,4,10,0,4,1,3,1,1
04287877,49,7,42,0,0,0,0,0,1
04288483,15,0,15,0,0,0,0,0,1
04289449,12,4,8,0,3,1,2,1,1
04289476,21,4,17,0,1,1,0,1,1
04289478,9,3,6,0,2,2,0,0,1
04289649,11,3,8,0,1,1,0,1,0
04289793,13,7,6,0,3,1,2,2,1
04289891,13,7,6,0,0,0,0,0,1
04290183,16,3,13,0,1,1,0,1,0
04290283,6,2,4,0,2,2,0,0,1
04290554,24,8,16,0,0,0,0,0,1
04290716,20,3,17,0,1,1,0,1,1
04291554,5,2,3,0,1,1,0,0,1
04291605,4,2,2,0,1,1,0,0,0
04292175,10,0,10,0,0,0,0,0,1
04292267,8,0,8,0,0,0,0,0,1
04292318,6,3,3,0,1,1,0,0,0
04292847,27,2,25,0,2,1,1,2,1
04292933,8,0,8,0,1,1,0,1,1
04293272,7,5,2,0,1,1,0,0,1
04293279,8,3,5,0,2,2,0,0,1
04293417,13,5,8,0,0,0,0,0,1
04293487,8,3,5,0,1,1,0,0,0
04293636,14,3,11,0,5,2,3,1,1
04293695,14,5,9,0,4,1,3,2,1
04293817,25,1,24,0,1,1,0,1,1
04293862,16,3,13,0,6,1,5,1,1
04293930,69,15,54,0,0,0,0,0,1
04293933,8,2,6,0,1,1,0,1,0
04294109,6,2,4,0,2,2,0,1,1
04294118,17,3,14,0,1,1,0,1,1
04294298,22,4,18,0,1,1,0,1,1
04294740,18,5,13,0,1,1,0,1,1
04294869,5,4,1,0,2,2,0,0,0
04294906,21,2,19,0,1,1,0,1,1
04294994,5,1,4,0,1,1,0,0,0
04295370,30,6,24,0,0,0,0,0,1
04295390,6,0,6,0,1,1,0,0,1
04295393,11,6,5,0,3,3,0,0,1
04295564,23,7,16,0,0,0,0,0,0
04295714,29,0,29,0,0,0,0,0,1
04295888,5,1,4,0,2,2,0,1,1
04296257,13,3,10,0,1,1,0,1,1
04296394,25,3,22,0,1,1,0,1,1
04296436,91,11,80,0,0,0,0,0,1
04296909,5,0,5,0,0,0,0,0,1
04296959,4,1,3,0,2,2,0,0,0
04297071,7,0,7,0,0,0,0,0,1
04297497,32,9,23,0,1,1,0,0,1
04297708,45,4,41,0,2,2,0,2,1
04297771,30,5,25,0,0,0,0,0,1
04297833,22,7,15,3,0,0,0,0,1
04297836,23,3,20,0,1,1,0,1,1
04297861,4,2,2,0,1,1,0,0,0
04297905,48,15,33,0,2,1,1,0,1
04298019,8,3,5,0,3,3,0,1,1
04298115,35,4,31,0,2,2,0,2,1
04298141,20,3,17,0,1,1,0,1,1
04298309,8,2,6,0,1,1,0,0,1
04298347,12,3,9,0,1,1,0,1,0
04298900,9,0,9,0,0,0,0,0,1
04298947,23,7,16,0,0,0,0,0,1
04299001,18,1,17,0,1,1,0,1,1
04299162,10,3,7,0,1,1,0,0,0
04299360,19,3,16,0,1,1,0,1,1
04299511,24,6,18,0,1,1,0,0,1
04300098,14,2,12,0,1,1,0,1,1
04300102,5,3,2,0,2,2,0,0,0
04300370,11,5,6,0,1,1,0,1,0
04300414,11,0,11,0,0,0,0,0,1
04300737,10,3,7,0,1,1,0,1,1
04300899,9,2,7,0,1,1,0,0,0
04301197,11,4,7,0,1,1,0,1,1
04301206,9,3,6,0,1,1,0,1,1
04301535,4,3,1,0,3,3,0,0,0
04301594,8,6,2,0,1,1,0,0,1
04301665,5,3,2,0,2,2,0,0,0
04301801,6,4,2,0,3,2,1,0,1
04301952,16,9,7,0,0,0,0,0,1
04302402,23,9,14,0,0,0,0,0,1
04302461,6,5,1,0,0,0,0,0,0
04302474,70,0,70,0,1,1,0,0,1
04302475,5,0,5,0,0,0,0,0,1
04302488,18,2,16,0,1,1,0,1,1
04302491,10,2,8,0,0,0,0,0,0
04302493,19,6,13,0,2,2,0,0,1
04302905,18,0,18,0,1,1,0,1,1
04302968,36,12,24,0,0,0,0,0,0
04302973,64,11,53,0,0,0,0,0,1
04303322,48,7,41,0,1,1,0,1,1
04303687,13,5,8,0,0,0,0,0,0
04303731,38,6,32,0,1,1,0,1,1
04303736,32,3,29,0,1,1,0,1,1
04303771,25,0,25,0,0,0,0,0,1
04304053,6,3,3,0,2,2,0,0,0
04304196,5,3,2,0,1,1,0,0,1
04304375,6,2,4,0,1,1,0,0,1
04304466,8,4,4,0,1,1,0,0,1
04304791,25,3,22,0,1,1,0,1,1
04304849,36,9,27,0,1,1,0,1,1
04304977,4,1,3,0,1,1,0,1,0
04305048,35,6,29,0,0,0,0,0,1
04305343,13,5,8,0,1,1,0,1,1
04305781,14,10,4,0,1,1,0,0,0
04305805,26,6,20,0,2,2,0,2,1
04305862,5,2,3,0,1,1,0,0,1
04306193,18,0,18,0,1,1,0,1,0
04306641,5,3,2,0,2,2,0,0,1
04306751,27,3,24,0,1,1,0,1,1
04306769,29,2,27,0,1,1,0,1,1
04306847,7,4,3,0,3,3,0,0,0
04306996,8,0,8,0,0,0,0,0,0
04307833,36,13,23,0,0,0,0,0,1
04307985,16,4,12,0,0,0,0,0,1
04308091,24,3,21,0,1,1,0,1,1
04308169,4,2,2,0,2,2,0,0,1
04308957,8,0,8,0,0,0,0,0,1
04309018,4,1,3,0,1,1,0,0,0
04309191,9,2,7,0,1,1,0,0,1
04309218,10,2,8,0,1,1,0,0,1
04309364,12,6,6,0,0,0,0,0,1
04309544,48,12,36,0,0,0,0,0,1
04309631,21,3,18,0,3,3,0,3,1
04309934,30,4,26,0,2,2,0,2,1
04310096,22,7,15,0,2,2,0,2,1
04310195,8,1,7,0,2,1,1,1,1
04310203,8,1,7,0,2,1,1,1,1
04310360,13,4,9,0,2,2,0,0,1
04310408,17,0,17,0,1,1,0,1,1
04310424,5,0,5,0,0,0,0,0,0
04310751,25,3,22,0,1,1,0,1,1
04310807,24,10,14,0,0,0,0,0,1
04310812,5,1,4,0,1,1,0,0,1
04310930,6,1,5,0,0,0,0,0,0
04311107,34,4,30,0,1,1,0,1,1
04311303,6,2,4,0,2,2,0,0,0
04311391,24,8,16,0,0,0,0,0,1
04311542,6,4,2,0,1,1,0,1,1
04311748,5,0,5,0,1,1,0,0,0
04311873,0,0,0,0,0,0,0,0,1
04311892,15,5,10,0,0,0,0,0,1
04311952,13,3,10,0,1,1,0,1,1
04311953,8,3,5,0,1,1,0,1,1
04312380,24,4,20,0,1,1,0,1,1
04312415,15,2,13,0,1,1,0,1,1
04312431,19,3,16,0,1,1,0,1,1
04312532,21,3,18,0,2,1,1,2,1
04312711,3,2,1,0,1,1,0,0,1
04312745,22,9,13,0,0,0,0,0,0
04312754,9,4,5,0,3,3,0,0,1
04312785,21,3,18,0,2,1,1,2,1
04312853,16,7,9,0,1,1,0,0,1
NI629071,2,2,0,0,2,2,0,0,0
NI629076,4,3,1,0,1,1,0,1,0
NI629082,4,0,4,0,1,1,0,0,0
NI629084,2,2,0,0,1,1,0,1,0
NI629209,3,3,0,0,0,0,0,0,1
NI629213,2,2,0,0,0,0,0,0,1
NI629308,1,1,0,0,2,2,0,0,0
NI629427,3,2,1,0,2,2,0,0,0
NI629449,4,2,2,0,1,1,0,1,1
NI629531,1,0,1,0,0,0,0,0,0
NI629540,7,6,1,0,0,0,0,0,0
NI629720,3,1,2,0,1,1,0,1,0
NI629886,1,0,1,0,1,1,0,0,0
NI630145,3,3,0,0,0,0,0,0,1
NI630291,6,3,3,0,6,3,3,0,0
NI630574,12,3,9,0,2,2,0,1,1
NI630642,2,1,1,0,1,1,0,1,0
NI630715,10,10,0,0,0,0,0,0,0
NI630827,6,5,1,0,1,1,0,0,0
NI630910,2,1,1,0,1,1,0,0,0
NI631027,4,1,3,0,1,1,0,0,0
NI631089,4,0,4,0,0,0,0,0,0
NI631132,2,2,0,0,2,2,0,1,0
NI631223,2,1,1,0,0,0,0,0,0
NI631470,24,12,12,0,0,0,0,0,0
NI631501,4,3,1,0,1,1,0,1,1
NI631531,4,4,0,0,3,3,0,0,0
NI631564,1,1,0,0,1,1,0,0,0
NI631613,10,7,3,0,0,0,0,0,1
NI631714,4,4,0,0,2,2,0,0,0
NI631967,1,1,0,0,1,1,0,0,0
NI632316,16,6,10,0,5,1,4,1,1
NI632722,2,1,1,0,1,1,0,1,0
NI632740,1,1,0,0,1,1,0,0,1
NI633194,7,7,0,0,0,0,0,0,0
NI633373,1,0,1,0,1,1,0,0,0
NI633416,1,0,1,0,0,0,0,0,0
NI633442,1,1,0,0,1,1,0,0,0
NI633645,3,2,1,0,4,4,0,2,0
NI633975,3,2,1,0,1,1,0,0,0
NI634104,3,2,1,0,1,1,0,0,0
NI634108,2,0,2,0,1,1,0,0,0
NI634222,2,2,0,0,1,1,0,1,0
NI634229,3,0,3,0,1,1,0,0,0
NI634394,1,1,0,0,1,1,0,0,0
NI634463,1,0,1,0,1,1,0,0,0
NI634479,1,0,1,0,1,1,0,0,0
NI634539,2,2,0,0,1,1,0,0,0
NI634778,1,1,0,0,1,1,0,0,0
NI634801,3,3,0,0,3,3,0,0,0
NI634828,14,6,8,0,0,0,0,0,0
NI634903,2,2,0,0,1,1,0,0,0
NI635064,3,1,2,0,0,0,0,0,0
NI635236,3,2,1,0,0,0,0,0,0
NI635286,2,1,1,0,2,1,1,0,0
NI635402,3,3,0,0,1,1,0,1,0
NI635406,3,3,0,0,2,2,0,0,0
NI635541,3,2,1,0,3,1,2,1,0
NI635663,2,2,0,0,2,2,0,0,0
NI635831,13,10,3,0,4,3,1,0,0
NI635910,2,2,0,0,1,1,0,0,0
NI636001,1,1,0,0,1,1,0,0,0
NI636082,2,1,1,0,2,1,1,1,0
NI636175,1,0,1,0,0,0,0,0,0
NI636280,1,1,0,0,1,1,0,0,0
NI636285,5,0,5,0,0,0,0,0,0
NI636304,1,1,0,0,1,1,0,0,0
NI636387,3,3,0,0,2,2,0,0,0
NI636415,2,2,0,0,2,2,0,0,0
NI636882,3,2,1,0,1,1,0,0,0
NI636890,1,1,0,0,1,1,0,0,0
NI636954,15,10,5,0,8,7,1,0,0
NI636970,28,23,5,0,0,0,0,0,0
NI637146,2,1,1,0,2,1,1,0,0
NI637155,2,2,0,0,1,1,0,1,0
NI637428,5,4,1,0,4,1,3,1,1
NI637463,1,1,0,0,1,1,0,0,0
NI637485,2,1,1,0,1,1,0,0,0
NI637541,2,1,1,0,1,1,0,0,0
NI637667,1,1,0,0,0,0,0,0,0
NI637986,3,3,0,0,3,3,0,0,0
NI638308,1,0,1,0,0,0,0,0,0
NI638386,5,4,1,2,4,2,2,1,0
NI638445,2,2,0,0,2,2,0,0,0
NI638446,1,0,1,0,1,1,0,0,0
NI638548,6,5,1,2,4,2,2,1,0
NI638588,4,4,0,0,0,0,0,0,1
NI638732,7,5,2,0,0,0,0,0,0
NI638733,16,7,9,0,4,1,3,0,0
NI638764,2,0,2,0,1,1,0,0,0
NI638801,3,3,0,0,2,2,0,1,1
NI638832,7,4,3,0,0,0,0,0,0
NI639138,4,4,0,0,0,0,0,0,0
NI639199,3,3,0,0,1,1,0,1,0
NI639489,4,2,2,0,1,1,0,0,0
NI640051,5,3,2,0,1,1,0,1,0
NI640259,2,2,0,0,2,2,0,0,0
NI640269,1,1,0,0,1,1,0,0,0
NI640450,11,9,2,0,1,1,0,0,0
NI640803,4,3,1,0,1,1,0,0,0
NI641025,2,2,0,0,2,1,1,1,0
NI641261,2,2,0,0,1,1,0,0,0
NI641318,1,0,1,0,1,1,0,0,0
NI641445,4,3,1,0,0,0,0,0,0
NI641574,2,2,0,0,2,2,0,0,0
NI641668,1,1,0,0,1,1,0,0,0
NI641807,3,3,0,0,2,2,0,0,0
NI641987,2,2,0,0,1,0,1,0,0
NI642017,5,0,5,0,0,0,0,0,0
NI642315,6,5,1,2,3,1,2,1,0
NI642364,1,0,1,0,1,1,0,0,0
NI642457,5,3,2,0,2,2,0,0,0
NI642473,7,4,3,0,1,1,0,0,0
NI642500,2,2,0,0,3,2,1,1,0
NI642576,2,1,1,0,2,2,0,0,0
NI642752,1,0,1,0,1,1,0,0,0
NI642753,8,7,1,0,1,1,0,0,0
NI643058,12,12,0,0,0,0,0,0,0
NI643081,8,4,4,0,0,0,0,0,1
NI643116,3,1,2,0,3,1,2,0,0
NI643255,4,4,0,0,2,2,0,0,1
NI643264,7,5,2,0,0,0,0,0,0
NI643290,1,0,1,0,1,1,0,0,0
NI643512,1,1,0,0,1,1,0,0,0
NI643881,1,0,1,0,1,1,0,0,0
NI644047,7,0,7,0,1,0,1,0,0
NI644270,1,1,0,0,1,1,0,0,0
NI644335,3,3,0,0,0,0,0,0,0
NI644372,1,1,0,0,1,1,0,0,0
NI644380,2,1,1,0,0,0,0,0,0
NI644431,11,7,4,0,0,0,0,0,0
NI644483,2,2,0,0,1,1,0,0,0
NI644527,2,2,0,0,2,2,0,0,0
NI644606,9,8,1,0,0,0,0,0,0
NI644643,1,0,1,0,0,0,0,0,0
NI644648,3,2,1,0,1,1,0,0,0
NI645026,3,2,1,0,4,3,1,0,0
NI645109,2,2,0,0,2,2,0,0,0
NI645122,5,5,0,0,0,0,0,0,0
NI645156,3,0,3,0,2,2,0,0,0
NI645211,3,2,1,0,2,1,1,0,0
NI645213,2,2,0,0,1,1,0,0,0
NI645301,1,0,1,0,0,0,0,0,0
NI645413,1,1,0,0,1,1,0,0,0
NI645549,8,5,3,0,0,0,0,0,0
NI645765,1,1,0,0,1,1,0,0,0
NI645897,2,2,0,0,1,1,0,1,1
NI645950,2,0,2,0,2,2,0,0,1
NI645965,2,1,1,0,1,1,0,0,0
NI646012,2,2,0,0,2,2,0,0,0
NI646020,4,2,2,0,2,1,1,0,0
NI646213,2,0,2,0,0,0,0,0,0
NI646252,1,1,0,0,2,2,0,0,0
NI646369,4,4,0,0,4,4,0,0,0
NI646427,4,3,1,0,1,1,0,1,0
NI646436,2,2,0,0,1,1,0,0,0
NI646505,7,5,2,0,0,0,0,0,0
NI646687,1,1,0,0,1,1,0,0,0
NI646702,2,2,0,0,1,1,0,1,1
NI646727,3,3,0,0,2,2,0,1,1
NI646834,7,6,1,1,1,0,1,1,1
NI646843,2,2,0,0,1,1,0,0,0
NI646854,1,1,0,0,1,1,0,0,0
NI646958,1,1,0,0,1,1,0,0,0
NI646979,5,4,1,0,1,0,1,0,0
NI647113,2,2,0,0,1,1,0,0,0
NI647218,4,3,1,0,0,0,0,0,0
NI647368,1,1,0,0,1,1,0,0,0
NI647456,1,1,0,0,1,1,0,0,0
NI647465,1,1,0,0,1,1,0,0,0
NI647539,1,1,0,0,1,1,0,0,0
NI647722,1,1,0,0,1,1,0,0,0
NI647866,3,3,0,0,1,1,0,0,0
NI648026,2,2,0,0,2,2,0,0,0
NI648039,1,1,0,0,1,1,0,0,0
NI648287,1,1,0,0,0,0,0,0,0
NI648359,2,2,0,0,2,2,0,0,0
NI648368,4,4,0,0,0,0,0,0,0
NI648462,6,0,6,0,1,1,0,1,1
NI648893,2,2,0,0,2,2,0,0,0
NI648937,1,1,0,0,1,1,0,0,0
NI648941,2,2,0,0,1,1,0,0,0
NI649047,3,3,0,0,3,3,0,0,0
NI649151,2,2,0,0,1,1,0,0,0
NI649174,2,2,0,0,1,1,0,1,0
NI649352,2,2,0,0,1,1,0,0,0
NI649520,4,3,1,0,1,1,0,1,1
NI649637,3,3,0,0,1,1,0,0,0
NI649724,15,13,2,0,0,0,0,0,1
NI649890,2,1,1,0,2,1,1,0,0
NI649957,6,5,1,0,1,1,0,0,1
NI649960,1,0,1,0,0,0,0,0,1
NI650008,2,0,2,0,1,1,0,0,0
NI650462,1,1,0,0,1,1,0,0,0
NI650811,2,2,0,0,2,2,0,0,0
NI651203,2,1,1,0,3,3,0,1,0
NI651206,1,1,0,0,1,1,0,0,0
NI651723,1,1,0,0,1,1,0,0,0
NI651825,2,2,0,0,2,2,0,1,0
NI651853,1,1,0,0,1,1,0,0,0
NI651975,4,4,0,0,1,1,0,1,0
NI652042,1,1,0,0,1,1,0,0,0
NI652489,1,1,0,0,1,1,0,0,0
NI652515,3,3,0,0,3,3,0,2,0
NI652522,1,1,0,0,1,1,0,0,0
NI652582,2,2,0,0,4,3,1,2,0
NI652589,4,3,1,0,1,1,0,1,0
NI652590,4,3,1,0,1,1,0,1,0
NI652803,2,2,0,0,1,1,0,1,0
NI652861,1,1,0,0,1,1,0,0,0
NI653153,1,1,0,0,1,1,0,0,0
NI653310,4,4,0,0,0,0,0,0,0
NI653481,1,1,0,0,1,1,0,1,0
NI653576,4,4,0,0,0,0,0,0,0
NI653620,2,2,0,0,1,1,0,0,0
NI653886,1,1,0,0,1,1,0,0,0
NI654056,3,3,0,0,0,0,0,0,0
NI654210,4,4,0,0,0,0,0,0,0
NI654233,5,5,0,0,2,2,0,0,1
NI654292,10,10,0,0,0,0,0,0,0
NI654575,1,1,0,0,1,1,0,0,0
NI654737,1,1,0,0,0,0,0,0,0
NI654741,2,2,0,0,2,2,0,0,0
NI654869,2,2,0,0,2,2,0,0,0
NI654898,2,1,1,0,2,1,1,0,0
NI655204,2,2,0,0,2,2,0,0,0
NI655259,6,1,5,0,2,0,2,0,0
NI655404,4,4,0,0,2,2,0,0,0
NI655816,1,1,0,0,1,1,0,0,0
NI655959,1,1,0,0,1,1,0,0,0
NI656309,1,1,0,0,1,1,0,0,0
NI656337,4,4,0,0,4,1,3,0,0
NI656457,1,1,0,0,1,1,0,0,0
NI656574,3,2,1,0,0,0,0,0,0
NI656920,5,5,0,0,0,0,0,0,0
NI656963,4,4,0,0,0,0,0,0,0
NI656993,2,2,0,0,0,0,0,0,1
04532104,5,3,2,0,2,2,0,0,0
04532202,14,2,12,0,0,0,0,0,1
04532449,11,5,6,0,0,0,0,0,1
04532561,6,3,3,0,1,1,0,1,1
04532619,5,3,2,0,1,1,0,0,0
04532703,5,1,4,0,1,1,0,0,0
04532906,8,4,4,0,1,1,0,0,0
04532950,5,3,2,0,2,2,0,0,0
04533301,7,1,6,0,1,1,0,0,1
04533512,15,3,12,0,2,2,0,0,1
04533848,5,3,2,0,1,1,0,0,0
04533879,15,4,11,0,3,3,0,0,1
04533902,29,11,18,0,1,1,0,1,1
04533942,6,2,4,0,1,1,0,0,1
04533948,38,10,28,0,1,1,0,0,1
04533950,30,4,26,0,0,0,0,0,1
04533970,49,10,39,0,1,1,0,1,1
04534022,120,4,116,0,1,1,0,1,1
04534289,16,3,13,0,2,2,0,0,1
04534438,21,2,19,0,3,1,2,3,1
04534786,8,0,8,0,0,0,0,0,1
04534842,7,2,5,0,1,1,0,0,0
04534861,7,2,5,0,3,2,1,0,0
04534962,9,0,9,0,0,0,0,0,1
04535296,15,5,10,0,1,1,0,1,1
04535408,5,3,2,0,1,1,0,0,0
04535619,8,1,7,0,1,1,0,0,1
04535690,4,2,2,0,2,2,0,0,0
04535855,25,3,22,0,1,1,0,1,1
04536120,37,10,27,0,0,0,0,0,1
04536267,4,2,2,0,1,1,0,0,0
04536350,5,0,5,0,0,0,0,0,0
04536415,25,0,25,0,0,0,0,0,1
04536442,41,13,28,0,0,0,0,0,1
04536464,7,4,3,0,1,1,0,0,0
04536485,18,4,14,0,3,1,2,1,1
04536761,4,2,2,0,1,1,0,0,1
04536767,4,2,2,0,1,1,0,0,1
04537496,7,3,4,0,1,1,0,0,1
04537744,10,4,6,0,1,0,1,0,0
04538068,0,0,0,0,0,0,0,0,1
04538102,18,2,16,0,1,1,0,0,1
04538362,6,4,2,0,1,1,0,0,0
04538433,20,9,11,0,4,2,2,0,1
04538868,10,0,10,0,1,1,0,1,1
04538888,23,5,18,0,0,0,0,0,0
04538897,5,3,2,0,2,2,0,0,0
04539028,6,2,4,0,1,1,0,0,0
04539191,5,1,4,0,1,1,0,0,0
04539285,9,0,9,0,1,1,0,1,1
04539295,5,2,3,0,1,1,0,1,1
04539303,10,7,3,0,0,0,0,0,1
04539436,5,1,4,0,1,1,0,0,1
04539764,21,5,16,0,1,1,0,1,0
04539803,4,1,3,0,1,1,0,0,0
04540001,16,4,12,0,2,1,1,2,1
04540057,4,0,4,0,0,0,0,0,1
04540273,13,8,5,0,0,0,0,0,0
04540647,10,6,4,0,7,5,2,0,1
04540773,17,3,14,0,1,1,0,0,1
04540838,18,7,11,0,0,0,0,0,0
04541104,5,3,2,0,1,1,0,0,0
04541278,7,0,7,0,2,1,1,1,0
04541439,10,0,10,0,1,1,0,0,1
04541715,14,6,8,0,0,0,0,0,1
04541809,5,3,2,0,2,2,0,0,0
04541965,28,4,24,0,1,1,0,1,1
04542019,21,0,21,0,0,0,0,0,1
04542042,9,4,5,0,0,0,0,0,1
04542170,28,3,25,0,0,0,0,0,1
04542359,7,5,2,0,3,3,0,1,1
04542728,13,5,8,0,2,2,0,0,1
04542729,20,3,17,0,1,1,0,1,1
04542751,8,0,8,0,1,1,0,0,1
04542813,4,1,3,0,1,1,0,0,0
04543344,15,3,12,0,1,1,0,1,1
04543741,7,2,5,0,1,1,0,0,1
04543744,12,0,12,0,0,0,0,0,1
04543827,6,2,4,0,1,1,0,0,0
04544276,22,3,19,0,1,1,0,1,1
04544421,4,0,4,0,0,0,0,0,1
04544528,6,2,4,0,1,1,0,0,1
04544698,30,0,30,0,0,0,0,0,1
04544700,10,4,6,0,1,1,0,1,1
04544777,5,3,2,0,0,0,0,0,1
04544791,19,5,14,0,0,0,0,0,1
04545084,37,0,37,0,0,0,0,0,1
04545094,9,4,5,0,4,2,2,0,1
04545164,11,3,8,0,1,1,0,0,1
04545195,20,3,17,0,1,1,0,1,1
04545269,4,2,2,0,1,1,0,0,0
04545533,6,3,3,0,3,2,1,1,1
04545653,5,3,2,0,2,2,0,0,0
04545786,16,5,11,0,1,1,0,1,1
04545910,5,2,3,0,2,2,0,0,1
04545951,16,5,11,0,1,1,0,1,1
04546335,18,4,14,0,1,1,0,1,1
04546703,6,3,3,0,2,2,0,0,0
04546709,7,3,4,0,2,2,0,0,1
04546803,11,2,9,0,0,0,0,0,1
04546841,4,2,2,0,1,1,0,0,0
04546995,20,3,17,0,0,0,0,0,1
04547140,8,0,8,0,0,0,0,0,1
04547277,9,5,4,0,2,1,1,1,0
04547971,2,2,0,0,2,2,0,0,0
04547974,61,13,48,0,0,0,0,0,1
04548124,5,2,3,0,1,1,0,1,1
04548271,14,4,10,0,0,0,0,0,1
04548316,8,4,4,0,0,0,0,0,0
04548540,9,6,3,0,3,1,2,1,0
04548568,16,1,15,0,5,3,2,1,1
04548613,13,3,10,0,2,1,1,0,1
04548651,40,8,32,0,1,1,0,1,1
04549009,41,11,30,0,1,1,0,0,1
04549309,4,2,2,0,1,1,0,0,0
04549491,5,1,4,0,1,1,0,0,0
04549651,13,0,13,0,0,0,0,0,1
04549858,7,2,5,0,2,1,1,0,1
04549920,5,2,3,0,1,1,0,0,1
04550038,6,4,2,0,3,3,0,0,1
04550204,5,3,2,0,2,2,0,0,0
04550215,5,3,2,0,1,1,0,0,0
04550309,6,4,2,0,1,1,0,1,1
04550864,33,10,23,0,0,0,0,0,1
04551070,8,6,2,0,1,1,0,0,1
04551528,31,5,26,0,1,1,0,1,1
04551784,10,3,7,0,0,0,0,0,1
04551824,27,8,19,0,0,0,0,0,1
04552005,20,0,20,0,0,0,0,0,1
04552017,5,2,3,0,1,1,0,0,0
04552045,4,1,3,0,1,1,0,0,0
04552449,21,7,14,0,3,1,2,1,1
04552555,6,0,6,0,0,0,0,0,1
04552616,11,0,11,0,0,0,0,0,1
04552753,26,8,18,0,1,1,0,1,1
04552819,7,1,6,0,1,1,0,0,0
04552976,7,5,2,0,1,1,0,1,0
04552996,9,4,5,0,1,1,0,0,1
04553599,13,0,13,0,0,0,0,0,1
04554193,6,3,3,0,1,1,0,0,0
04554256,4,0,4,0,0,0,0,0,0
04554471,16,3,13,0,0,0,0,0,1
04554830,6,3,3,0,1,1,0,0,1
04555155,5,2,3,0,2,0,2,0,1
04555700,9,1,8,0,1,1,0,0,1
04555864,4,2,2,0,1,1,0,0,0
04556634,21,6,15,0,1,1,0,1,1
04557062,5,2,3,0,1,1,0,0,1
04557064,7,3,4,0,1,1,0,0,1
04557207,5,0,5,0,0,0,0,0,1
04557294,5,2,3,0,2,2,0,0,0
04557458,4,2,2,0,2,2,0,0,0
04557729,2,0,2,0,0,0,0,0,1
04557888,68,12,56,0,0,0,0,0,0
04557996,10,4,6,0,1,1,0,1,0
04558112,23,3,20,0,0,0,0,0,1
04558239,9,0,9,0,0,0,0,0,1
04558616,4,0,4,0,0,0,0,0,0
04559144,4,3,1,0,2,2,0,0,0
04560091,34,9,25,0,0,0,0,0,1
04560102,26,3,23,0,1,1,0,1,1
04560122,2,1,1,0,1,1,0,0,0
04560139,9,4,5,0,1,1,0,1,1
04560157,18,0,18,0,1,1,0,1,1
04560244,7,4,3,0,1,1,0,0,0
04560277,24,5,19,0,1,1,0,1,1
04560726,18,6,12,0,0,0,0,0,1
04560770,26,3,23,0,1,1,0,1,1
04561162,7,2,5,0,2,1,1,1,0
04561595,4,1,3,0,1,1,0,0,0
04561727,44,2,42,0,1,1,0,1,1
04561825,37,11,26,0,1,1,0,0,1
04562374,4,2,2,0,1,1,0,0,0
04562432,5,2,3,0,1,1,0,0,0
04562610,9,2,7,0,2,2,0,0,0
04562687,11,3,8,0,3,2,1,0,0
04562803,40,9,31,0,0,0,0,0,1
04562828,6,3,3,0,2,2,0,0,0
04563236,10,0,10,0,0,0,0,0,1
04563661,7,4,3,0,1,1,0,0,0
04563789,5,3,2,0,2,2,0,0,0
04563825,10,5,5,0,1,1,0,1,1
04564083,8,0,8,0,1,1,0,0,1
04564594,23,4,19,0,0,0,0,0,1
04564631,30,4,26,0,2,2,0,2,1
04565637,22,3,19,0,4,4,0,0,1
04565701,11,4,7,0,1,1,0,1,1
04565984,4,2,2,0,1,1,0,0,1
04566117,7,4,3,0,0,0,0,0,1
04566129,45,5,40,0,0,0,0,0,1
04566225,5,2,3,0,1,1,0,0,1
04566268,3,2,1,0,1,1,0,0,0
04566895,8,1,7,0,1,1,0,0,1
04567172,6,3,3,0,2,2,0,0,1
04567378,15,6,9,0,0,0,0,0,1
04567407,5,3,2,0,2,2,0,0,1
04567760,19,4,15,0,1,1,0,1,1
04567917,24,0,24,0,0,0,0,0,1
04568131,14,6,8,0,0,0,0,0,0
04568500,50,0,50,0,0,0,0,0,1
04568559,5,3,2,0,2,2,0,0,0
04568573,13,3,10,0,1,1,0,1,0
04568583,18,0,18,0,0,0,0,0,1
04568629,2,0,2,0,1,1,0,0,0
04568948,5,3,2,0,2,2,0,0,0
04568984,19,3,16,0,3,2,1,0,1
04569029,2,2,0,0,1,1,0,0,0
04569069,12,4,8,0,3,3,0,0,1
04569102,3,2,1,0,1,1,0,0,0
04569150,15,0,15,0,0,0,0,0,1
04569344,3,0,3,0,0,0,0,0,0
04569346,26,9,17,0,0,0,0,0,1
04569443,9,3,6,0,2,2,0,0,1
04569515,5,1,4,0,1,1,0,0,0
04569647,24,0,24,0,0,0,0,0,1
04569694,19,5,14,0,1,1,0,1,1
04569941,5,1,4,0,1,1,0,0,0
04570140,6,2,4,0,1,1,0,0,0
04570275,25,11,14,0,1,1,0,1,1
04570491,27,0,27,0,0,0,0,0,1
04570516,6,2,4,0,1,1,0,0,1
04570518,4,0,4,0,0,0,0,0,1
04570581,12,5,7,0,0,0,0,0,1
04570951,19,4,15,0,1,1,0,1,1
04571057,12,5,7,0,0,0,0,0,1
04571132,15,4,11,0,0,0,0,0,1
04571628,23,0,23,0,0,0,0,0,1
04572091,5,1,4,0,1,1,0,0,0
04572121,16,0,16,0,0,0,0,0,1
04572348,4,2,2,0,3,3,0,0,0
04572355,6,4,2,0,2,2,0,0,0
04572458,6,1,5,0,0,0,0,0,0
04572959,38,12,26,0,1,1,0,0,1
04573000,3,0,3,0,0,0,0,0,1
04573036,13,0,13,0,0,0,0,0,1
04573090,10,0,10,0,0,0,0,0,1
04573248,27,8,19,0,0,0,0,0,1
04573449,7,1,6,0,0,0,0,0,0
04573608,14,4,10,0,3,3,0,0,1
04573692,6,2,4,0,4,2,2,2,0
04573798,7,3,4,0,2,2,0,0,0
04573848,29,9,20,0,0,0,0,0,0
04574222,6,4,2,0,1,1,0,0,0
04574421,18,2,16,0,0,0,0,0,1
04574790,5,2,3,0,1,1,0,0,1
04575412,13,3,10,0,1,1,0,0,1
04576085,5,3,2,0,0,0,0,0,0
04576114,6,4,2,0,1,1,0,0,0
04576545,20,0,20,0,1,1,0,1,0
04576985,12,0,12,0,0,0,0,0,1
04577002,5,3,2,0,2,2,0,0,0
04577148,12,2,10,0,1,1,0,0,0
04577601,15,3,12,0,1,1,0,1,1
04577702,7,3,4,0,1,1,0,1,1
04577746,5,1,4,0,2,1,1,0,0
04578237,7,0,7,0,0,0,0,0,1
04578394,10,0,10,0,0,0,0,0,1
04578555,12,0,12,0,0,0,0,0,1
04578654,8,3,5,0,2,2,0,0,1
04578730,3,3,0,0,1,1,0,0,1
04579067,24,4,20,0,0,0,0,0,1
04579093,5,3,2,0,1,1,0,0,0
04579095,13,0,13,0,0,0,0,0,1
04579458,6,3,3,0,2,2,0,0,0
04579481,9,3,6,0,0,0,0,0,1
04579498,21,7,14,0,1,1,0,0,1
04579518,16,2,14,0,0,0,0,0,0
11619566,2,2,0,0,2,2,0,0,0
11620012,1,1,0,0,1,1,0,0,0
11620233,1,1,0,0,1,1,0,0,0
11620257,1,1,0,0,1,1,0,0,0
11620418,2,2,0,0,1,1,0,0,0
11620555,2,2,0,0,1,1,0,0,0
11621497,1,1,0,0,1,1,0,0,0
11621637,3,3,0,0,0,0,0,0,1
11621831,9,9,0,0,0,0,0,0,0
11622045,4,4,0,0,0,0,0,0,0
11622303,2,1,1,0,2,1,1,0,0
11622656,2,2,0,0,1,1,0,1,1
11623446,6,6,0,0,1,1,0,1,0
11623447,2,2,0,0,1,1,0,0,1
11623731,4,4,0,0,3,3,0,0,0
11623760,3,3,0,0,4,4,0,1,1
11623777,1,1,0,0,1,1,0,0,0
11624160,2,2,0,0,1,1,0,0,0
11624277,1,1,0,0,2,2,0,0,0
11624699,1,1,0,0,1,1,0,0,0
11624739,6,6,0,0,2,2,0,0,1
11625466,1,1,0,0,0,0,0,0,0
11626056,1,1,0,0,1,1,0,0,0
11626385,1,1,0,0,0,0,0,0,0
11627411,2,1,1,0,2,1,1,0,0
11627500,2,1,1,0,3,2,1,2,0
11627534,2,2,0,0,1,1,0,1,1
11627839,2,2,0,0,2,2,0,0,0
11628127,1,1,0,0,1,1,0,0,0
11628128,1,1,0,0,1,1,0,0,1
11628236,1,1,0,0,1,1,0,0,0
11628286,2,2,0,0,1,1,0,1,1
11628357,1,1,0,0,1,1,0,0,0
11628437,2,2,0,0,2,2,0,0,0
11628803,1,1,0,0,1,1,0,0,0
11628877,1,1,0,0,1,1,0,0,0
11629438,1,1,0,0,2,2,0,0,0
11629627,1,1,0,0,1,1,0,0,0
11629908,2,1,1,0,2,2,0,0,0
11630018,2,2,0,0,2,2,0,0,1
11630066,2,2,0,0,1,1,0,0,1
11630110,1,1,0,0,1,1,0,0,0
11630441,2,2,0,0,1,1,0,0,0
11630494,1,1,0,0,1,1,0,0,0
11630585,1,0,1,0,1,1,0,0,0
11631386,1,1,0,0,1,1,0,0,0
11631414,1,1,0,0,1,1,0,0,0
11631450,1,1,0,0,1,1,0,0,0
11631603,1,1,0,0,1,1,0,0,0
11631665,2,2,0,0,2,2,0,0,0
11631670,2,2,0,0,2,2,0,0,0
11631784,1,1,0,0,1,1,0,0,0
11631909,3,1,2,0,1,1,0,1,0
11631955,2,2,0,0,1,1,0,1,1
11632183,3,1,2,0,1,1,0,1,0
11632394,3,1,2,0,1,1,0,1,0
11632571,2,2,0,0,2,2,0,0,0
11632633,6,5,1,0,2,1,1,2,1
11632651,3,3,0,0,1,1,0,1,1
11632722,1,1,0,0,1,1,0,0,0
11632727,1,1,0,0,1,1,0,0,0
11632909,2,2,0,0,2,2,0,0,0
11633282,5,5,0,0,0,0,0,0,1
11633326,1,1,0,0,1,1,0,0,0
11633498,1,1,0,0,1,1,0,0,0
11634146,2,2,0,0,1,1,0,0,0
11634720,2,2,0,0,1,1,0,0,0
11635239,1,1,0,0,1,1,0,0,0
11635292,2,2,0,0,1,1,0,0,0
11635484,2,2,0,0,2,2,0,0,0
11635663,1,1,0,0,1,1,0,0,0
11635711,2,1,1,0,2,1,1,0,0
11635713,2,2,0,0,2,2,0,0,0
11635856,1,1,0,0,1,1,0,0,0
11636428,1,1,0,0,2,2,0,0,0
11637138,2,2,0,0,2,2,0,0,0
11637140,2,1,1,0,2,1,1,0,0
11637663,1,0,1,0,1,1,0,0,0
11637698,1,0,1,0,1,1,0,0,0
11637902,2,2,0,0,2,2,0,0,0
11639152,4,4,0,0,3,3,0,0,1
11639184,4,4,0,0,3,3,0,0,1
11639361,1,1,0,0,1,1,0,0,0
11639567,2,2,0,0,1,1,0,1,0
11639577,1,1,0,0,1,1,0,0,0
11639615,4,4,0,0,1,1,0,0,0
11639743,1,1,0,0,1,1,0,0,0
11640483,2,2,0,0,1,1,0,1,0
11640831,3,3,0,0,4,4,0,0,1
11640889,1,1,0,0,1,1,0,0,1
11640995,2,1,1,0,2,1,1,0,0
11641574,2,1,1,0,2,1,1,0,0
11641756,1,1,0,0,1,1,0,0,0
11641761,2,1,1,0,2,1,1,0,0
11642293,2,2,0,0,1,1,0,0,0
11642636,1,1,0,0,2,1,1,1,0
11643210,1,1,0,0,1,1,0,0,0
11643719,4,0,4,0,2,0,2,0,0
11643728,2,1,1,0,1,1,0,0,0
11643749,9,9,0,0,0,0,0,0,0
11643774,1,1,0,0,1,1,0,0,0
11643890,2,2,0,0,2,2,0,0,0
11644022,2,1,1,0,2,1,1,0,0
11644219,4,4,0,0,1,1,0,1,1
11644242,3,3,0,0,3,3,0,0,0
11644283,2,2,0,0,2,2,0,0,0
11644492,4,4,0,0,0,0,0,0,0
11644658,2,2,0,0,2,2,0,0,0
11644681,1,1,0,0,1,1,0,0,0
11645089,1,1,0,0,1,1,0,0,0
11645471,3,3,0,0,2,2,0,0,0
11645549,2,2,0,0,2,2,0,0,0
11646140,1,1,0,0,1,1,0,0,0
11646168,2,2,0,0,2,2,0,0,1
11646333,2,2,0,0,2,2,0,0,0
11646531,1,1,0,0,1,1,0,0,0
11646740,3,2,1,0,2,1,1,0,1
11646755,2,2,0,0,2,2,0,0,1
11646844,2,2,0,0,1,1,0,0,0
11647143,2,2,0,0,2,2,0,0,1
11647252,1,1,0,0,1,1,0,0,0
11647266,1,1,0,0,1,1,0,0,0
11647370,11,7,4,0,2,1,1,2,1
11647381,1,1,0,0,2,2,0,0,0
11647392,3,3,0,0,2,2,0,0,0
11647433,11,7,4,0,2,1,1,2,1
11647483,2,1,1,0,2,1,1,0,0
11648031,3,3,0,0,1,1,0,1,1
11648577,3,2,1,0,1,1,0,1,1
11648802,2,2,0,0,2,2,0,0,0
11649067,1,1,0,0,1,1,0,0,0
11649181,1,1,0,0,1,1,0,0,0
11649286,1,1,0,0,1,1,0,0,0
11649428,5,3,2,0,1,1,0,1,0
11649432,1,1,0,0,1,1,0,0,0
11649536,6,3,3,0,0,0,0,0,0
11649558,3,3,0,0,1,1,0,1,1
11649565,3,3,0,0,1,1,0,1,0
11649719,1,0,1,0,0,0,0,0,0
11649742,11,7,4,0,2,1,1,2,1
11649971,1,1,0,0,2,2,0,0,0
11650186,2,2,0,0,1,1,0,0,0
11650377,1,1,0,0,1,1,0,0,0
11650420,2,2,0,0,1,1,0,0,0
11650826,1,1,0,0,1,1,0,0,0
11650893,1,1,0,0,1,1,0,0,0
11651104,8,8,0,0,0,0,0,0,0
11651168,2,2,0,0,0,0,0,0,0
11651289,1,1,0,0,1,1,0,0,0
11651322,1,1,0,0,1,1,0,0,0
11651722,9,9,0,0,0,0,0,0,0
11651739,1,1,0,0,1,1,0,0,0
11652458,3,3,0,0,3,3,0,0,0
11653876,3,3,0,0,1,1,0,0,1
11653917,3,3,0,0,1,1,0,0,1
11654096,4,4,0,0,1,1,0,1,0
11654568,2,2,0,0,1,1,0,0,0
11654805,1,1,0,0,1,1,0,0,0
11655123,3,3,0,0,2,2,0,0,0
11655167,7,4,3,0,2,1,1,2,1
11655444,3,3,0,0,2,2,0,0,0
11655591,1,1,0,0,1,1,0,0,0
11655852,4,4,0,0,1,1,0,1,1
11656333,1,1,0,0,1,1,0,0,0
11656571,1,1,0,0,1,1,0,0,0
11656586,3,3,0,0,1,1,0,0,0
11656657,3,3,0,0,1,1,0,0,0
11656984,2,2,0,0,2,2,0,0,0
11657060,2,2,0,0,1,1,0,0,0
11657112,3,3,0,0,1,1,0,0,0
11657156,1,1,0,0,1,1,0,0,0
11657995,3,3,0,0,2,2,0,0,0
11658097,1,1,0,0,1,1,0,0,0
11658106,2,2,0,0,1,1,0,0,0
11658476,4,3,1,0,2,2,0,0,0
11658725,1,1,0,0,1,1,0,1,1
11658733,3,2,1,0,2,1,1,2,0
11659204,1,1,0,0,1,1,0,0,0
11660203,2,2,0,0,2,2,0,0,0
11660505,2,2,0,0,1,1,0,0,0
11660726,3,3,0,0,0,0,0,0,0
11660937,1,1,0,0,1,1,0,0,0
11661527,4,4,0,0,2,2,0,0,1
11661544,1,1,0,0,1,1,0,0,0
11661899,1,1,0,0,1,1,0,0,0
11661953,1,1,0,0,1,1,0,0,0
11661992,1,1,0,0,1,1,0,0,0
11662173,1,1,0,0,1,1,0,0,0
11662212,1,1,0,0,1,1,0,0,0
11662386,2,2,0,0,2,2,0,0,1
11662398,1,1,0,0,1,1,0,1,0
11662851,2,2,0,0,1,1,0,1,1
11662871,1,1,0,0,1,1,0,0,1
11663047,2,2,0,0,2,2,0,0,1
11663283,1,1,0,0,3,1,2,2,0
11663366,2,2,0,0,1,1,0,0,0
11663436,7,6,1,0,2,0,2,0,0
11663461,4,2,2,0,2,2,0,0,0
11664011,1,1,0,0,1,1,0,0,1
11664195,1,1,0,0,1,1,0,0,0
11664625,3,1,2,0,3,3,0,0,0
11664720,2,2,0,0,1,1,0,0,0
11664883,1,1,0,0,1,1,0,0,0
11664994,6,5,1,0,2,1,1,2,1
11665300,1,1,0,0,1,1,0,0,0
11665315,1,1,0,0,1,1,0,0,0
11665445,1,0,1,0,1,1,0,0,0
11665548,3,3,0,0,0,0,0,0,0
11665666,3,3,0,0,3,3,0,0,0
11665892,2,2,0,0,2,2,0,0,0
11666136,2,2,0,0,1,1,0,0,0
11667091,1,1,0,0,1,1,0,0,0
11667410,1,1,0,0,1,1,0,0,0
11667612,2,2,0,0,2,2,0,0,1
11667677,2,2,0,0,0,0,0,0,1
11668169,2,2,0,0,2,2,0,0,0
11668316,4,3,1,0,0,0,0,0,0
11668710,2,2,0,0,1,1,0,1,1
11668919,5,5,0,0,0,0,0,0,1
11669063,2,2,0,0,2,2,0,0,0
11669650,1,1,0,0,1,1,0,0,0
11669678,1,1,0,0,1,1,0,0,0
11670009,2,2,0,0,2,2,0,0,1
11670163,2,2,0,0,0,0,0,0,0
11670269,2,2,0,0,2,2,0,0,0
11670414,2,2,0,0,1,1,0,1,1
11670422,1,1,0,0,1,1,0,0,0
11671216,2,2,0,0,1,1,0,0,0
11671324,1,1,0,0,1,1,0,0,0
11671329,3,3,0,0,3,3,0,0,0
11671531,1,1,0,0,1,1,0,0,0
11671591,1,1,0,0,1,1,0,0,0
11672173,2,2,0,0,4,3,1,2,0
11672213,2,2,0,0,2,2,0,0,0
11672433,2,2,0,0,1,1,0,0,1
11672621,1,1,0,0,1,1,0,0,0
11673033,1,1,0,0,1,1,0,0,0
11673368,3,3,0,0,2,2,0,0,0
11673691,2,2,0,0,1,1,0,0,0
11674331,1,1,0,0,1,1,0,0,0
11674497,1,1,0,0,1,1,0,1,0
11674516,2,1,1,0,0,0,0,0,0
11674825,1,1,0,0,1,1,0,0,1
11675238,2,1,1,0,2,1,1,0,0
11675827,2,2,0,0,2,2,0,0,0
11676038,4,4,0,0,2,2,0,2,1
11676088,1,1,0,0,1,1,0,0,0
11676180,1,1,0,0,1,1,0,0,0
11676209,1,1,0,0,1,1,0,0,0
11676212,1,1,0,0,1,1,0,0,0
11676418,1,1,0,0,1,1,0,0,0
11676517,1,1,0,0,1,1,0,0,0
11676546,1,1,0,0,1,1,0,0,0
11677495,6,6,0,0,1,1,0,1,1
11677552,6,6,0,0,1,1,0,1,1
11677710,3,3,0,0,0,0,0,0,0
11677727,3,3,0,0,1,1,0,1,1
11677826,1,1,0,0,1,1,0,0,0
11678069,1,1,0,0,1,1,0,0,0
11678354,3,3,0,0,0,0,0,0,0
11678394,5,3,2,0,1,1,0,1,0
11678863,1,1,0,0,1,1,0,0,0
11679431,2,2,0,0,1,1,0,0,0
11679867,2,2,0,0,1,1,0,0,0
11680078,1,1,0,0,1,1,0,0,0
11680122,2,2,0,0,1,1,0,0,0
11680756,3,2,1,0,2,1,1,0,0
11680851,2,2,0,0,1,1,0,0,0
11681796,2,2,0,0,2,2,0,0,0
11681846,2,2,0,0,1,1,0,0,1
11682001,3,3,0,0,1,1,0,1,1
11682249,2,2,0,0,1,1,0,1,1
11682353,4,4,0,0,5,5,0,0,1
11682430,2,2,0,0,1,1,0,1,1
11682524,1,1,0,0,0,0,0,0,0
11682542,4,4,0,0,0,0,0,0,0
11682838,2,2,0,0,2,2,0,0,1
11683284,2,2,0,0,0,0,0,0,0
11683307,1,1,0,0,1,1,0,0,0
11683856,1,1,0,0,1,1,0,0,0
11683868,2,2,0,0,2,2,0,0,0
11684038,1,1,0,0,1,1,0,0,0
11684098,1,1,0,0,1,1,0,0,0
11684101,2,1,1,0,2,1,1,1,0
11684243,2,2,0,0,1,1,0,0,0
11684516,3,3,0,0,2,2,0,0,1
11684612,1,1,0,0,1,1,0,0,0
11684625,3,3,0,0,3,3,0,0,0
11685122,1,1,0,0,1,1,0,0,0
11685580,1,0,1,0,1,1,0,0,0
11685654,1,1,0,0,1,1,0,0,0
11686210,1,1,0,0,1,1,0,0,0
11686474,2,2,0,0,1,1,0,0,1
11686741,1,1,0,0,1,1,0,0,0
11686778,4,4,0,0,2,1,1,1,1
11687292,4,4,0,0,1,1,0,1,1
11687610,4,4,0,0,1,1,0,1,0
11688029,2,1,1,0,1,1,0,0,0
11688050,3,3,0,0,1,1,0,1,1
11688689,2,2,0,0,2,2,0,0,0
11689022,2,2,0,0,1,1,0,0,0
11689132,2,2,0,0,1,1,0,0,0
11689446,2,2,0,0,1,1,0,0,0
11689468,6,4,2,0,2,2,0,0,1
11689797,5,5,0,0,2,1,1,0,0
11689905,1,1,0,0,1,1,0,0,0
11690141,4,3,1,0,1,1,0,1,0
11690289,1,1,0,0,1,1,0,0,0
11690435,1,1,0,0,1,1,0,0,0
11691192,1,1,0,0,1,1,0,0,0
11692247,2,2,0,0,2,2,0,0,0
11692504,1,1,0,0,1,1,0,0,0
11692744,2,1,1,0,2,1,1,0,0
11692947,5,5,0,0,1,1,0,1,0
11693182,2,1,1,0,2,1,1,2,0
11693613,1,1,0,0,1,1,0,0,0
11693687,3,3,0,0,3,3,0,0,0
11693725,7,7,0,0,2,2,0,0,1
11693763,2,2,0,0,1,1,0,0,0
11694067,3,2,1,0,0,0,0,0,1
11694148,3,3,0,0,0,0,0,0,1
11694288,1,1,0,0,1,1,0,0,0
11694624,2,2,0,0,2,2,0,0,0
11694781,1,1,0,0,1,1,0,0,0
11694826,1,1,0,0,1,1,0,0,0
11694986,4,4,0,0,1,1,0,1,1
11695051,1,1,0,0,1,1,0,0,0
11695496,1,1,0,0,2,2,0,0,0
11695498,2,2,0,0,2,2,0,0,0
11695919,1,1,0,0,1,1,0,0,0
11695957,2,2,0,0,2,2,0,0,0
11696240,1,1,0,0,1,1,0,0,0
11696403,1,1,0,0,1,1,0,0,0
11696660,1,1,0,0,1,1,0,0,0
11696676,2,2,0,0,2,2,0,0,0
11697910,3,3,0,0,2,2,0,0,0
11697947,1,1,0,0,1,1,0,0,1
11698298,1,1,0,0,1,1,0,0,0
11698310,2,2,0,0,1,1,0,0,0
11699155,1,1,0,0,1,1,0,0,0
11699540,5,5,0,0,2,2,0,0,0
01284170,52,5,47,0,1,0,1,1,1
01284384,13,0,13,0,0,0,0,0,1
01284413,6,4,2,0,1,1,0,0,0
01284579,21,4,17,0,1,1,0,1,1
01284754,71,7,64,0,1,1,0,1,1
01285030,12,3,9,0,1,1,0,1,1
01285301,47,4,43,0,0,0,0,0,1
01285384,2,2,0,0,1,1,0,0,0
01285706,11,4,7,0,0,0,0,0,0
01285742,2,2,0,0,1,1,0,0,0
01285764,12,3,9,0,1,1,0,1,1
01285981,30,0,30,0,0,0,0,0,1
01286190,15,1,14,0,1,1,0,0,1
01286740,28,3,25,0,0,0,0,0,0
01287383,111,14,97,0,1,1,0,1,1
01287488,13,0,13,0,1,1,0,0,1
01287626,17,0,17,0,0,0,0,0,1
01287713,25,7,18,0,1,1,0,1,1
01288177,33,9,24,0,0,0,0,0,0
01288213,7,0,7,0,0,0,0,0,1
01288938,39,6,33,0,1,1,0,1,1
01289107,29,7,22,0,0,0,0,0,1
01289147,32,4,28,0,2,2,0,2,1
01289296,73,13,60,0,0,0,0,0,1
01289379,13,2,11,0,0,0,0,0,1
01289445,38,0,38,0,0,0,0,0,1
01290055,13,6,7,0,3,2,1,0,1
01290384,13,0,13,0,0,0,0,0,1
01290424,113,8,105,0,0,0,0,0,0
01290521,13,2,11,0,1,1,0,0,1
01290629,35,0,35,0,0,0,0,0,1
01290661,6,3,3,0,1,1,0,0,1
01290976,31,2,29,0,1,1,0,1,1
01291418,24,0,24,0,0,0,0,0,1
01291866,3,2,1,0,1,1,0,0,0
01291876,9,3,6,0,1,1,0,1,1
01292692,21,8,13,0,1,1,0,0,0
01292956,139,7,132,0,1,1,0,1,1
01293025,26,0,26,0,0,0,0,0,1
01293091,25,0,25,0,0,0,0,0,1
01293232,119,14,105,0,0,0,0,0,1
01293463,12,2,10,0,1,1,0,0,1
01293566,58,13,45,0,1,1,0,1,1
01293927,8,3,5,0,2,2,0,0,0
01293962,28,5,23,0,1,1,0,1,1
01294090,42,7,35,0,0,0,0,0,1
01294168,12,0,12,0,0,0,0,0,1
01294636,18,5,13,0,3,1,2,1,1
01294669,2,2,0,0,1,1,0,0,0
01294685,25,0,25,0,0,0,0,0,1
01294885,10,3,7,0,2,2,0,0,1
01295138,6,2,4,0,1,1,0,1,0
01295174,73,13,60,0,0,0,0,0,1
01295183,35,0,35,0,1,1,0,1,1
01295192,26,10,16,0,0,0,0,0,0
01295207,43,4,39,0,1,1,0,1,1
01295856,63,0,63,0,0,0,0,0,1
01296016,50,0,50,0,0,0,0,0,1
01296094,10,2,8,0,1,1,0,1,1
01296528,5,3,2,0,0,0,0,0,1
01296533,13,3,10,0,1,1,0,1,1
01296690,5,3,2,0,3,2,1,0,0
01296752,4,3,1,0,1,1,0,0,1
01296829,37,7,30,0,0,0,0,0,0
01297171,3,3,0,0,1,1,0,0,0
01297313,26,0,26,0,1,1,0,1,1
01297610,4,4,0,0,1,1,0,0,0
01297780,24,5,19,0,1,1,0,1,1
01297941,24,7,17,0,1,1,0,1,1
01298292,43,8,35,0,4,2,2,0,1
01298404,21,0,21,0,0,0,0,0,1
01298682,60,14,46,0,0,0,0,0,1
01299127,14,3,11,0,1,1,0,1,0
01299139,25,0,25,0,1,1,0,1,1
01299174,45,0,45,0,0,0,0,0,1
01299199,9,3,6,0,0,0,0,0,0
01299222,29,2,27,0,2,1,1,2,1
01299337,7,3,4,0,1,1,0,1,0
01299366,2,2,0,0,2,2,0,0,0
01299490,5,2,3,0,2,2,0,0,1
01299541,25,6,19,0,0,0,0,0,0
01299631,19,3,16,0,0,0,0,0,0
01299676,4,2,2,0,2,2,0,0,0
01299727,7,2,5,0,3,1,2,0,0
01299733,45,3,42,0,2,2,0,2,1
01299823,32,4,28,0,6,1,5,2,1
01299996,38,4,34,0,1,0,1,0,0
01300565,67,11,56,0,0,0,0,0,1
01300957,14,0,14,0,0,0,0,0,1
01300965,39,4,35,0,1,1,0,1,1
01301313,12,2,10,0,2,2,0,0,1
01302353,77,7,70,0,0,0,0,0,0
01302416,11,3,8,0,1,1,0,1,1
01302437,12,0,12,0,0,0,0,0,1
01302478,31,10,21,0,0,0,0,0,1
01302947,101,10,91,0,0,0,0,0,1
01303101,21,0,21,0,1,1,0,1,1
01303332,21,0,21,0,0,0,0,0,1
01303475,18,3,15,0,3,3,0,0,0
01303760,5,4,1,0,3,3,0,0,0
01304753,19,5,14,0,0,0,0,0,1
01304888,5,2,3,0,1,1,0,0,0
01304916,5,5,0,0,2,2,0,0,0
01304963,9,6,3,0,1,1,0,0,1
01305030,75,9,66,0,0,0,0,0,1
01305599,0,0,0,0,0,0,0,0,0
01305869,16,0,16,0,1,1,0,1,1
01305876,24,4,20,0,1,1,0,1,1
01306335,30,1,29,0,1,1,0,1,1
01306436,5,3,2,0,1,1,0,0,0
01306875,38,0,38,0,1,1,0,1,1
01307136,11,2,9,0,3,3,0,1,1
01307994,6,1,5,0,1,1,0,0,0
01308385,5,2,3,0,1,1,0,0,0
01308583,86,18,68,0,0,0,0,0,1
01308739,14,0,14,0,1,1,0,1,1
01309643,17,0,17,0,1,1,0,1,1
01310067,41,0,41,0,0,0,0,0,1
01310070,58,10,48,0,0,0,0,0,0
01310502,22,0,22,0,0,0,0,0,1
01310636,81,11,70,0,0,0,0,0,1
01311055,16,4,12,0,1,1,0,1,1
01311315,41,9,32,0,2,2,0,2,1
01311387,6,5,1,0,0,0,0,0,0
01312163,3,3,0,0,0,0,0,0,0
01312218,31,11,20,0,1,1,0,1,1
01312292,25,12,13,0,0,0,0,0,1
01312313,10,5,5,0,1,1,0,1,0
01312337,33,6,27,0,0,0,0,0,0
01312605,12,7,5,0,2,2,0,1,1
01312833,19,10,9,0,3,3,0,0,1
01313045,14,8,6,0,3,3,0,0,1
01313075,4,2,2,0,1,1,0,1,0
01313542,19,4,15,0,0,0,0,0,1
01314077,20,5,15,0,0,0,0,0,1
01314381,33,8,25,0,1,1,0,1,1
01314543,24,7,17,0,0,0,0,0,1
01314592,12,2,10,0,1,1,0,1,1
01314676,48,3,45,0,1,1,0,1,1
01314733,42,4,38,0,0,0,0,0,1
01314879,85,10,75,0,0,0,0,0,1
01315581,27,4,23,0,1,1,0,1,1
01315734,22,0,22,0,1,1,0,1,1
01315795,26,3,23,0,0,0,0,0,1
01316321,6,4,2,0,1,1,0,0,0
01316805,28,4,24,0,1,1,0,1,1
01317074,20,3,17,0,1,1,0,1,1
01317299,6,4,2,0,2,2,0,0,1
01317369,59,8,51,0,2,1,1,0,0
01317421,53,8,45,0,1,1,0,1,1
01317772,47,0,47,0,1,1,0,1,1
01317798,80,3,77,0,1,1,0,1,1
01318080,32,5,27,0,1,1,0,0,0
01318327,6,4,2,0,3,3,0,0,0
01318708,41,5,36,0,2,2,0,2,1
01319183,48,7,41,0,0,0,0,0,1
01319326,23,0,23,0,0,0,0,0,1
01319406,56,15,41,0,0,0,0,0,0
01319421,18,2,16,0,1,1,0,1,1
01319546,13,5,8,0,2,2,0,0,0
01319710,23,7,16,0,0,0,0,0,0
01319722,12,7,5,0,2,2,0,0,0
01319819,25,0,25,0,1,1,0,1,1
01319909,19,4,15,0,1,1,0,1,1
01320773,19,0,19,0,1,1,0,1,1
01321807,20,2,18,0,1,1,0,1,1
01322002,16,2,14,0,1,1,0,0,1
01322161,44,0,44,0,0,0,0,0,1
01322564,35,7,28,0,1,1,0,1,1
01322680,30,0,30,0,0,0,0,0,1
01323394,13,3,10,0,1,1,0,1,1
01323949,27,3,24,0,1,1,0,1,1
01324410,14,5,9,0,4,4,0,0,1
01324414,14,1,13,0,0,0,0,0,1
01324818,5,3,2,0,1,1,0,0,0
01324937,10,2,8,0,1,1,0,1,1
01325752,24,5,19,0,4,4,0,0,1
01325808,24,0,24,0,0,0,0,0,1
01325827,26,3,23,0,0,0,0,0,0
01325939,20,3,17,0,1,1,0,1,1
01326049,4,1,3,0,1,1,0,0,1
01326673,14,0,14,0,0,0,0,0,1
01327326,24,3,21,0,1,1,0,1,1
01327370,13,0,13,0,1,1,0,0,1
01327447,11,5,6,0,0,0,0,0,1
01327534,24,0,24,0,0,0,0,0,1
01327814,135,8,127,0,0,0,0,0,1
01328075,4,2,2,0,1,1,0,0,0
01328098,19,0,19,0,0,0,0,0,1
01328479,26,7,19,0,0,0,0,0,1
01328771,16,4,12,0,1,1,0,0,1
01329000,32,4,28,0,3,2,1,0,1
01329092,55,10,45,0,1,1,0,0,1
01329311,26,4,22,0,1,1,0,1,1
01330505,26,0,26,0,1,1,0,1,1
01331151,12,2,10,0,1,1,0,1,1
01331202,27,7,20,0,0,0,0,0,1
01331303,10,3,7,0,3,2,1,1,1
01331370,60,3,57,0,2,1,1,2,1
01331778,30,5,25,0,1,1,0,1,1
01331817,33,7,26,0,1,1,0,1,1
01332065,28,0,28,0,1,1,0,1,1
01332117,9,6,3,0,1,1,0,1,0
01332483,8,4,4,0,0,0,0,0,1
01332697,9,0,9,0,0,0,0,0,1
01332955,49,12,37,0,0,0,0,0,1
01333017,13,3,10,0,0,0,0,0,1
01333209,26,2,24,0,1,1,0,1,1
01333575,12,2,10,0,1,1,0,1,1
01333878,11,1,10,0,1,1,0,1,0
01334062,20,4,16,0,1,1,0,1,1
01334681,17,2,15,0,4,3,1,1,0
01334873,3,3,0,0,0,0,0,0,0
01335908,9,4,5,0,2,1,1,0,0
01336436,5,3,2,0,3,3,0,0,0
01336570,24,3,21,0,2,1,1,2,1
01336835,7,1,6,0,2,2,0,0,0
01337172,47,6,41,0,1,1,0,1,1
01337265,28,4,24,0,1,1,0,1,1
01337495,44,6,38,0,0,0,0,0,1
01337510,32,8,24,0,1,1,0,1,1
01337912,16,0,16,0,0,0,0,0,1
NI064075,5,3,2,0,2,2,0,0,0
NI064204,5,3,2,0,0,0,0,0,0
NI064502,18,0,18,0,0,0,0,0,0
NI064592,4,2,2,0,1,1,0,0,0
NI064615,10,3,7,0,0,0,0,0,0
NI064661,6,4,2,0,0,0,0,0,0
NI064879,3,3,0,0,1,1,0,1,0
NI064892,5,2,3,0,1,1,0,0,0
NI064989,6,0,6,0,0,0,0,0,0
NI065086,26,4,22,0,1,1,0,1,1
NI065181,21,5,16,0,1,1,0,0,0
NI065598,11,6,5,0,1,1,0,0,0
NI065938,10,2,8,0,1,1,0,0,0
NI066055,9,3,6,0,2,2,0,0,0
NI066215,21,6,15,0,1,1,0,0,0
NI066227,6,2,4,0,1,1,0,1,0
NI066357,3,0,3,0,0,0,0,0,1
NI066477,10,3,7,0,2,2,0,0,0
NI066966,4,3,1,0,1,1,0,0,0
NI067105,5,3,2,0,1,1,0,0,0
NI067298,3,2,1,0,1,1,0,0,0
NI067627,4,3,1,0,0,0,0,0,0
NI067989,17,9,8,0,0,0,0,0,1
NI068179,4,2,2,0,1,1,0,0,0
NI068361,12,10,2,0,1,1,0,0,0
NI068762,5,2,3,0,1,1,0,0,0
NI068771,5,3,2,0,2,2,0,0,1
NI068979,4,1,3,0,1,1,0,0,0
NI069096,6,2,4,0,2,1,1,1,0
NI069219,5,4,1,0,1,1,0,0,0
NI069567,5,2,3,0,1,1,0,0,0
NI069718,5,4,1,0,4,1,3,1,0
NI069719,4,3,1,0,4,2,2,1,0
NI069779,5,3,2,0,0,0,0,0,0
NI069933,22,0,22,0,0,0,0,0,0
NI070316,8,2,6,0,2,2,0,2,0
NI070570,12,0,12,0,0,0,0,0,0
NI070645,5,1,4,0,0,0,0,0,0
NI071172,20,9,11,0,0,0,0,0,0
NI071212,6,2,4,0,1,1,0,0,0
NI071414,11,0,11,0,0,0,0,0,0
NI071415,10,0,10,0,0,0,0,0,0
NI071575,18,8,10,0,0,0,0,0,0
NI071660,13,0,13,0,0,0,0,0,1
NI071688,4,3,1,0,1,1,0,0,0
NI071724,4,0,4,0,1,1,0,0,1
NI071777,13,0,13,0,0,0,0,0,1
NI071861,5,1,4,0,1,1,0,0,0
NI071976,34,12,22,0,0,0,0,0,1
NI072127,10,2,8,0,1,1,0,1,1
NI072159,5,0,5,0,0,0,0,0,0
NI072284,3,1,2,0,1,1,0,0,0
NI072611,2,1,1,0,1,1,0,0,1
NI072666,4,1,3,0,0,0,0,0,0
NI072736,8,3,5,0,1,1,0,0,0
NI072823,4,4,0,0,3,3,0,0,0
NI072882,4,1,3,0,0,0,0,0,0
NI073054,5,5,0,0,4,4,0,0,0
NI073060,7,5,2,0,2,0,2,0,1
NI073136,7,3,4,0,0,0,0,0,0
NI073454,8,3,5,0,2,2,0,0,0
NI073690,6,2,4,0,3,1,2,1,0
NI073771,3,3,0,0,2,2,0,0,0
NI073828,6,3,3,0,1,1,0,0,0
NI073829,5,2,3,0,1,1,0,0,0
NI073832,5,2,3,0,2,2,0,0,0
NI073834,5,1,4,0,1,1,0,0,0
NI073839,7,2,5,0,1,1,0,0,0
NI601058,23,5,18,0,1,0,1,0,1
NI601080,5,2,3,0,0,0,0,0,0
NI601285,6,0,6,0,2,2,0,1,0
NI601341,22,11,11,0,1,1,0,0,0
NI601527,3,3,0,0,1,1,0,1,0
NI601863,3,3,0,0,1,1,0,0,0
NI601906,5,2,3,0,0,0,0,0,0
NI602024,3,1,2,0,2,2,0,0,0
NI602193,7,4,3,0,1,1,0,0,1
NI602218,2,0,2,0,0,0,0,0,0
NI602356,3,3,0,0,1,1,0,0,0
NI602612,1,1,0,0,1,1,0,0,0
NI602640,7,3,4,0,0,0,0,0,0
NI602875,10,6,4,0,2,1,1,1,1
NI603174,6,3,3,0,1,1,0,0,0
NI603221,3,2,1,0,2,2,0,0,1
NI603248,6,2,4,0,1,1,0,1,0
NI603263,3,0,3,0,0,0,0,0,1
NI603270,1,1,0,0,1,1,0,0,0
NI603345,2,2,0,0,2,2,0,0,0
NI603429,1,0,1,0,1,1,0,0,0
NI603743,2,2,0,0,2,2,0,0,0
NI603814,5,0,5,0,0,0,0,0,1
NI603834,4,0,4,0,0,0,0,0,0
NI603919,1,0,1,0,1,1,0,0,0
NI603955,3,3,0,0,1,1,0,0,1
NI603999,12,7,5,0,0,0,0,0,0
NI604175,4,2,2,0,1,1,0,0,0
NI604190,3,2,1,0,0,0,0,0,0
NI604226,4,0,4,0,0,0,0,0,1
NI604227,5,0,5,0,0,0,0,0,1
NI604238,3,0,3,0,0,0,0,0,1
NI604285,14,6,8,0,1,1,0,1,1
NI604430,6,5,1,0,1,1,0,0,1
NI604582,5,1,4,0,1,0,1,0,0
NI604633,2,1,1,0,1,1,0,0,0
NI604717,2,1,1,0,1,1,0,0,0
NI604888,3,0,3,0,1,1,0,0,0
NI604890,3,3,0,0,2,2,0,0,1
NI604905,3,1,2,0,2,1,1,0,0
NI605020,4,3,1,0,1,1,0,0,0
NI605022,4,0,4,0,0,0,0,0,0
NI605194,4,3,1,0,1,1,0,0,0
NI605234,33,11,22,0,0,0,0,0,0
NI605669,3,3,0,0,1,1,0,0,0
NI605794,3,0,3,0,0,0,0,0,0
NI605910,4,2,2,0,1,1,0,1,0
NI606047,3,2,1,0,2,2,0,0,0
NI606156,4,0,4,0,0,0,0,0,0
NI606223,1,1,0,0,1,1,0,0,0
NI606362,12,3,9,0,2,2,0,2,1
NI606409,12,3,9,0,2,2,0,2,1
NI606571,6,4,2,0,3,3,0,0,0
NI606690,2,2,0,0,2,2,0,0,0
NI607093,2,2,0,0,2,2,0,0,0
NI607444,2,2,0,0,2,2,0,0,0
NI607491,6,6,0,0,0,0,0,0,0
NI607517,2,2,0,0,2,2,0,0,0
NI607666,12,9,3,0,0,0,0,0,0
NI607848,6,0,6,0,2,1,1,0,1
NI607916,11,9,2,0,8,7,1,0,0
NI608232,45,9,36,0,0,0,0,0,0
NI608307,4,2,2,0,2,1,1,1,0
NI608362,4,0,4,0,0,0,0,0,0
NI608499,3,2,1,0,2,2,0,0,0
NI608647,2,2,0,0,2,2,0,0,0
NI608667,4,4,0,0,2,2,0,0,1
NI608704,2,2,0,0,2,2,0,0,0
NI608801,3,3,0,0,2,2,0,0,0
NI608920,2,1,1,0,1,1,0,0,0
NI608927,2,0,2,0,0,0,0,0,0
NI608939,39,13,26,0,0,0,0,0,0
NI609003,2,1,1,0,1,1,0,0,0
NI609116,3,1,2,0,0,0,0,0,0
NI609352,1,1,0,0,1,1,0,0,0
NI609447,1,1,0,0,1,1,0,0,0
NI609455,2,2,0,0,2,2,0,0,0
NI609497,6,4,2,0,2,2,0,0,1
NI609573,1,0,1,0,0,0,0,0,0
NI609857,2,2,0,0,2,2,0,0,0
NI610020,4,0,4,0,0,0,0,0,1
NI610230,2,2,0,0,2,2,0,0,0
NI610926,4,0,4,0,0,0,0,0,0
NI610946,5,4,1,0,1,1,0,0,0
NI611099,3,3,0,0,1,1,0,0,0
NI611307,11,10,1,0,4,1,3,1,1
NI611425,2,0,2,0,0,0,0,0,1
NI611438,17,6,11,0,3,3,0,1,1
NI611746,1,1,0,0,1,1,0,0,0
NI611749,7,3,4,0,0,0,0,0,0
NI611863,4,0,4,0,0,0,0,0,0
NI611879,19,7,12,0,0,0,0,0,0
NI611881,1,1,0,0,2,2,0,0,0
NI612007,3,0,3,0,0,0,0,0,0
NI612057,7,6,1,0,0,0,0,0,0
NI612138,3,1,2,0,1,1,0,0,0
NI612260,5,4,1,0,0,0,0,0,1
NI612286,8,7,1,0,1,1,0,0,0
NI612567,13,3,10,0,1,1,0,1,0
NI612572,7,5,2,0,0,0,0,0,0
NI612665,8,6,2,0,5,5,0,0,0
NI612779,2,2,0,0,2,2,0,0,0
NI612949,1,1,0,0,1,1,0,0,0
NI613466,5,0,5,0,0,0,0,0,1
NI613490,2,1,1,0,2,1,1,0,0
NI613588,4,1,3,0,1,1,0,0,1
NI613754,3,2,1,0,1,1,0,1,1
NI613827,3,0,3,0,1,1,0,0,0
NI613999,1,1,0,0,1,1,0,0,0
NI614410,1,0,1,0,0,0,0,0,0
NI614436,2,2,0,0,2,2,0,0,0
NI614491,4,3,1,0,1,1,0,0,0
NI614552,4,4,0,0,2,2,0,0,1
NI614614,12,6,6,0,0,0,0,0,0
NI614882,2,2,0,0,2,2,0,0,0
NI614907,4,0,4,0,0,0,0,0,0
NI614934,5,5,0,0,4,4,0,0,0
NI615222,3,1,2,0,0,0,0,0,0
NI615451,11,0,11,0,0,0,0,0,0
NI615488,5,0,5,0,0,0,0,0,0
NI615520,2,0,2,0,0,0,0,0,0
NI615558,5,4,1,0,3,3,0,0,0
NI615573,8,3,5,0,0,0,0,0,0
NI615623,3,2,1,0,2,2,0,0,0
NI615667,5,5,0,0,0,0,0,0,0
NI615720,2,2,0,0,2,2,0,0,0
NI615722,2,2,0,0,1,1,0,0,0
NI615993,1,1,0,0,1,1,0,0,0
NI616018,3,2,1,0,1,1,0,0,0
NI616135,4,4,0,0,1,1,0,1,0
NI616148,2,2,0,0,1,1,0,0,0
NI616158,1,1,0,0,1,1,0,0,0
NI616236,15,7,8,0,0,0,0,0,0
NI616288,30,17,13,0,0,0,0,0,0
NI616504,3,0,3,0,0,0,0,0,1
NI616505,3,3,0,0,0,0,0,0,1
NI616509,3,0,3,0,0,0,0,0,1
NI616511,3,3,0,0,0,0,0,0,1
NI616520,3,3,0,0,1,1,0,0,0
NI617041,1,0,1,0,0,0,0,0,0
NI617190,2,1,1,0,1,1,0,0,0
NI617486,1,1,0,0,1,1,0,0,0
NI617531,2,0,2,0,0,0,0,0,0
NI617560,1,1,0,0,1,1,0,1,0
NI617614,3,2,1,0,2,2,0,0,0
NI617735,9,4,5,0,1,1,0,1,1
NI617737,9,6,3,0,2,1,1,1,1
NI617770,2,2,0,0,2,2,0,0,0
NI618266,15,4,11,0,5,4,1,0,0
NI618431,1,1,0,0,1,1,0,0,0
NI618454,1,1,0,0,1,1,0,0,0
NI618455,1,1,0,0,1,1,0,0,0
NI618558,3,3,0,0,2,2,0,0,0
NI618641,4,0,4,0,0,0,0,0,1
NI618751,8,3,5,0,1,1,0,1,1
NI618759,3,0,3,0,0,0,0,0,0
NI618790,2,2,0,0,1,1,0,0,0
NI619522,2,2,0,0,2,2,0,0,0
NI619544,4,3,1,0,1,1,0,1,0
NI619572,1,0,1,0,0,0,0,0,0
NI619703,1,0,1,0,0,0,0,0,0
NI619976,1,1,0,0,1,1,0,0,0
NI620108,5,0,5,0,1,1,0,0,0
NI620246,5,2,3,0,1,1,0,1,1
NI620281,2,1,1,0,1,1,0,0,0
NI620388,1,0,1,0,0,0,0,0,0
NI620434,1,1,0,0,1,1,0,0,0
NI620632,1,1,0,0,1,1,0,0,0
NI620839,2,2,0,0,2,2,0,0,0
NI620996,2,2,0,0,2,2,0,0,0
NI621003,6,6,0,0,1,1,0,0,0
NI621142,9,7,2,0,0,0,0,0,0
NI621322,1,1,0,0,1,1,0,0,0
NI621339,3,0,3,0,1,1,0,0,0
NI621509,6,4,2,0,2,2,0,0,1
NI621585,1,1,0,0,1,1,0,0,0
NI621599,2,2,0,0,1,1,0,0,0
NI621611,4,4,0,0,3,3,0,0,1
NI621615,1,0,1,0,0,0,0,0,0
NI621790,17,12,5,0,1,1,0,0,0
NI621995,5,2,3,0,1,1,0,0,0
NI622062,2,0,2,0,0,0,0,0,1
NI622229,5,2,3,0,4,3,1,0,0
NI622316,1,1,0,0,1,1,0,0,0
NI622589,1,0,1,0,0,0,0,0,0
NI622768,10,6,4,0,3,3,0,1,1
NI622804,2,2,0,0,1,1,0,0,0
NI622935,1,1,0,0,1,1,0,0,0
NI623061,3,3,0,0,0,0,0,0,0
NI623214,1,0,1,0,0,0,0,0,0
NI623376,5,4,1,0,4,4,0,0,0
NI623433,13,7,6,0,1,0,1,0,0
NI623437,6,1,5,0,3,1,2,3,0
NI623438,5,5,0,0,5,4,1,0,0
NI623838,10,6,4,0,2,2,0,0,1
NI624057,2,2,0,0,1,1,0,0,0
NI624092,13,7,6,0,1,1,0,0,0
NI624259,3,0,3,0,1,1,0,0,0
NI624421,1,1,0,0,1,1,0,0,0
NI624476,4,4,0,0,2,2,0,0,1
NI624790,10,5,5,0,1,1,0,1,1
NI624914,5,4,1,0,1,1,0,0,1
NI624990,3,1,2,0,1,1,0,0,0
NI625175,1,1,0,0,1,1,0,0,0
NI625235,1,1,0,0,1,1,0,0,0
NI625355,4,3,1,0,4,4,0,1,0
NI625391,1,1,0,0,1,1,0,0,0
NI625401,1,1,0,0,1,1,0,0,0
NI625426,1,1,0,0,1,1,0,0,0
NI625523,2,0,2,0,0,0,0,0,0
NI625571,3,1,2,0,2,1,1,0,0
NI625819,2,1,1,0,1,1,0,0,0
NI626181,7,4,3,0,1,1,0,1,0
NI626182,7,4,3,0,1,1,0,1,0
NI626438,4,2,2,0,2,1,1,0,0
NI626450,4,3,1,0,1,1,0,1,0
NI626475,7,0,7,0,2,2,0,0,0
NI626604,3,2,1,0,2,2,0,0,0
NI626709,2,1,1,0,1,1,0,0,0
NI626976,1,0,1,0,0,0,0,0,0
NI627176,2,2,0,0,1,1,0,0,0
NI627177,3,0,3,0,0,0,0,0,1
NI627178,1,1,0,0,1,1,0,0,0
NI627179,1,1,0,0,1,1,0,0,0
NI627241,22,4,18,0,6,2,4,0,0
NI627294,1,1,0,0,2,2,0,0,0
NI627409,2,2,0,0,1,1,0,0,0
NI627535,3,0,3,0,1,1,0,0,0
NI627611,1,0,1,0,1,1,0,0,0
NI627819,1,0,1,0,1,1,0,0,0
NI627924,2,0,2,0,0,0,0,0,0
NI627932,3,2,1,0,0,0,0,0,0
NI628034,1,1,0,0,1,1,0,0,0
NI628075,2,2,0,0,2,1,1,1,0
NI628111,1,1,0,0,1,1,0,0,0
NI628191,1,0,1,0,1,1,0,0,0
NI628384,41,27,14,0,0,0,0,0,1
NI628436,2,0,2,0,0,0,0,0,0
NI628638,2,0,2,0,0,0,0,0,1
NI628652,3,2,1,0,2,2,0,0,0
NI628684,1,1,0,0,1,1,0,0,0
NI628716,3,2,1,0,4,4,0,2,0
NI628740,1,1,0,0,1,1,0,0,0
NI628783,4,0,4,0,0,0,0,0,0
10180516,3,2,1,0,2,2,0,0,0
10180696,2,0,2,0,0,0,0,0,0
10181340,1,1,0,0,1,1,0,0,0
10181564,3,3,0,0,1,1,0,1,0
10181606,3,3,0,0,1,1,0,1,0
10181619,3,3,0,0,1,1,0,0,0
10181814,2,0,2,0,0,0,0,0,1
10182391,7,6,1,0,2,1,1,2,1
10182462,13,7,6,0,1,1,0,1,1
10184215,4,3,1,0,4,4,0,0,1
10184613,2,2,0,0,3,3,0,1,0
10184812,3,1,2,0,1,1,0,0,1
10185051,2,0,2,0,1,1,0,0,0
10185326,1,1,0,0,1,1,0,0,0
10185399,9,6,3,0,1,0,1,1,1
10185628,7,6,1,0,2,2,0,0,1
10185732,1,1,0,0,1,1,0,0,1
10186914,1,1,0,0,1,1,0,0,0
10187305,15,11,4,0,0,0,0,0,1
10187316,3,2,1,0,1,1,0,1,1
10187373,5,5,0,0,0,0,0,0,0
10187469,1,0,1,0,1,1,0,0,0
10187538,1,0,1,0,1,1,0,0,1
10188706,5,5,0,0,6,6,0,0,1
10188710,5,2,3,0,1,1,0,1,1
10188722,1,1,0,0,1,1,0,0,0
10188732,1,1,0,0,2,2,0,0,0
10188776,5,5,0,0,6,6,0,0,1
10188794,5,2,3,0,1,1,0,1,1
10188871,3,3,0,0,3,3,0,0,1
10188990,4,3,1,0,1,1,0,1,0
10189050,6,4,2,0,4,3,1,0,1
10189060,6,2,4,0,1,1,0,1,1
10189370,2,2,0,0,1,1,0,1,1
10189548,5,2,3,0,1,1,0,1,1
10189944,13,7,6,0,0,0,0,0,1
10189982,2,2,0,0,1,1,0,1,1
10190286,6,1,5,0,6,1,5,0,1
10190788,2,0,2,0,2,2,0,0,0
10191222,4,1,3,0,1,1,0,0,0
10191380,1,0,1,0,1,1,0,0,0
10191390,4,4,0,0,3,3,0,0,1
10191397,1,1,0,0,1,1,0,1,0
10191434,1,1,0,0,4,3,1,0,0
10191617,3,2,1,0,1,1,0,1,0
10191634,6,4,2,0,1,1,0,1,1
10191770,6,4,2,0,1,1,0,1,1
10192037,3,1,2,0,1,1,0,0,0
10192087,1,0,1,0,0,0,0,0,0
10192256,1,0,1,0,1,1,0,0,0
10192975,4,3,1,0,1,1,0,0,1
10192979,2,2,0,0,0,0,0,0,0
10193072,4,3,1,0,1,1,0,0,1
10193164,3,3,0,0,1,1,0,0,0
10193207,2,2,0,0,1,1,0,1,1
10193247,1,1,0,0,1,1,0,0,0
10193466,2,2,0,0,1,1,0,0,0
10193694,3,3,0,0,1,1,0,1,1
10193701,3,2,1,0,2,2,0,0,1
10193765,2,2,0,0,1,1,0,0,0
10193932,2,2,0,0,1,1,0,0,1
10194182,2,1,1,0,1,0,1,1,1
10194230,2,0,2,0,2,2,0,0,0
10194440,3,2,1,0,3,3,0,0,0
10195411,15,6,9,0,1,1,0,1,1
10195435,1,0,1,0,0,0,0,0,0
10195484,2,0,2,0,2,1,1,0,0
10195971,1,1,0,0,1,1,0,1,0
10198109,4,3,1,0,4,3,1,0,0
10198509,2,2,0,0,2,2,0,0,0
10198510,1,1,0,0,1,1,0,0,0
10198575,2,2,0,0,2,2,0,0,0
10198766,2,2,0,0,2,2,0,0,0
10198981,2,2,0,0,1,1,0,1,1
10199186,2,1,1,0,1,1,0,0,0
10199206,2,1,1,0,1,1,0,0,0
10199245,3,2,1,0,2,1,1,1,1
10199286,1,1,0,0,1,1,0,0,0
10199479,3,3,0,0,5,5,0,2,1
10199802,5,3,2,0,0,0,0,0,1
10199861,2,2,0,0,2,2,0,0,0
10200469,2,0,2,0,2,2,0,0,0
10200598,2,0,2,0,1,1,0,0,0
10200740,1,0,1,0,1,1,0,0,0
10200917,1,1,0,0,1,1,0,0,0
10201000,3,3,0,0,1,1,0,0,1
10201377,1,0,1,0,0,0,0,0,0
10201730,9,8,1,0,0,0,0,0,1
10201784,1,0,1,0,1,1,0,0,0
10201790,1,1,0,0,1,1,0,0,0
10201881,1,0,1,0,1,1,0,0,0
10201901,2,2,0,0,3,2,1,0,1
10202014,3,3,0,0,1,1,0,0,1
10202193,3,2,1,0,3,3,0,0,1
10202262,1,1,0,0,1,1,0,0,0
10203037,2,2,0,0,1,1,0,0,1
10203345,2,1,1,0,0,0,0,0,0
10203800,5,0,5,0,1,1,0,0,0
10203923,1,1,0,0,1,1,0,0,0
10204158,1,0,1,0,0,0,0,0,0
10204550,5,4,1,0,2,2,0,2,1
10204667,11,8,3,0,0,0,0,0,1
10204683,3,2,1,0,1,1,0,0,1
10204723,3,2,1,0,1,1,0,0,1
10204847,1,1,0,0,1,1,0,0,0
10205102,2,1,1,0,1,1,0,0,0
10205282,3,2,1,0,2,1,1,2,0
10206451,1,1,0,0,1,1,0,0,0
10206763,2,2,0,0,1,1,0,0,0
10207048,3,0,3,0,3,2,1,0,0
10208081,2,1,1,0,1,1,0,0,0
10208190,1,1,0,0,1,1,0,0,0
10208733,3,3,0,0,2,2,0,0,0
10209218,5,4,1,0,1,1,0,0,0
10209876,1,0,1,0,0,0,0,0,0
10210432,2,1,1,0,1,1,0,0,0
10210477,3,2,1,0,3,1,2,1,0
10210479,3,1,2,0,2,1,1,0,0
10210724,2,2,0,0,1,1,0,0,1
10211762,1,0,1,0,1,1,0,0,1
10212206,2,2,0,0,2,2,0,0,0
10212398,1,1,0,0,1,1,0,0,0
10212813,3,3,0,0,2,2,0,0,0
10213452,6,6,0,0,0,0,0,0,0
10213753,2,1,1,0,1,1,0,0,0
10213767,2,2,0,0,2,2,0,0,0
10214265,2,2,0,0,0,0,0,0,0
10214326,4,3,1,0,3,3,0,0,0
10214411,8,7,1,0,0,0,0,0,0
10214476,1,1,0,0,1,1,0,0,0
10214479,1,0,1,0,1,1,0,0,1
10214606,2,0,2,0,2,2,0,1,0
10214748,2,2,0,0,0,0,0,0,1
10215263,1,0,1,0,1,1,0,0,0
10215313,1,0,1,0,0,0,0,0,0
10215327,2,0,2,0,0,0,0,0,0
10215389,2,1,1,0,2,2,0,0,0
10215527,3,2,1,0,1,1,0,0,0
10215616,2,2,0,0,1,1,0,0,0
10215649,3,2,1,0,2,1,1,1,1
10216313,1,1,0,0,1,1,0,0,0
10216326,1,1,0,0,1,1,0,0,0
10216419,7,5,2,0,1,1,0,1,1
10216643,1,1,0,0,2,2,0,1,0
10216853,1,1,0,0,1,1,0,0,0
10217163,5,3,2,0,1,1,0,1,1
10217353,1,0,1,0,0,0,0,0,0
10217359,1,1,0,0,1,1,0,0,0
10217489,2,2,0,0,1,1,0,0,0
10217902,1,0,1,0,0,0,0,0,0
10218776,1,1,0,0,1,1,0,0,0
10219644,6,2,4,0,2,2,0,0,1
10220057,2,2,0,0,3,3,0,0,1
10220428,2,0,2,0,1,1,0,0,0
10220488,1,1,0,0,1,1,0,0,0
10220584,4,4,0,0,1,1,0,1,1
10220648,5,3,2,0,0,0,0,0,0
10221394,1,1,0,0,1,1,0,0,0
10221541,1,1,0,0,1,1,0,0,0
10221548,21,7,14,0,0,0,0,0,0
10221596,8,6,2,0,0,0,0,0,0
10222534,5,2,3,0,1,1,0,1,1
10223277,3,3,0,0,1,1,0,0,1
10223290,3,0,3,0,3,2,1,0,0
10223320,1,0,1,0,0,0,0,0,1
10223574,2,0,2,0,0,0,0,0,0
10223890,4,0,4,0,4,4,0,0,0
10224375,1,1,0,0,2,2,0,0,0
10224693,3,0,3,0,0,0,0,0,1
10224785,15,12,3,0,0,0,0,0,1
10225078,2,2,0,0,1,1,0,0,1
10225188,3,2,1,0,1,1,0,1,1
10225221,2,0,2,0,1,1,0,0,0
10225302,2,2,0,0,2,2,0,0,0
10225502,2,2,0,0,1,1,0,0,0
10226137,4,2,2,0,1,1,0,1,1
10226588,2,2,0,0,2,2,0,0,1
10226779,4,4,0,0,0,0,0,0,0
10227051,15,7,8,0,0,0,0,0,0
10227117,1,1,0,0,1,1,0,0,0
10227273,3,1,2,0,1,0,1,0,0
10227312,3,2,1,0,0,0,0,0,0
10227576,12,10,2,0,0,0,0,0,1
10227598,2,2,0,0,2,2,0,0,0
10227899,1,0,1,0,1,1,0,0,0
10228920,1,1,0,0,1,1,0,0,0
10229632,6,3,3,0,1,1,0,1,0
10229698,2,1,1,0,1,1,0,1,1
10229703,3,1,2,0,2,1,1,0,0
10230003,1,1,0,0,1,1,0,1,1
10230007,1,1,0,0,1,1,0,1,1
10230020,1,0,1,0,1,1,0,0,0
10230276,2,2,0,0,2,2,0,0,1
10230465,7,4,3,0,1,0,1,1,1
10230891,2,0,2,0,0,0,0,0,1
10230895,1,0,1,0,1,1,0,0,0
10231285,2,1,1,0,1,1,0,0,1
10231479,2,1,1,0,1,1,0,0,1
10231689,15,10,5,0,0,0,0,0,1
10231718,13,6,7,0,2,1,1,0,1
10231817,3,2,1,0,1,1,0,1,0
10231975,7,6,1,0,2,1,1,2,1
10232342,1,1,0,0,1,1,0,0,0
10232721,4,4,0,0,4,4,0,0,0
10232878,2,2,0,0,1,1,0,0,1
10232984,6,2,4,0,1,1,0,1,1
10233203,3,1,2,0,0,0,0,0,0
10233210,2,1,1,0,1,1,0,0,0
10233663,1,1,0,0,1,1,0,0,0
10233818,1,1,0,0,1,1,0,0,0
10234041,7,5,2,0,6,1,5,1,1
10234415,2,1,1,0,2,1,1,0,1
10234485,2,1,1,0,1,1,0,0,0
10234758,4,4,0,0,1,1,0,1,0
10234854,2,2,0,0,2,2,0,0,0
10235161,2,0,2,0,0,0,0,0,0
10235304,10,5,5,0,0,0,0,0,1
10235321,1,1,0,0,1,1,0,0,0
10236128,1,1,0,0,1,1,0,0,0
10236537,6,3,3,0,2,2,0,0,1
10236554,7,4,3,0,1,0,1,1,1
10236572,6,3,3,0,2,0,2,0,1
10236607,7,5,2,0,1,1,0,0,0
10236669,2,2,0,0,1,1,0,0,1
10238697,9,6,3,0,9,6,3,0,0
10238938,2,1,1,0,1,1,0,1,0
10239438,2,1,1,0,1,1,0,0,0
10239531,8,3,5,0,4,1,3,2,1
10239791,1,1,0,0,3,3,0,1,0
10240209,8,5,3,0,2,2,0,0,1
10240237,3,1,2,0,2,2,0,0,1
10240295,3,2,1,0,1,1,0,1,0
10241268,8,8,0,0,1,1,0,0,1
10241431,5,2,3,0,1,1,0,1,1
10241523,5,2,3,0,1,1,0,1,1
10241993,5,4,1,0,3,0,3,0,1
10242375,1,1,0,0,1,1,0,0,1
10242996,1,1,0,0,0,0,0,0,0
10243118,4,2,2,0,0,0,0,0,0
10243277,3,0,3,0,2,1,1,0,0
10243907,1,1,0,0,0,0,0,0,0
10244141,2,2,0,0,1,1,0,0,0
10244370,2,2,0,0,0,0,0,0,0
10244589,4,4,0,0,1,1,0,0,0
10244736,6,5,1,0,1,1,0,1,0
10245109,1,1,0,0,1,1,0,0,0
10245142,1,1,0,0,1,1,0,0,0
10245306,1,1,0,0,1,1,0,0,1
10245349,2,2,0,0,2,2,0,0,1
10245437,2,2,0,0,2,2,0,0,0
10246155,1,1,0,0,1,1,0,0,0
10246288,1,0,1,0,0,0,0,0,0
10246426,2,1,1,0,0,0,0,0,0
10247250,1,1,0,0,1,1,0,0,0
10247578,2,2,0,0,1,1,0,0,1
10247793,2,2,0,0,1,1,0,0,1
10247798,4,4,0,0,0,0,0,0,1
10248807,1,1,0,0,1,1,0,0,0
10248894,1,0,1,0,0,0,0,0,1
10248906,6,2,4,0,0,0,0,0,1
10249615,1,0,1,0,1,1,0,0,0
10249626,1,1,0,0,1,1,0,0,0
10249782,1,1,0,0,1,1,0,0,0
10249914,2,0,2,0,0,0,0,0,0
10250225,3,3,0,0,2,2,0,0,1
10250660,2,1,1,0,2,1,1,1,0
10250694,4,3,1,0,0,0,0,0,0
10250698,7,3,4,0,1,1,0,1,1
10250798,12,9,3,0,0,0,0,0,0
10250863,2,1,1,0,1,1,0,0,0
10250908,3,1,2,0,3,1,2,0,0
10250958,19,11,8,0,0,0,0,0,1
10251221,3,2,1,0,3,1,2,1,1
10251297,2,2,0,0,2,2,0,0,1
10251495,7,6,1,0,0,0,0,0,0
10251524,2,0,2,0,1,1,0,0,1
10251736,3,3,0,0,0,0,0,0,0
10251914,1,1,0,0,0,0,0,0,0
10252466,3,1,2,0,1,1,0,0,0
10252558,1,1,0,0,1,1,0,0,0
10252788,1,1,0,0,1,1,0,0,0
10252805,1,0,1,0,1,1,0,0,0
10252836,3,0,3,0,0,0,0,0,1
10252879,3,3,0,0,1,1,0,1,1
10253185,6,3,3,0,1,1,0,1,1
10253380,1,1,0,0,1,1,0,0,0
10253455,1,1,0,0,0,0,0,0,0
10253772,1,0,1,0,0,0,0,0,0
10254412,2,1,1,0,1,1,0,0,0
10254516,1,0,1,0,1,1,0,0,0
10254606,1,1,0,0,1,1,0,0,0
10255496,7,5,2,0,1,1,0,1,1
10255867,1,1,0,0,1,1,0,0,0
10256065,2,0,2,0,0,0,0,0,1
10257177,10,4,6,0,0,0,0,0,0
10257238,3,2,1,0,1,1,0,0,0
10257304,1,1,0,0,1,1,0,0,0
10257389,6,3,3,0,1,1,0,1,0
10257405,2,1,1,0,1,1,0,0,0
10257443,9,7,2,0,3,2,1,2,1
10257450,5,3,2,0,3,0,3,0,0
10257677,4,2,2,0,3,2,1,0,1
10257711,1,0,1,0,0,0,0,0,1
10257759,2,0,2,0,0,0,0,0,0
10257787,7,5,2,0,1,1,0,0,0
10258521,1,1,0,0,1,1,0,0,1
10258596,1,1,0,0,1,1,0,0,0
10258704,15,9,6,0,0,0,0,0,0
10259257,1,1,0,0,1,1,0,0,0
10259550,1,0,1,0,1,1,0,0,0
10259651,10,4,6,0,3,1,2,3,1
10259705,11,5,6,0,3,1,2,3,1
10259759,4,0,4,0,1,1,0,0,1
OC385057,2,0,2,0,0,0,0,0,1
OC385121,2,0,2,0,0,0,0,0,1
OC385143,114,3,111,0,2,2,0,1,1
OC385203,2,2,0,0,1,1,0,0,0
OC385350,3,0,3,0,1,1,0,1,0
OC385478,11,9,2,0,1,1,0,1,1
OC385635,44,19,25,0,3,3,0,2,1
OC385820,63,50,13,0,0,0,0,0,0
OC385942,2,2,0,0,2,2,0,2,0
OC385980,2,0,2,0,0,0,0,0,1
OC386161,2,0,2,0,0,0,0,0,0
OC386255,3,2,1,0,1,1,0,0,1
OC386506,4,3,1,0,4,4,0,0,1
OC386558,5,2,3,1,3,0,3,0,1
OC386559,17,14,3,6,1,1,0,1,1
OC386678,11,8,3,0,0,0,0,0,1
OC386692,3,0,3,0,1,1,0,0,0
OC386749,3,2,1,0,2,1,1,1,0
OC387112,3,0,3,0,0,0,0,0,1
OC387230,3,3,0,0,3,3,0,0,0
OC387525,6,5,1,0,1,1,0,1,1
OC387766,2,2,0,0,2,2,0,0,0
OC388098,3,3,0,0,1,1,0,0,0
OC388179,11,9,2,1,10,8,2,1,1
OC388392,3,0,3,0,2,2,0,0,1
OC388512,3,0,3,0,0,0,0,0,1
OC388535,3,2,1,0,2,2,0,0,0
OC388704,4,1,3,0,1,1,0,1,0
OC388717,2,2,0,0,1,1,0,0,0
OC388738,3,2,1,0,0,0,0,0,0
OC389623,17,15,2,0,1,1,0,0,1
OC390004,3,0,3,0,0,0,0,0,1
OC390123,54,34,20,0,0,0,0,0,0
OC390321,4,3,1,0,1,1,0,0,0
OC390330,6,0,6,0,0,0,0,0,1
OC390366,4,0,4,0,2,2,0,0,1
OC390652,48,39,9,0,1,1,0,1,1
OC390718,3,0,3,1,2,1,1,0,0
OC390981,2,2,0,0,2,2,0,0,1
OC391120,17,0,17,0,0,0,0,0,0
OC391241,4,3,1,0,3,3,0,0,0
OC391350,5,2,3,0,2,1,1,2,0
OC391376,2,2,0,0,2,2,0,0,0
OC391377,4,2,2,0,3,2,1,0,1
OC391409,3,2,1,0,1,1,0,1,1
OC391526,39,39,0,0,0,0,0,0,1
OC391850,3,3,0,0,3,3,0,0,0
OC391874,2,0,2,0,0,0,0,0,1
OC391969,7,7,0,0,6,6,0,1,1
OC391999,5,5,0,0,1,1,0,0,1
OC392102,17,17,0,0,0,0,0,0,1
OC392114,3,3,0,0,1,1,0,1,1
OC392408,4,0,4,4,1,1,0,0,0
OC392611,4,2,2,0,1,1,0,0,1
OC392822,5,2,3,2,3,1,2,2,0
OC392873,2,2,0,0,1,1,0,0,1
OC392991,2,2,0,0,2,2,0,0,0
OC393282,15,3,12,1,1,1,0,0,0
OC393640,5,2,3,0,1,1,0,0,0
OC393681,3,0,3,0,3,2,1,0,0
OC393829,2,2,0,0,2,2,0,0,1
OC393866,6,5,1,0,0,0,0,0,1
OC393904,4,3,1,1,2,2,0,2,0
OC394249,24,24,0,0,0,0,0,0,1
OC394386,3,3,0,0,1,1,0,0,1
OC394559,3,2,1,2,1,1,0,0,0
OC394615,4,3,1,1,2,1,1,2,0
OC394765,5,3,2,1,1,1,0,0,0
OC394868,7,3,4,0,3,1,2,0,0
OC394937,2,2,0,0,1,1,0,0,0
OC395020,2,2,0,0,2,2,0,2,0
OC395187,4,2,2,0,1,1,0,0,1
OC395202,30,29,1,3,1,1,0,1,1
OC395319,4,0,4,4,2,1,1,1,0
OC395336,7,0,7,0,1,1,0,0,0
OC395361,3,2,1,0,2,2,0,0,1
OC395405,6,2,4,0,0,0,0,0,1
OC395428,3,3,0,0,1,1,0,0,0
OC395431,5,3,2,2,3,2,1,3,0
OC395446,4,3,1,0,3,2,1,3,0
OC395725,2,2,0,0,2,2,0,0,0
OC395728,11,11,0,0,2,2,0,0,0
OC395814,4,3,1,0,2,1,1,2,0
OC395955,5,0,5,2,0,0,0,0,1
OC396008,4,2,2,1,6,2,4,0,0
OC396613,6,5,1,0,3,2,1,0,1
OC396832,2,2,0,0,2,2,0,2,0
OC397020,4,2,2,0,2,1,1,2,0
OC397049,4,2,2,1,2,1,1,2,0
OC397142,10,4,6,1,2,1,1,1,0
OC397150,3,3,0,0,2,2,0,0,1
OC397448,6,4,2,0,2,0,2,2,1
OC397478,2,2,0,0,2,2,0,0,1
OC397480,2,0,2,0,0,0,0,0,0
OC397796,14,11,3,0,0,0,0,0,0
OC398347,6,6,0,0,1,1,0,0,1
OC398483,4,4,0,0,2,2,0,0,1
OC398599,6,0,6,0,0,0,0,0,0
OC398610,5,5,0,0,3,3,0,1,1
OC398640,10,5,5,0,0,0,0,0,1
OC398731,14,11,3,0,1,1,0,0,1
OC398733,4,2,2,1,1,1,0,1,1
OC398835,6,2,4,0,1,1,0,0,1
OC399122,4,2,2,0,1,1,0,0,0
OC399130,3,2,1,1,1,1,0,1,0
OC399308,8,8,0,1,3,3,0,1,0
OC399327,5,4,1,0,1,1,0,0,1
OC399610,2,2,0,0,1,1,0,0,0
OC399667,2,2,0,0,2,2,0,0,0
OC399694,2,2,0,0,2,2,0,2,0
OC399767,4,4,0,2,0,0,0,0,1
OC399786,8,7,1,0,2,2,0,0,0
OC399906,4,3,1,1,2,1,1,2,0
OC399908,4,3,1,0,2,1,1,2,0
OC399957,5,4,1,0,0,0,0,0,0
OC399969,141,127,14,0,0,0,0,0,1
OC400105,4,4,0,0,2,2,0,2,1
OC400187,2,2,0,0,2,2,0,0,1
OC400286,32,28,4,0,1,1,0,0,1
OC400400,5,0,5,0,0,0,0,0,1
OC400435,3,3,0,0,0,0,0,0,1
OC400463,2,2,0,0,2,2,0,0,0
OC400549,2,2,0,0,2,2,0,0,0
OC400667,4,2,2,4,1,1,0,0,0
OC401071,4,2,2,0,3,3,0,3,0
OC401136,3,3,0,1,0,0,0,0,0
OC401143,2,2,0,0,2,2,0,0,1
OC401365,2,0,2,0,2,2,0,0,0
OC401415,3,2,1,0,1,1,0,0,0
OC401458,9,4,5,1,2,1,1,1,0
OC401623,2,0,2,0,2,1,1,0,0
OC401716,2,0,2,0,0,0,0,0,0
OC401990,3,3,0,0,1,1,0,0,1
OC402071,2,0,2,0,1,1,0,0,0
OC402270,3,2,1,0,3,2,1,3,0
OC402310,14,13,1,0,0,0,0,0,1
OC402449,4,0,4,0,0,0,0,0,1
OC402475,66,0,66,0,0,0,0,0,1
OC402724,3,2,1,0,2,2,0,0,1
OC403003,146,120,26,0,2,1,1,2,1
OC403274,6,0,6,0,0,0,0,0,1
OC403461,4,4,0,0,4,2,2,0,1
OC403707,17,12,5,0,1,1,0,0,0
OC404136,2,2,0,0,2,2,0,2,0
OC404137,2,2,0,0,2,2,0,2,0
OC404141,2,2,0,2,1,1,0,1,0
OC404524,2,2,0,1,1,1,0,1,0
OC404733,2,2,0,0,2,2,0,0,0
OC407301,53,34,19,0,2,1,1,0,0
OC407343,3,3,0,0,2,2,0,2,0
OC407421,2,2,0,0,2,2,0,0,0
OC407531,2,2,0,2,0,0,0,0,0
OC407681,7,7,0,0,2,2,0,0,0
OC411434,3,3,0,0,3,3,0,0,1
OC411463,4,4,0,0,1,1,0,0,0
OC411493,2,2,0,0,2,2,0,0,0
OC411588,2,2,0,0,2,2,0,0,1
OC412076,536,450,86,0,1,0,1,1,1
OC412120,2,0,2,0,0,0,0,0,1
OC412145,5,0,5,0,4,4,0,0,0
OC412216,2,2,0,0,2,2,0,0,0
OC412251,2,2,0,0,2,2,0,0,1
OC412478,4,4,0,0,0,0,0,0,1
OC412593,2,2,0,0,2,2,0,0,0
OC412642,4,2,2,0,2,1,1,0,0
OC412653,8,8,0,1,1,1,0,0,1
OC412900,3,2,1,0,3,2,1,3,0
OC412919,3,2,1,0,3,2,1,3,0
OC413013,10,10,0,0,3,1,2,1,1
OC413373,3,0,3,0,3,3,0,0,0
OC413420,34,33,1,0,1,1,0,1,1
OC413421,59,55,4,0,1,1,0,1,1
OC413586,21,21,0,0,2,0,2,0,1
OC413841,2,2,0,0,2,2,0,2,0
OC413843,2,0,2,0,2,2,0,0,0
OC413950,10,10,0,0,1,1,0,0,1
OC414013,2,0,2,0,4,4,0,2,1
OC414185,2,0,2,0,2,2,0,1,1
OC414286,2,0,2,0,1,1,0,1,1
OC414334,4,3,1,0,2,2,0,1,0
OC414455,2,0,2,0,2,2,0,0,0
OC414559,3,2,1,0,2,1,1,2,0
OC414560,3,2,1,0,2,1,1,2,0
OC414666,3,2,1,0,2,1,1,2,0
OC414668,3,2,1,0,2,1,1,2,0
OC414688,2,2,0,2,1,1,0,1,0
OC414762,2,2,0,0,1,1,0,1,0
OC414811,2,2,0,0,2,2,0,0,1
OC414923,6,6,0,1,3,3,0,0,1
OC415004,12,11,1,0,2,0,2,0,1
OC415036,3,3,0,0,3,3,0,0,1
OC415050,31,0,31,0,2,2,0,0,1
OC415178,4,3,1,0,3,3,0,0,0
OC415334,15,0,15,0,2,2,0,0,1
OC415335,32,0,32,0,2,2,0,0,1
OC415438,90,83,7,0,0,0,0,0,1
OC415480,2,2,0,0,4,4,0,0,0
OC415751,2,2,0,0,2,1,1,2,0
OC415821,3,3,0,0,1,1,0,0,1
OC415997,4,3,1,1,3,2,1,2,0
OC415998,4,3,1,1,3,2,1,2,0
OC416000,4,3,1,1,5,2,3,4,0
OC416034,2,2,0,0,2,2,0,0,0
OC416242,7,3,4,0,2,1,1,2,1
OC416587,3,3,0,0,0,0,0,0,1
OC416673,3,3,0,0,3,3,0,0,0
OC416752,10,4,6,0,2,2,0,0,1
OC416794,31,28,3,1,0,0,0,0,1
OC416846,4,2,2,0,3,1,2,0,0
OC416997,2,2,0,0,2,2,0,2,0
OC417019,3,3,0,0,3,3,0,0,1
OC417183,4,4,0,0,0,0,0,0,1
OC417505,5,5,0,2,0,0,0,0,0
OC417558,2,2,0,0,2,2,0,2,0
OC417561,2,2,0,0,2,2,0,2,0
OC417597,2,2,0,0,2,2,0,2,0
OC417722,17,16,1,0,2,1,1,1,1
OC417866,4,4,0,0,0,0,0,0,0
OC417906,4,0,4,1,2,2,0,0,0
OC418115,2,2,0,0,2,2,0,0,1
OC418268,3,2,1,1,3,2,1,2,0
OC418309,2,0,2,0,2,1,1,0,0
OC418506,3,3,0,0,1,1,0,0,0
OC419149,2,2,0,0,2,2,0,0,0
OC419182,4,2,2,0,2,1,1,1,0
OC419268,4,4,0,0,2,2,0,0,0
OC419282,5,3,2,2,2,1,1,1,0
OC419430,2,2,0,0,2,2,0,0,0
OC419588,2,2,0,0,1,1,0,0,0
OC419596,2,2,0,0,1,1,0,1,0
OC419691,2,2,0,0,2,2,0,2,0
OC419763,2,0,2,0,2,2,0,0,0
OC419948,2,0,2,0,2,2,0,1,0
OC420058,2,2,0,0,1,1,0,1,0
OC420177,3,2,1,1,2,2,0,1,1
OC420212,5,5,0,2,0,0,0,0,0
OC420225,2,2,0,0,2,2,0,0,1
OC420282,4,3,1,0,1,1,0,0,0
OC420337,4,2,2,0,1,1,0,0,1
OC420564,5,5,0,0,0,0,0,0,0
OC420642,3,3,0,0,3,3,0,0,1
OC420643,3,3,0,0,3,3,0,0,1
OC420657,2,2,0,1,1,1,0,0,0
OC420871,6,6,0,0,2,2,0,0,1
OC420977,5,4,1,0,0,0,0,0,1
OC420987,4,2,2,1,4,2,2,2,0
OC421263,4,4,0,0,1,1,0,0,1
OC421323,3,2,1,0,0,0,0,0,0
OC421343,8,8,0,1,1,1,0,1,1
OC421357,2,2,0,0,2,2,0,0,0
OC421384,4,3,1,0,2,1,1,0,0
OC421434,8,7,1,0,7,7,0,0,0
OC421619,2,2,0,0,2,2,0,0,1
OC421834,2,2,0,0,2,2,0,0,0
OC421857,4,2,2,1,4,4,0,1,1
OC421915,3,0,3,0,1,1,0,0,0
OC422021,2,2,0,0,2,2,0,0,0
OC422284,3,3,0,0,3,3,0,0,0
OC422463,2,2,0,0,2,2,0,2,0
OC422536,3,3,0,1,1,1,0,1,0
OC422858,2,2,0,0,2,2,0,0,0
OC422885,2,2,0,0,1,1,0,1,0
OC423339,2,2,0,2,2,2,0,2,0
OC423346,4,4,0,0,3,3,0,2,1
OC423352,6,6,0,0,2,2,0,2,0
OC423382,3,3,0,0,0,0,0,0,0
OC423384,180,178,2,0,4,1,3,1,1
OC423450,3,3,0,0,0,0,0,0,1
OC423774,3,3,0,0,1,1,0,0,0
OC423791,2,2,0,0,1,1,0,1,0
OC423810,8,8,0,0,0,0,0,0,1
OC423849,4,3,1,0,1,1,0,0,1
OC424395,2,2,0,0,2,2,0,0,1
OC424511,2,2,0,0,0,0,0,0,0
OC424529,4,4,0,0,1,1,0,0,0
OC424556,2,2,0,0,2,2,0,1,0
OC424611,2,2,0,0,2,2,0,2,0
OC424671,2,2,0,0,1,1,0,1,0
OC424688,2,2,0,0,2,2,0,1,0
OC424711,289,283,6,0,3,3,0,0,1
OC424773,2,2,0,0,2,2,0,0,0
OC424780,4,3,1,0,0,0,0,0,0
OC424788,2,2,0,0,0,0,0,0,0
OC424860,2,2,0,0,2,2,0,0,0
OC424932,4,3,1,0,2,1,1,2,0
OC425034,4,4,0,0,4,4,0,1,1
OC425106,4,4,0,0,0,0,0,0,1
OC425548,3,2,1,0,1,1,0,0,0
OC425844,2,2,0,0,2,2,0,0,0
OC425855,2,2,0,0,0,0,0,0,0
OC426104,5,5,0,0,0,0,0,0,1
OC426205,6,6,0,0,0,0,0,0,0
OC426378,4,4,0,0,0,0,0,0,0
OC426380,2,2,0,0,2,2,0,0,0
OC426486,2,2,0,0,2,2,0,0,0
OC426725,2,2,0,0,2,2,0,0,1
OC426833,2,2,0,0,1,1,0,0,1
OC426887,4,3,1,0,3,1,2,0,0
OC427113,2,2,0,0,2,2,0,0,0
OC427124,2,2,0,0,2,2,0,1,0
OC427190,2,2,0,0,2,2,0,2,0
OC427441,2,2,0,0,2,2,0,0,0
OC427482,3,3,0,0,3,3,0,0,0
11763723,2,2,0,0,1,1,0,1,1
11763726,2,2,0,0,1,1,0,1,1
11763731,2,2,0,0,1,1,0,1,1
11763732,2,2,0,0,1,1,0,1,1
11764051,2,2,0,0,2,2,0,0,0
11764142,1,1,0,0,1,1,0,0,0
11764385,2,1,1,0,2,1,1,0,0
11764714,3,3,0,0,2,2,0,0,0
11765410,2,2,0,0,1,1,0,1,1
11765463,1,1,0,0,1,1,0,0,0
11765589,1,1,0,0,2,2,0,0,0
11765620,5,4,1,0,3,2,1,3,1
11765808,1,1,0,0,1,1,0,0,0
11765842,1,1,0,0,2,2,0,0,0
11765869,3,3,0,0,3,3,0,0,0
11765935,1,1,0,0,1,1,0,0,0
11766337,2,2,0,0,2,2,0,0,0
11766374,1,1,0,0,1,1,0,0,0
11766421,2,2,0,0,1,1,0,1,1
11766448,9,9,0,0,1,1,0,1,0
11766641,1,1,0,0,1,1,0,0,1
11766778,3,3,0,0,2,2,0,0,1
11768214,4,4,0,0,2,2,0,0,1
11768335,1,1,0,0,1,1,0,0,0
11768620,1,1,0,0,2,2,0,0,0
11769135,4,4,0,0,1,1,0,1,1
11769689,7,6,1,0,0,0,0,0,0
11771202,1,1,0,0,1,1,0,0,1
11771422,2,2,0,0,2,2,0,0,0
11771456,2,2,0,0,2,2,0,0,0
11771551,1,1,0,0,1,1,0,1,0
11771673,1,1,0,0,1,1,0,0,0
11772036,1,1,0,0,1,1,0,0,0
11772541,2,2,0,0,1,1,0,0,0
11772649,2,2,0,0,2,2,0,0,0
11772660,3,3,0,0,0,0,0,0,1
11772768,2,2,0,0,2,2,0,0,0
11773018,1,1,0,0,1,1,0,0,0
11773314,3,3,0,0,1,1,0,0,0
11773317,2,1,1,0,2,1,1,0,0
11773656,3,3,0,0,2,2,0,0,0
11774375,2,2,0,0,1,1,0,0,0
11774425,1,1,0,0,1,1,0,0,0
11774502,1,1,0,0,1,1,0,0,0
11774613,1,1,0,0,1,1,0,1,1
11774815,1,1,0,0,1,1,0,0,0
11774970,3,1,2,0,2,1,1,0,0
11775001,2,2,0,0,1,1,0,0,0
11775665,2,2,0,0,2,2,0,0,1
11776623,1,1,0,0,1,1,0,0,0
11777213,1,1,0,0,1,1,0,0,0
11777392,1,1,0,0,1,1,0,0,0
11777412,1,1,0,0,1,1,0,0,0
11777442,2,2,0,0,2,2,0,0,0
11778401,1,1,0,0,1,1,0,0,0
11778413,1,1,0,0,1,1,0,0,0
11779041,2,2,0,0,1,1,0,0,0
11779566,2,2,0,0,2,2,0,0,0
11779596,3,3,0,0,1,1,0,0,0
11780014,2,2,0,0,1,1,0,0,0
11780200,1,1,0,0,1,1,0,0,0
11780331,1,1,0,0,1,1,0,0,1
11780341,1,1,0,0,1,1,0,0,0
11780648,2,1,1,0,2,1,1,0,0
11780841,1,1,0,0,1,1,0,0,0
11780981,2,2,0,0,0,0,0,0,0
11781001,1,1,0,0,1,1,0,0,0
11781173,3,3,0,0,3,3,0,0,0
11781227,1,1,0,0,0,0,0,0,0
11781332,1,1,0,0,1,1,0,0,0
11781455,2,2,0,0,2,2,0,0,0
11781544,1,1,0,0,1,1,0,0,1
11781725,2,2,0,0,1,1,0,0,0
11781889,2,2,0,0,2,2,0,0,0
11782308,1,1,0,0,1,1,0,0,0
11782321,1,1,0,0,1,1,0,0,0
11782470,2,2,0,0,1,1,0,0,0
11782746,1,1,0,0,1,1,0,0,0
11783462,1,1,0,0,2,2,0,2,0
11783481,1,1,0,0,1,1,0,0,0
11783525,1,1,0,0,1,1,0,0,0
11783587,1,1,0,0,1,1,0,0,0
11783888,2,2,0,0,0,0,0,0,1
11784058,2,2,0,0,2,2,0,2,1
11784119,1,1,0,0,1,1,0,0,0
11784987,2,2,0,0,1,1,0,1,1
11785112,1,1,0,0,1,1,0,0,0
11785139,1,1,0,0,0,0,0,0,0
11785298,1,1,0,0,1,1,0,0,0
11785393,2,2,0,0,1,1,0,0,0
11785440,1,1,0,0,1,1,0,0,0
11785535,1,1,0,0,1,1,0,0,0
11785705,1,1,0,0,1,1,0,0,0
11786245,1,1,0,0,1,1,0,0,0
11786830,2,2,0,0,2,2,0,0,1
11787002,1,1,0,0,1,1,0,0,0
11787062,2,2,0,0,1,1,0,0,0
11787157,2,2,0,0,2,2,0,0,0
11787571,1,1,0,0,1,1,0,0,0
11787689,1,1,0,0,1,1,0,0,0
11787895,2,2,0,0,0,0,0,0,0
11788132,1,1,0,0,1,1,0,0,0
11788661,1,1,0,0,1,1,0,0,0
11788746,2,2,0,0,1,1,0,0,1
11788851,1,1,0,0,1,1,0,0,0
11789141,2,2,0,0,2,2,0,0,0
11790464,2,2,0,0,2,2,0,0,0
11790751,5,5,0,0,1,1,0,1,1
11790798,8,7,1,2,1,1,0,1,0
11791292,1,1,0,0,2,2,0,0,0
11792010,2,2,0,0,1,1,0,0,0
11792287,1,1,0,0,1,1,0,0,0
11792424,3,3,0,0,1,1,0,0,0
11793980,2,2,0,0,1,1,0,0,0
11794043,5,5,0,0,2,2,0,0,0
11794123,4,4,0,0,1,1,0,0,1
11794396,1,1,0,0,1,1,0,0,0
11794458,4,2,2,0,0,0,0,0,1
11794505,2,2,0,0,2,2,0,0,0
11794568,6,2,4,0,0,0,0,0,1
11794607,1,1,0,0,1,1,0,0,0
11795135,1,1,0,0,1,1,0,0,0
11795636,6,6,0,0,0,0,0,0,0
11795734,2,2,0,0,2,2,0,0,0
11795783,2,2,0,0,1,1,0,1,1
11795928,1,1,0,0,1,1,0,0,0
11796019,2,2,0,0,2,2,0,0,0
11796042,2,2,0,0,1,1,0,1,1
11796044,2,2,0,0,1,1,0,1,1
11796116,1,1,0,0,1,1,0,0,1
11796195,1,1,0,0,1,1,0,0,0
11796220,1,1,0,0,1,1,0,0,0
11796371,2,2,0,0,2,2,0,0,0
11796390,1,1,0,0,1,1,0,0,0
11796903,3,2,1,0,2,2,0,0,1
11797022,1,1,0,0,1,1,0,0,0
11797200,3,2,1,0,0,0,0,0,1
11798099,2,2,0,0,1,1,0,1,0
11798761,1,1,0,0,1,1,0,0,0
11798777,2,2,0,0,1,1,0,1,1
11798855,1,1,0,0,1,1,0,0,0
11799060,3,3,0,0,2,2,0,0,1
11799215,1,1,0,0,1,1,0,0,0
11799533,2,1,1,0,2,1,1,0,0
11799552,2,2,0,0,2,2,0,0,0
11799638,1,1,0,0,1,1,0,0,0
11799661,1,1,0,0,1,1,0,0,0
11799908,2,2,0,0,2,2,0,0,0
11800192,5,4,1,0,1,1,0,1,0
11800252,5,4,1,0,1,1,0,1,0
11800454,1,1,0,0,1,1,0,0,0
11800488,2,2,0,0,2,2,0,0,1
11800741,1,0,1,0,1,1,0,0,0
11800796,1,1,0,0,1,1,0,0,0
11800838,1,1,0,0,1,1,0,0,0
11800841,2,2,0,0,2,2,0,2,0
11801068,1,1,0,0,1,1,0,0,0
11801229,1,1,0,0,1,1,0,0,1
11801348,1,1,0,0,1,1,0,0,0
11801844,1,1,0,0,1,1,0,0,0
11801922,5,5,0,0,1,1,0,1,1
11802063,2,2,0,0,1,1,0,1,1
11802089,1,1,0,0,1,1,0,0,1
11802122,1,1,0,0,1,1,0,0,0
11802160,1,1,0,0,1,1,0,0,0
11802877,1,1,0,0,1,1,0,0,1
11803086,2,2,0,0,1,1,0,0,0
11803101,2,2,0,0,1,1,0,0,1
11803316,1,1,0,0,1,1,0,0,0
11803364,2,2,0,0,1,1,0,0,0
11803558,1,1,0,0,1,1,0,0,0
11803619,3,3,0,0,2,2,0,0,0
11803704,1,1,0,0,1,1,0,0,0
11804039,2,2,0,0,2,2,0,0,0
11804194,2,2,0,0,1,1,0,1,1
11804692,1,1,0,0,1,1,0,0,0
11804926,2,2,0,0,2,2,0,0,0
11806083,2,2,0,0,1,1,0,0,0
11806148,1,1,0,0,1,1,0,0,0
11806209,1,0,1,0,1,1,0,0,0
11806222,1,1,0,0,1,1,0,0,1
11806260,2,2,0,0,1,1,0,0,0
11806335,2,2,0,0,2,2,0,0,0
11806346,1,1,0,0,1,1,0,0,0
11806462,1,1,0,0,1,1,0,0,0
11806491,2,2,0,0,1,1,0,0,0
11806701,1,1,0,0,1,1,0,0,0
11806877,3,3,0,1,0,0,0,0,1
11807840,2,2,0,0,1,1,0,1,1
11808710,1,1,0,0,1,1,0,0,0
11808764,2,2,0,0,1,1,0,1,1
11809339,1,1,0,0,1,1,0,0,0
11809737,1,1,0,0,1,1,0,0,0
11809815,2,2,0,0,2,2,0,0,0
11809936,2,2,0,0,2,2,0,0,0
11809964,4,4,0,0,1,1,0,1,1
11810123,3,3,0,0,2,2,0,0,0
11810347,1,1,0,0,1,1,0,0,0
11810378,1,1,0,0,1,1,0,0,0
11810689,1,1,0,0,1,1,0,0,0
11810828,1,1,0,0,1,1,0,0,0
11811079,2,2,0,0,2,2,0,0,1
11811100,2,1,1,0,2,1,1,0,0
11811408,1,1,0,0,1,1,0,0,1
11811582,1,1,0,0,1,1,0,0,0
11812037,4,4,0,0,0,0,0,0,0
11812092,2,2,0,0,1,1,0,1,1
11812520,3,3,0,0,1,1,0,1,1
11812528,1,1,0,0,1,1,0,0,0
11812733,1,1,0,0,1,1,0,0,0
11812956,1,1,0,0,1,1,0,0,0
11812979,1,1,0,0,1,1,0,0,0
11813202,6,6,0,0,0,0,0,0,1
11813505,1,1,0,0,1,1,0,0,0
11813710,2,2,0,0,0,0,0,0,1
11813933,1,1,0,0,1,1,0,0,0
11813947,2,2,0,0,1,1,0,0,1
11814364,3,3,0,0,3,3,0,0,0
11814534,2,2,0,0,1,1,0,1,1
11814721,1,1,0,0,1,1,0,0,0
11814917,2,2,0,0,2,2,0,0,0
11815287,1,1,0,0,1,1,0,0,0
11815370,3,3,0,0,3,3,0,0,0
11815665,1,1,0,0,1,1,0,0,0
11816163,1,1,0,0,1,1,0,0,0
11816178,1,1,0,0,1,1,0,0,0
11816322,1,1,0,0,1,1,0,0,0
11816542,1,1,0,0,1,1,0,0,0
11816756,1,1,0,0,1,1,0,0,0
11816759,1,1,0,0,1,1,0,0,0
11816943,1,1,0,0,1,1,0,0,1
11817135,2,2,0,0,1,1,0,1,0
11817141,3,2,1,0,1,1,0,1,1
11817408,1,1,0,0,1,1,0,0,0
11817518,2,1,1,0,1,1,0,0,0
11817682,3,2,1,0,1,1,0,1,1
11817909,2,2,0,0,0,0,0,0,0
11817988,1,1,0,0,1,1,0,0,0
11817997,2,2,0,0,1,1,0,0,0
11818007,3,3,0,0,0,0,0,0,1
11818046,2,2,0,0,1,1,0,1,1
11818192,2,2,0,0,2,2,0,0,0
11818358,2,2,0,0,1,1,0,1,1
11819035,1,1,0,0,1,1,0,0,0
11819466,2,2,0,0,0,0,0,0,0
11819525,2,2,0,0,0,0,0,0,0
11819866,5,5,0,0,0,0,0,0,0
NI657150,1,1,0,0,1,1,0,0,0
NI657248,2,2,0,0,2,2,0,0,0
NI657470,1,1,0,0,1,1,0,0,0
NI657620,2,2,0,0,1,1,0,1,1
NI657631,1,1,0,0,1,1,0,0,0
NI657660,2,2,0,0,2,2,0,0,0
NI657798,1,1,0,0,2,2,0,0,0
NI657820,2,2,0,0,2,2,0,1,0
NI657864,2,2,0,0,2,2,0,0,0
NI658033,2,2,0,0,2,2,0,0,0
NI658088,1,1,0,0,1,1,0,0,0
NI658448,2,2,0,0,1,1,0,0,0
NI658536,1,1,0,0,1,1,0,0,0
NI658703,2,2,0,0,2,2,0,0,0
NI658706,2,2,0,0,2,2,0,2,0
NI658768,1,1,0,0,1,1,0,0,0
NI659318,1,1,0,0,1,1,0,0,0
NI659503,2,2,0,0,2,2,0,0,0
NI659515,1,1,0,0,1,1,0,0,0
NI659693,1,1,0,0,1,1,0,0,0
NI659810,1,1,0,0,1,1,0,0,0
NI659952,2,2,0,0,2,2,0,0,0
NI660082,1,1,0,0,1,1,0,0,0
NI660101,1,1,0,0,1,1,0,0,0
NI661107,1,1,0,0,1,1,0,0,0
NI661147,1,1,0,0,1,1,0,0,0
NI661299,7,7,0,0,0,0,0,0,0
NI661826,1,1,0,0,1,1,0,0,0
NO000009,1,1,0,0,0,0,0,0,0
NO000012,0,0,0,0,0,0,0,0,0
NO000013,0,0,0,0,0,0,0,0,0
NO000014,0,0,0,0,0,0,0,0,0
NO000015,0,0,0,0,0,0,0,0,0
NO000021,0,0,0,0,0,0,0,0,0
NO000023,0,0,0,0,0,0,0,0,0
NO000027,1,1,0,0,0,0,0,0,0
NO000031,0,0,0,0,0,0,0,0,0
NO000034,1,1,0,0,0,0,0,0,0
NO000037,0,0,0,0,0,0,0,0,0
NO000041,0,0,0,0,0,0,0,0,0
NO000042,0,0,0,0,0,0,0,0,0
NO000043,0,0,0,0,0,0,0,0,0
NO000045,0,0,0,0,0,0,0,0,0
NO000047,1,1,0,0,0,0,0,0,0
NO000056,0,0,0,0,0,0,0,0,0
NO000059,0,0,0,0,0,0,0,0,0
NO000060,0,0,0,0,0,0,0,0,0
NO000064,0,0,0,0,0,0,0,0,0
NO000081,0,0,0,0,0,0,0,0,0
NO000087,0,0,0,0,0,0,0,0,0
NO000094,0,0,0,0,0,0,0,0,0
NO000109,0,0,0,0,0,0,0,0,0
NO000115,0,0,0,0,0,0,0,0,0
NO000117,0,0,0,0,0,0,0,0,0
NO000124,1,1,0,0,0,0,0,0,0
NO000126,0,0,0,0,0,0,0,0,0
NO000153,0,0,0,0,0,0,0,0,0
NO000163,0,0,0,0,0,0,0,0,0
NO000164,0,0,0,0,0,0,0,0,0
NP000016,0,0,0,0,0,0,0,0,0
NP000031,0,0,0,0,0,0,0,0,0
NP000064,0,0,0,0,0,0,0,0,0
NP000112,0,0,0,0,0,0,0,0,0
NP000118,0,0,0,0,0,0,0,0,0
NP000149,0,0,0,0,0,0,0,0,0
NP000201,0,0,0,0,0,0,0,0,0
NP000251,0,0,0,0,0,0,0,0,0
NP000269,0,0,0,0,0,0,0,0,0
NP000279,0,0,0,0,0,0,0,0,0
NP000280,0,0,0,0,0,0,0,0,0
NP000297,0,0,0,0,0,0,0,0,0
NP000301,0,0,0,0,0,0,0,0,0
NP000327,0,0,0,0,0,0,0,0,0
NP000336,0,0,0,0,0,0,0,0,0
NP000370,0,0,0,0,0,0,0,0,0
NP000393,1,1,0,0,0,0,0,0,0
NP000410,0,0,0,0,0,0,0,0,0
NP000416,0,0,0,0,0,0,0,0,0
NP000419,0,0,0,0,0,0,0,0,0
NP000421,0,0,0,0,0,0,0,0,0
NP000426,0,0,0,0,0,0,0,0,0
NP000427,0,0,0,0,0,0,0,0,0
NP000430,0,0,0,0,0,0,0,0,0
OC300001,1427,714,713,0,1,1,0,1,1
OC300091,52,0,52,2,0,0,0,0,1
OC300172,51,24,27,0,1,1,0,1,1
OC300368,4,2,2,0,2,2,0,0,0
OC300510,58,2,56,0,0,0,0,0,1
OC300613,18,2,16,0,1,1,0,1,1
OC300796,22,2,20,1,1,1,0,1,0
OC300846,7,7,0,0,0,0,0,0,0
OC300878,108,43,65,1,1,1,0,0,1
OC301118,6,0,6,0,0,0,0,0,1
OC301149,296,157,139,0,0,0,0,0,1
OC301153,78,2,76,0,0,0,0,0,1
OC301206,29,2,27,0,5,2,3,1,1
OC301429,295,286,9,2,0,0,0,0,1
OC301522,156,153,3,0,0,0,0,0,1
OC301523,39,34,5,0,0,0,0,0,1
OC301540,1589,638,951,0,0,0,0,0,1
OC301593,9,0,9,0,3,3,0,0,1
OC301658,9,0,9,0,3,3,0,0,1
OC301683,147,144,3,2,0,0,0,0,1
OC301880,59,12,47,1,3,3,0,1,1
OC302131,7,2,5,0,2,2,0,0,1
OC302228,30,18,12,0,18,18,0,1,1
OC302244,3,3,0,0,3,3,0,0,0
OC302317,16,16,0,0,0,0,0,0,1
OC302636,93,16,77,1,8,7,1,1,1
OC302716,22,9,13,0,0,0,0,0,1
OC302755,27,26,1,0,0,0,0,0,1
OC302902,33,0,33,0,0,0,0,0,1
OC302991,361,285,76,0,13,10,3,0,0
OC303359,250,83,167,0,0,0,0,0,1
OC303400,55,32,23,0,0,0,0,0,1
OC303525,1862,897,965,0,2,1,1,0,1
OC303527,5,4,1,0,0,0,0,0,0
OC303584,12,6,6,0,4,0,4,0,1
OC303675,1375,704,671,0,0,0,0,0,1
OC303881,12,12,0,0,0,0,0,0,1
OC303959,9,3,6,4,1,1,0,1,1
OC304017,11,0,11,0,0,0,0,0,1
OC304026,50,35,15,0,0,0,0,0,1
OC304029,52,35,17,0,0,0,0,0,1
OC304039,4,0,4,0,0,0,0,0,1
OC304065,856,375,481,0,2,1,1,0,1
OC304165,89,42,47,0,0,0,0,0,1
OC304188,116,0,116,0,0,0,0,0,1
OC304205,35,35,0,0,1,1,0,0,1
OC304261,56,54,2,0,4,2,2,4,1
OC304288,6,3,3,0,3,2,1,0,0
OC304313,12,0,12,0,1,1,0,0,1
OC304404,5,0,5,0,0,0,0,0,1
OC304456,92,0,92,0,0,0,0,0,1
OC304469,15,0,15,0,0,0,0,0,1
OC304471,5,0,5,0,0,0,0,0,1
OC304613,75,68,7,0,0,0,0,0,1
OC304712,105,76,29,0,0,0,0,0,1
OC304821,4,2,2,0,1,1,0,0,0
OC304870,24,0,24,1,0,0,0,0,1
OC305006,60,3,57,0,3,3,0,1,1
OC305071,43,38,5,0,0,0,0,0,1
OC305072,31,25,6,0,0,0,0,0,1
OC305103,92,43,49,0,4,4,0,0,1
OC305123,243,236,7,0,2,2,0,2,1
OC305149,64,50,14,0,4,4,0,4,1
OC305195,22,0,22,0,0,0,0,0,1
OC305222,57,0,57,0,1,1,0,1,1
OC305288,81,57,24,0,1,1,0,1,1
OC305320,271,260,11,0,4,2,2,4,1
OC305342,44,2,42,0,2,1,1,2,1
OC305343,20,6,14,0,1,1,0,1,1
OC305357,1605,663,942,0,15,11,4,0,1
OC305363,4,0,4,0,2,2,0,0,1
OC305433,116,113,3,0,0,0,0,0,1
OC305641,6,5,1,0,2,2,0,0,1
OC305678,111,0,111,0,0,0,0,0,1
OC305693,83,49,34,0,1,1,0,0,1
OC305875,89,82,7,0,0,0,0,0,1
OC305898,120,46,74,0,0,0,0,0,1
OC305899,12,6,6,0,1,1,0,0,1
OC305927,79,13,66,0,1,1,0,0,1
OC305934,859,491,368,0,0,0,0,0,1
OC305965,14,7,7,1,5,3,2,0,1
OC306105,85,4,81,0,5,5,0,1,1
OC306111,5,2,3,0,2,2,0,0,0
OC306202,46,21,25,0,0,0,0,0,1
OC306215,162,161,1,0,0,0,0,0,1
OC306444,13,3,10,0,1,1,0,0,1
OC306454,89,52,37,0,0,0,0,0,1
OC306495,21,4,17,0,0,0,0,0,1
OC306540,135,49,86,2,1,1,0,1,1
OC306582,217,148,69,0,1,1,0,0,1
OC306583,100,47,53,0,1,1,0,0,1
OC306584,100,47,53,0,1,1,0,0,1
OC306585,100,47,53,0,1,1,0,0,1
OC306586,71,48,23,0,1,1,0,0,1
OC306587,71,47,24,0,1,1,0,0,1
OC306588,116,62,54,0,1,1,0,0,1
OC306597,3,3,0,0,1,1,0,0,1
OC306663,3,2,1,0,0,0,0,0,0
OC306889,4,4,0,0,2,2,0,0,1
OC306932,6,5,1,0,1,1,0,1,1
OC307012,2,0,2,0,0,0,0,0,0
OC307023,10,7,3,0,0,0,0,0,1
OC307072,3,2,1,0,2,2,0,0,1
OC307138,20,6,14,0,0,0,0,0,1
OC307151,2,0,2,0,0,0,0,0,1
OC307212,135,92,43,0,0,0,0,0,1
OC307243,184,179,5,0,0,0,0,0,1
OC307261,75,74,1,0,2,2,0,2,1
OC307298,120,120,0,0,0,0,0,0,1
OC307300,86,85,1,0,0,0,0,0,1
OC307334,2,0,2,0,0,0,0,0,1
OC307336,34,0,34,0,0,0,0,0,1
OC307362,61,0,61,0,0,0,0,0,1
OC307476,129,0,129,0,0,0,0,0,1
OC307696,261,248,13,0,0,0,0,0,1
OC307697,145,139,6,0,0,0,0,0,1
OC307719,19,5,14,0,1,1,0,0,0
OC307742,540,200,340,0,2,1,1,0,1
OC307747,10,5,5,0,0,0,0,0,1
OC307847,928,346,582,0,8,6,2,1,1
OC308039,36,24,12,1,0,0,0,0,1
OC308165,3,0,3,0,0,0,0,0,1
OC308268,2,2,0,0,2,2,0,0,0
OC308384,5,5,0,0,1,1,0,0,0
OC308457,6,4,2,0,1,1,0,0,0
OC308575,13,10,3,0,2,2,0,0,1
OC308605,17,2,15,0,1,1,0,1,1
OC308614,49,19,30,0,0,0,0,0,1
OC308650,46,15,31,0,0,0,0,0,1
OC308658,213,132,81,0,2,2,0,0,1
OC308659,713,11,702,0,1,1,0,0,1
OC308685,63,0,63,0,0,0,0,0,1
OC308786,2,2,0,0,2,2,0,0,1
OC308818,131,131,0,0,0,0,0,0,1
OC308897,15,10,5,0,2,2,0,0,1
OC308929,41,41,0,0,0,0,0,0,1
06379175,14,8,6,0,1,1,0,1,1
06379176,3,3,0,0,2,2,0,0,1
06379552,5,2,3,0,1,1,0,0,1
06379896,8,0,8,0,0,0,0,0,1
06380061,6,0,6,0,0,0,0,0,0
06380397,5,2,3,0,1,1,0,0,0
06380591,2,0,2,0,0,0,0,0,0
06380602,13,4,9,0,3,3,0,0,0
06380764,17,9,8,0,1,1,0,1,1
06381059,10,2,8,0,1,1,0,1,1
06381124,10,1,9,0,1,1,0,0,1
06381142,4,3,1,0,2,2,0,0,1
06381241,7,0,7,0,0,0,0,0,1
06381253,2,1,1,0,1,1,0,0,1
06381265,5,2,3,0,1,1,0,0,1
06382192,46,16,30,0,0,0,0,0,1
06382547,19,0,19,0,1,1,0,1,1
06382655,5,3,2,0,2,2,0,1,1
06382802,5,0,5,0,0,0,0,0,1
06382808,13,3,10,0,0,0,0,0,1
06382812,2,0,2,0,0,0,0,0,1
06382888,4,3,1,0,1,1,0,0,1
06383237,4,3,1,0,0,0,0,0,1
06383292,8,5,3,0,0,0,0,0,1
06384129,14,6,8,0,2,1,1,2,1
06384221,3,3,0,0,2,2,0,0,1
06384604,7,4,3,0,2,1,1,0,1
06384729,5,1,4,0,1,1,0,0,0
06385307,8,3,5,0,2,2,0,2,1
06386614,7,4,3,0,1,1,0,0,1
06386637,8,0,8,0,0,0,0,0,1
06386643,4,2,2,0,1,1,0,0,0
06387018,2,1,1,0,1,1,0,0,0
06387110,8,5,3,0,1,1,0,0,1
06387397,5,0,5,0,0,0,0,0,1
06387461,6,0,6,0,0,0,0,0,1
06387617,45,7,38,0,0,0,0,0,0
06387697,13,2,11,0,1,1,0,1,1
06387705,8,2,6,0,1,1,0,1,1
06387768,4,2,2,0,1,1,0,0,0
06387778,4,2,2,0,1,1,0,0,1
06387842,11,2,9,0,2,2,0,0,1
06387850,5,3,2,0,2,2,0,0,0
06388506,4,1,3,0,2,1,1,1,0
06388576,6,0,6,0,0,0,0,0,1
06388762,3,1,2,0,1,1,0,0,1
06388809,21,0,21,0,1,1,0,1,1
06388947,16,4,12,0,0,0,0,0,1
06389031,2,2,0,0,1,1,0,0,1
06389174,4,1,3,0,1,1,0,0,1
06389418,6,0,6,0,0,0,0,0,1
06389454,5,1,4,0,1,1,0,0,1
06389506,4,0,4,0,0,0,0,0,1
06389553,5,2,3,0,0,0,0,0,0
06389799,3,2,1,0,1,1,0,0,1
06389856,5,4,1,0,3,3,0,0,0
06389976,5,3,2,0,2,2,0,0,1
06390013,5,2,3,0,0,0,0,0,0
06390126,23,2,21,0,1,1,0,1,1
06390291,12,4,8,0,1,1,0,0,1
06390305,5,2,3,0,1,1,0,0,0
06390346,7,2,5,0,0,0,0,0,1
06390393,7,3,4,0,0,0,0,0,1
06390436,2,1,1,0,1,1,0,0,0
06390801,6,3,3,0,1,1,0,0,1
06390861,8,5,3,0,1,0,1,1,1
06391136,15,2,13,0,1,1,0,1,1
06391183,35,9,26,0,1,1,0,1,1
06391380,6,0,6,0,0,0,0,0,1
06391489,5,3,2,0,1,1,0,0,1
06391560,4,2,2,0,1,1,0,0,0
06391683,4,2,2,0,1,1,0,0,1
06391761,2,0,2,0,0,0,0,0,0
06391856,2,1,1,0,2,2,0,0,1
06392402,4,3,1,0,1,1,0,0,1
06392494,8,3,5,0,0,0,0,0,1
06392802,9,3,6,0,0,0,0,0,1
06392875,6,0,6,0,0,0,0,0,1
06393155,6,2,4,0,2,1,1,0,1
06393416,11,5,6,0,0,0,0,0,1
06393526,3,3,0,0,2,2,0,0,0
06393590,3,3,0,0,1,1,0,0,1
06393751,12,0,12,0,0,0,0,0,1
06393774,5,2,3,0,1,1,0,0,1
06393787,20,4,16,0,0,0,0,0,1
06393960,27,8,19,0,10,6,4,0,1
06393992,5,4,1,0,0,0,0,0,0
06394272,6,2,4,0,1,1,0,1,1
06394283,32,6,26,0,1,1,0,1,1
06394318,20,4,16,0,1,1,0,1,1
06394327,24,9,15,0,1,0,1,0,0
06394526,13,4,9,0,1,1,0,1,1
06394532,8,3,5,0,1,1,0,1,1
06394640,6,3,3,0,2,2,0,0,1
06394744,10,2,8,0,0,0,0,0,1
06395296,36,0,36,0,2,1,1,2,1
06395584,17,5,12,0,1,1,0,1,1
06395771,5,2,3,0,0,0,0,0,1
06395837,3,0,3,0,0,0,0,0,1
06395903,20,4,16,0,1,1,0,1,1
06395979,7,0,7,0,1,0,1,0,1
06395985,2,2,0,0,1,1,0,0,1
06396027,17,9,8,0,1,1,0,0,0
06396032,6,2,4,0,0,0,0,0,0
06396065,3,3,0,0,2,2,0,0,0
06396374,8,2,6,0,2,2,0,0,1
06396583,5,1,4,0,1,1,0,0,0
06396785,8,1,7,0,2,1,1,0,0
06397195,42,15,27,0,0,0,0,0,1
06397427,27,3,24,0,1,1,0,1,1
06397461,11,2,9,0,0,0,0,0,1
06397500,6,0,6,0,0,0,0,0,1
06397568,28,5,23,0,1,1,0,1,1
06397934,3,3,0,0,2,2,0,0,0
06397979,4,0,4,0,0,0,0,0,1
06398227,24,9,15,0,1,1,0,1,1
06398410,17,4,13,0,2,1,1,2,1
06398416,22,5,17,0,2,1,1,2,1
06398470,4,2,2,0,1,1,0,0,1
06399006,5,3,2,0,2,2,0,0,0
06399087,6,5,1,0,3,1,2,1,1
06399505,20,7,13,0,0,0,0,0,0
06399621,4,0,4,0,0,0,0,0,1
06399658,4,0,4,0,0,0,0,0,1
06399694,5,3,2,0,2,2,0,0,0
06399857,2,2,0,0,1,1,0,0,0
06400607,7,3,4,0,0,0,0,0,0
06400710,5,0,5,0,1,1,0,0,1
06400750,6,0,6,0,0,0,0,0,1
06400760,8,3,5,0,2,1,1,2,1
06400870,15,4,11,0,0,0,0,0,1
06401245,2,2,0,0,1,1,0,0,0
06401971,4,2,2,0,1,1,0,0,1
06402143,32,12,20,0,3,3,0,2,1
06402194,14,0,14,0,0,0,0,0,1
06402216,12,5,7,0,0,0,0,0,1
06402398,9,6,3,0,1,1,0,0,0
06402961,5,0,5,0,0,0,0,0,0
06403110,14,1,13,0,1,1,0,1,1
06403569,55,12,43,0,0,0,0,0,1
06403660,16,5,11,0,0,0,0,0,1
06403816,5,0,5,0,0,0,0,0,1
06403957,17,4,13,0,2,2,0,2,1
06404026,12,1,11,0,0,0,0,0,0
06404255,16,6,10,0,0,0,0,0,1
06404582,3,3,0,0,1,1,0,0,1
06404930,4,2,2,0,1,1,0,0,1
06405108,4,2,2,0,1,1,0,0,1
06405180,7,0,7,0,0,0,0,0,1
06405181,8,0,8,0,0,0,0,0,1
06405212,5,3,2,0,2,2,0,0,0
06405310,6,2,4,0,2,2,0,0,0
06405474,4,0,4,0,0,0,0,0,1
06405519,7,0,7,0,0,0,0,0,1
06405545,7,3,4,0,1,1,0,1,1
06405604,23,4,19,0,1,1,0,1,1
06405917,6,1,5,1,1,1,0,0,1
06405944,12,4,8,0,0,0,0,0,1
06405959,7,0,7,0,0,0,0,0,1
06406001,8,0,8,0,0,0,0,0,1
06406312,8,0,8,0,1,1,0,1,1
06406366,4,1,3,0,1,1,0,0,0
06406479,6,4,2,0,5,5,0,1,0
06406536,5,3,2,0,1,1,0,0,0
06406680,4,4,0,0,1,1,0,1,0
06406717,22,3,19,0,2,1,1,2,1
06406718,10,0,10,0,0,0,0,0,1
06406967,12,2,10,0,1,1,0,1,1
06407169,3,3,0,0,2,2,0,0,0
06407182,5,3,2,0,1,1,0,0,1
06407212,22,0,22,0,0,0,0,0,1
06407339,7,2,5,0,1,1,0,0,1
06407584,3,3,0,0,1,1,0,0,0
06407667,3,0,3,0,1,1,0,0,1
06407808,5,5,0,0,1,1,0,0,1
06407889,10,3,7,0,1,1,0,1,1
06407911,4,0,4,0,0,0,0,0,1
06407922,11,3,8,0,1,1,0,1,1
06407965,9,5,4,0,0,0,0,0,1
06407985,54,15,39,0,0,0,0,0,1
06408143,5,0,5,0,2,2,0,0,1
06408282,23,3,20,0,1,1,0,1,0
06408358,6,3,3,0,2,2,0,0,0
06408406,4,2,2,0,1,1,0,0,0
06408465,11,1,10,0,1,1,0,0,1
06408724,13,0,13,0,1,1,0,1,1
06408727,24,3,21,0,1,1,0,1,1
06408905,4,2,2,0,1,1,0,1,1
06408994,11,7,4,0,1,1,0,1,1
06409008,17,5,12,0,1,1,0,1,1
06409037,22,5,17,0,1,1,0,1,1
06409066,17,5,12,0,1,1,0,1,1
06409117,17,5,12,0,1,1,0,1,1
06409119,17,5,12,0,1,1,0,1,1
06409746,4,0,4,0,1,1,0,0,1
06410010,6,0,6,0,0,0,0,0,1
06410037,48,14,34,0,0,0,0,0,1
06410268,22,7,15,0,9,0,9,0,1
06410320,8,3,5,0,1,1,0,1,1
06410556,4,0,4,0,0,0,0,0,1
06410617,8,3,5,0,1,1,0,1,1
06410667,5,1,4,0,1,1,0,0,1
06410734,28,3,25,0,1,1,0,1,1
06410814,5,1,4,0,1,1,0,0,0
06410890,4,2,2,0,2,2,0,0,1
06410902,4,0,4,0,0,0,0,0,1
06411115,3,2,1,0,2,2,0,0,1
06411210,5,1,4,0,0,0,0,0,1
06411278,4,3,1,0,1,1,0,0,1
06411344,5,2,3,0,1,1,0,0,1
06411416,2,0,2,0,0,0,0,0,1
06411476,4,2,2,0,1,1,0,0,1
06411541,20,6,14,0,1,1,0,1,1
06411555,5,0,5,0,1,1,0,0,1
06411625,7,2,5,0,3,2,1,0,1
06411817,8,6,2,0,1,1,0,1,1
06412064,9,5,4,0,1,1,0,1,1
06412066,8,4,4,0,2,2,0,0,1
06412198,6,2,4,0,1,1,0,0,0
06412222,13,4,9,0,2,2,0,2,1
06412306,2,0,2,0,0,0,0,0,1
06412309,3,1,2,0,1,1,0,0,1
06412337,6,0,6,0,0,0,0,0,1
06412371,13,6,7,0,0,0,0,0,1
06412385,2,1,1,0,1,1,0,0,1
06412599,7,5,2,0,5,5,0,1,0
06412691,6,4,2,0,3,3,0,0,0
06412692,6,2,4,0,2,1,1,1,0
06412890,6,1,5,0,2,1,1,0,1
06412899,10,3,7,0,0,0,0,0,1
06412905,3,2,1,0,2,2,0,0,1
06412921,4,2,2,0,1,1,0,1,1
06412940,5,2,3,0,0,0,0,0,1
06413032,3,1,2,0,0,0,0,0,0
06413069,2,2,0,0,1,1,0,0,0
06413229,4,0,4,0,1,1,0,0,1
06413231,9,2,7,0,1,1,0,0,1
06413307,2,2,0,0,1,1,0,0,0
06413331,4,3,1,0,0,0,0,0,1
06413493,7,0,7,0,0,0,0,0,1
06413588,4,0,4,0,1,1,0,0,1
07948009,1,0,1,0,0,0,0,0,0
07948177,5,4,1,0,1,1,0,0,1
07948431,9,3,6,0,2,2,0,2,1
07949462,1,0,1,0,0,0,0,0,0
07949464,25,9,16,0,1,1,0,0,1
07949601,4,4,0,0,0,0,0,0,1
07949801,4,4,0,0,1,1,0,0,0
07949854,2,0,2,0,0,0,0,0,1
07949858,4,2,2,0,3,1,2,1,0
07950827,31,11,20,0,0,0,0,0,1
07950854,2,0,2,0,0,0,0,0,0
07950891,17,8,9,0,5,3,2,1,1
07951051,12,0,12,0,0,0,0,0,1
07951060,5,0,5,0,0,0,0,0,1
07951088,19,4,15,0,0,0,0,0,1
07951117,3,0,3,0,0,0,0,0,1
07951118,21,9,12,0,4,4,0,0,1
07951145,12,4,8,0,0,0,0,0,0
07951526,6,5,1,2,4,2,2,1,0
07951533,22,11,11,0,2,2,0,2,0
07951737,2,2,0,0,1,1,0,0,1
07952371,1,0,1,0,0,0,0,0,1
07952658,2,0,2,0,0,0,0,0,1
07952734,4,4,0,0,2,2,0,0,0
07952786,40,19,21,0,0,0,0,0,1
07953007,2,2,0,0,1,1,0,0,1
07953341,6,5,1,0,0,0,0,0,0
07953387,1,1,0,0,1,1,0,0,0
07953554,2,0,2,0,0,0,0,0,0
07954379,11,0,11,0,0,0,0,0,0
07954383,17,6,11,0,0,0,0,0,1
07954503,5,2,3,0,1,1,0,0,1
07954615,4,0,4,0,0,0,0,0,1
07954630,11,6,5,0,0,0,0,0,1
07954649,22,0,22,0,0,0,0,0,1
07955570,7,1,6,0,2,1,1,0,0
07956417,13,8,5,0,0,0,0,0,1
07956695,26,12,14,0,2,0,2,0,1
07957104,2,0,2,0,0,0,0,0,1
07957325,1,1,0,0,1,1,0,0,0
07957355,1,1,0,0,1,1,0,0,0
07957593,4,3,1,0,2,2,0,1,1
07957631,1,1,0,0,1,1,0,0,0
07958139,1,1,0,0,1,1,0,0,0
07958465,3,0,3,0,0,0,0,0,0
07958581,12,6,6,0,0,0,0,0,1
07958676,12,5,7,0,3,1,2,1,1
07958732,3,1,2,0,1,1,0,0,1
07958759,8,1,7,0,2,1,1,0,1
07958890,5,5,0,0,3,0,3,0,1
07959031,8,4,4,0,3,1,2,3,1
07959470,8,5,3,0,0,0,0,0,0
07959495,3,0,3,0,0,0,0,0,0
07959624,3,0,3,0,0,0,0,0,0
07960081,1,1,0,0,1,1,0,0,0
07960153,1,1,0,0,1,1,0,0,0
07960392,6,3,3,0,1,1,0,1,1
07960494,1,1,0,0,1,1,0,0,1
07960502,1,0,1,0,0,0,0,0,0
07960550,5,1,4,0,3,1,2,1,0
07960581,24,8,16,0,1,1,0,1,1
07960712,2,2,0,1,1,1,0,1,1
07960716,2,2,0,0,2,2,0,0,0
07960743,2,1,1,0,1,1,0,0,1
07960889,1,1,0,0,1,1,0,0,0
07961029,1,1,0,0,2,2,0,0,0
07961122,2,0,2,0,0,0,0,0,0
07961352,2,1,1,0,1,1,0,0,0
07961463,1,1,0,0,1,1,0,0,0
07962088,15,8,7,0,1,1,0,1,1
07962217,16,7,9,0,10,7,3,0,1
07962242,15,6,9,0,3,2,1,3,0
07962328,1,1,0,0,1,1,0,0,0
07962463,1,1,0,0,1,1,0,0,0
07962578,1,1,0,0,1,1,0,0,0
07963026,15,8,7,0,2,2,0,0,0
07963028,1,1,0,0,3,3,0,0,0
07963035,4,0,4,0,0,0,0,0,1
07963150,20,6,14,0,0,0,0,0,0
07963386,3,0,3,0,0,0,0,0,0
07963598,5,5,0,0,1,1,0,0,1
07963961,7,4,3,0,1,1,0,0,0
07963992,2,0,2,0,0,0,0,0,1
07964014,3,0,3,0,0,0,0,0,0
07964061,10,5,5,0,0,0,0,0,0
07964371,2,0,2,0,0,0,0,0,1
07964537,2,2,0,0,2,2,0,0,1
07964619,2,0,2,0,0,0,0,0,1
07964731,14,0,14,0,0,0,0,0,1
07964819,3,0,3,0,0,0,0,0,0
07964865,1,0,1,0,0,0,0,0,1
07965176,2,0,2,0,0,0,0,0,1
07965403,2,2,0,0,1,1,0,0,1
07965503,6,4,2,0,3,3,0,0,1
07965826,1,1,0,0,1,1,0,0,0
07965908,3,0,3,0,1,1,0,0,1
07965916,1,0,1,0,0,0,0,0,0
07965957,9,6,3,0,0,0,0,0,1
07966238,3,3,0,0,2,2,0,0,0
07966325,3,3,0,0,2,2,0,0,0
07966345,3,3,0,0,2,2,0,0,1
07967402,11,7,4,0,5,0,5,0,0
07967511,12,8,4,0,1,1,0,1,0
07967861,4,0,4,0,0,0,0,0,1
07967924,1,1,0,0,1,1,0,0,1
07968149,4,3,1,0,3,3,0,0,1
07968269,10,6,4,0,1,1,0,1,1
07968358,4,4,0,0,1,1,0,0,0
07968378,6,1,5,0,2,1,1,1,1
07968397,1,1,0,0,1,1,0,0,0
07968609,3,1,2,0,1,1,0,0,0
07968871,7,1,6,0,5,1,4,3,1
07969173,3,2,1,0,2,2,0,1,0
07970271,15,9,6,0,0,0,0,0,0
07970682,2,2,0,0,1,1,0,0,0
07970756,6,0,6,0,0,0,0,0,0
07971032,16,6,10,0,0,0,0,0,1
07971685,2,2,0,0,2,2,0,0,1
07971734,2,2,0,0,2,2,0,0,1
07972197,11,4,7,0,2,2,0,2,1
07972619,8,1,7,0,0,0,0,0,1
07972855,15,6,9,0,3,1,2,1,1
07972958,33,12,21,0,0,0,0,0,1
07973213,2,0,2,0,0,0,0,0,0
07973391,3,1,2,0,1,1,0,0,0
07973670,4,2,2,0,1,1,0,0,0
07974041,1,1,0,0,1,1,0,0,0
07974116,6,2,4,0,0,0,0,0,1
07974167,13,6,7,0,3,1,2,1,1
07974172,2,2,0,0,1,1,0,0,1
07974203,6,2,4,0,4,2,2,0,1
07974212,2,1,1,0,2,2,0,0,0
07974225,6,2,4,0,2,2,0,0,1
07974362,4,4,0,0,1,1,0,0,1
07974406,37,13,24,0,0,0,0,0,1
07974766,1,1,0,0,1,1,0,0,1
07975120,3,2,1,0,0,0,0,0,1
07975135,5,5,0,0,2,2,0,0,0
07975273,1,1,0,0,1,1,0,0,1
07975397,6,2,4,0,1,1,0,0,1
07975896,2,2,0,0,1,1,0,1,1
07975902,2,0,2,0,2,2,0,0,0
07976233,3,2,1,0,1,1,0,1,0
07976284,2,0,2,0,0,0,0,0,1
07976468,3,3,0,0,2,2,0,0,0
07976655,2,2,0,0,2,2,0,0,0
07976731,3,3,0,0,1,1,0,0,1
07977014,5,4,1,0,1,1,0,0,0
07977368,27,11,16,0,4,4,0,1,0
07977987,23,8,15,0,0,0,0,0,1
07978510,2,1,1,0,1,1,0,0,0
07978861,1,1,0,0,1,1,0,0,0
07978879,9,6,3,0,2,2,0,0,1
07978915,1,0,1,0,0,0,0,0,0
07978943,8,0,8,0,0,0,0,0,1
07979020,2,2,0,0,1,1,0,0,0
07979628,3,2,1,0,1,1,0,0,0
07979761,2,1,1,0,0,0,0,0,0
07980303,3,0,3,0,0,0,0,0,1
07980329,4,0,4,0,0,0,0,0,1
07980334,5,3,2,0,2,1,1,2,1
07980394,3,2,1,0,1,1,0,0,0
07980401,4,2,2,0,1,1,0,0,1
07980665,8,3,5,0,1,1,0,1,1
07980777,13,0,13,0,0,0,0,0,1
07981389,2,2,0,0,2,2,0,0,0
07981630,1,1,0,0,1,1,0,0,0
07981894,3,0,3,0,1,1,0,0,0
07981930,2,0,2,0,0,0,0,0,0
07982112,2,0,2,0,0,0,0,0,0
07982220,2,1,1,0,1,1,0,0,0
07982302,5,3,2,0,4,3,1,2,1
07982308,5,0,5,0,0,0,0,0,1
07982328,2,2,0,0,2,2,0,0,0
07982397,4,1,3,0,1,1,0,0,1
07982401,4,1,3,0,0,0,0,0,0
07982624,2,0,2,0,2,2,0,0,0
07982759,3,1,2,0,1,1,0,0,1
07983071,2,0,2,0,1,1,0,0,1
07983209,1,1,0,0,2,1,1,0,0
07983293,3,1,2,0,1,1,0,0,1
07983404,3,1,2,0,1,1,0,0,1
07983451,3,1,2,0,1,1,0,0,1
07983802,2,0,2,0,0,0,0,0,0
07983862,13,7,6,0,0,0,0,0,1
07983913,1,1,0,0,1,1,0,0,0
07983969,7,2,5,0,1,1,0,1,1
07983984,1,1,0,0,1,1,0,0,0
07984073,37,13,24,0,3,3,0,1,1
07984125,36,16,20,0,0,0,0,0,0
07984254,1,1,0,0,1,1,0,0,0
07984522,3,1,2,0,4,4,0,0,0
07984843,38,14,24,0,4,0,4,0,1
07984866,3,3,0,0,1,1,0,0,0
07985159,1,0,1,0,0,0,0,0,0
07985278,1,1,0,0,0,0,0,0,1
07985448,4,2,2,0,1,1,0,1,0
07985676,1,1,0,0,1,1,0,0,0
07985979,3,3,0,0,1,1,0,0,1
07986012,2,2,0,0,2,2,0,0,1
07986464,3,2,1,0,2,2,0,0,0
07986624,14,8,6,0,0,0,0,0,1
07986652,2,2,0,0,2,2,0,0,0
07986870,17,9,8,0,0,0,0,0,1
07986973,11,3,8,0,2,2,0,0,1
07987011,3,0,3,0,0,0,0,0,1
07987021,1,1,0,0,1,1,0,0,0
07987302,2,2,0,0,2,2,0,0,0
07987350,10,5,5,0,2,2,0,2,1
07987469,6,4,2,0,1,1,0,1,1
07987486,10,4,6,0,0,0,0,0,0
07988247,3,0,3,0,0,0,0,0,1
07988255,2,2,0,0,2,2,0,0,0
07988398,2,0,2,0,0,0,0,0,1
07988514,11,5,6,0,1,1,0,1,0
07988777,8,3,5,0,0,0,0,0,1
07988956,2,2,0,0,1,1,0,0,1
07989034,3,1,2,0,2,1,1,2,0
07989228,2,1,1,0,2,1,1,0,0
07989508,3,0,3,0,1,1,0,0,0
07989774,1,0,1,0,0,0,0,0,1
07989829,1,0,1,0,0,0,0,0,0
07989883,2,0,2,0,0,0,0,0,1
07989998,1,1,0,0,1,1,0,0,0
07990530,18,10,8,0,0,0,0,0,1
07990571,4,3,1,2,3,2,1,2,0
07990660,13,5,8,0,0,0,0,0,1
07990772,6,3,3,0,0,0,0,0,0
07990816,2,1,1,0,1,1,0,0,0
07990856,4,3,1,0,0,0,0,0,0
07990889,8,5,3,0,0,0,0,0,1
07991010,3,0,3,0,0,0,0,0,0
07991361,3,0,3,0,0,0,0,0,1
07991399,1,1,0,0,1,1,0,0,0
07991462,3,0,3,0,0,0,0,0,0
07991554,13,1,12,0,1,1,0,1,1
07991569,1,0,1,0,0,0,0,0,1
07991652,2,2,0,0,2,2,0,0,0
07991984,2,2,0,0,1,1,0,0,0
07992450,5,5,0,0,2,2,0,0,0
07992789,13,0,13,0,0,0,0,0,0
07992841,8,4,4,0,1,1,0,0,1
07992899,41,15,26,0,6,5,1,0,1
07992960,7,0,7,0,0,0,0,0,1
07993194,11,6,5,0,1,1,0,1,1
07993423,1,1,0,0,2,2,0,1,0
07993736,2,2,0,0,2,2,0,0,0
07993785,9,3,6,0,1,1,0,1,1
07993807,2,2,0,0,2,2,0,0,0
07993832,1,1,0,0,1,1,0,0,0
07993835,2,0,2,0,0,0,0,0,0
07994300,3,2,1,0,1,1,0,1,1
07994413,17,9,8,0,0,0,0,0,1
07994436,9,2,7,0,1,1,0,1,1
07994476,9,2,7,0,1,1,0,1,1
07994516,13,0,13,0,0,0,0,0,1
07994703,1,1,0,0,1,1,0,0,0
07994833,13,0,13,0,0,0,0,0,1
07994913,4,0,4,0,0,0,0,0,0
07995090,3,3,0,0,2,2,0,0,0
07995447,1,1,0,0,1,1,0,0,0
07995608,1,1,0,0,1,1,0,0,0
07995877,1,1,0,0,1,1,0,0,0
07996433,5,0,5,0,1,1,0,1,0
07996509,5,3,2,0,1,1,0,1,1
07996942,3,3,0,0,2,2,0,0,0
07997181,1,0,1,0,0,0,0,0,1
07997858,3,2,1,0,1,1,0,0,0
07998083,6,3,3,0,1,1,0,1,1
07998173,6,3,3,0,2,1,1,2,1
07998189,6,3,3,0,1,1,0,1,1
07998192,6,3,3,0,1,1,0,1,1
07998666,7,5,2,0,2,1,1,1,1
07998844,1,1,0,0,1,1,0,0,0
07998870,3,3,0,0,3,3,0,3,1
07998894,12,10,2,0,0,0,0,0,0
07999176,3,3,0,0,2,2,0,1,1
07999285,1,0,1,0,0,0,0,0,0
07999553,3,3,0,0,2,2,0,0,0
00233112,45,4,41,0,1,1,0,1,1
00233200,34,3,31,0,1,1,0,1,1
00233462,39,6,33,0,1,1,0,1,1
00233472,10,3,7,0,0,0,0,0,0
00233616,19,2,17,0,1,1,0,1,1
00234506,1,1,0,0,0,0,0,0,1
00234552,5,3,2,0,2,2,0,0,0
00234742,55,6,49,0,1,1,0,1,1
00235117,17,3,14,0,1,1,0,1,1
00235384,17,8,9,0,0,0,0,0,0
00235481,33,10,23,0,0,0,0,0,1
00235578,70,2,68,0,1,1,0,1,1
00235874,11,5,6,0,1,1,0,0,0
00235891,13,0,13,0,0,0,0,0,1
00236040,25,0,25,0,0,0,0,0,1
00236042,11,0,11,0,0,0,0,0,0
00236139,27,10,17,0,1,1,0,0,0
00236371,110,12,98,0,0,0,0,0,0
00236394,35,4,31,0,1,1,0,1,1
00236594,252,39,213,0,0,0,0,0,1
00236608,42,5,37,0,2,2,0,2,1
00236706,12,0,12,0,0,0,0,0,1
00236725,18,4,14,0,4,4,0,0,1
00236895,14,0,14,0,0,0,0,0,1
00236964,18,8,10,1,0,0,0,0,1
00237017,17,0,17,0,0,0,0,0,1
00237095,36,0,36,0,0,0,0,0,1
00237172,18,3,15,0,1,1,0,1,1
00237259,10,2,8,0,1,1,0,0,1
00237382,35,4,31,0,0,0,0,0,1
00237558,48,6,42,0,1,1,0,1,1
00237621,57,9,48,0,1,1,0,1,1
00237958,19,5,14,0,0,0,0,0,1
00238151,41,3,38,0,1,1,0,1,1
00238208,162,14,148,0,0,0,0,0,1
00238339,36,3,33,0,1,1,0,1,1
00238386,58,8,50,0,0,0,0,0,1
00238525,69,3,66,0,1,1,0,1,1
00238567,32,5,27,0,1,1,0,1,1
00238811,54,8,46,0,1,1,0,1,1
00238937,73,14,59,0,1,1,0,1,1
00239561,132,28,104,0,1,1,0,1,1
00239630,69,13,56,0,3,3,0,0,0
00239652,27,5,22,0,1,1,0,1,1
00239893,23,5,18,0,1,1,0,1,1
00240392,45,5,40,0,0,0,0,0,0
00240576,39,8,31,0,0,0,0,0,0
00240604,23,3,20,0,1,1,0,1,1
00240613,49,9,40,0,0,0,0,0,0
00240621,27,3,24,0,1,1,0,1,1
00240631,21,5,16,0,1,1,0,1,1
00240679,82,15,67,0,1,1,0,1,1
00241313,20,0,20,0,0,0,0,0,1
00241618,60,15,45,0,0,0,0,0,1
00241676,75,9,66,0,0,0,0,0,1
00241796,76,7,69,0,0,0,0,0,1
00241973,25,6,19,0,1,1,0,1,1
00242107,17,4,13,0,1,1,0,1,1
00242188,48,0,48,0,1,1,0,1,1
00242246,84,3,81,0,1,1,0,1,1
00242372,41,8,33,0,1,1,0,1,1
00242794,77,23,54,0,5,3,2,0,1
00243708,43,7,36,0,2,2,0,2,1
00243794,26,10,16,0,0,0,0,0,1
00243842,33,3,30,2,1,1,0,1,1
00243952,28,5,23,0,1,1,0,1,1
00244415,49,9,40,0,2,2,0,2,1
00244578,19,0,19,0,0,0,0,0,0
00244974,22,3,19,0,0,0,0,0,1
00244976,5,3,2,0,1,1,0,0,1
00245111,103,0,103,0,0,0,0,0,1
00245156,30,3,27,0,1,1,0,1,1
00245550,21,10,11,0,13,9,4,0,0
00246223,6,2,4,0,1,1,0,1,1
00246224,9,3,6,0,1,1,0,1,1
00246323,135,10,125,0,1,0,1,0,1
00246469,15,4,11,0,1,1,0,1,1
00246667,23,0,23,0,0,0,0,0,1
00246764,14,4,10,0,3,2,1,0,1
00246919,86,12,74,0,0,0,0,0,1
00246969,62,4,58,0,0,0,0,0,1
00247077,21,3,18,0,0,0,0,0,1
00247806,88,9,79,0,0,0,0,0,0
00248343,80,11,69,0,0,0,0,0,1
00248525,16,4,12,0,1,1,0,1,1
00248609,281,6,275,0,2,1,1,2,1
00248751,36,5,31,0,1,1,0,1,1
00249001,55,4,51,0,1,1,0,1,1
00249071,20,4,16,0,1,1,0,1,1
00249130,14,0,14,0,1,1,0,1,1
00249168,19,0,19,0,0,0,0,0,1
00249354,4,2,2,0,1,1,0,0,1
00249462,243,12,231,0,0,0,0,0,1
00249688,40,7,33,0,0,0,0,0,1
00249776,70,5,65,0,1,1,0,1,1
00249790,40,5,35,0,1,1,0,1,1
00249974,0,0,0,0,0,0,0,0,0
00249996,7,0,7,0,1,1,0,0,0
00250031,92,11,81,0,1,0,1,0,1
00250351,34,3,31,0,1,1,0,1,1
00250744,34,5,29,0,1,1,0,1,0
00250828,14,7,7,0,0,0,0,0,0
00251977,57,8,49,0,1,1,0,1,1
00252159,8,4,4,0,0,0,0,0,1
00252455,26,7,19,0,2,1,1,2,1
00252696,18,2,16,0,1,1,0,1,1
00252734,40,8,32,0,0,0,0,0,1
00252783,64,14,50,0,0,0,0,0,1
00252785,0,0,0,0,0,0,0,0,0
00252860,13,4,9,0,1,1,0,0,1
00252923,15,7,8,0,2,1,1,0,0
00252946,19,0,19,0,0,0,0,0,1
00253063,41,5,36,0,1,1,0,1,1
00253252,25,5,20,0,2,2,0,2,1
00253366,5,4,1,0,4,3,1,0,0
00253393,33,3,30,0,1,1,0,1,1
00253665,17,0,17,0,0,0,0,0,1
00253690,22,0,22,0,1,1,0,1,1
00254245,18,3,15,0,1,1,0,1,1
00254449,46,12,34,0,0,0,0,0,1
00254941,34,5,29,0,1,1,0,1,1
00254946,11,7,4,0,1,1,0,1,0
00255374,39,10,29,0,0,0,0,0,1
00255427,0,0,0,0,0,0,0,0,0
00255486,71,16,55,0,0,0,0,0,1
00255503,63,7,56,0,0,0,0,0,0
00255642,9,3,6,0,2,2,0,2,0
00255852,29,5,24,0,1,1,0,1,1
00255864,63,9,54,0,1,1,0,0,1
00255912,52,5,47,0,1,1,0,1,1
00256353,71,14,57,0,18,11,7,0,1
00256980,19,0,19,0,0,0,0,0,1
00257614,29,5,24,0,1,1,0,1,1
00257981,88,18,70,0,0,0,0,0,1
00258068,9,1,8,0,1,1,0,1,1
00258414,45,4,41,0,1,1,0,1,1
00258557,22,3,19,0,1,1,0,1,1
00258577,82,16,66,0,0,0,0,0,1
00258949,35,3,32,0,1,1,0,1,1
00259345,51,3,48,0,1,1,0,1,1
00259378,33,4,29,0,1,1,0,1,1
00259647,179,15,164,0,0,0,0,0,1
00260104,51,16,35,0,0,0,0,0,1
00260320,31,5,26,0,3,3,0,3,1
00260431,23,5,18,0,1,1,0,1,1
00260637,23,8,15,0,1,1,0,0,0
00262152,45,5,40,0,0,0,0,0,1
00262511,140,0,140,0,0,0,0,0,1
00262770,136,19,117,0,0,0,0,0,0
00262938,40,3,37,0,1,1,0,1,1
00263047,34,4,30,0,2,2,0,2,1
00263054,20,4,16,0,1,1,0,1,1
00263162,84,8,76,0,0,0,0,0,1
00263528,30,0,30,0,1,1,0,1,1
00263866,55,4,51,0,1,1,0,1,1
00264191,24,6,18,0,1,1,0,1,1
00264228,16,3,13,0,1,1,0,1,0
00264516,4,3,1,0,1,1,0,0,0
00264527,37,3,34,0,0,0,0,0,1
00264709,32,0,32,0,0,0,0,0,1
00265048,37,5,32,0,1,1,0,1,1
00265328,84,10,74,0,0,0,0,0,1
00265896,38,5,33,0,1,1,0,1,1
00265904,12,3,9,0,1,1,0,1,1
00266309,33,0,33,0,0,0,0,0,1
00266666,10,0,10,0,0,0,0,0,1
00266744,6,0,6,0,0,0,0,0,1
00266951,23,3,20,0,1,1,0,1,1
00267003,12,4,8,0,1,1,0,1,1
00267063,52,5,47,0,0,0,0,0,1
00267491,15,3,12,0,1,1,0,1,1
00268229,20,3,17,1,2,1,1,1,1
00269238,8,3,5,0,1,1,0,0,0
00269422,41,0,41,0,0,0,0,0,1
00269663,26,0,26,0,1,1,0,1,1
00269999,16,4,12,0,1,1,0,1,1
00270145,136,14,122,0,0,0,0,0,1
00270153,33,8,25,0,1,1,0,1,1
00270704,11,6,5,0,0,0,0,0,0
00270903,42,4,38,0,1,1,0,1,1
00271932,19,0,19,0,0,0,0,0,1
00271998,27,3,24,0,1,1,0,1,1
00272272,12,2,10,0,0,0,0,0,1
00272562,20,2,18,0,1,1,0,1,1
00272806,22,3,19,0,1,1,0,1,1
00273338,13,0,13,0,0,0,0,0,1
00273408,34,4,30,0,2,1,1,2,1
00274345,19,3,16,0,4,2,2,0,1
00274453,17,3,14,0,1,1,0,1,1
00274611,33,0,33,0,0,0,0,0,1
00275161,11,3,8,0,1,1,0,1,1
00275294,28,0,28,0,1,1,0,1,1
00275642,16,5,11,0,1,1,0,1,1
00275947,24,5,19,0,1,1,0,1,1
00276021,17,0,17,0,0,0,0,0,1
00276029,16,2,14,0,1,1,0,1,1
00276120,0,0,0,0,0,0,0,0,0
00276180,46,1,45,0,1,1,0,1,1
00276532,4,4,0,0,2,2,0,0,1
00276770,26,0,26,0,1,1,0,1,1
00277468,21,3,18,0,1,1,0,1,1
00277478,16,3,13,0,1,1,0,0,1
00278109,203,7,196,0,0,0,0,0,1
00278208,42,5,37,0,0,0,0,0,1
00278224,38,7,31,0,1,1,0,1,1
00278235,42,5,37,0,1,1,0,1,1
00278733,9,4,5,0,1,1,0,1,1
00278795,147,7,140,0,10,7,3,0,1
00278802,55,12,43,0,0,0,0,0,1
00278994,26,4,22,0,1,1,0,1,1
00279157,68,11,57,0,0,0,0,0,1
00279588,5,1,4,0,1,1,0,0,1
00279756,86,5,81,0,1,1,0,0,0
00279942,16,5,11,0,1,1,0,0,1
SC630189,4,1,3,0,2,1,1,1,0
SC630286,2,2,0,0,1,1,0,1,1
SC630338,1,1,0,0,1,1,0,0,0
SC630418,2,2,0,0,2,2,0,0,0
SC630815,4,4,0,0,0,0,0,0,0
SC630902,2,2,0,0,1,1,0,0,0
SC630948,1,1,0,0,3,3,0,0,0
SC630977,1,1,0,0,1,1,0,0,0
SC630985,2,2,0,0,2,2,0,0,0
SC631046,1,1,0,0,1,1,0,0,1
SC631103,2,2,0,0,2,2,0,0,0
SC631307,1,1,0,0,1,1,0,0,0
SC631534,1,1,0,0,1,1,0,0,1
SC631540,1,1,0,0,1,1,0,0,0
SC631757,1,1,0,0,1,1,0,0,0
SC631766,1,1,0,0,1,1,0,0,0
SC631938,1,1,0,0,1,1,0,0,0
SC632029,2,2,0,0,2,2,0,0,0
SC632037,1,1,0,0,1,1,0,0,0
SC632044,1,1,0,0,1,1,0,0,0
SC632144,1,1,0,0,1,1,0,0,0
SC632190,1,1,0,0,1,1,0,0,0
SE000076,5,3,2,0,0,0,0,0,1
SE000081,4,4,0,0,0,0,0,0,1
SF000300,57,5,52,0,0,0,0,0,1
SF000900,10,3,7,0,0,0,0,0,1
SF000919,15,0,15,0,0,0,0,0,1
SF000987,4,4,0,0,0,0,0,0,0
SL000224,0,0,0,0,0,0,0,0,0
SL000403,0,0,0,0,0,0,0,0,0
SL000714,0,0,0,0,0,0,0,0,0
SL000902,0,0,0,0,0,0,0,0,0
SL001045,0,0,0,0,0,0,0,0,0
SL001192,0,0,0,0,0,0,0,0,0
SL001340,0,0,0,0,0,0,0,0,0
SL001503,0,0,0,0,0,0,0,0,0
SL001534,0,0,0,0,0,0,0,0,0
SL001539,0,0,0,0,0,0,0,0,0
SL001726,0,0,0,0,0,0,0,0,0
SL001732,0,0,0,0,0,0,0,0,0
SL001846,0,0,0,0,0,0,0,0,0
SL001849,0,0,0,0,0,0,0,0,0
SL001902,0,0,0,0,0,0,0,0,0
SL001955,0,0,0,0,0,0,0,0,0
SL002078,0,0,0,0,0,0,0,0,0
SL002158,0,0,0,0,0,0,0,0,0
SL002162,0,0,0,0,0,0,0,0,0
SL002163,0,0,0,0,0,0,0,0,0
SL002166,0,0,0,0,0,0,0,0,0
SL002179,0,0,0,0,2,2,0,0,0
SL002233,0,0,0,0,0,0,0,0,0
SL002243,0,0,0,0,0,0,0,0,0
SL002244,0,0,0,0,0,0,0,0,0
SL002298,0,0,0,0,0,0,0,0,0
SL002390,0,0,0,0,0,0,0,0,0
SL002409,0,0,0,0,0,0,0,0,0
SL002494,0,0,0,0,0,0,0,0,0
SL002518,0,0,0,0,0,0,0,0,0
SL002711,0,0,0,0,0,0,0,0,0
SL002805,0,0,0,0,0,0,0,0,0
SL002942,0,0,0,0,1,1,0,1,0
SL003293,0,0,0,0,1,1,0,0,0
SL003532,0,0,0,0,0,0,0,0,0
SL003587,0,0,0,0,0,0,0,0,0
SL003658,0,0,0,0,0,0,0,0,0
SL003682,0,0,0,0,0,0,0,0,0
SL003861,0,0,0,0,0,0,0,0,0
SL003871,0,0,0,0,1,1,0,0,0
SL003926,0,0,0,0,0,0,0,0,0
SL004491,0,0,0,0,0,0,0,0,0
SL004719,0,0,0,0,0,0,0,0,0
SL004726,0,0,0,0,0,0,0,0,0
SL004954,0,0,0,0,0,0,0,0,0
SL005116,0,0,0,0,0,0,0,0,0
SL005417,0,0,0,0,0,0,0,0,0
SL006869,0,0,0,0,2,2,0,2,0
SL006871,0,0,0,0,3,3,0,2,0
SL006873,0,0,0,0,0,0,0,0,0
SL007636,0,0,0,0,1,1,0,0,0
SL007789,0,0,0,0,0,0,0,0,0
SL007968,0,0,0,0,0,0,0,0,0
SL008028,0,0,0,0,0,0,0,0,0
SL008317,0,0,0,0,1,1,0,1,0
SL008500,0,0,0,0,0,0,0,0,0
SL008657,0,0,0,0,0,0,0,0,0
SL008788,0,0,0,0,0,0,0,0,0
SL009117,0,0,0,0,0,0,0,0,0
SL009658,0,0,0,0,0,0,0,0,0
SL009994,0,0,0,0,1,1,0,0,0
SL010171,0,0,0,0,0,0,0,0,0
SL010231,0,0,0,0,0,0,0,0,0
SL010280,0,0,0,0,0,0,0,0,0
SL010702,0,0,0,0,0,0,0,0,0
SL010758,0,0,0,0,0,0,0,0,0
SL011234,0,0,0,0,0,0,0,0,0
SL011256,0,0,0,0,2,2,0,2,0
SL01158A,0,0,0,0,0,0,0,0,0
SL011693,0,0,0,0,0,0,0,0,0
SL011696,0,0,0,0,1,1,0,1,0
SL011929,0,0,0,0,0,0,0,0,0
SL012110,0,0,0,0,2,1,1,1,0
SL012256,0,0,0,0,1,1,0,0,0
SL012363,0,0,0,0,1,1,0,0,0
SL012438,0,0,0,0,0,0,0,0,0
SL012621,0,0,0,0,0,0,0,0,0
SL012683,0,0,0,0,0,0,0,0,0
SL012739,0,0,0,0,0,0,0,0,0
SL013899,0,0,0,0,0,0,0,0,0
SL014046,0,0,0,0,0,0,0,0,0
SL014074,0,0,0,0,0,0,0,0,0
SL014227,0,0,0,0,1,1,0,0,0
SL014326,0,0,0,0,0,0,0,0,0
SL014477,0,0,0,0,1,1,0,1,0
SL014779,0,0,0,0,0,0,0,0,0
SL015036,0,0,0,0,0,0,0,0,0
SL015047,0,0,0,0,0,0,0,0,0
SL015048,0,0,0,0,0,0,0,0,0
SL015626,0,0,0,0,1,1,0,0,0
SL015768,0,0,0,0,0,0,0,0,0
SL015866,0,0,0,0,2,2,0,2,0
SL015867,0,0,0,0,2,2,0,2,0
SL015980,0,0,0,0,0,0,0,0,0
SL016059,0,0,0,0,0,0,0,0,0
SL016445,0,0,0,0,0,0,0,0,0
SL017255,0,0,0,0,0,0,0,0,0
SL018113,0,0,0,0,0,0,0,0,0
SL018733,0,0,0,0,0,0,0,0,0
SL018734,0,0,0,0,0,0,0,0,0
SL018736,0,0,0,0,0,0,0,0,0
SL018939,0,0,0,0,0,0,0,0,0
SL019555,0,0,0,0,0,0,0,0,0
SL019556,0,0,0,0,1,1,0,1,0
SL019558,0,0,0,0,1,1,0,1,0
SL019589,0,0,0,0,0,0,0,0,0
SL019590,0,0,0,0,0,0,0,0,0
SL019819,0,0,0,0,0,0,0,0,0
SL020261,0,0,0,0,2,2,0,2,0
SL022276,0,0,0,0,0,0,0,0,0
SL022377,0,0,0,0,0,0,0,0,0
SL022617,0,0,0,0,0,0,0,0,0
SL022747,0,0,0,0,1,1,0,0,0
SL022753,0,0,0,0,1,1,0,0,0
SL022756,0,0,0,0,0,0,0,0,0
SL023336,0,0,0,0,0,0,0,0,0
SL025196,0,0,0,0,0,0,0,0,0
SL026185,0,0,0,0,2,1,1,0,0
SL026247,0,0,0,0,2,1,1,1,0
SL026378,0,0,0,0,2,1,1,0,0
SL026755,0,0,0,0,1,1,0,0,0
SL027014,0,0,0,0,0,0,0,0,0
SL027025,0,0,0,0,0,0,0,0,0
SL027923,0,0,0,0,1,1,0,0,0
SL028138,0,0,0,0,0,0,0,0,0
SL028375,0,0,0,0,0,0,0,0,0
SL028410,0,0,0,0,2,2,0,2,0
SL028499,0,0,0,0,0,0,0,0,0
SL029026,0,0,0,0,2,2,0,0,0
SL029067,0,0,0,0,0,0,0,0,0
SL029411,0,0,0,0,0,0,0,0,0
SL029412,0,0,0,0,0,0,0,0,0
SL030134,0,0,0,0,1,1,0,0,0
SL030632,0,0,0,0,1,1,0,0,0
SL030659,0,0,0,0,2,1,1,2,0
SL030715,0,0,0,0,1,1,0,1,0
SL031060,0,0,0,0,2,2,0,2,0
SL031264,0,0,0,0,0,0,0,0,0
SL031418,0,0,0,0,1,1,0,0,0
SL031938,0,0,0,0,0,0,0,0,0
SL032372,0,0,0,0,0,0,0,0,0
SL032571,0,0,0,0,1,1,0,0,0
SL033756,0,0,0,0,2,2,0,2,0
SO300143,24,16,8,0,0,0,0,0,1
SO300197,26,0,26,0,0,0,0,0,1
SO300208,36,30,6,0,0,0,0,0,1
SO300334,158,101,57,0,0,0,0,0,1
SO300337,60,29,31,0,0,0,0,0,1
SO300361,3,3,0,0,3,3,0,0,0
SO300365,50,12,38,0,5,4,1,2,1
SO300380,113,69,44,0,0,0,0,0,1
SO300381,85,58,27,0,0,0,0,0,1
SO300472,81,46,35,0,0,0,0,0,1
SO300483,11,0,11,0,2,2,0,0,0
SO300523,11,0,11,0,3,3,0,0,1
SO300528,3,3,0,0,3,3,0,0,0
SO300554,16,5,11,0,2,2,0,0,1
SO300743,40,22,18,0,0,0,0,0,1
SO300744,131,2,129,1,1,1,0,0,1
SO300763,9,2,7,0,2,2,0,0,1
SO300895,146,79,67,0,0,0,0,0,1
SO300995,36,16,20,0,0,0,0,0,1
SO301047,5,2,3,0,2,2,0,0,1
SO301342,50,23,27,1,2,2,0,0,1
SO301363,6,2,4,0,0,0,0,0,0
SO301434,3,2,1,0,2,2,0,0,0
SO301438,12,0,12,0,0,0,0,0,1
SO301457,5,4,1,0,3,3,0,1,1
SO301485,93,51,42,0,0,0,0,0,1
SO301528,4,0,4,0,0,0,0,0,1
SO301530,5,2,3,0,2,2,0,1,1
SO301600,52,30,22,0,0,0,0,0,1
SO301640,2,2,0,0,2,2,0,0,1
SO301657,10,6,4,0,2,2,0,1,1
SO301685,46,21,25,0,0,0,0,0,1
SO301745,3,2,1,0,2,2,0,2,1
SO301790,8,0,8,0,0,0,0,0,1
SO301792,5,5,0,0,1,1,0,0,1
SO301878,3,3,0,0,1,1,0,1,1
SO301884,8,6,2,0,1,1,0,0,1
SO301924,7,3,4,0,3,3,0,0,1
SO301951,7,3,4,1,0,0,0,0,1
SO301976,5,0,5,0,0,0,0,0,1
SO302141,3,2,1,0,2,2,0,0,0
SO302305,3,2,1,0,2,2,0,1,0
SO302323,5,0,5,0,0,0,0,0,1
SO302385,3,0,3,0,0,0,0,0,1
SO302402,2,2,0,0,0,0,0,0,0
SO302461,4,0,4,0,0,0,0,0,1
SO302536,7,0,7,0,0,0,0,0,1
SO302584,6,0,6,0,1,1,0,0,1
SO302634,22,14,8,0,0,0,0,0,1
SO302766,11,8,3,0,1,1,0,0,1
SO302772,4,0,4,0,0,0,0,0,1
SO302785,8,4,4,0,0,0,0,0,1
SO302828,3,0,3,0,0,0,0,0,0
SO302865,2,0,2,0,0,0,0,0,0
SO302971,3,2,1,0,1,1,0,0,0
SO303043,6,0,6,0,0,0,0,0,1
SO303061,34,33,1,1,0,0,0,0,0
SO303107,9,9,0,0,1,1,0,0,1
SO303170,7,2,5,0,2,2,0,0,0
SO303243,23,14,9,0,0,0,0,0,1
SO303252,4,4,0,0,1,1,0,0,0
SO303274,11,3,8,0,0,0,0,0,1
SO303286,4,4,0,0,4,4,0,0,1
SO303418,3,3,0,0,2,2,0,2,1
SO303419,3,3,0,0,2,2,0,2,1
SO303494,2,0,2,0,2,2,0,0,1
SO303514,5,3,2,0,3,3,0,0,0
SO303517,3,0,3,0,0,0,0,0,1
SO303545,2,2,0,0,1,1,0,0,1
SO303547,2,2,0,0,1,1,0,0,1
SO303605,5,0,5,0,0,0,0,0,1
SO303684,3,3,0,0,2,2,0,2,1
SO303685,3,3,0,0,2,2,0,2,1
SO303802,2,0,2,0,0,0,0,0,0
SO303818,7,3,4,0,3,2,1,0,1
SO303886,3,3,0,0,1,1,0,0,1
SO303918,10,4,6,0,4,4,0,0,1
SO303947,7,2,5,0,2,2,0,0,1
SO304021,4,0,4,0,0,0,0,0,1
SO304026,2,2,0,0,1,1,0,0,0
SO304061,5,5,0,0,2,2,0,0,0
SO304076,5,0,5,0,1,1,0,0,0
SO304435,6,3,3,0,1,1,0,1,1
SO304493,5,5,0,2,0,0,0,0,1
SO304527,3,0,3,0,0,0,0,0,1
SO304672,8,5,3,0,0,0,0,0,1
SO304725,2,2,0,2,1,1,0,0,0
SO304751,28,27,1,0,2,2,0,0,1
SO304793,13,11,2,3,2,2,0,0,0
SO304824,4,2,2,0,3,2,1,3,0
SO304913,4,3,1,0,2,2,0,2,1
SO304914,3,3,0,0,2,2,0,2,1
SO305086,60,0,60,0,0,0,0,0,1
SO305165,2,2,0,0,2,2,0,0,1
SO305173,3,3,0,0,2,2,0,2,1
SO305217,4,2,2,0,1,1,0,0,1
SO305450,4,3,1,0,4,3,1,3,1
SO305470,4,3,1,0,3,2,1,3,1
SO305500,2,2,0,0,2,2,0,2,1
SO305527,4,4,0,0,1,1,0,0,1
SO305530,3,3,0,0,2,2,0,2,1
SO305535,3,3,0,0,2,2,0,2,1
SO305799,4,4,0,0,0,0,0,0,1
SO305818,3,2,1,2,1,1,0,0,0
SO305864,3,0,3,0,3,2,1,2,0
SO306228,29,5,24,0,2,2,0,0,0
SO306275,2,2,0,0,0,0,0,0,0
SO306320,13,12,1,0,1,1,0,0,0
SO306433,6,6,0,0,2,2,0,0,1
SO306448,5,5,0,0,2,2,0,0,1
SO306564,15,15,0,0,1,1,0,0,0
SO306637,3,3,0,0,3,3,0,0,0
SP000083,0,0,0,0,0,0,0,0,0
SP000087,0,0,0,0,0,0,0,0,0
SP00015F,0,0,0,0,0,0,0,0,0
SP000164,0,0,0,0,0,0,0,0,0
SP00062F,0,0,0,0,0,0,0,0,0
SP0014RS,0,0,0,0,0,0,0,0,0
SP0014WS,0,0,0,0,0,0,0,0,0
SP0018CU,0,0,0,0,0,0,0,0,0
SP002102,0,0,0,0,0,0,0,0,0
SP002711,0,0,0,0,0,0,0,0,0
SP002714,0,0,0,0,0,0,0,0,0
SP002723,0,0,0,0,0,0,0,0,0
SP002727,0,0,0,0,0,0,0,0,0
SP002736,0,0,0,0,0,0,0,0,0
SP002773,0,0,0,0,0,0,0,0,0
SP0032RS,0,0,0,0,0,0,0,0,0
SP0038RS,0,0,0,0,0,0,0,0,0
SP0040CU,0,0,0,0,0,0,0,0,0
SP0050RS,0,0,0,0,0,0,0,0,0
SP0085RS,0,0,0,0,0,0,0,0,0
SP0095CU,0,0,0,0,0,0,0,0,0
SP0096CU,0,0,0,0,0,0,0,0,0
SP010SAS,0,0,0,0,0,0,0,0,0
SP01624R,0,0,0,0,0,0,0,0,0
SP017CUS,0,0,0,0,0,0,0,0,0
SP0214RS,0,0,0,0,0,0,0,0,0
SP02160R,0,0,0,0,0,0,0,0,0
SP02272R,0,0,0,0,0,0,0,0,0
SP0234RS,0,0,0,0,0,0,0,0,0
SP02382R,0,0,0,0,0,0,0,0,0
SP02389R,0,0,0,0,0,0,0,0,0
SP02398R,0,0,0,0,0,0,0,0,0
SP02BENS,0,0,0,0,0,0,0,0,0
SP0300RS,0,0,0,0,0,0,0,0,0
SP0306RS,0,0,0,0,0,0,0,0,0
SP03BENS,0,0,0,0,0,0,0,0,0
SP0429RS,0,0,0,0,0,0,0,0,0
SP06BENS,0,0,0,0,0,0,0,0,0
SP0815RS,0,0,0,0,0,0,0,0,0
SP0816RS,0,0,0,0,0,0,0,0,0
SP0826RS,0,0,0,0,0,0,0,0,0
SP0849RS,0,0,0,0,0,0,0,0,0
SP0891RS,0,0,0,0,0,0,0,0,0
SP0895RS,0,0,0,0,0,0,0,0,0
SP0941RS,0,0,0,0,0,0,0,0,0
SP0981RS,0,0,0,0,0,0,0,0,0
SP1089RS,0,0,0,0,0,0,0,0,0
SP109CUS,0,0,0,0,0,0,0,0,0
SP110CUS,0,0,0,0,0,0,0,0,0
SP111CUS,0,0,0,0,0,0,0,0,0
SP1157RS,0,0,0,0,0,0,0,0,0
SP1163RS,0,0,0,0,0,0,0,0,0
SP1207RS,0,0,0,0,0,0,0,0,0
SP1211RS,0,0,0,0,0,0,0,0,0
SP1238RS,0,0,0,0,0,0,0,0,0
SP1242RS,0,0,0,0,0,0,0,0,0
SP1264RS,0,0,0,0,0,0,0,0,0
SP1278RS,0,0,0,0,0,0,0,0,0
SP1284RS,0,0,0,0,0,0,0,0,0
SP1303RS,0,0,0,0,0,0,0,0,0
SP1316RS,0,0,0,0,0,0,0,0,0
SP1317RS,0,0,0,0,0,0,0,0,0
SP1335RS,0,0,0,0,0,0,0,0,0
SP1340RS,0,0,0,0,0,0,0,0,0
SP1362RS,0,0,0,0,0,0,0,0,0
SP1445RS,0,0,0,0,0,0,0,0,0
SP1463RS,0,0,0,0,0,0,0,0,0
SP1495RS,0,0,0,0,0,0,0,0,0
SP1523RS,0,0,0,0,0,0,0,0,0
SP1624RS,0,0,0,0,0,0,0,0,0
SP1649RS,0,0,0,0,0,0,0,0,0
SP1735RS,0,0,0,0,0,0,0,0,0
SP1749RS,0,0,0,0,0,0,0,0,0
SP1751RS,0,0,0,0,0,0,0,0,0
SP1813RS,0,0,0,0,0,0,0,0,0
SP1891RS,0,0,0,0,0,0,0,0,0
SP1944RS,0,0,0,0,0,0,0,0,0
SP2008RS,0,0,0,0,0,0,0,0,0
SP2024RS,0,0,0,0,0,0,0,0,0
SP2029RS,0,0,0,0,0,0,0,0,0
SP2078RS,0,0,0,0,0,0,0,0,0
SP2084RS,0,0,0,0,0,0,0,0,0
SP2332RS,0,0,0,0,0,0,0,0,0
SP2428RS,0,0,0,0,0,0,0,0,0
SP2463RS,0,0,0,0,0,0,0,0,0
SP2470RS,0,0,0,0,0,0,0,0,0
SP2502RS,0,0,0,0,0,0,0,0,0
SP2534RS,0,0,0,0,0,0,0,0,0
SP2535RS,0,0,0,0,0,0,0,0,0
SP2540RS,0,0,0,0,0,0,0,0,0
SP2588RS,0,0,0,0,0,0,0,0,0
SP2627RS,0,0,0,0,0,0,0,0,0
SP2680RS,0,0,0,0,0,0,0,0,0
SP2696RS,0,0,0,0,0,0,0,0,0
SP29508R,0,0,0,0,0,0,0,0,0
SP29560R,0,0,0,0,0,0,0,0,0
SP29689R,0,0,0,0,0,0,0,0,0
SZ000002,42,3,39,0,1,1,0,1,1
SZ000004,53,3,50,0,2,1,1,2,1
SZ000005,55,6,49,0,1,1,0,1,1
SZ000012,36,3,33,0,0,0,0,0,1
SZ000015,57,6,51,0,1,0,1,1,1
ZC000018,59,15,44,0,0,0,0,0,1
ZC000035,17,0,17,0,1,1,0,1,1
ZC000065,37,3,34,0,1,1,0,1,1
ZC000073,64,5,59,0,1,1,0,1,1
ZC000150,9,4,5,0,0,0,0,0,0
ZC000167,15,3,12,0,0,0,0,0,1
ZC000169,13,3,10,0,0,0,0,0,0
ZC000177,5,3,2,0,0,0,0,0,0
ZC000191,16,5,11,0,1,1,0,0,0
10700405,2,0,2,0,2,2,0,0,1
10701012,4,3,1,0,1,1,0,1,1
10701460,2,2,0,0,1,1,0,0,0
10701566,1,1,0,0,1,1,0,0,0
10702007,2,2,0,0,1,1,0,0,0
10702135,1,1,0,0,1,1,0,0,0
10702594,1,0,1,0,0,0,0,0,0
10703217,3,3,0,0,3,1,2,1,0
10703742,1,1,0,0,1,1,0,0,0
10704120,1,1,0,0,1,1,0,0,0
10704240,2,0,2,0,1,1,0,0,0
10704806,2,2,0,0,2,2,0,0,0
10705639,2,0,2,0,2,1,1,0,0
10706158,2,2,0,0,2,2,0,0,0
10706274,2,2,0,0,0,0,0,0,1
10706499,1,0,1,0,1,1,0,0,0
10706980,1,1,0,0,1,1,0,0,0
10707260,1,1,0,0,1,1,0,0,0
10707629,3,3,0,0,3,3,0,0,1
10707713,2,0,2,0,2,1,1,1,0
10707817,1,0,1,0,1,1,0,0,0
10707840,1,1,0,0,1,1,0,0,0
10707862,3,3,0,0,3,3,0,0,1
10707928,3,3,0,0,3,3,0,0,1
10708097,1,1,0,0,1,1,0,0,0
10708314,2,2,0,0,1,1,0,0,1
10708930,1,1,0,0,1,1,0,1,0
10709008,3,1,2,0,1,1,0,0,0
10709098,1,1,0,0,1,1,0,0,0
10709472,2,2,0,0,2,2,0,0,0
10709909,1,1,0,0,1,1,0,0,0
10710062,7,4,3,0,1,1,0,1,1
10710065,4,4,0,0,2,1,1,1,1
10710100,2,2,0,0,0,0,0,0,0
10710139,7,4,3,0,1,1,0,1,1
10710239,3,2,1,0,0,0,0,0,0
10710696,3,2,1,1,2,1,1,0,0
10710729,1,1,0,0,1,1,0,0,0
10711032,3,2,1,0,2,1,1,0,0
10711139,1,1,0,0,1,1,0,0,0
10711244,1,1,0,0,1,1,0,0,0
10711282,2,2,0,0,1,1,0,0,0
10711334,3,3,0,0,3,3,0,0,0
10711739,1,1,0,0,1,1,0,0,0
10711948,1,1,0,0,1,1,0,0,0
10711977,3,2,1,0,1,1,0,0,0
10712078,1,1,0,0,2,2,0,0,0
10712575,2,1,1,0,2,1,1,0,0
10712578,5,4,1,0,3,2,1,0,0
10712864,2,0,2,0,2,2,0,0,0
10712872,1,1,0,0,2,2,0,0,0
10712953,14,8,6,0,2,2,0,0,0
10713097,1,0,1,0,1,1,0,0,0
10713149,3,3,0,0,2,2,0,0,1
10713303,1,1,0,0,1,1,0,0,0
10714110,1,1,0,0,1,1,0,0,0
10714418,1,1,0,0,1,1,0,0,0
10714568,12,6,6,0,1,0,1,0,1
10715079,6,2,4,0,2,1,1,2,1
10715118,1,1,0,0,1,1,0,0,0
10715162,1,0,1,0,0,0,0,0,0
10715394,2,2,0,0,2,2,0,0,1
10716203,9,9,0,0,0,0,0,0,0
10716468,1,1,0,0,1,1,0,0,0
10717598,3,2,1,0,1,1,0,0,0
10717865,1,0,1,0,1,1,0,0,0
10717917,2,2,0,0,2,2,0,0,0
10717980,2,0,2,0,1,1,0,0,0
10719625,1,1,0,0,1,1,0,0,0
10720103,4,2,2,0,4,2,2,0,0
10720400,1,1,0,0,1,1,0,0,0
10720910,2,2,0,0,2,2,0,0,0
10721550,1,1,0,0,2,1,1,0,0
10721584,4,4,0,0,1,1,0,1,0
10721657,1,1,0,0,1,1,0,0,0
10721689,1,1,0,0,1,1,0,0,0
10721850,2,1,1,0,0,0,0,0,0
10721936,2,2,0,0,2,2,0,0,1
10722259,3,1,2,0,3,1,2,0,0
10722553,1,1,0,0,1,1,0,0,0
10722556,1,1,0,0,2,2,0,0,0
10722711,4,3,1,0,1,1,0,1,1
10722853,2,0,2,0,1,1,0,0,0
10722907,17,13,4,0,0,0,0,0,0
10723950,2,1,1,0,0,0,0,0,0
10724064,2,2,0,0,2,2,0,0,0
10724631,2,2,0,0,1,1,0,0,0
10724781,2,2,0,0,2,2,0,0,0
10725191,2,2,0,0,2,2,0,0,0
10725344,2,2,0,0,2,2,0,0,1
10725781,2,0,2,0,1,1,0,0,0
10725926,1,0,1,0,1,1,0,0,0
10726056,5,5,0,0,4,2,2,1,1
10726148,4,4,0,0,2,1,1,1,1
10726228,2,2,0,0,2,2,0,0,1
10726349,2,1,1,0,2,1,1,0,1
10726559,1,1,0,0,2,1,1,0,1
10726663,2,1,1,0,2,1,1,0,1
10727248,1,0,1,0,1,1,0,0,0
10727551,1,0,1,0,1,1,0,0,0
10727958,2,2,0,0,1,1,0,0,1
10728432,1,0,1,0,1,1,0,0,0
10728471,1,1,0,0,1,1,0,0,0
10728530,1,1,0,0,1,1,0,0,0
10728546,1,1,0,0,1,1,0,0,0
10728571,2,2,0,0,0,0,0,0,0
10728794,2,0,2,0,0,0,0,0,0
10728852,1,1,0,0,1,1,0,0,0
10729192,1,1,0,0,1,1,0,0,0
10730149,2,2,0,0,1,1,0,1,1
10730151,1,0,1,0,1,1,0,0,0
10730623,1,0,1,0,1,1,0,0,0
10730774,1,0,1,0,1,1,0,0,0
10730909,2,0,2,0,1,1,0,0,0
10731128,1,1,0,0,1,1,0,0,0
10731204,1,1,0,0,1,1,0,0,0
10732541,1,1,0,0,1,1,0,0,0
10732816,6,4,2,0,1,1,0,1,0
10732858,1,1,0,0,1,1,0,0,0
10733045,2,2,0,0,1,1,0,1,0
10733499,2,1,1,0,1,1,0,1,1
10733568,3,0,3,0,0,0,0,0,0
10733967,1,0,1,0,1,1,0,0,0
10734251,1,0,1,0,1,1,0,0,0
10734395,12,7,5,0,0,0,0,0,0
10734592,3,3,0,0,0,0,0,0,0
10734801,1,1,0,0,1,1,0,0,0
10735116,21,13,8,0,2,1,1,2,1
10735121,8,3,5,0,1,1,0,1,1
10735273,8,3,5,0,1,1,0,1,1
10735544,4,2,2,0,4,1,3,1,1
10736311,2,2,0,0,2,2,0,0,0
10736403,1,0,1,0,1,1,0,0,0
10736418,4,0,4,0,2,2,0,0,0
10736583,2,1,1,0,2,1,1,0,0
10736751,1,1,0,0,1,1,0,0,0
10736891,1,1,0,0,1,1,0,0,0
10736894,2,2,0,0,2,2,0,0,0
10737611,8,3,5,0,1,1,0,1,1
10737809,3,3,0,0,2,2,0,0,0
10737985,2,2,0,0,2,2,0,0,0
10738036,8,3,5,0,1,1,0,1,1
10738214,8,3,5,0,1,1,0,1,1
10738697,2,2,0,0,2,2,0,0,0
10738795,3,3,0,0,3,3,0,0,0
10739038,1,1,0,0,1,1,0,0,0
10739113,1,1,0,0,1,1,0,0,0
10739356,2,2,0,0,2,2,0,0,0
10739529,2,1,1,0,2,1,1,0,1
10739867,3,3,0,0,2,2,0,0,1
10740637,3,3,0,0,1,1,0,1,0
10740779,1,1,0,0,1,1,0,0,0
10741628,2,2,0,0,1,1,0,0,0
10741940,2,2,0,0,1,1,0,0,1
10742274,3,3,0,0,2,2,0,0,0
10742368,6,5,1,0,0,0,0,0,0
10742568,5,2,3,0,3,2,1,1,1
10742824,6,3,3,0,1,0,1,1,1
10742954,1,1,0,0,1,1,0,0,1
10742998,3,2,1,0,2,1,1,0,1
10743058,1,1,0,0,0,0,0,0,0
10743235,1,1,0,0,1,1,0,0,0
10743612,1,1,0,0,2,2,0,0,0
10743656,6,0,6,0,0,0,0,0,1
10743701,5,3,2,0,1,1,0,1,1
10744253,1,0,1,0,1,1,0,0,0
10744301,2,1,1,0,2,1,1,0,0
10744306,2,2,0,0,1,1,0,0,1
10744352,2,2,0,0,2,2,0,0,0
10744437,1,1,0,0,1,1,0,0,0
10744525,2,2,0,0,1,1,0,0,0
10744589,2,0,2,0,1,1,0,0,0
10744598,3,3,0,0,3,3,0,0,0
10744845,1,0,1,0,0,0,0,0,0
10745726,3,3,0,0,4,4,0,1,0
10745922,1,0,1,0,1,1,0,0,0
10745931,2,0,2,0,1,1,0,0,0
10746107,1,1,0,0,1,1,0,1,0
10746203,4,3,1,0,1,1,0,0,0
10746252,3,3,0,0,0,0,0,0,0
10746543,5,4,1,0,2,2,0,2,1
10746756,1,1,0,0,1,1,0,0,0
10746880,1,1,0,0,1,1,0,0,0
10746890,5,3,2,0,1,1,0,1,1
10746905,7,6,1,0,0,0,0,0,1
10746933,5,5,0,0,1,1,0,0,0
10746990,1,1,0,0,1,1,0,0,1
10747122,2,2,0,0,1,1,0,0,0
10747366,1,1,0,0,0,0,0,0,0
10747640,2,2,0,0,2,2,0,0,0
10747717,3,1,2,0,1,1,0,0,0
10747854,1,0,1,0,1,1,0,0,0
10748203,2,0,2,0,2,2,0,0,0
10748251,1,1,0,0,1,1,0,0,0
10748366,1,0,1,0,1,1,0,0,0
10748450,1,0,1,0,1,1,0,0,0
10748455,3,3,0,0,1,0,1,0,1
10749073,2,2,0,0,1,1,0,0,0
10749254,4,4,0,0,2,2,0,1,1
10749582,4,4,0,0,1,1,0,0,1
10749627,2,0,2,0,0,0,0,0,0
10749688,10,6,4,0,2,1,1,2,1
10749757,1,0,1,0,0,0,0,0,0
10750434,2,1,1,0,1,1,0,0,0
10750791,4,4,0,0,2,0,2,0,1
10750879,1,1,0,0,1,1,0,0,0
10751001,2,2,0,0,1,1,0,0,1
10751231,1,0,1,0,0,0,0,0,0
10751268,2,2,0,0,2,2,0,0,0
10751555,1,1,0,0,1,1,0,0,0
10751563,2,1,1,0,2,1,1,0,0
10751669,1,1,0,0,1,1,0,0,0
10751884,1,1,0,0,1,1,0,0,0
10752061,2,0,2,0,1,1,0,0,0
10752087,1,1,0,0,1,1,0,0,0
10752097,2,2,0,0,2,2,0,0,1
10752183,2,1,1,0,1,1,0,0,0
10752188,2,2,0,0,2,2,0,0,0
10752190,1,0,1,0,1,1,0,0,0
10752497,2,2,0,0,1,1,0,0,0
10752503,2,2,0,0,2,2,0,0,0
10752611,10,6,4,0,1,1,0,1,1
10752797,1,1,0,0,1,1,0,0,0
10752826,4,1,3,0,2,1,1,1,1
10752833,1,1,0,0,1,1,0,0,0
10753014,4,4,0,0,0,0,0,0,1
10753022,4,0,4,0,4,2,2,0,0
10753301,5,5,0,0,2,2,0,0,0
10753319,1,1,0,0,1,1,0,0,0
10753361,2,2,0,0,1,1,0,0,1
10753370,6,5,1,0,1,1,0,1,1
10753720,2,2,0,0,1,1,0,0,1
10753734,2,2,0,0,2,2,0,0,0
10753855,4,4,0,0,2,0,2,0,0
10754023,1,1,0,0,1,1,0,0,1
10754352,2,2,0,0,1,1,0,0,0
10754619,1,0,1,0,1,1,0,0,0
10754652,11,6,5,0,1,1,0,1,1
10755142,1,0,1,0,0,0,0,0,0
10755155,1,0,1,0,1,1,0,0,0
10755779,8,6,2,0,4,1,3,2,0
10755783,1,0,1,0,1,1,0,0,0
10755888,2,2,0,0,1,1,0,0,0
10755990,2,2,0,0,1,1,0,0,1
10756033,2,2,0,0,1,1,0,0,0
10756295,1,1,0,0,1,1,0,0,0
10756460,4,4,0,0,1,1,0,1,0
10756559,3,3,0,0,1,1,0,1,0
10756631,3,3,0,0,2,2,0,0,0
10756819,1,1,0,0,1,1,0,0,0
10756824,2,2,0,0,2,1,1,0,0
10757078,1,0,1,0,1,1,0,0,0
10757290,2,2,0,0,2,2,0,0,0
10758150,1,1,0,0,0,0,0,0,0
10758273,3,0,3,0,1,1,0,0,0
10758716,1,0,1,0,1,0,1,0,0
10758801,11,10,1,0,2,0,2,0,1
10759139,1,0,1,0,1,1,0,0,0
10759235,1,0,1,0,1,1,0,0,0
10760199,1,1,0,0,1,1,0,0,0
10760312,4,4,0,0,1,1,0,1,1
10760646,1,1,0,0,1,1,0,0,0
10760649,1,0,1,0,1,1,0,0,0
10760737,3,3,0,0,3,3,0,0,0
10760930,7,7,0,0,0,0,0,0,0
10761286,1,0,1,0,1,1,0,0,0
10762004,4,4,0,0,1,1,0,0,0
10762713,1,1,0,0,1,1,0,0,0
10762759,1,0,1,0,1,1,0,0,0
10762858,1,1,0,0,1,1,0,0,0
10762920,3,0,3,0,1,1,0,0,0
10763116,1,1,0,0,1,1,0,0,0
10763291,3,2,1,0,3,2,1,0,0
10763344,1,1,0,0,1,1,0,0,0
10763358,1,1,0,0,1,1,0,0,0
10763383,3,2,1,0,1,1,0,0,1
10763509,3,2,1,0,2,1,1,1,0
10763790,1,1,0,0,1,1,0,0,0
10763884,2,0,2,0,2,2,0,0,1
10764185,2,1,1,0,1,1,0,0,0
10764278,7,6,1,0,2,0,2,0,1
10764301,3,3,0,0,0,0,0,0,1
10764470,1,1,0,0,1,1,0,0,1
10764579,5,5,0,0,0,0,0,0,1
10764630,1,1,0,0,1,1,0,0,0
10765119,4,4,0,0,1,1,0,1,1
10765206,1,1,0,0,0,0,0,0,0
10765539,2,2,0,0,1,1,0,1,1
10765546,1,1,0,0,1,1,0,0,0
10765603,3,3,0,0,1,1,0,0,0
10765670,1,1,0,0,1,1,0,0,0
10765695,1,1,0,0,1,1,0,0,0
10765709,5,3,2,0,1,1,0,1,1
10765871,1,1,0,0,1,1,0,0,0
10765912,1,1,0,0,1,1,0,1,0
10765949,2,2,0,0,2,1,1,1,1
10765993,14,6,8,0,3,1,2,2,1
10766366,6,1,5,0,0,0,0,0,0
10766377,1,0,1,0,1,1,0,0,0
10766443,2,0,2,0,1,1,0,0,0
10766668,2,0,2,0,0,0,0,0,0
10766713,1,1,0,0,1,1,0,0,0
10766757,2,2,0,0,2,2,0,0,0
10767145,1,1,0,0,1,1,0,0,0
10767166,1,0,1,0,1,1,0,0,0
10767183,1,1,0,0,1,1,0,0,0
10767249,3,2,1,0,2,1,1,1,0
10767346,2,2,0,0,2,2,0,0,0
10767392,1,1,0,0,1,1,0,0,0
10767712,1,1,0,0,1,1,0,0,0
10768045,3,3,0,0,2,2,0,0,1
10768958,1,1,0,0,1,1,0,0,0
10769160,5,4,1,0,3,2,1,1,1
10769274,4,2,2,0,2,1,1,1,0
10769303,1,1,0,0,1,1,0,0,0
10769646,1,0,1,0,1,1,0,0,0
10769857,4,4,0,0,1,1,0,0,1
10770022,1,0,1,0,0,0,0,0,0
10770130,1,0,1,0,1,1,0,0,1
10770438,1,0,1,0,2,2,0,0,0
10770459,3,0,3,0,2,1,1,0,0
10770881,2,2,0,0,1,1,0,0,0
10770957,10,8,2,0,1,1,0,1,1
10771312,2,0,2,0,1,1,0,0,0
10771375,6,4,2,0,2,2,0,0,1
10771501,1,0,1,0,0,0,0,0,0
10771617,1,0,1,0,1,1,0,0,0
10772027,1,1,0,0,1,1,0,0,0
10772585,1,1,0,0,1,1,0,0,1
10772810,2,2,0,0,1,1,0,0,1
10773255,3,2,1,0,1,1,0,1,0
10775470,1,1,0,0,2,2,0,0,0
10775724,1,1,0,0,1,1,0,1,0
10776107,1,1,0,0,1,1,0,0,0
10776461,9,7,2,0,0,0,0,0,0
10776472,4,4,0,0,0,0,0,0,1
10776497,4,3,1,0,3,2,1,0,1
10776504,2,0,2,0,2,2,0,0,1
10776981,2,1,1,0,2,1,1,0,0
10777010,2,2,0,0,2,2,0,0,0
10777245,1,1,0,0,1,1,0,0,0
10777328,2,2,0,0,2,2,0,0,1
10778046,2,2,0,0,0,0,0,0,0
10778251,1,0,1,0,0,0,0,0,0
10779071,1,1,0,0,1,1,0,0,0
10779138,3,2,1,0,2,1,1,0,0
10779544,7,7,0,0,1,1,0,1,1
10779592,1,1,0,0,1,1,0,0,0
10779730,1,1,0,0,1,1,0,0,0
10779779,2,2,0,0,0,0,0,0,1
10779906,1,1,0,0,1,1,0,0,0
09997019,3,2,1,0,2,2,0,2,0
09997222,4,2,2,0,1,1,0,1,0
09997394,2,1,1,0,2,1,1,0,1
09997512,1,1,0,0,0,0,0,0,0
09997610,1,1,0,0,1,1,0,0,0
09997656,2,2,0,0,2,2,0,0,0
09998008,1,1,0,0,1,1,0,0,0
09998176,3,2,1,0,1,1,0,0,0
09998414,2,2,0,0,1,1,0,0,1
09998689,5,0,5,0,1,1,0,1,1
09998929,8,5,3,0,1,1,0,0,0
09998988,2,2,0,0,1,1,0,0,0
09999375,2,2,0,0,2,2,0,2,0
10000431,2,2,0,0,2,2,0,0,0
10000475,6,2,4,0,1,1,0,0,1
10000684,9,8,1,0,0,0,0,0,0
10001222,2,0,2,0,2,2,0,0,0
10001358,2,1,1,0,1,1,0,1,0
10001427,1,1,0,0,1,1,0,0,0
10001463,1,1,0,0,1,1,0,0,0
10001482,12,8,4,0,0,0,0,0,0
10001603,2,2,0,0,2,2,0,0,1
10001955,2,1,1,0,1,1,0,0,0
10002354,1,1,0,0,1,1,0,0,0
10002440,1,1,0,0,1,1,0,0,0
10002767,1,1,0,0,1,1,0,0,0
10003432,2,2,0,0,2,2,0,0,0
10003607,3,3,0,0,2,2,0,0,0
10004322,1,1,0,0,1,1,0,0,0
10004580,1,1,0,0,0,0,0,0,0
10005249,2,2,0,0,2,2,0,0,0
10005407,3,3,0,0,2,2,0,0,0
10005940,1,1,0,0,1,1,0,0,0
10006375,1,1,0,0,1,1,0,0,0
10006752,2,1,1,0,1,1,0,0,0
10007626,4,3,1,0,1,1,0,1,1
10007757,1,1,0,0,1,1,0,0,0
10007813,8,8,0,0,1,1,0,1,1
10007843,2,2,0,0,2,2,0,0,0
10007896,1,1,0,0,1,1,0,0,0
10008141,1,1,0,0,1,1,0,0,0
10008657,4,4,0,0,0,0,0,0,0
10008949,1,1,0,0,1,1,0,0,0
10008980,2,1,1,0,1,1,0,0,0
10009361,6,0,6,0,0,0,0,0,1
10009504,2,2,0,0,1,1,0,0,0
10009906,2,0,2,0,0,0,0,0,0
10009918,11,7,4,0,3,1,2,0,1
10009922,1,1,0,0,0,0,0,0,0
10010574,3,3,0,0,1,1,0,1,1
10010749,1,1,0,0,1,1,0,0,0
10010870,2,2,0,0,2,2,0,0,0
10010988,3,3,0,0,0,0,0,0,0
10011158,2,2,0,0,1,1,0,0,1
10011336,3,3,0,0,2,2,0,0,0
10011434,3,3,0,0,0,0,0,0,1
10011570,14,9,5,0,8,5,3,0,1
10011596,1,0,1,0,1,1,0,0,0
10012952,1,1,0,0,1,1,0,0,0
10013985,1,0,1,0,0,0,0,0,1
10014035,2,2,0,0,1,1,0,0,0
10014085,2,2,0,0,2,2,0,0,0
10014175,12,8,4,0,0,0,0,0,1
10014348,4,3,1,0,1,1,0,0,0
10014440,6,0,6,0,2,2,0,0,1
10015147,1,0,1,0,1,1,0,0,0
10015444,9,3,6,0,1,1,0,1,1
10015556,5,4,1,0,4,4,0,0,0
10015809,1,1,0,0,1,1,0,0,0
10015893,12,10,2,0,0,0,0,0,1
10016555,4,4,0,0,3,3,0,0,1
10016723,7,4,3,0,0,0,0,0,0
10017197,1,1,0,0,1,1,0,1,0
10017621,2,2,0,0,1,1,0,0,0
10017774,5,1,4,0,2,2,0,1,1
10017870,1,0,1,0,1,1,0,0,0
10018061,8,3,5,0,1,1,0,1,1
10018095,7,3,4,0,1,1,0,1,1
10018445,5,1,4,0,1,1,0,0,1
10018657,2,0,2,0,2,2,0,0,0
10018779,2,1,1,0,2,1,1,1,0
10019708,7,3,4,0,0,0,0,0,0
10020408,1,1,0,0,1,1,0,0,0
10020601,11,5,6,0,0,0,0,0,1
10020619,2,2,0,0,1,1,0,0,0
10020664,2,2,0,0,2,2,0,2,0
10020758,1,1,0,0,1,1,0,0,0
10021515,3,2,1,0,1,1,0,0,1
10021796,1,0,1,0,1,1,0,0,0
10021822,1,1,0,0,1,1,0,0,0
10021854,4,4,0,0,1,1,0,0,0
10022717,2,2,0,0,2,2,0,0,0
10023161,4,3,1,0,1,1,0,0,1
10023177,14,6,8,0,1,1,0,1,1
10023270,1,1,0,0,1,1,0,0,0
10023559,1,1,0,0,1,1,0,0,0
10023599,5,3,2,0,4,3,1,0,0
10024121,9,5,4,0,1,1,0,0,0
10024335,8,8,0,0,0,0,0,0,1
10024384,1,1,0,0,1,1,0,0,0
10024452,7,2,5,0,1,1,0,1,1
10024923,9,4,5,0,2,2,0,0,1
10025035,1,1,0,0,1,1,0,0,0
10025104,2,0,2,0,1,1,0,0,0
10025448,2,2,0,0,1,1,0,0,1
10025558,2,0,2,0,0,0,0,0,0
10025565,2,0,2,0,1,1,0,0,0
10026284,2,2,0,0,0,0,0,0,0
10026496,8,3,5,0,1,1,0,1,0
10026611,4,3,1,0,0,0,0,0,1
10026874,2,2,0,0,1,1,0,1,0
10027156,1,0,1,0,1,1,0,0,0
10027238,5,2,3,0,3,3,0,0,0
10027352,1,1,0,0,1,1,0,0,0
10028674,1,0,1,0,1,1,0,0,0
10028724,2,0,2,0,0,0,0,0,0
10028946,2,2,0,0,1,1,0,0,0
10029037,2,2,0,0,3,3,0,1,1
10029134,6,3,3,0,2,2,0,0,1
10029333,1,0,1,0,1,1,0,0,0
10029369,2,0,2,0,2,2,0,0,0
10029397,1,1,0,0,1,1,0,0,0
10029550,5,5,0,0,1,1,0,1,1
10029758,3,2,1,0,2,2,0,0,1
10030239,10,7,3,0,1,0,1,1,1
10030251,3,1,2,0,1,1,0,0,0
10030718,3,3,0,0,1,1,0,0,1
10031048,2,2,0,0,1,1,0,0,0
10031299,7,3,4,0,1,1,0,1,1
10031467,1,0,1,0,0,0,0,0,0
10031686,2,0,2,0,1,1,0,0,0
10033201,3,1,2,0,3,1,2,0,0
10033391,1,1,0,0,2,2,0,2,0
10033548,5,3,2,0,0,0,0,0,0
10033669,1,1,0,0,1,1,0,0,0
10034172,2,2,0,0,1,1,0,0,1
10034419,19,13,6,0,7,6,1,0,1
10034566,1,1,0,0,1,1,0,0,0
10034612,2,2,0,0,2,2,0,0,0
10034748,2,1,1,0,2,1,1,0,0
10034930,1,0,1,0,0,0,0,0,0
10035370,1,1,0,0,1,1,0,0,0
10036025,4,4,0,0,1,1,0,1,1
10036134,4,2,2,0,3,2,1,0,0
10036141,8,6,2,0,0,0,0,0,0
10036607,2,1,1,0,2,2,0,0,1
10036848,5,2,3,0,2,2,0,0,0
10036853,1,1,0,0,1,1,0,0,0
10036911,3,3,0,0,1,1,0,1,0
10037115,2,2,0,0,1,1,0,0,1
10037236,2,2,0,0,1,1,0,0,1
10037308,2,2,0,0,1,1,0,0,1
10037345,4,4,0,0,2,2,0,0,0
10037390,7,2,5,2,0,0,0,0,1
10037934,3,1,2,0,1,1,0,1,1
10038277,4,3,1,0,2,2,0,2,1
10038416,6,3,3,0,3,3,0,0,0
10038482,4,4,0,0,0,0,0,0,1
10038519,4,4,0,0,1,0,1,0,1
10038538,4,4,0,0,0,0,0,0,1
10038567,1,1,0,0,1,1,0,0,0
10039271,1,1,0,0,1,1,0,0,0
10039710,1,0,1,0,1,1,0,0,0
10039888,5,5,0,0,4,4,0,1,1
10040007,1,1,0,0,1,1,0,0,0
10040720,1,1,0,0,1,1,0,0,0
10041014,2,2,0,0,2,1,1,0,1
10041032,1,1,0,0,1,1,0,0,0
10041779,2,2,0,0,2,2,0,0,0
10041810,2,2,0,0,1,1,0,0,0
10042373,4,3,1,0,3,3,0,0,0
10042606,2,2,0,0,1,1,0,1,0
10042712,3,3,0,0,3,3,0,0,0
10043131,3,0,3,0,0,0,0,0,1
10043185,1,1,0,0,1,1,0,0,0
10043228,4,4,0,0,3,3,0,0,0
10043437,2,0,2,0,2,2,0,0,1
10043631,1,0,1,0,1,1,0,0,0
10043837,2,1,1,0,2,2,0,0,1
10043892,3,3,0,0,2,2,0,0,0
10043916,2,2,0,0,2,2,0,0,0
10043921,2,1,1,0,2,2,0,0,1
10043990,1,1,0,0,1,1,0,0,0
10044237,1,0,1,0,0,0,0,0,1
10044338,2,2,0,0,2,2,0,0,0
10044617,4,2,2,0,1,1,0,0,0
10044826,1,1,0,0,1,1,0,0,1
10045429,1,1,0,0,1,1,0,0,0
10045635,5,5,0,0,6,6,0,0,1
10046009,9,4,5,1,1,1,0,1,0
10046215,1,1,0,0,1,1,0,0,0
10046726,1,1,0,0,1,1,0,0,0
10047250,2,1,1,0,1,1,0,0,0
10047331,2,1,1,0,1,1,0,0,0
10047890,4,3,1,0,2,1,1,2,1
10048329,4,2,2,0,2,2,0,0,0
10048352,2,2,0,0,2,2,0,0,0
10049239,2,2,0,0,1,1,0,0,1
10049447,2,0,2,0,1,1,0,0,0
10049506,2,2,0,0,1,1,0,0,0
10049523,2,1,1,0,1,1,0,0,1
10049593,4,2,2,0,1,1,0,1,1
10049666,1,1,0,0,1,1,0,0,0
10049701,4,0,4,0,4,2,2,0,0
10049784,1,1,0,0,1,1,0,0,0
10049929,2,2,0,0,2,2,0,0,0
10051264,1,1,0,0,1,1,0,0,0
10051674,2,2,0,0,1,1,0,0,0
10051787,4,3,1,0,4,3,1,0,0
10051938,2,2,0,0,2,2,0,0,0
10052664,1,1,0,0,2,2,0,0,0
10052689,4,4,0,0,1,1,0,1,0
10053049,1,1,0,0,1,1,0,0,0
10053854,2,0,2,0,2,2,0,0,0
10053870,7,0,7,0,0,0,0,0,1
10054063,3,3,0,0,1,1,0,0,0
10054467,2,2,0,0,2,1,1,0,0
10054518,14,7,7,0,0,0,0,0,1
10055327,1,1,0,0,1,1,0,0,0
10055482,5,2,3,1,2,1,1,1,1
10055491,2,1,1,0,2,1,1,0,0
10055690,4,4,0,0,0,0,0,0,0
10055890,1,1,0,0,1,1,0,0,0
10055980,2,2,0,0,1,1,0,0,0
10057019,1,1,0,0,1,0,1,0,0
10057031,2,0,2,0,1,1,0,0,0
10057621,6,1,5,0,4,1,3,0,0
10057964,9,7,2,0,1,1,0,1,1
10058183,6,3,3,0,3,1,2,3,1
10058362,1,1,0,0,1,1,0,1,0
10059069,6,4,2,0,0,0,0,0,0
10059211,2,0,2,0,1,1,0,1,1
10059413,4,1,3,0,1,1,0,0,1
10059591,5,3,2,0,1,1,0,1,0
10059639,1,1,0,0,1,1,0,1,0
10059923,3,2,1,0,1,1,0,0,0
10060052,1,1,0,0,1,1,0,0,0
10060083,4,2,2,0,2,2,0,0,0
10060239,5,3,2,0,5,3,2,0,0
10060754,2,2,0,0,2,2,0,0,1
10060817,9,7,2,0,1,1,0,1,1
10060844,3,3,0,0,1,1,0,0,0
10060881,4,4,0,0,3,3,0,0,1
10060955,2,2,0,0,2,2,0,0,0
10061096,3,0,3,0,0,0,0,0,1
10061562,2,0,2,0,1,1,0,0,0
10062109,8,6,2,0,1,1,0,1,1
10062196,20,12,8,0,0,0,0,0,0
10062249,6,5,1,0,1,1,0,0,1
10062404,2,2,0,0,2,2,0,0,0
10062452,10,2,8,0,1,1,0,1,1
10062785,2,2,0,0,1,1,0,0,0
10063508,1,1,0,0,2,2,0,0,0
10064246,1,1,0,0,1,1,0,0,0
10064563,2,2,0,0,1,1,0,0,0
10064886,8,7,1,0,1,1,0,1,1
10065891,1,0,1,0,0,0,0,0,0
10066009,2,0,2,0,0,0,0,0,1
10066053,1,1,0,0,0,0,0,0,1
10066396,2,2,0,0,1,1,0,1,1
10066420,5,5,0,0,1,1,0,1,1
10067203,1,0,1,0,0,0,0,0,0
10067387,4,4,0,0,1,1,0,1,1
10067425,2,0,2,0,1,1,0,0,0
10067571,6,5,1,0,1,1,0,1,0
10068025,1,1,0,0,1,1,0,0,0
10068168,2,2,0,0,2,2,0,0,0
10068504,2,2,0,0,2,2,0,0,0
10068774,2,2,0,0,1,1,0,1,0
10069094,2,1,1,0,0,0,0,0,0
10069112,9,4,5,0,2,2,0,2,1
10069145,8,4,4,0,2,2,0,2,1
10069553,3,2,1,0,0,0,0,0,1
10069686,1,1,0,0,1,1,0,0,0
10069828,1,1,0,0,1,1,0,0,0
10069893,1,1,0,0,1,1,0,0,0
10070076,1,1,0,0,1,1,0,0,0
10070094,1,1,0,0,1,1,0,1,0
10070398,11,7,4,0,2,2,0,2,1
10070530,1,0,1,0,1,1,0,0,1
10070721,3,2,1,0,1,1,0,0,0
10070814,2,2,0,0,2,2,0,0,0
10070830,2,2,0,0,1,1,0,0,1
10071316,1,1,0,0,1,1,0,0,0
10071614,1,1,0,0,2,1,1,1,0
10071993,10,10,0,0,10,10,0,0,1
10072153,6,6,0,0,0,0,0,0,1
10072425,2,2,0,0,1,1,0,0,1
10072549,2,0,2,0,2,2,0,0,1
10073151,3,3,0,0,2,2,0,0,1
10073638,3,2,1,0,2,2,0,0,0
10073986,1,1,0,0,1,1,0,0,0
10074128,10,9,1,0,2,2,0,2,0
10074414,1,1,0,0,1,1,0,0,0
10074474,7,4,3,0,5,1,4,1,1
10074488,7,3,4,0,2,1,1,1,1
10074707,1,1,0,0,1,1,0,0,0
10074909,3,2,1,0,2,1,1,0,0
10074949,6,3,3,0,1,1,0,1,1
10075155,5,2,3,0,1,1,0,0,1
10075186,1,1,0,0,1,1,0,0,0
10075873,2,2,0,0,2,2,0,0,1
10075999,7,5,2,0,1,1,0,0,1
10076048,1,1,0,0,1,1,0,0,0
10076328,6,4,2,0,1,1,0,1,0
10076800,4,1,3,0,2,1,1,0,0
10077147,2,2,0,0,2,2,0,0,0
10077176,2,2,0,0,2,2,0,0,0
10077246,2,2,0,0,2,2,0,0,0
10077560,1,1,0,0,1,1,0,0,0
10077920,1,1,0,0,1,1,0,0,0
10077969,4,1,3,0,2,1,1,0,0
10078396,2,0,2,0,1,1,0,0,0
10078534,2,0,2,0,0,0,0,0,1
10079023,2,1,1,0,1,1,0,0,0
10079301,1,1,0,0,1,1,0,0,0
10079621,2,2,0,0,2,2,0,0,0
10079759,1,1,0,0,1,1,0,0,1
10079783,2,2,0,0,0,0,0,0,0
03085104,14,0,14,0,0,0,0,0,0
03085170,44,8,36,0,1,1,0,0,0
03085473,8,0,8,0,3,1,2,1,1
03085530,50,6,44,0,1,1,0,1,1
03085552,15,8,7,0,1,1,0,1,0
03085664,23,4,19,0,5,4,1,0,1
03085817,26,3,23,0,2,1,1,2,1
03085922,24,2,22,0,1,1,0,1,1
03086310,38,3,35,0,1,1,0,1,1
03086378,85,16,69,0,1,1,0,1,1
03086382,22,5,17,0,1,1,0,1,1
03086995,23,0,23,0,0,0,0,0,1
03087103,24,5,19,0,2,2,0,2,1
03087175,24,5,19,0,2,2,0,2,1
03087187,24,0,24,0,0,0,0,0,1
03087287,18,3,15,0,0,0,0,0,1
03087362,49,10,39,0,0,0,0,0,1
03087455,27,4,23,0,0,0,0,0,1
03087463,27,9,18,0,0,0,0,0,1
03087640,6,2,4,0,1,1,0,0,1
03087772,28,3,25,0,1,1,0,1,0
03087773,15,0,15,0,0,0,0,0,1
03087779,18,3,15,0,0,0,0,0,1
03087896,5,2,3,0,1,1,0,0,1
03088126,30,3,27,0,0,0,0,0,1
03088172,27,10,17,0,0,0,0,0,1
03088287,39,10,29,0,1,1,0,1,1
03088346,6,2,4,0,1,1,0,0,0
03088356,16,2,14,0,0,0,0,0,1
03088472,24,5,19,0,1,1,0,1,1
03088500,7,0,7,0,0,0,0,0,1
03088573,6,0,6,0,0,0,0,0,1
03088581,10,0,10,0,0,0,0,0,1
03089372,7,0,7,0,0,0,0,0,1
03089555,8,4,4,0,1,1,0,1,1
03089865,26,7,19,0,2,0,2,0,1
03089989,27,3,24,0,1,1,0,1,1
03090306,9,4,5,0,2,2,0,2,1
03090884,32,3,29,0,1,1,0,1,1
03091040,27,3,24,0,1,1,0,1,1
03091103,10,7,3,0,0,0,0,0,1
03091163,45,21,24,0,0,0,0,0,1
03091386,13,6,7,0,1,1,0,0,1
03091521,9,3,6,0,2,2,0,0,0
03091835,63,13,50,0,1,0,1,0,1
03092197,68,9,59,0,0,0,0,0,1
03092239,27,3,24,0,1,1,0,1,1
03092251,31,4,27,0,0,0,0,0,1
03092306,7,4,3,0,5,1,4,0,1
03092549,27,4,23,0,1,1,0,1,1
03092560,50,18,32,0,0,0,0,0,1
03092714,14,0,14,0,0,0,0,0,1
03092759,34,4,30,0,1,1,0,1,1
03092870,25,5,20,0,2,2,0,2,1
03092944,6,5,1,0,3,1,2,1,0
03093291,13,0,13,0,0,0,0,0,1
03093486,16,7,9,0,1,1,0,0,0
03093642,66,5,61,0,1,1,0,1,1
03093684,46,18,28,0,1,1,0,1,1
03094141,24,5,19,0,2,2,0,2,1
03094425,21,4,17,0,1,1,0,1,1
03094597,6,3,3,0,2,2,0,0,0
03094797,29,5,24,0,2,1,1,2,1
03094854,31,7,24,0,0,0,0,0,0
03094861,9,4,5,0,1,1,0,0,1
03095019,28,3,25,0,1,1,0,1,1
03095058,34,3,31,0,1,1,0,1,1
03095291,65,7,58,0,0,0,0,0,1
03095310,26,0,26,0,0,0,0,0,1
03095557,33,5,28,0,1,1,0,1,1
03095751,31,6,25,0,0,0,0,0,1
03095963,38,8,30,0,0,0,0,0,1
03096304,42,7,35,0,0,0,0,0,0
03096510,14,3,11,1,2,2,0,2,1
03096772,45,7,38,0,1,1,0,1,1
03096937,118,14,104,0,0,0,0,0,1
03097017,7,2,5,0,1,1,0,0,1
03097392,8,2,6,0,3,3,0,1,1
03097471,9,0,9,0,0,0,0,0,1
03097885,10,2,8,0,3,2,1,0,1
03097977,36,5,31,0,1,1,0,1,1
03098240,12,3,9,0,2,1,1,1,0
03098474,37,6,31,0,0,0,0,0,1
03098593,44,7,37,0,0,0,0,0,0
03099047,32,3,29,0,1,1,0,1,1
03099067,48,7,41,0,1,1,0,1,1
03099083,10,2,8,0,1,1,0,0,0
03099287,6,0,6,0,0,0,0,0,1
03099346,0,0,0,0,0,0,0,0,1
03099763,19,3,16,0,1,1,0,1,1
03099929,43,7,36,0,0,0,0,0,1
03100039,35,4,31,0,1,1,0,1,1
03100258,10,0,10,0,1,1,0,0,1
03100354,31,6,25,0,1,1,0,0,0
03100777,16,2,14,0,1,1,0,1,1
03100886,10,7,3,0,4,2,2,1,0
03100993,40,7,33,0,0,0,0,0,1
03101215,25,5,20,0,1,1,0,1,1
03101724,59,8,51,0,1,1,0,1,1
03101766,5,2,3,0,1,1,0,0,1
03101814,26,3,23,0,1,1,0,1,1
03101815,47,2,45,0,1,1,0,1,1
03101837,16,2,14,0,1,1,0,1,1
03101844,18,0,18,0,0,0,0,0,1
03101886,28,3,25,0,1,1,0,1,1
03101930,35,7,28,0,1,0,1,0,1
03102054,22,4,18,0,1,1,0,0,1
03102176,29,9,20,0,3,2,1,3,1
03102277,18,0,18,0,0,0,0,0,1
03102665,29,8,21,0,0,0,0,0,1
03102684,32,3,29,0,1,1,0,1,1
03103277,18,3,15,0,0,0,0,0,1
03103602,28,9,19,0,0,0,0,0,1
03103971,30,0,30,0,0,0,0,0,1
03104077,40,6,34,0,1,1,0,1,1
03104090,14,0,14,0,0,0,0,0,1
03104360,12,4,8,0,0,0,0,0,1
03104516,0,0,0,0,0,0,0,0,0
03104670,85,4,81,0,1,1,0,1,1
03104671,88,12,76,0,1,1,0,1,1
03104973,33,0,33,0,0,0,0,0,1
03105133,11,2,9,0,1,1,0,0,1
03105626,30,0,30,0,0,0,0,0,1
03106027,29,3,26,0,1,1,0,1,1
03106213,12,6,6,0,1,1,0,1,1
03106232,34,7,27,0,0,0,0,0,0
03106332,35,4,31,0,2,2,0,2,1
03106339,17,9,8,0,0,0,0,0,1
03106440,11,1,10,0,2,2,0,0,1
03107018,11,4,7,0,1,1,0,0,0
03107225,41,4,37,0,1,1,0,1,1
03107229,13,0,13,0,0,0,0,0,1
03107232,10,3,7,0,1,1,0,0,0
03107316,25,2,23,0,0,0,0,0,1
03107568,10,1,9,0,2,1,1,0,1
03107630,7,3,4,0,2,2,0,0,0
03107653,24,2,22,0,1,1,0,1,1
03107849,9,2,7,0,2,2,0,0,0
03107969,7,3,4,0,0,0,0,0,0
03108212,7,4,3,0,1,1,0,0,0
03108236,46,7,39,0,1,1,0,1,1
03108243,18,0,18,0,0,0,0,0,1
03108642,9,6,3,0,1,1,0,0,0
03108663,23,0,23,0,0,0,0,0,1
03109022,22,4,18,0,0,0,0,0,1
03109219,37,5,32,0,1,1,0,1,1
03109650,32,3,29,0,1,1,0,1,1
03109660,31,3,28,0,2,1,1,2,1
03109772,47,0,47,0,0,0,0,0,1
03110031,25,1,24,0,1,1,0,1,1
03110096,18,3,15,0,1,1,0,1,1
03110569,29,9,20,0,0,0,0,0,1
03110665,38,7,31,0,2,1,1,2,1
03110908,63,20,43,0,0,0,0,0,1
03110917,23,13,10,0,0,0,0,0,0
03110970,36,4,32,0,1,1,0,1,1
03111039,32,6,26,0,0,0,0,0,1
03111540,5,1,4,0,1,1,0,0,0
03111741,7,5,2,0,4,2,2,1,0
03111744,8,6,2,0,4,1,3,1,0
03112025,18,3,15,0,1,1,0,1,1
03112156,7,2,5,0,1,0,1,1,1
03112530,9,6,3,0,3,1,2,1,0
03112601,11,2,9,0,1,1,0,0,0
03112894,25,2,23,0,1,1,0,1,1
03112933,31,4,27,0,1,1,0,1,1
03113041,31,0,31,0,0,0,0,0,1
03113139,41,9,32,0,0,0,0,0,1
03113148,35,9,26,0,0,0,0,0,1
03113337,9,1,8,0,0,0,0,0,0
03113827,6,2,4,0,2,2,0,0,1
03113991,11,4,7,0,1,1,0,1,1
03114407,22,9,13,0,0,0,0,0,1
03114590,50,12,38,0,1,1,0,1,1
03114596,7,5,2,0,1,1,0,0,1
03114981,16,3,13,0,0,0,0,0,1
03115084,30,2,28,0,1,1,0,1,1
03115088,29,3,26,0,1,1,0,1,1
03115179,52,5,47,0,3,2,1,3,1
03115184,25,3,22,0,1,1,0,1,1
03115251,12,4,8,0,1,1,0,1,1
03115284,31,2,29,0,2,2,0,0,1
03115466,14,6,8,0,1,1,0,1,1
03115825,50,7,43,0,0,0,0,0,1
03116152,5,3,2,0,1,1,0,0,1
03116221,20,2,18,0,0,0,0,0,1
03116225,13,2,11,0,0,0,0,0,1
03116316,7,0,7,0,0,0,0,0,1
03116567,8,2,6,0,1,1,0,0,0
03116705,23,3,20,0,1,1,0,1,1
03116765,5,0,5,0,0,0,0,0,0
03116873,37,4,33,0,1,1,0,1,1
03117116,22,3,19,0,1,1,0,1,1
03117136,29,2,27,0,1,1,0,1,1
03117166,75,10,65,0,0,0,0,0,1
03117355,22,6,16,0,0,0,0,0,1
03117529,5,0,5,0,0,0,0,0,1
03117563,10,6,4,0,1,1,0,0,0
03117836,43,9,34,0,1,1,0,0,1
03117906,7,2,5,0,2,1,1,0,0
03118387,25,0,25,0,0,0,0,0,1
03118409,17,0,17,0,0,0,0,0,1
03118500,26,7,19,0,1,1,0,0,0
03118614,25,0,25,0,0,0,0,0,1
03118648,5,3,2,0,2,2,0,0,0
03118887,39,5,34,0,1,1,0,1,1
03119001,18,2,16,0,0,0,0,0,1
03119047,41,13,28,0,3,3,0,0,1
03119069,11,0,11,0,0,0,0,0,1
03119071,31,5,26,0,1,1,0,1,1
03119228,11,2,9,0,4,2,2,1,1
03119353,7,2,5,0,2,1,1,1,1
03119779,38,3,35,0,1,1,0,1,1
SC590031,2,0,2,0,1,1,0,1,1
SC590032,2,2,0,0,1,1,0,1,1
SC590402,1,1,0,0,1,1,0,0,0
SC590454,1,1,0,0,1,1,0,0,0
SC590478,2,0,2,0,1,1,0,0,0
SC590642,2,2,0,0,1,1,0,0,0
SC590694,1,1,0,0,0,0,0,0,0
SC590726,1,1,0,0,1,1,0,0,0
SC590823,1,1,0,0,1,1,0,0,0
SC590903,2,2,0,0,2,2,0,0,1
SC590904,2,2,0,0,2,2,0,0,1
SC590905,2,2,0,0,2,2,0,0,1
SC590906,2,2,0,0,2,2,0,0,1
SC590907,2,2,0,0,2,2,0,0,1
SC590961,2,2,0,0,2,2,0,0,0
SC590981,4,2,2,0,3,1,2,1,1
SC591116,1,1,0,0,1,1,0,0,0
SC591122,1,1,0,0,1,1,0,0,0
SC591336,1,1,0,0,1,1,0,0,0
SC591663,1,1,0,0,1,1,0,0,0
SC591730,3,2,1,0,2,1,1,1,1
SC591736,3,2,1,0,2,1,1,1,1
SC591769,3,3,0,0,3,3,0,0,1
SC591899,1,1,0,0,1,1,0,0,0
SC591900,3,2,1,0,1,1,0,1,0
SC592039,5,4,1,0,2,2,0,2,1
SC592060,2,2,0,0,1,1,0,0,0
SC592092,1,0,1,0,1,1,0,0,0
SC592187,1,1,0,0,1,1,0,0,0
SC592304,1,1,0,0,1,1,0,0,0
SC592444,1,1,0,0,1,1,0,0,0
SC593071,2,2,0,0,2,2,0,0,0
SC593084,1,1,0,0,1,1,0,0,0
SC593129,1,1,0,0,1,1,0,0,0
SC593262,1,1,0,0,1,1,0,0,0
SC593327,1,0,1,0,1,1,0,0,0
SC593340,2,2,0,0,1,1,0,0,0
SC593416,2,2,0,0,1,1,0,0,0
SC593422,1,1,0,0,1,1,0,0,0
SC593519,1,1,0,0,1,1,0,0,0
SC593602,2,2,0,0,2,2,0,0,0
SC593712,1,1,0,0,1,1,0,0,0
SC593852,1,1,0,0,1,1,0,0,0
SC594213,2,1,1,0,0,0,0,0,0
SC594345,1,1,0,0,1,1,0,0,0
SC594410,1,1,0,0,2,2,0,2,0
SC594597,2,2,0,0,1,1,0,0,0
SC594787,1,1,0,0,1,1,0,0,0
SC594789,1,1,0,0,1,1,0,0,0
SC594919,3,3,0,0,2,2,0,0,1
SC595351,2,2,0,0,1,1,0,0,0
SC595476,2,2,0,0,2,2,0,0,0
SC595529,1,1,0,0,1,1,0,0,0
SC595635,1,1,0,0,2,2,0,1,0
SC595676,1,1,0,0,1,1,0,0,0
SC596214,2,2,0,0,3,2,1,1,0
SC596229,1,1,0,0,1,1,0,0,1
SC596421,5,4,1,0,1,1,0,1,1
SC596422,5,5,0,0,0,0,0,0,1
SC596428,1,1,0,0,1,1,0,0,0
SC596596,1,1,0,0,1,1,0,0,0
SC596882,2,1,1,0,2,1,1,0,0
SC596914,2,2,0,0,2,2,0,0,1
SC597014,2,1,1,0,2,1,1,0,0
SC597026,1,1,0,0,1,1,0,0,0
SC597102,1,1,0,0,1,1,0,0,1
SC597202,1,1,0,0,1,1,0,0,0
SC597236,2,2,0,0,2,2,0,0,1
SC597352,1,1,0,0,1,1,0,0,0
SC597406,2,2,0,0,2,2,0,0,0
SC597440,1,1,0,0,0,0,0,0,0
SC597463,1,1,0,0,1,1,0,0,0
SC597523,1,1,0,0,0,0,0,0,0
SC597528,1,1,0,0,1,1,0,0,0
SC597678,2,2,0,0,1,1,0,1,0
SC597940,1,1,0,0,1,1,0,0,0
SC598093,1,1,0,0,1,1,0,0,0
SC598120,2,2,0,0,1,1,0,0,1
SC598199,2,2,0,0,2,2,0,0,1
SC598205,3,3,0,0,1,1,0,0,0
SC598439,1,1,0,0,1,1,0,0,0
SC598554,1,1,0,0,1,1,0,0,0
SC598652,1,1,0,0,1,1,0,0,0
SC599574,1,1,0,0,0,0,0,0,0
SC599593,2,2,0,0,1,1,0,0,0
SC599648,1,1,0,0,1,1,0,0,0
SC599705,1,1,0,0,1,1,0,0,0
SC599716,6,6,0,0,0,0,0,0,0
SC599775,5,4,1,0,0,0,0,0,0
SC600041,1,1,0,0,2,2,0,0,0
SC600304,1,1,0,0,1,1,0,0,0
SC600337,3,3,0,0,2,2,0,0,0
SC600382,3,2,1,0,2,2,0,2,1
SC600623,7,3,4,0,0,0,0,0,0
SC600625,7,3,4,0,0,0,0,0,0
SC600637,1,1,0,0,1,1,0,0,1
SC600771,1,1,0,0,1,1,0,0,0
SC600898,1,1,0,0,1,1,0,1,1
SC601019,2,2,0,0,1,1,0,0,1
SC601089,3,3,0,0,1,1,0,1,1
SC601156,2,2,0,0,2,2,0,0,0
SC601169,2,1,1,0,0,0,0,0,0
SC601180,1,1,0,0,1,1,0,0,0
SC601209,1,1,0,0,1,1,0,0,0
SC601237,1,1,0,0,1,1,0,0,0
SC601564,1,1,0,0,1,1,0,0,0
SC601608,1,1,0,0,1,1,0,0,0
SC601614,1,1,0,0,1,1,0,0,0
SC601675,1,1,0,0,1,1,0,0,0
SC601704,1,1,0,0,1,1,0,0,0
SC601740,2,2,0,0,1,1,0,0,0
SC601759,2,2,0,0,2,2,0,0,0
SC601802,4,4,0,0,1,1,0,1,1
SC601917,5,5,0,0,1,1,0,0,1
SC602154,1,1,0,0,1,1,0,0,0
SC602239,2,2,0,0,0,0,0,0,0
SC602690,1,1,0,0,1,1,0,0,0
SC602859,1,1,0,0,1,1,0,0,0
SC603058,4,4,0,0,1,1,0,1,1
SC603288,1,1,0,0,1,1,0,0,1
SC603566,2,2,0,0,1,1,0,0,0
SC603638,2,2,0,0,1,1,0,0,0
SC603888,1,1,0,0,1,1,0,0,0
SC603933,2,2,0,0,1,1,0,0,1
SC603967,1,1,0,0,1,1,0,0,0
SC603981,2,2,0,0,1,1,0,0,0
SC603989,1,1,0,0,1,1,0,0,0
SC604064,2,2,0,0,2,2,0,0,1
SC604126,1,1,0,0,1,1,0,0,0
SC604214,2,2,0,0,1,1,0,0,0
SC604233,1,1,0,0,1,1,0,0,0
SC604392,1,1,0,0,1,1,0,0,0
SC604479,1,1,0,0,1,1,0,0,0
SC604765,1,1,0,0,1,1,0,0,0
SC604787,1,1,0,0,1,1,0,0,0
SC604936,3,3,0,0,0,0,0,0,0
SC605121,4,3,1,0,2,1,1,0,0
SC605225,1,1,0,0,2,2,0,0,0
SC605512,1,1,0,0,1,1,0,1,0
SC605556,1,1,0,0,2,2,0,0,1
SC605570,6,2,4,1,4,3,1,4,1
SC605684,1,1,0,0,1,1,0,0,0
SC605692,1,1,0,0,2,2,0,0,0
SC605952,1,1,0,0,1,1,0,0,0
SC606230,2,2,0,0,2,2,0,0,0
SC606288,1,1,0,0,1,1,0,0,0
SC606426,1,1,0,0,1,1,0,0,0
SC606588,1,1,0,0,1,1,0,0,0
SC606595,11,11,0,0,0,0,0,0,0
SC606771,2,2,0,0,2,2,0,0,0
SC606888,1,1,0,0,0,0,0,0,0
SC607080,2,1,1,0,2,1,1,0,0
SC607217,1,1,0,0,1,1,0,0,0
SC607913,1,1,0,0,1,1,0,0,0
SC607932,1,1,0,0,1,1,0,0,0
SC608123,2,2,0,0,1,1,0,1,0
SC608148,3,3,0,0,3,3,0,0,0
SC608154,1,1,0,0,1,1,0,0,0
SC608159,1,1,0,0,1,1,0,0,0
SC608178,1,1,0,0,1,1,0,0,0
SC608615,2,2,0,0,1,1,0,0,0
SC608758,3,3,0,0,2,2,0,0,0
SC608825,2,2,0,0,0,0,0,0,0
SC609002,1,1,0,0,1,1,0,0,0
SC609016,1,1,0,0,1,1,0,0,0
SC609034,1,1,0,0,1,1,0,0,0
SC609101,4,4,0,0,3,3,0,0,1
SC609347,2,2,0,0,1,1,0,1,0
SC609365,2,2,0,0,1,1,0,1,0
SC609485,1,1,0,0,1,1,0,0,0
SC610056,1,1,0,0,1,1,0,0,0
SC610398,2,2,0,0,2,2,0,0,0
SC610639,2,2,0,0,1,1,0,0,0
SC610858,1,1,0,0,1,1,0,0,1
SC610917,1,1,0,0,1,1,0,0,0
SC610935,1,1,0,0,1,1,0,0,0
SC610972,2,2,0,0,1,1,0,0,0
SC611009,2,1,1,0,2,1,1,0,0
SC611107,2,1,1,0,1,1,0,0,0
SC611282,1,1,0,0,1,1,0,0,0
SC611283,1,1,0,0,1,1,0,0,0
SC611417,1,1,0,0,2,2,0,0,0
SC611849,5,5,0,0,0,0,0,0,1
SC611898,1,1,0,0,1,1,0,0,0
SC611966,2,2,0,0,1,1,0,0,1
SC611992,1,1,0,0,1,1,0,0,1
SC612010,1,1,0,0,1,1,0,0,0
SC612222,2,2,0,0,1,1,0,0,0
SC612295,1,1,0,0,1,1,0,0,0
SC612323,2,2,0,0,1,1,0,0,1
SC612396,1,1,0,0,1,1,0,0,0
SC612431,1,0,1,0,1,1,0,0,0
SC612530,1,1,0,0,1,1,0,0,0
SC612556,3,2,1,0,3,2,1,0,0
SC612708,1,1,0,0,1,1,0,0,0
SC612741,1,1,0,0,1,1,0,0,0
SC612865,2,2,0,0,2,2,0,0,1
SC612870,2,2,0,0,1,1,0,0,0
SC612938,1,1,0,0,1,1,0,1,0
SC613059,1,1,0,0,1,1,0,0,0
SC613148,2,2,0,0,1,1,0,0,0
SC613242,2,2,0,0,2,2,0,0,0
SC613312,3,3,0,0,2,2,0,0,0
SC613421,3,3,0,0,2,2,0,0,1
SC613531,2,2,0,0,2,2,0,0,0
SC613777,1,1,0,0,1,1,0,0,0
SC614088,1,1,0,0,1,1,0,0,0
SC614327,1,1,0,0,1,1,0,0,0
SC614336,3,3,0,0,3,3,0,0,1
SC614374,1,1,0,0,1,1,0,0,0
SC614745,1,1,0,0,1,1,0,0,0
SC614752,1,1,0,0,1,1,0,0,0
SC615074,2,2,0,0,1,1,0,0,0
SC615258,1,1,0,0,2,2,0,0,0
SC615429,1,1,0,0,1,1,0,0,0
SC615670,2,2,0,0,2,2,0,0,1
SC615743,1,1,0,0,0,0,0,0,0
SC615847,3,2,1,0,3,2,1,1,0
SC615904,1,1,0,0,1,1,0,0,0
SC615929,2,2,0,0,2,2,0,0,0
SC616067,2,2,0,0,2,2,0,0,1
SC616112,1,1,0,0,1,1,0,0,0
SC616189,1,1,0,0,1,1,0,0,0
SC616483,1,1,0,0,1,1,0,0,0
SC616597,1,1,0,0,1,1,0,0,0
SC616970,11,11,0,0,0,0,0,0,0
SC617013,1,1,0,0,0,0,0,0,0
SC617025,1,1,0,0,1,1,0,0,1
SC617026,1,1,0,0,1,1,0,0,1
SC617061,2,2,0,0,2,2,0,0,0
SC617147,1,1,0,0,1,1,0,0,0
SC617302,2,2,0,0,2,2,0,0,0
SC617697,2,2,0,0,2,2,0,0,0
SC617708,1,1,0,0,1,1,0,0,0
SC617742,1,1,0,0,1,1,0,0,0
SC617768,1,1,0,0,1,1,0,0,0
SC617771,1,1,0,0,1,1,0,0,0
SC618003,2,2,0,0,1,1,0,0,0
SC618035,2,2,0,0,2,2,0,0,0
SC618106,1,1,0,0,1,1,0,0,0
SC618540,3,3,0,0,1,1,0,1,1
SC618555,1,1,0,0,1,1,0,0,0
SC618628,1,1,0,0,1,1,0,0,0
SC618765,1,1,0,0,1,1,0,0,0
SC618786,1,1,0,0,1,1,0,0,0
SC618985,3,3,0,0,3,3,0,0,0
SC618990,1,1,0,0,1,1,0,0,0
SC619309,1,1,0,0,1,1,0,0,0
SC619434,3,2,1,0,3,2,1,0,1
SC619615,2,2,0,0,2,2,0,1,0
SC619637,1,1,0,0,1,1,0,0,0
SC619713,1,1,0,0,1,1,0,0,0
SC619867,1,1,0,0,1,1,0,0,0
SC619998,1,1,0,0,1,1,0,0,0
SC620201,1,1,0,0,1,1,0,0,0
SC620316,1,1,0,0,1,1,0,0,0
SC620430,1,1,0,0,1,1,0,0,0
SC620536,1,1,0,0,1,1,0,0,0
SC620871,1,1,0,0,1,1,0,0,0
SC620998,1,1,0,0,1,1,0,0,0
SC621036,1,1,0,0,1,1,0,0,0
SC621043,3,3,0,0,1,1,0,0,0
SC621080,1,1,0,0,1,1,0,0,0
SC621082,1,1,0,0,1,1,0,0,0
SC621209,4,4,0,0,0,0,0,0,0
SC621235,1,1,0,0,0,0,0,0,0
SC621302,1,1,0,0,1,1,0,0,0
SC621348,1,1,0,0,1,1,0,0,0
SC621746,2,2,0,0,2,2,0,0,0
SC621751,3,3,0,0,2,2,0,0,0
SC621810,2,2,0,0,2,2,0,0,0
SC622357,2,2,0,0,2,2,0,1,1
SC622433,2,2,0,0,2,2,0,0,0
SC622784,2,2,0,0,2,2,0,0,0
SC622872,7,7,0,0,0,0,0,0,0
SC622936,3,3,0,0,0,0,0,0,0
SC622945,2,2,0,0,1,1,0,0,0
SC623008,2,2,0,0,1,1,0,1,1
SC623022,1,1,0,0,1,1,0,0,0
SC623178,2,2,0,0,2,2,0,0,1
SC623207,2,2,0,0,1,1,0,0,0
SC623352,1,1,0,0,1,1,0,0,0
SC623383,2,2,0,1,1,1,0,0,0
SC623445,1,1,0,0,1,1,0,0,0
SC623515,2,2,0,0,2,1,1,2,1
SC623531,1,1,0,0,1,1,0,0,0
SC624099,6,6,0,0,1,1,0,1,1
SC624181,3,3,0,0,2,2,0,0,0
SC624456,1,1,0,0,1,1,0,0,0
SC625004,2,2,0,0,2,2,0,0,0
SC625038,1,1,0,0,1,1,0,0,0
SC625156,1,1,0,0,1,1,0,0,0
SC625213,1,1,0,0,1,1,0,0,0
SC625372,1,1,0,0,1,1,0,0,0
SC625399,3,3,0,0,2,2,0,0,0
SC625466,2,2,0,0,2,2,0,0,0
SC625841,2,2,0,0,1,1,0,0,0
SC626120,2,1,1,0,1,1,0,0,1
SC626134,3,3,0,0,1,1,0,0,1
SC626170,2,2,0,0,2,2,0,0,0
SC626200,3,3,0,0,1,1,0,1,1
SC626203,1,1,0,0,1,1,0,0,0
SC626419,1,1,0,0,1,1,0,0,0
SC626443,1,1,0,0,1,1,0,0,0
SC626714,5,5,0,0,1,1,0,1,0
SC626788,2,2,0,0,1,1,0,0,0
SC626789,1,1,0,0,1,1,0,0,0
SC627003,1,1,0,0,1,1,0,0,0
SC627134,2,2,0,0,1,1,0,1,1
SC628093,1,1,0,0,1,1,0,0,0
SC628124,1,1,0,0,1,1,0,0,0
SC628145,1,1,0,0,1,1,0,0,0
SC628146,3,3,0,0,2,2,0,0,1
SC628459,1,1,0,0,1,1,0,0,0
SC628515,1,1,0,0,1,1,0,0,0
SC628636,2,2,0,0,2,2,0,0,0
SC628675,2,2,0,0,1,1,0,0,0
SC628708,5,5,0,0,0,0,0,0,0
SC628966,1,1,0,0,1,1,0,0,1
SC629521,1,1,0,0,1,1,0,0,0
SC629971,2,2,0,0,1,1,0,1,1
SC629974,2,2,0,0,1,1,0,1,1
SC629975,2,2,0,0,1,1,0,1,1
SC629976,1,1,0,0,1,1,0,1,1
SC629977,2,2,0,0,1,1,0,1,1
SC629978,2,1,1,0,1,1,0,1,1
08065328,4,2,2,0,1,1,0,0,0
08065361,2,1,1,0,1,1,0,0,0
08066004,3,2,1,0,1,1,0,0,1
08066178,1,1,0,0,1,1,0,0,0
08067077,13,5,8,0,1,1,0,1,1
08067232,2,1,1,0,1,1,0,0,0
08067486,8,0,8,0,1,1,0,0,0
08067955,1,1,0,0,1,1,0,0,0
08068231,3,0,3,0,0,0,0,0,0
08068416,2,1,1,0,1,1,0,0,0
08068551,5,0,5,0,4,4,0,0,1
08068857,6,0,6,0,1,1,0,0,0
08069115,2,2,0,0,2,2,0,0,1
08069338,1,0,1,0,1,1,0,0,0
08069385,3,0,3,0,0,0,0,0,1
08069588,1,1,0,0,1,1,0,0,0
08069762,12,3,9,0,2,1,1,2,1
08069771,2,2,0,0,2,2,0,0,1
08070292,1,0,1,0,1,1,0,0,0
08070407,1,1,0,0,1,1,0,0,0
08070821,7,5,2,0,0,0,0,0,0
08070927,2,2,0,0,2,2,0,0,0
08071506,3,3,0,0,1,1,0,0,0
08071651,4,2,2,0,2,2,0,0,0
08071709,2,2,0,0,2,2,0,0,0
08071783,30,10,20,0,1,1,0,0,0
08071972,7,4,3,0,1,1,0,0,1
08071990,2,2,0,0,2,2,0,0,1
08072118,10,8,2,0,0,0,0,0,1
08072121,10,4,6,0,1,1,0,1,1
08072150,15,2,13,0,1,1,0,0,1
08072175,2,2,0,0,1,1,0,1,1
08072432,15,4,11,0,1,1,0,1,1
08072692,2,2,0,0,2,2,0,0,0
08073296,2,2,0,0,2,2,0,0,0
08073538,2,2,0,0,0,0,0,0,1
08073776,6,0,6,0,0,0,0,0,0
08073967,2,0,2,0,0,0,0,0,1
08073994,2,0,2,0,0,0,0,0,1
08074058,4,3,1,0,3,3,0,0,0
08074308,1,1,0,0,2,2,0,0,0
08074373,1,1,0,0,1,1,0,0,0
08074498,10,1,9,0,1,1,0,0,1
08074846,4,2,2,0,1,1,0,0,1
08075354,3,3,0,0,1,1,0,1,1
08075400,13,7,6,0,0,0,0,0,1
08075507,11,4,7,0,1,1,0,1,1
08075551,11,4,7,0,1,1,0,1,1
08075568,11,4,7,0,1,1,0,1,1
08075594,3,0,3,0,0,0,0,0,0
08075971,3,0,3,0,0,0,0,0,0
08076133,2,1,1,0,1,1,0,0,0
08076488,6,4,2,0,1,1,0,0,0
08076547,1,1,0,0,0,0,0,0,0
08077041,3,2,1,0,2,2,0,0,0
08077071,6,4,2,0,2,2,0,0,0
08077320,1,1,0,0,1,1,0,0,1
08077418,1,1,0,0,1,1,0,0,0
08078513,1,1,0,0,1,1,0,0,0
08078574,2,2,0,0,1,1,0,0,0
08078716,1,1,0,0,1,1,0,0,0
08078846,4,2,2,0,2,1,1,0,0
08079200,1,0,1,0,0,0,0,0,1
08079222,3,3,0,0,2,2,0,0,0
08079461,1,1,0,0,1,1,0,0,0
08079680,2,2,0,0,2,2,0,0,0
08080831,1,1,0,0,1,1,0,0,0
08080996,5,3,2,0,4,2,2,0,0
08081570,2,2,0,0,1,1,0,0,0
08081660,2,0,2,0,0,0,0,0,0
08081920,11,2,9,0,2,2,0,0,1
08082167,3,1,2,0,2,1,1,0,0
08082316,6,3,3,0,1,1,0,1,0
08082709,1,1,0,0,1,1,0,0,0
08082738,1,1,0,0,2,2,0,0,0
08082891,2,2,0,0,1,1,0,0,1
08083117,4,3,1,0,2,1,1,2,0
08083512,5,0,5,0,0,0,0,0,1
08084081,2,2,0,0,2,2,0,0,1
08084485,1,1,0,0,1,1,0,0,0
08084516,2,0,2,0,0,0,0,0,1
08084669,2,0,2,0,2,2,0,0,0
08084925,2,2,0,0,2,2,0,0,0
08085620,2,0,2,0,0,0,0,0,0
08086143,2,2,0,0,1,1,0,0,0
08086209,1,0,1,0,0,0,0,0,1
08086266,1,1,0,0,1,1,0,0,0
08086448,2,0,2,0,0,0,0,0,0
08086453,4,3,1,0,1,1,0,0,1
08087266,2,1,1,0,2,1,1,0,0
08087508,28,10,18,0,0,0,0,0,1
08087520,14,3,11,0,1,1,0,1,1
08087556,6,0,6,0,0,0,0,0,0
08087562,1,1,0,0,1,1,0,0,0
08087597,5,4,1,0,3,3,0,0,1
08087907,9,4,5,0,1,1,0,0,1
08088271,2,2,0,0,1,1,0,0,0
08088411,2,2,0,0,1,1,0,0,0
08088683,2,0,2,0,0,0,0,0,1
08089385,1,0,1,0,0,0,0,0,1
08089789,1,1,0,0,1,1,0,0,1
08089855,6,4,2,0,1,1,0,0,0
08089967,5,3,2,0,0,0,0,0,0
08089968,17,8,9,0,0,0,0,0,0
08090053,3,3,0,0,2,2,0,0,1
08090159,5,3,2,0,1,1,0,0,0
08090165,5,3,2,0,1,1,0,0,0
08090527,9,0,9,0,0,0,0,0,1
08090844,2,2,0,0,1,1,0,0,0
08090900,15,6,9,0,5,5,0,0,1
08090935,1,1,0,0,1,1,0,0,0
08090962,4,0,4,0,0,0,0,0,0
08091232,2,0,2,0,1,1,0,0,0
08091235,3,1,2,0,3,1,2,0,1
08091459,1,0,1,0,0,0,0,0,0
08091613,2,0,2,0,0,0,0,0,1
08091734,3,3,0,0,2,1,1,0,1
08092342,2,2,0,0,1,1,0,0,0
08092358,38,17,21,0,0,0,0,0,1
08092391,16,9,7,0,0,0,0,0,1
08092642,2,0,2,0,0,0,0,0,1
08092673,1,0,1,0,0,0,0,0,0
08092963,1,0,1,0,0,0,0,0,0
08093129,8,2,6,0,1,1,0,0,1
08093934,5,0,5,0,0,0,0,0,1
08094066,8,2,6,0,0,0,0,0,1
08094315,5,0,5,0,0,0,0,0,1
08094396,4,0,4,0,0,0,0,0,1
08094914,1,1,0,0,1,1,0,0,0
08095585,1,1,0,0,1,1,0,0,1
08095601,13,7,6,0,1,1,0,0,0
08095737,1,1,0,0,1,1,0,0,1
08095835,3,2,1,0,1,1,0,0,1
08096021,6,3,3,0,0,0,0,0,1
08096411,2,2,0,0,1,1,0,0,0
08096773,8,7,1,0,1,1,0,0,0
08096824,3,3,0,0,1,1,0,0,0
08097203,4,3,1,0,1,1,0,0,0
08097631,4,3,1,0,1,1,0,0,0
08097643,5,0,5,0,0,0,0,0,1
08097941,1,1,0,0,1,1,0,0,0
08097993,1,0,1,0,0,0,0,0,0
08098011,1,0,1,0,0,0,0,0,0
08098630,4,3,1,0,2,2,0,0,0
08098889,1,0,1,0,0,0,0,0,1
08098956,31,12,19,0,1,1,0,1,0
08098975,3,2,1,0,4,4,0,0,0
08099049,2,2,0,0,1,1,0,0,1
08099098,24,18,6,0,4,3,1,0,1
08099214,4,0,4,0,0,0,0,0,0
08099275,3,0,3,0,0,0,0,0,0
08099283,3,0,3,0,0,0,0,0,0
08099426,3,0,3,0,0,0,0,0,1
08100072,1,0,1,0,0,0,0,0,0
08100409,24,13,11,0,5,3,2,0,1
08100662,26,12,14,0,1,1,0,1,1
08100818,1,1,0,0,1,1,0,0,0
08101123,3,2,1,0,1,1,0,1,0
08101456,1,0,1,0,0,0,0,0,1
08101614,1,0,1,0,0,0,0,0,0
08101731,1,0,1,0,0,0,0,0,0
08102243,1,1,0,0,1,1,0,0,0
08102394,3,1,2,0,1,1,0,0,1
08102515,4,0,4,0,0,0,0,0,1
08102528,6,2,4,0,1,1,0,0,1
08102564,4,2,2,0,0,0,0,0,0
08102719,2,1,1,0,1,1,0,0,0
08103129,9,3,6,0,2,2,0,0,0
08103166,2,2,0,0,1,1,0,0,0
08103336,2,2,0,0,1,1,0,0,1
08103724,3,1,2,0,1,1,0,0,1
08103935,6,3,3,0,3,1,2,1,1
08104083,6,6,0,0,4,4,0,0,1
08104281,5,4,1,0,2,2,0,0,0
08104403,5,2,3,0,1,0,1,0,0
08104415,40,11,29,0,0,0,0,0,1
08104426,7,3,4,0,0,0,0,0,1
08104561,4,3,1,0,3,1,2,2,1
08105110,1,1,0,0,1,1,0,0,0
08105163,1,1,0,0,0,0,0,0,0
08105194,2,0,2,0,0,0,0,0,0
08105841,6,4,2,0,0,0,0,0,0
08105978,9,8,1,0,3,3,0,0,1
08105995,9,7,2,0,0,0,0,0,1
08106009,12,3,9,0,0,0,0,0,1
08106108,2,2,0,0,1,1,0,0,1
08106111,3,0,3,0,0,0,0,0,0
08106289,9,0,9,0,0,0,0,0,1
08106664,1,1,0,0,1,1,0,0,0
08107158,11,5,6,0,0,0,0,0,0
08107457,3,0,3,0,0,0,0,0,1
08107480,18,8,10,0,0,0,0,0,0
08107589,9,4,5,0,1,1,0,1,1
08107651,1,1,0,0,1,1,0,0,1
08108581,1,1,0,0,1,1,0,0,0
08108644,1,1,0,0,1,1,0,0,0
08108756,3,0,3,0,0,0,0,0,0
08108762,1,1,0,0,1,1,0,0,0
08109042,2,2,0,0,2,2,0,0,0
08109403,70,24,46,0,0,0,0,0,1
08109617,2,2,0,0,1,1,0,0,0
08109918,2,1,1,0,1,1,0,0,0
08110458,2,0,2,0,0,0,0,0,0
08110806,2,2,0,0,1,1,0,0,0
08111130,1,1,0,0,1,1,0,0,0
08111371,1,0,1,0,0,0,0,0,0
08111386,2,2,0,0,2,2,0,0,1
08111534,24,12,12,0,0,0,0,0,0
08111577,4,1,3,0,1,1,0,0,0
08111857,1,0,1,0,0,0,0,0,0
08112119,2,2,0,0,4,4,0,0,0
08112587,1,1,0,0,1,1,0,0,1
08113062,1,0,1,0,0,0,0,0,0
08113168,9,6,3,0,0,0,0,0,0
08113414,1,0,1,0,0,0,0,0,0
08113439,2,1,1,0,1,1,0,0,0
08113704,1,0,1,0,0,0,0,0,0
08113751,1,0,1,0,0,0,0,0,0
08113900,30,5,25,0,2,1,1,2,1
08114138,31,5,26,0,1,1,0,1,1
08114471,10,7,3,0,0,0,0,0,0
08114514,3,1,2,0,1,1,0,0,0
08114545,10,0,10,0,1,1,0,1,1
08114691,5,1,4,0,2,2,0,0,1
08114757,13,0,13,0,0,0,0,0,1
08114942,2,2,0,0,1,1,0,0,0
08115034,5,0,5,0,0,0,0,0,0
08115118,15,4,11,0,1,1,0,1,1
08115121,37,7,30,0,7,3,4,2,0
08115531,1,1,0,0,1,1,0,0,0
08115578,2,0,2,0,0,0,0,0,1
08115967,6,0,6,0,0,0,0,0,1
08116040,1,1,0,0,1,1,0,0,0
08116342,9,7,2,0,2,2,0,1,1
08116403,2,2,0,0,4,4,0,0,0
08116434,3,0,3,0,0,0,0,0,1
08116654,2,2,0,0,2,2,0,0,0
08116813,1,0,1,0,0,0,0,0,1
08117241,8,4,4,0,1,1,0,0,1
08117379,5,2,3,0,2,2,0,0,1
08117432,2,2,0,0,1,1,0,0,1
08117525,4,3,1,0,4,4,0,1,1
08117915,17,8,9,0,0,0,0,0,1
08117939,2,0,2,0,0,0,0,0,0
08118138,2,2,0,0,1,0,1,0,1
08118207,1,1,0,0,1,1,0,0,0
08118981,1,0,1,0,0,0,0,0,1
08119055,5,0,5,0,0,0,0,0,1
08119358,2,2,0,0,2,2,0,0,0
08119381,2,2,0,0,2,2,0,0,0
08119402,4,4,0,0,2,1,1,0,0
08119494,13,11,2,0,0,0,0,0,0
08119890,1,1,0,0,1,1,0,0,0
08119915,4,0,4,0,0,0,0,0,1
08120083,1,1,0,0,1,1,0,0,0
08120113,8,4,4,0,4,4,0,0,0
08120122,2,2,0,0,1,1,0,0,0
08120231,2,0,2,0,0,0,0,0,1
08120322,1,0,1,0,0,0,0,0,0
08120949,2,2,0,0,2,2,0,0,0
08121464,2,2,0,0,1,1,0,0,0
08121468,4,4,0,0,1,1,0,0,0
08121656,5,2,3,0,0,0,0,0,1
08121657,8,7,1,0,2,2,0,0,1
08121977,5,3,2,0,2,2,0,2,1
08122177,4,1,3,0,0,0,0,0,0
08122565,5,0,5,0,0,0,0,0,1
08123171,2,2,0,0,2,2,0,0,1
08123217,9,7,2,0,0,0,0,0,0
08123221,17,9,8,0,1,0,1,0,0
08123365,8,4,4,0,2,2,0,2,0
08123465,18,7,11,0,0,0,0,0,0
08123495,21,7,14,0,1,1,0,1,1
08123510,13,8,5,0,0,0,0,0,0
08124201,3,1,2,0,1,1,0,0,0
08124341,2,2,0,0,1,1,0,1,0
08124394,1,1,0,0,1,1,0,1,0
08124416,26,10,16,0,0,0,0,0,0
08124468,1,1,0,0,1,1,0,0,0
08124820,34,15,19,6,0,0,0,0,1
08124965,6,4,2,0,0,0,0,0,0
08125379,6,3,3,0,1,1,0,1,1
08125798,2,2,0,0,0,0,0,0,0
08126300,4,1,3,0,3,1,2,0,0
08126402,20,4,16,0,1,1,0,1,1
08126913,1,1,0,0,1,1,0,0,1
08126948,1,1,0,0,1,1,0,0,1
08127108,27,14,13,0,4,4,0,0,0
08127157,38,14,24,0,1,1,0,1,1
08127612,5,2,3,0,1,1,0,0,1
08128049,3,3,0,0,2,2,0,0,0
08128276,2,2,0,0,1,1,0,0,0
08128583,11,2,9,0,1,1,0,1,0
08128622,3,0,3,0,0,0,0,0,0
08128684,9,2,7,0,1,1,0,1,1
08128760,10,6,4,0,1,1,0,1,1
08128871,5,0,5,0,0,0,0,0,1
08128905,17,0,17,0,0,0,0,0,1
08129538,2,1,1,0,1,1,0,0,0
08129680,3,0,3,0,0,0,0,0,1
08129746,3,0,3,0,0,0,0,0,1
10843206,1,1,0,0,1,1,0,0,1
10843265,1,1,0,0,1,1,0,0,0
10843356,2,2,0,0,2,2,0,0,1
10843393,2,2,0,0,2,2,0,0,0
10843512,5,4,1,0,2,1,1,1,0
10843652,2,0,2,0,2,2,0,0,0
10843659,3,1,2,0,2,1,1,0,0
10843843,1,0,1,0,1,1,0,0,0
10844570,4,4,0,0,1,1,0,0,0
10844634,2,0,2,0,2,1,1,0,0
10844903,3,2,1,0,3,2,1,0,0
10844939,4,4,0,0,6,4,2,1,1
10845042,1,1,0,0,1,1,0,0,0
10845406,1,1,0,0,1,1,0,0,0
10845957,1,1,0,0,1,1,0,0,0
10846027,1,0,1,0,1,1,0,0,0
10846128,2,2,0,0,2,2,0,0,0
10846506,1,1,0,0,1,1,0,0,0
10846595,1,1,0,0,1,1,0,0,0
10846723,1,1,0,0,1,1,0,0,0
10847025,3,0,3,0,1,1,0,0,0
10847223,3,2,1,0,2,1,1,0,0
10847883,2,0,2,0,1,1,0,0,0
10847911,3,3,0,0,3,3,0,0,0
10848283,1,1,0,0,1,1,0,0,0
10848407,1,0,1,0,1,1,0,0,0
10848573,4,4,0,0,1,1,0,0,0
10849024,2,1,1,0,1,1,0,0,0
10849289,1,1,0,0,1,1,0,0,0
10849410,1,1,0,0,1,1,0,0,0
10849642,2,2,0,0,2,2,0,0,1
10849899,4,3,1,0,1,1,0,1,1
10850228,6,6,0,0,0,0,0,0,1
10850274,4,1,3,0,1,1,0,0,1
10850606,1,0,1,0,1,1,0,0,0
10851188,1,1,0,0,1,1,0,0,0
10851204,1,0,1,0,1,1,0,0,0
10851366,2,0,2,0,1,1,0,0,0
10851460,2,2,0,0,2,2,0,0,0
10851555,2,2,0,0,2,2,0,0,0
10851706,1,1,0,0,1,1,0,0,0
10852262,1,1,0,0,1,1,0,0,0
10852332,2,2,0,0,2,2,0,0,0
10852444,7,5,2,0,0,0,0,0,1
10852550,4,3,1,0,0,0,0,0,0
10852672,4,4,0,0,3,3,0,0,1
10853107,1,1,0,0,1,1,0,0,0
10853704,1,1,0,0,1,1,0,0,0
10853753,3,3,0,0,1,1,0,1,1
10853770,3,3,0,0,1,1,0,1,1
10853846,4,4,0,0,1,1,0,1,1
10854072,4,4,0,0,1,1,0,1,1
10854131,3,3,0,0,1,1,0,1,1
10855287,3,0,3,0,2,2,0,0,0
10855499,1,1,0,0,1,1,0,0,0
10855524,1,1,0,0,1,1,0,0,0
10855623,1,1,0,0,1,1,0,0,0
10855836,1,1,0,0,1,1,0,0,0
10856004,2,2,0,0,2,2,0,0,0
10856470,4,4,0,0,1,1,0,0,1
10856494,3,3,0,0,2,2,0,0,1
10857028,3,3,0,0,2,2,0,0,0
10857265,1,1,0,0,1,1,0,0,1
10857447,1,1,0,0,1,1,0,0,0
10857544,2,2,0,0,1,1,0,0,0
10857702,2,2,0,0,2,2,0,0,0
10857999,8,3,5,0,1,1,0,1,1
10858033,2,0,2,0,1,1,0,0,1
10858056,2,1,1,0,2,1,1,0,0
10858091,1,0,1,0,0,0,0,0,0
10858600,2,2,0,0,2,2,0,0,0
10858688,1,0,1,0,1,1,0,0,0
10858964,3,2,1,0,1,1,0,0,0
10859112,2,2,0,0,2,2,0,0,0
10859308,1,0,1,0,1,1,0,0,0
10860325,2,1,1,0,2,2,0,0,0
10860791,2,1,1,0,1,1,0,0,0
10861146,5,5,0,0,1,1,0,0,1
10861176,3,2,1,0,2,1,1,0,1
10861651,6,5,1,0,1,1,0,0,1
10861916,8,7,1,2,3,1,2,1,0
10861986,2,2,0,0,1,1,0,0,0
10862269,1,0,1,0,1,1,0,0,0
10862507,2,2,0,0,1,1,0,0,0
10862616,1,1,0,0,1,1,0,0,0
10862742,1,0,1,0,1,1,0,0,0
10862780,2,2,0,0,2,2,0,0,0
10862791,1,1,0,0,1,1,0,0,0
10862931,1,0,1,0,1,1,0,0,0
10862934,2,1,1,0,1,1,0,0,0
10862969,2,2,0,0,2,2,0,0,1
10863118,2,2,0,0,0,0,0,0,0
10863126,2,0,2,0,2,2,0,0,0
10863334,2,2,0,0,2,2,0,0,0
10863450,1,1,0,0,1,1,0,0,0
10863679,2,0,2,0,2,2,0,0,0
10865041,5,5,0,0,1,1,0,0,1
10865329,2,2,0,0,1,1,0,1,1
10865516,2,2,0,0,2,2,0,0,0
10865848,1,1,0,0,1,1,0,0,0
10865936,1,1,0,0,1,1,0,0,0
10866003,2,1,1,0,1,1,0,0,1
10866138,2,2,0,0,2,2,0,0,0
10866226,5,2,3,0,1,1,0,1,1
10866247,2,2,0,0,2,2,0,0,1
10866658,2,1,1,0,1,1,0,0,0
10866973,1,1,0,0,1,1,0,0,1
10866995,3,2,1,0,4,2,2,2,1
10867315,5,2,3,0,0,0,0,0,1
10867426,1,0,1,0,1,1,0,0,0
10868469,5,4,1,0,3,2,1,2,1
10868640,8,6,2,0,1,1,0,1,1
10868930,3,3,0,0,2,2,0,0,0
10868947,1,1,0,0,1,1,0,0,0
10869717,1,1,0,0,1,1,0,0,0
10869953,3,3,0,0,2,2,0,0,0
10869961,3,2,1,0,2,2,0,0,0
10870119,4,3,1,0,2,2,0,0,1
10870974,2,2,0,0,2,2,0,0,0
10871563,5,2,3,0,2,1,1,2,1
10871728,1,1,0,0,1,1,0,0,0
10871753,1,0,1,0,2,2,0,0,0
10872211,2,0,2,0,1,1,0,0,0
10872299,2,2,0,0,0,0,0,0,0
10872508,2,2,0,0,1,1,0,1,1
10872546,1,0,1,0,1,1,0,0,0
10872664,1,0,1,0,1,1,0,0,0
10872739,3,3,0,0,1,1,0,1,1
10872744,5,2,3,0,5,2,3,0,0
10872824,1,1,0,0,2,2,0,0,0
10873136,1,0,1,0,0,0,0,0,0
10873140,1,1,0,0,0,0,0,0,0
10873169,3,3,0,0,1,1,0,0,1
10873427,4,2,2,0,2,2,0,0,0
10873712,1,1,0,0,1,1,0,0,0
10874233,2,2,0,0,1,1,0,0,0
10874375,3,3,0,0,2,2,0,0,0
10874451,4,4,0,0,3,3,0,0,1
10874540,8,8,0,0,1,1,0,1,1
10874925,3,3,0,0,1,1,0,0,0
10875326,3,3,0,0,1,1,0,0,0
10875456,2,2,0,0,2,2,0,0,1
10875856,1,0,1,0,0,0,0,0,0
10875968,3,1,2,0,3,1,2,0,0
10876042,1,1,0,0,1,1,0,0,0
10876367,2,0,2,0,2,2,0,0,0
10876500,8,7,1,0,3,1,2,1,1
10876673,1,1,0,0,1,1,0,0,0
10877456,1,1,0,0,1,1,0,0,0
10877527,2,2,0,0,2,2,0,0,0
10877586,1,1,0,0,1,1,0,0,0
10877606,1,1,0,0,1,1,0,0,0
10878017,4,0,4,0,1,1,0,0,0
10878629,3,2,1,0,3,2,1,0,0
10878633,1,1,0,0,2,2,0,0,0
10878964,2,2,0,0,2,2,0,0,1
10879174,1,1,0,0,1,1,0,0,0
10879228,1,1,0,0,1,1,0,0,0
10879361,2,2,0,0,2,2,0,0,0
10880189,1,1,0,0,1,1,0,0,0
10880327,1,0,1,0,1,1,0,0,0
10880817,2,0,2,0,2,2,0,0,0
10880975,4,3,1,0,2,2,0,0,0
10881026,2,2,0,0,2,2,0,0,1
10881203,2,0,2,0,2,2,0,0,0
10881247,1,1,0,0,1,1,0,0,0
10881378,4,4,0,0,3,3,0,0,0
10881477,2,0,2,0,2,2,0,0,0
10881707,1,1,0,0,1,1,0,0,0
10881717,2,2,0,0,2,2,0,0,0
10881854,2,2,0,0,1,1,0,0,0
10881934,6,6,0,0,1,1,0,1,1
10882104,1,1,0,0,0,0,0,0,0
10882898,1,1,0,0,1,1,0,0,1
10883112,9,5,4,0,2,1,1,2,1
10883842,1,1,0,0,1,1,0,0,0
10884019,1,1,0,0,1,1,0,0,0
10884228,1,1,0,0,0,0,0,0,0
10884298,2,2,0,0,2,2,0,0,1
10884537,1,1,0,0,1,1,0,0,0
10884796,1,0,1,0,1,1,0,0,0
10884851,1,1,0,0,0,0,0,0,1
10884901,3,3,0,0,2,2,0,2,0
10885038,2,2,0,0,4,4,0,0,0
10885127,4,3,1,0,3,2,1,0,0
10885593,8,7,1,0,0,0,0,0,0
10885928,1,1,0,0,1,1,0,0,0
10886656,1,1,0,0,1,1,0,0,0
10887220,2,2,0,0,1,1,0,0,0
10887222,6,6,0,0,0,0,0,0,0
10888387,1,1,0,0,2,1,1,1,0
10888403,2,1,1,0,2,1,1,0,0
10888639,7,5,2,0,3,1,2,2,1
10888903,7,5,2,0,3,1,2,2,1
10889003,3,3,0,0,1,1,0,0,1
10889591,4,0,4,0,1,1,0,1,1
10889655,3,2,1,0,0,0,0,0,1
10889748,4,4,0,0,3,3,0,0,1
10889803,4,4,0,0,1,1,0,0,0
10890160,3,1,2,0,2,1,1,1,1
10890922,1,1,0,0,1,1,0,0,0
10891009,1,1,0,0,2,2,0,0,0
10891687,1,1,0,0,1,1,0,0,0
10891788,10,7,3,0,4,2,2,3,1
10892083,1,0,1,0,1,1,0,0,0
10892130,1,1,0,0,1,1,0,0,1
10892751,4,4,0,0,1,1,0,1,0
10892844,7,5,2,0,3,1,2,1,0
10892853,7,1,6,0,4,1,3,3,1
10893298,1,1,0,0,1,1,0,0,0
10893399,1,1,0,0,1,1,0,0,0
10894105,2,2,0,0,2,2,0,0,0
10894460,1,1,0,0,1,1,0,0,0
10894512,10,9,1,0,1,0,1,0,1
10894610,1,0,1,0,1,1,0,0,1
10894970,1,0,1,0,1,1,0,0,0
10894988,1,1,0,0,1,1,0,0,0
10895134,1,0,1,0,1,1,0,0,0
10895708,2,2,0,0,1,1,0,1,1
10895764,8,7,1,0,2,1,1,1,1
10895803,1,1,0,0,1,1,0,0,0
10896213,3,3,0,0,3,2,1,0,0
10896235,5,5,0,0,0,0,0,0,0
10896445,1,0,1,0,1,1,0,0,0
10896588,1,1,0,0,2,2,0,0,1
10897217,1,1,0,0,1,1,0,0,0
10897337,3,2,1,0,3,2,1,1,1
10897740,1,1,0,0,1,1,0,0,0
10897797,11,9,2,0,1,1,0,0,0
10897946,1,1,0,0,0,0,0,0,1
10898110,1,1,0,0,1,1,0,0,0
10898697,2,2,0,0,1,1,0,0,0
10899201,4,4,0,0,3,1,2,1,1
10899401,2,2,0,0,2,2,0,0,0
10899483,1,1,0,0,1,1,0,0,0
10899487,1,1,0,0,1,1,0,0,0
10899678,3,2,1,0,2,1,1,0,0
10899760,1,1,0,0,1,1,0,0,0
10899779,2,2,0,0,1,1,0,0,0
10899794,1,1,0,0,1,1,0,0,0
10899991,3,3,0,0,2,0,2,0,1
10900601,4,4,0,0,1,1,0,1,1
10900966,2,2,0,0,2,2,0,0,0
10901774,1,0,1,0,0,0,0,0,1
10902026,3,3,0,0,1,1,0,1,1
10902377,1,1,0,0,1,1,0,0,0
10902511,3,3,0,0,1,1,0,1,1
10902581,2,2,0,0,2,2,0,0,0
10902750,2,2,0,0,2,2,0,0,0
10903556,10,9,1,0,0,0,0,0,0
10903674,1,1,0,0,0,0,0,0,0
10904035,2,0,2,0,2,2,0,0,0
10904050,5,4,1,0,1,1,0,1,1
10904081,1,1,0,0,2,2,0,0,0
10904496,3,3,0,0,1,0,1,0,0
10904554,1,1,0,0,0,0,0,0,1
10905000,3,3,0,0,2,1,1,2,1
10906072,2,2,0,0,1,1,0,0,1
10906190,6,5,1,2,3,1,2,1,0
10906203,2,1,1,0,2,2,0,0,0
10907066,1,0,1,0,1,1,0,0,0
10907623,1,0,1,0,1,1,0,0,0
10907863,1,0,1,0,1,1,0,0,0
10908128,1,1,0,0,1,1,0,0,0
10908305,4,4,0,0,1,1,0,1,1
10908664,1,1,0,0,1,1,0,0,0
10909521,2,2,0,0,0,0,0,0,1
10910352,1,1,0,0,1,1,0,0,1
10910472,1,1,0,0,1,1,0,0,0
10910920,2,2,0,0,1,1,0,0,1
10911041,2,2,0,0,2,2,0,0,0
10911173,1,0,1,0,1,1,0,0,1
10911288,2,1,1,0,2,1,1,0,0
10911512,2,1,1,0,1,1,0,0,1
10912411,2,1,1,0,2,1,1,0,0
10912458,2,2,0,0,1,1,0,1,0
10912488,7,4,3,0,2,2,0,0,1
10912845,1,1,0,0,1,1,0,0,0
10913109,1,1,0,0,1,1,0,0,1
10913240,2,2,0,0,1,1,0,0,1
10913687,1,0,1,0,2,2,0,0,0
10914011,2,2,0,0,2,2,0,0,0
10914124,1,0,1,0,1,1,0,0,0
10914732,2,0,2,0,2,1,1,0,0
10914843,1,1,0,0,1,1,0,0,0
10915229,1,0,1,0,1,1,0,0,0
10915277,2,2,0,0,1,1,0,1,0
10915481,2,1,1,0,1,1,0,0,0
10915625,2,2,0,0,2,2,0,0,0
10915751,1,0,1,0,1,1,0,0,0
10915761,1,1,0,0,0,0,0,0,0
10915789,1,1,0,0,0,0,0,0,0
10915803,5,5,0,0,1,1,0,1,1
10915816,2,0,2,0,2,2,0,0,0
10915830,1,0,1,0,1,1,0,0,0
10915900,1,1,0,0,1,1,0,0,0
10915969,1,1,0,0,1,1,0,0,0
10916023,4,4,0,0,2,2,0,0,0
10916140,1,1,0,0,1,1,0,0,1
10916246,1,1,0,0,1,1,0,0,0
10916326,1,1,0,0,0,0,0,0,0
10916468,1,1,0,0,1,1,0,0,0
10917290,2,1,1,0,2,1,1,1,0
10917368,1,1,0,0,1,1,0,0,0
10917391,2,1,1,0,2,1,1,2,0
10917527,3,0,3,0,1,1,0,1,1
10917746,2,2,0,0,1,1,0,0,0
10918710,2,0,2,0,2,2,0,0,0
10918742,1,0,1,0,1,1,0,0,0
10918855,11,5,6,0,0,0,0,0,0
10919062,8,7,1,0,0,0,0,0,0
10919076,1,0,1,0,1,1,0,1,0
10919279,3,2,1,0,2,1,1,0,0
10919461,1,1,0,0,1,1,0,0,0
10919729,5,5,0,0,0,0,0,0,0
10920269,1,0,1,0,1,1,0,0,0
10920373,1,0,1,0,1,1,0,0,0
10921162,4,4,0,0,1,1,0,0,1
10921184,3,3,0,0,1,1,0,1,1
10921187,1,1,0,0,1,1,0,0,1
10921689,4,3,1,0,1,1,0,0,0
10921863,1,1,0,0,1,1,0,0,0
10922062,1,1,0,0,1,1,0,0,0
10922145,1,1,0,0,1,1,0,0,0
10922369,2,1,1,0,0,0,0,0,0
10922669,1,1,0,0,1,1,0,0,0
10922831,2,2,0,0,2,2,0,0,0
10922872,7,4,3,0,1,1,0,1,0
10923027,1,1,0,0,1,1,0,0,0
10923437,4,4,0,0,1,1,0,1,1
10923651,2,2,0,0,0,0,0,0,1
10923699,4,4,0,0,1,1,0,0,0
10923817,2,2,0,0,2,2,0,0,0
09616020,8,1,7,0,5,1,4,0,0
09616076,13,6,7,0,0,0,0,0,1
09616310,1,1,0,0,1,1,0,0,0
09616629,2,2,0,0,1,1,0,0,1
09616774,1,1,0,0,1,1,0,0,0
09616816,5,4,1,0,0,0,0,0,1
09617166,13,9,4,0,8,7,1,0,0
09617264,18,10,8,0,11,8,3,0,0
09617311,14,9,5,0,0,0,0,0,1
09617543,6,5,1,0,0,0,0,0,1
09617654,6,2,4,0,1,1,0,1,1
09617963,6,2,4,0,1,1,0,1,1
09618149,3,0,3,0,0,0,0,0,0
09618234,1,0,1,0,0,0,0,0,0
09618258,2,2,0,0,2,2,0,0,0
09618719,7,6,1,0,2,1,1,1,1
09618863,1,1,0,0,0,0,0,0,1
09619214,3,0,3,0,0,0,0,0,0
09619726,3,0,3,0,0,0,0,0,1
09620278,1,1,0,0,1,1,0,0,0
09620457,8,5,3,0,1,1,0,0,0
09620653,1,1,0,0,1,1,0,0,0
09622070,3,2,1,0,1,1,0,0,1
09622429,4,4,0,0,1,1,0,1,1
09622780,1,1,0,0,1,1,0,0,0
09622925,1,1,0,0,1,1,0,0,0
09623014,2,1,1,0,1,1,0,0,0
09623123,3,2,1,0,1,1,0,1,1
09623146,2,2,0,0,2,2,0,0,0
09623305,2,2,0,0,1,1,0,0,0
09623537,26,15,11,0,0,0,0,0,1
09623867,1,0,1,0,0,0,0,0,0
09624319,1,1,0,0,1,1,0,0,0
09624456,1,1,0,0,1,1,0,0,0
09624486,1,1,0,0,1,1,0,0,0
09624624,4,0,4,0,1,1,0,0,1
09624695,2,2,0,0,2,2,0,0,0
09624908,2,2,0,0,2,2,0,0,0
09625229,1,1,0,0,1,1,0,0,0
09625288,2,2,0,0,2,2,0,0,1
09625526,1,0,1,0,0,0,0,0,1
09625533,3,2,1,0,2,2,0,0,0
09625936,1,0,1,0,1,1,0,0,0
09626055,1,1,0,0,1,1,0,0,0
09626060,2,0,2,0,1,1,0,0,0
09626123,2,2,0,0,2,2,0,0,0
09626221,2,2,0,0,1,1,0,1,0
09626412,6,4,2,0,0,0,0,0,0
09626475,7,0,7,0,1,1,0,0,1
09626660,9,6,3,0,1,0,1,1,1
09626921,3,3,0,0,2,2,0,0,1
09627041,2,2,0,0,1,1,0,0,0
09627765,3,3,0,0,2,2,0,0,0
09627776,1,1,0,0,1,1,0,1,1
09627818,1,0,1,0,2,2,0,0,1
09628339,1,0,1,0,0,0,0,0,0
09628613,6,0,6,0,1,1,0,1,1
09628815,5,0,5,0,1,1,0,1,1
09628891,5,0,5,0,1,1,0,1,1
09629467,2,1,1,0,1,1,0,0,0
09629550,2,2,0,0,2,2,0,0,1
09629636,3,0,3,0,0,0,0,0,0
09629688,2,2,0,0,1,1,0,0,0
09629953,1,1,0,0,1,1,0,0,0
09629974,2,2,0,0,1,1,0,1,1
09630103,1,1,0,0,1,1,0,0,0
09630281,1,1,0,0,1,1,0,0,1
09630416,2,0,2,0,2,2,0,0,1
09630645,2,2,0,0,2,2,0,0,1
09630922,2,1,1,0,1,1,0,0,0
09631340,2,1,1,0,2,2,0,0,0
09631628,4,4,0,0,1,1,0,0,1
09632002,1,1,0,0,1,1,0,0,0
09632074,9,2,7,0,0,0,0,0,0
09632247,1,1,0,0,1,1,0,0,1
09632254,3,2,1,0,1,1,0,1,1
09632852,2,2,0,0,1,1,0,0,0
09632857,1,0,1,0,1,1,0,0,1
09633288,4,4,0,0,2,2,0,0,1
09633477,5,0,5,0,0,0,0,0,0
09633493,5,3,2,0,1,1,0,1,1
09633635,1,1,0,0,1,1,0,0,0
09633673,1,1,0,0,1,1,0,0,0
09633840,4,4,0,0,1,1,0,1,1
09633876,6,3,3,0,1,1,0,1,1
09634177,2,2,0,0,1,1,0,0,0
09634338,1,1,0,0,1,1,0,0,0
09634465,2,2,0,0,1,1,0,1,1
09634517,2,2,0,0,1,1,0,1,1
09634645,3,2,1,0,1,1,0,1,1
09634692,3,2,1,0,1,1,0,1,1
09634782,2,2,0,0,2,2,0,0,0
09634797,2,1,1,0,3,1,2,0,0
09634865,1,0,1,0,0,0,0,0,0
09635259,4,0,4,0,1,1,0,0,0
09635465,28,11,17,0,0,0,0,0,1
09635478,3,3,0,0,3,3,0,0,0
09636215,4,2,2,0,2,2,0,0,0
09636294,1,1,0,0,0,0,0,0,0
09636308,1,1,0,0,1,1,0,0,0
09636548,1,1,0,0,2,2,0,1,0
09636727,2,1,1,0,1,1,0,0,0
09636796,4,3,1,0,1,1,0,1,1
09638002,1,1,0,0,3,3,0,0,0
09638023,5,5,0,0,1,1,0,0,0
09639481,2,0,2,0,2,2,0,0,0
09639585,6,3,3,0,0,0,0,0,1
09639708,1,0,1,0,1,1,0,0,0
09640121,4,4,0,0,1,1,0,0,0
09640192,2,2,0,0,2,2,0,0,0
09640349,1,1,0,0,1,1,0,0,0
09640586,1,0,1,0,1,1,0,0,0
09640796,1,0,1,0,0,0,0,0,0
09640924,1,0,1,0,1,1,0,0,0
09641072,1,1,0,0,1,1,0,0,0
09641135,2,2,0,0,1,1,0,0,0
09641190,29,13,16,0,1,1,0,0,1
09641370,5,4,1,0,1,1,0,1,1
09641815,2,2,0,0,0,0,0,0,0
09641912,1,0,1,0,0,0,0,0,0
09641920,2,0,2,0,1,1,0,0,0
09642084,2,0,2,0,0,0,0,0,0
09642211,3,2,1,0,3,2,1,0,1
09642453,4,2,2,0,2,2,0,0,1
09642762,1,0,1,0,0,0,0,0,0
09643318,3,3,0,0,2,2,0,0,0
09643500,6,3,3,0,0,0,0,0,1
09643653,2,2,0,0,2,2,0,0,0
09643680,3,3,0,0,0,0,0,0,1
09643897,1,0,1,0,0,0,0,0,0
09644514,1,1,0,0,1,1,0,0,0
09644904,2,0,2,0,0,0,0,0,1
09645719,7,1,6,0,1,1,0,0,0
09646320,26,15,11,0,0,0,0,0,0
09646998,5,4,1,0,1,1,0,1,1
09647021,9,5,4,0,0,0,0,0,1
09647034,5,4,1,0,1,1,0,1,1
09647035,5,4,1,0,1,1,0,1,1
09647121,2,2,0,0,1,1,0,0,0
09647308,5,4,1,0,1,1,0,0,0
09647432,9,7,2,0,1,1,0,1,1
09647504,3,3,0,0,2,2,0,0,0
09647669,2,2,0,0,2,2,0,0,0
09647722,1,0,1,0,1,1,0,0,0
09647923,9,6,3,0,1,1,0,1,1
09648268,4,3,1,0,1,1,0,0,1
09648359,2,2,0,0,0,0,0,0,0
09648381,1,1,0,0,1,1,0,0,0
09648605,2,2,0,0,2,2,0,0,0
09648663,16,6,10,0,0,0,0,0,0
09648854,5,5,0,0,2,2,0,0,1
09648885,1,1,0,0,1,1,0,0,1
09649017,3,2,1,0,1,1,0,0,0
09649031,2,2,0,0,1,1,0,0,0
09649240,12,4,8,0,2,1,1,2,0
09649327,4,0,4,0,0,0,0,0,1
09649436,4,0,4,0,0,0,0,0,1
09649442,2,2,0,0,2,2,0,0,0
09649456,4,0,4,0,0,0,0,0,1
09649504,7,2,5,0,1,1,0,0,0
09649536,5,2,3,0,3,1,2,1,0
09649602,4,0,4,0,0,0,0,0,1
09649606,4,0,4,0,0,0,0,0,1
09649796,11,10,1,0,3,3,0,0,1
09650092,2,2,0,0,1,1,0,0,0
09650217,2,0,2,0,1,1,0,0,0
09650788,2,2,0,0,2,2,0,0,0
09651123,6,3,3,0,1,1,0,1,0
09651367,13,6,7,0,0,0,0,0,1
09651650,5,3,2,0,0,0,0,0,1
09651696,1,1,0,0,1,1,0,0,0
09652241,2,2,0,0,1,1,0,0,1
09652357,7,3,4,0,1,1,0,1,1
09652697,1,0,1,0,1,1,0,0,0
09653058,8,2,6,0,1,1,0,1,0
09653090,8,2,6,0,1,1,0,1,0
09654053,4,2,2,0,1,1,0,1,1
09654079,1,1,0,0,1,1,0,0,0
09654097,1,1,0,0,1,1,0,0,0
09654141,5,3,2,0,1,1,0,1,1
09654425,4,3,1,0,3,3,0,0,0
09654635,1,1,0,0,1,1,0,0,0
09655061,2,2,0,0,1,1,0,0,0
09655385,6,4,2,0,1,1,0,1,1
09655520,11,9,2,0,0,0,0,0,1
09656066,7,3,4,0,0,0,0,0,1
09656255,5,3,2,0,1,1,0,1,1
09656327,4,2,2,0,1,1,0,0,1
09656483,5,5,0,0,1,1,0,0,0
09656956,6,5,1,0,1,1,0,1,1
09657139,1,1,0,0,1,1,0,0,0
09657181,2,2,0,0,1,1,0,0,0
09657546,2,2,0,0,1,1,0,0,0
09657753,7,3,4,0,1,1,0,1,0
09658172,1,1,0,0,2,2,0,0,0
09658276,3,0,3,0,0,0,0,0,1
09658428,1,1,0,0,1,1,0,0,0
09658537,23,11,12,0,0,0,0,0,1
09659105,5,2,3,0,1,1,0,1,1
09659618,6,0,6,0,0,0,0,0,1
09659950,2,2,0,0,2,2,0,0,0
09660141,1,1,0,0,1,1,0,0,1
09660165,7,5,2,0,0,0,0,0,0
09660543,4,1,3,0,1,1,0,0,0
09660899,5,5,0,0,1,1,0,0,0
09661262,2,1,1,0,1,1,0,0,0
09661615,3,1,2,0,1,1,0,0,0
09662095,5,3,2,0,0,0,0,0,1
09662256,5,4,1,0,1,1,0,0,0
09662720,4,3,1,0,3,1,2,3,1
09663314,2,2,0,0,2,2,0,0,0
09663401,1,0,1,0,1,1,0,0,0
09663430,2,2,0,0,2,2,0,0,0
09663513,1,0,1,0,0,0,0,0,0
09663885,6,3,3,0,0,0,0,0,1
09663911,1,1,0,0,1,1,0,0,0
09664651,5,5,0,0,2,2,0,0,1
09664682,1,0,1,0,1,1,0,0,0
09664872,2,1,1,0,1,1,0,0,0
09664930,3,3,0,0,1,1,0,0,1
09665118,4,1,3,0,1,1,0,0,0
09665469,12,4,8,0,2,2,0,0,1
09665682,1,0,1,0,1,1,0,0,0
09665693,2,2,0,0,1,1,0,0,0
09665825,5,3,2,0,1,1,0,1,1
09665862,3,0,3,0,4,4,0,0,1
09666461,3,0,3,0,2,2,0,0,1
09666882,2,2,0,0,2,2,0,0,0
09666925,2,2,0,0,5,1,4,2,0
09666963,4,4,0,0,1,1,0,0,1
09667417,2,2,0,0,1,1,0,1,0
09667681,5,5,0,0,1,1,0,0,1
09667721,1,1,0,0,1,1,0,0,0
09668229,1,0,1,0,1,1,0,0,0
09668285,2,0,2,0,1,1,0,0,0
09668506,4,4,0,0,1,1,0,0,0
09668574,1,0,1,0,1,1,0,0,0
07131003,10,6,4,0,2,2,0,0,1
07131018,2,0,2,0,0,0,0,0,1
07131180,2,0,2,0,0,0,0,0,1
07131182,7,3,4,0,1,1,0,0,0
07131250,1,1,0,0,1,1,0,0,0
07131294,10,3,7,0,2,2,0,2,1
07131416,11,4,7,0,0,0,0,0,1
07131466,3,2,1,0,2,2,0,0,0
07131649,7,0,7,0,0,0,0,0,1
07131805,10,0,10,0,0,0,0,0,1
07132123,3,1,2,0,1,1,0,0,0
07132156,13,6,7,0,0,0,0,0,1
07132584,10,6,4,0,3,3,0,1,1
07133023,8,5,3,0,2,2,0,0,1
07133066,2,1,1,0,1,1,0,0,0
07133186,3,2,1,0,1,1,0,0,1
07133193,6,0,6,0,0,0,0,0,0
07133698,12,6,6,0,0,0,0,0,1
07133922,2,2,0,0,1,1,0,0,0
07134026,1,0,1,0,0,0,0,0,1
07134366,3,3,0,0,1,1,0,0,1
07134442,3,0,3,0,0,0,0,0,1
07134493,7,2,5,0,1,1,0,1,1
07134863,3,3,0,0,3,3,0,0,1
07134975,5,2,3,0,2,2,0,0,0
07135297,2,0,2,0,2,2,0,0,0
07135346,1,1,0,0,2,2,0,0,1
07135355,12,3,9,0,1,1,0,1,1
07135359,3,1,2,0,2,2,0,0,0
07135691,8,0,8,0,0,0,0,0,1
07135866,4,1,3,0,0,0,0,0,0
07135945,32,17,15,0,0,0,0,0,0
07136213,5,5,0,0,0,0,0,0,0
07136274,16,0,16,0,0,0,0,0,1
07136446,4,4,0,0,2,2,0,0,0
07136799,21,6,15,0,0,0,0,0,1
07137003,5,0,5,0,0,0,0,0,1
07137203,7,3,4,0,1,1,0,1,1
07137377,13,0,13,0,0,0,0,0,1
07137500,1,1,0,0,1,1,0,0,0
07137844,2,0,2,0,2,2,0,0,1
07137935,5,4,1,0,2,2,0,0,0
07137953,2,0,2,0,0,0,0,0,1
07138012,2,1,1,0,1,1,0,0,1
07138123,3,0,3,0,0,0,0,0,1
07138126,3,2,1,0,2,1,1,0,0
07138167,1,1,0,0,1,1,0,0,0
07138262,3,2,1,0,1,1,0,0,0
07138325,9,6,3,0,0,0,0,0,0
07138465,17,3,14,0,0,0,0,0,1
07138777,4,0,4,0,1,1,0,1,1
07138832,7,4,3,0,2,2,0,0,0
07139131,14,8,6,0,3,3,0,1,1
07139260,6,6,0,0,0,0,0,0,0
07139537,3,2,1,0,1,1,0,1,0
07139739,6,2,4,0,2,1,1,0,0
07139745,1,1,0,0,1,1,0,0,0
07139752,3,0,3,0,0,0,0,0,0
07139828,18,0,18,0,0,0,0,0,1
07139960,15,5,10,0,1,1,0,1,1
07140154,9,3,6,1,0,0,0,0,1
07140181,9,3,6,1,0,0,0,0,1
07140255,13,3,10,0,1,1,0,1,1
07140272,23,3,20,0,1,1,0,1,1
07140606,17,7,10,0,1,1,0,0,0
07140614,7,3,4,0,0,0,0,0,1
07140891,20,10,10,0,0,0,0,0,1
07140994,2,2,0,0,1,1,0,0,0
07140997,1,1,0,0,1,1,0,0,0
07141046,5,0,5,0,1,1,0,1,0
07141047,4,4,0,0,1,1,0,0,1
07141268,10,5,5,0,0,0,0,0,0
07142153,16,6,10,0,0,0,0,0,1
07142287,3,0,3,0,0,0,0,0,1
07142300,1,1,0,0,2,2,0,1,1
07142317,6,3,3,0,1,1,0,0,1
07142716,2,2,0,0,2,2,0,0,0
07142946,26,9,17,0,0,0,0,0,1
07143015,5,2,3,0,1,1,0,0,1
07143057,3,0,3,0,0,0,0,0,1
07143202,6,3,3,0,2,2,0,0,1
07143479,6,0,6,0,0,0,0,0,1
07143677,2,2,0,0,2,2,0,0,0
07143728,1,1,0,0,1,1,0,0,1
07143777,2,1,1,0,1,1,0,0,1
07143806,3,1,2,0,1,1,0,0,0
07144326,4,2,2,0,1,1,0,0,0
07144335,4,2,2,0,1,1,0,0,0
07144397,3,2,1,0,1,1,0,0,0
07144972,7,4,3,0,1,1,0,1,1
07145006,2,2,0,0,1,1,0,0,0
07145018,11,0,11,0,0,0,0,0,1
07145272,9,0,9,1,0,0,0,0,1
07145604,7,0,7,0,0,0,0,0,1
07145635,1,1,0,0,1,1,0,0,0
07146157,1,0,1,0,0,0,0,0,1
07146421,10,0,10,0,0,0,0,0,1
07146505,10,0,10,0,0,0,0,0,1
07146941,10,3,7,0,0,0,0,0,1
07147645,9,0,9,0,0,0,0,0,1
07148094,2,2,0,0,2,2,0,1,1
07148323,1,1,0,0,1,1,0,0,0
07148608,1,1,0,0,1,1,0,0,0
07148887,6,0,6,0,0,0,0,0,1
07148936,13,5,8,0,0,0,0,0,0
07149227,16,2,14,0,2,2,0,0,1
07149456,14,0,14,0,1,1,0,1,1
07149785,2,2,0,0,1,1,0,0,0
07150000,6,2,4,0,0,0,0,0,0
07150052,6,3,3,0,2,2,0,0,0
07150069,16,13,3,0,0,0,0,0,1
07150139,7,2,5,0,1,1,0,0,1
07150410,7,4,3,0,1,0,1,0,1
07150857,3,0,3,0,0,0,0,0,0
07151084,7,2,5,0,2,1,1,0,1
07151137,4,2,2,0,1,1,0,0,0
07151159,32,8,24,0,2,2,0,1,1
07151534,2,0,2,0,0,0,0,0,0
07151982,5,3,2,0,1,1,0,0,1
07152154,2,1,1,0,2,1,1,0,0
07153323,13,3,10,0,1,1,0,1,1
07153346,5,4,1,0,1,1,0,0,0
07153600,5,2,3,0,2,2,0,0,1
07153623,6,1,5,0,2,1,1,1,1
07153998,2,2,0,0,1,1,0,1,0
07154018,21,3,18,0,1,1,0,1,1
07154092,3,3,0,0,2,2,0,0,0
07154151,16,9,7,0,1,1,0,0,1
07154255,2,0,2,0,1,1,0,0,0
07154808,2,2,0,0,1,1,0,0,0
07154855,3,1,2,0,1,1,0,0,0
07154988,6,3,3,0,2,2,0,0,0
07155068,1,0,1,0,1,1,0,0,0
07155161,22,6,16,0,0,0,0,0,0
07155164,2,2,0,0,1,1,0,0,0
07155558,10,2,8,0,2,1,1,1,1
07155782,3,1,2,0,1,1,0,0,0
07156017,3,2,1,0,2,2,0,0,0
07156391,11,6,5,0,1,1,0,1,1
07156484,12,3,9,0,1,1,0,1,1
07156554,1,1,0,0,1,1,0,0,1
07156633,9,5,4,0,0,0,0,0,1
07156754,3,3,0,0,1,1,0,0,1
07156831,1,1,0,0,1,1,0,0,0
07157165,1,0,1,0,0,0,0,0,0
07157222,1,1,0,0,1,1,0,0,0
07157540,10,8,2,0,0,0,0,0,1
07157573,2,0,2,0,2,2,0,0,0
07157593,2,2,0,0,2,2,0,0,1
07158055,9,2,7,0,3,1,2,3,0
07158064,9,2,7,0,2,1,1,2,0
07158175,2,2,0,0,1,1,0,0,0
07158371,11,9,2,0,1,1,0,1,1
07158460,3,1,2,0,1,1,0,0,0
07158554,14,3,11,0,0,0,0,0,0
07158636,4,2,2,0,1,1,0,0,0
07158865,2,1,1,0,1,1,0,0,1
07158964,3,3,0,0,1,1,0,0,1
07159117,2,2,0,0,2,2,0,0,0
07159188,8,3,5,0,0,0,0,0,0
07159647,10,6,4,0,0,0,0,0,0
07159767,28,11,17,0,2,1,1,0,1
07159984,4,3,1,0,1,1,0,1,1
07160485,8,3,5,0,2,1,1,0,1
07160526,8,3,5,0,2,1,1,0,1
07160558,9,0,9,0,0,0,0,0,1
07160564,13,0,13,0,1,1,0,1,1
07160740,3,1,2,0,0,0,0,0,1
07160790,6,5,1,0,0,0,0,0,1
07161150,3,0,3,0,0,0,0,0,1
07161372,3,3,0,0,0,0,0,0,1
07161450,3,2,1,0,1,1,0,0,0
07161626,3,2,1,0,1,1,0,1,1
07161870,3,0,3,0,1,1,0,1,0
07161991,6,1,5,0,1,1,0,0,1
07162100,13,4,9,0,1,1,0,2,1
07162127,4,2,2,0,0,0,0,0,0
07162168,7,5,2,0,1,1,0,0,1
07162177,10,4,6,0,0,0,0,0,0
07162224,3,2,1,0,2,2,0,0,1
07162316,3,2,1,0,1,1,0,0,0
07162408,3,2,1,0,2,2,0,0,0
07162516,18,9,9,0,0,0,0,0,1
07162707,2,1,1,0,1,1,0,0,1
07162884,4,3,1,0,1,1,0,1,0
07163118,5,0,5,0,0,0,0,0,1
07163189,2,2,0,0,2,2,0,0,1
07163421,17,7,10,0,1,1,0,1,1
07163464,9,4,5,0,0,0,0,0,1
07163527,6,0,6,0,0,0,0,0,1
07163541,3,0,3,0,0,0,0,0,0
07163887,8,3,5,0,0,0,0,0,0
07163927,24,7,17,0,0,0,0,0,0
07164289,5,4,1,0,3,3,0,0,0
07164379,5,5,0,0,0,0,0,0,0
07164586,7,3,4,0,1,1,0,1,1
07164745,20,8,12,0,0,0,0,0,1
07165227,1,1,0,0,1,1,0,0,0
07165429,20,3,17,0,2,2,0,2,1
07165431,5,0,5,0,0,0,0,0,1
07165818,6,3,3,0,2,2,0,0,1
07165870,6,3,3,0,2,2,0,0,1
07165899,6,3,3,0,2,2,0,0,1
07166046,5,3,2,0,2,2,0,0,0
07166149,1,1,0,0,1,1,0,0,0
07166304,10,4,6,0,1,1,0,1,1
07166532,6,0,6,0,0,0,0,0,1
07166699,1,1,0,0,1,1,0,0,0
07167526,6,1,5,0,1,1,0,0,1
07167712,3,3,0,0,2,2,0,0,1
07167859,5,3,2,0,0,0,0,0,1
07168013,12,0,12,0,0,0,0,0,1
07168038,5,3,2,0,2,2,0,0,0
07168211,7,3,4,0,1,1,0,0,1
07168431,3,0,3,0,0,0,0,0,0
07168488,5,0,5,0,0,0,0,0,1
07168489,16,5,11,0,1,1,0,1,1
07168613,4,1,3,0,1,1,0,0,0
07168674,31,7,24,0,0,0,0,0,1
07169065,6,0,6,0,0,0,0,0,1
07169154,11,6,5,0,1,1,0,1,1
07169209,4,2,2,0,1,1,0,1,0
07169761,11,4,7,0,1,1,0,1,1
07169795,4,2,2,0,2,1,1,0,1
07169907,6,4,2,0,2,1,1,1,1
04715312,9,6,3,0,0,0,0,0,0
04715386,5,2,3,0,1,1,0,0,0
04715569,13,4,9,0,1,1,0,1,1
04715570,5,3,2,0,2,2,0,0,0
04715640,5,1,4,0,1,1,0,0,1
04715824,50,7,43,0,0,0,0,0,0
04715948,12,2,10,0,2,2,0,0,1
04715958,21,8,13,0,0,0,0,0,1
04716155,4,2,2,0,2,2,0,0,1
04716325,12,6,6,0,0,0,0,0,1
04716361,27,1,26,0,1,0,1,0,1
04716472,11,0,11,0,0,0,0,0,1
04716809,5,3,2,0,2,2,0,0,1
04717197,12,2,10,0,1,1,0,1,1
04717201,21,5,16,0,1,1,0,1,1
04717253,2,2,0,0,1,1,0,0,0
04717372,23,3,20,0,3,3,0,3,1
04717817,4,2,2,0,0,0,0,0,1
04718208,7,3,4,0,1,1,0,0,0
04718373,12,4,8,0,1,1,0,1,1
04718501,9,0,9,0,0,0,0,0,1
04719303,11,3,8,0,0,0,0,0,0
04719541,4,1,3,0,1,1,0,0,1
04719672,8,1,7,0,1,1,0,1,1
04719679,4,2,2,0,1,1,0,0,1
04719865,7,3,4,0,2,2,0,0,1
04719999,4,2,2,0,1,1,0,0,0
04720013,19,0,19,0,0,0,0,0,1
04720018,29,6,23,0,0,0,0,0,1
04720073,7,0,7,0,0,0,0,0,1
04720077,7,0,7,0,0,0,0,0,1
04720384,3,3,0,0,1,1,0,0,0
04720439,22,5,17,0,1,1,0,1,1
04720466,16,4,12,0,1,1,0,1,1
04720793,13,4,9,0,1,1,0,1,1
04720855,11,2,9,0,1,1,0,1,1
04720916,6,0,6,0,0,0,0,0,1
04720979,5,3,2,0,2,2,0,0,0
04721046,15,2,13,0,2,2,0,0,1
04721373,7,2,5,0,1,1,0,0,1
04721395,5,2,3,0,1,1,0,0,0
04721677,26,0,26,0,0,0,0,0,1
04721742,4,2,2,0,0,0,0,0,0
04721861,6,0,6,0,1,1,0,0,1
04722107,38,8,30,0,0,0,0,0,1
04722278,13,3,10,0,1,1,0,1,1
04722634,11,5,6,0,1,1,0,1,0
04722674,13,0,13,0,0,0,0,0,1
04722680,4,2,2,0,2,2,0,0,0
04722702,11,4,7,0,2,1,1,1,1
04722758,4,0,4,0,0,0,0,0,1
04722808,13,0,13,0,0,0,0,0,1
04722877,6,3,3,0,1,1,0,0,0
04722898,5,1,4,0,1,1,0,1,0
04723034,5,2,3,0,1,1,0,0,0
04723103,6,2,4,0,1,1,0,0,0
04723252,5,2,3,0,2,1,1,0,1
04723365,5,1,4,0,1,1,0,1,0
04723839,28,6,22,0,1,1,0,1,1
04724243,10,0,10,0,1,1,0,1,1
04724493,9,3,6,0,1,1,0,0,0
04724772,19,5,14,0,1,1,0,1,1
04725091,22,7,15,0,2,2,0,0,1
04725240,5,0,5,0,0,0,0,0,1
04726115,28,6,22,0,0,0,0,0,0
04726204,4,2,2,0,2,2,0,0,0
04726360,24,2,22,0,2,2,0,2,1
04726394,4,2,2,0,1,1,0,0,0
04726639,39,14,25,0,1,0,1,0,1
04726666,16,3,13,0,1,1,0,1,1
04726788,9,0,9,0,0,0,0,0,1
04726837,17,4,13,0,1,1,0,1,1
04727161,10,7,3,0,1,1,0,0,1
04727372,5,3,2,0,2,2,0,0,0
04727465,4,3,1,0,0,0,0,0,0
04727690,48,8,40,0,0,0,0,0,1
04727693,5,2,3,0,1,1,0,0,1
04727861,7,3,4,0,2,2,0,0,0
04727874,29,9,20,0,0,0,0,0,1
04728026,5,1,4,0,2,1,1,0,0
04728146,16,5,11,0,0,0,0,0,1
04728148,16,0,16,0,0,0,0,0,1
04728150,6,4,2,0,1,1,0,0,1
04728774,4,2,2,0,1,1,0,0,1
04729266,63,14,49,0,0,0,0,0,1
04729321,7,0,7,0,0,0,0,0,1
04729410,12,5,7,0,1,1,0,1,1
04729494,8,2,6,0,1,1,0,1,1
04729498,8,0,8,0,1,1,0,1,1
04729499,8,0,8,0,1,1,0,1,1
04729593,3,2,1,0,1,1,0,0,0
04729737,5,0,5,0,0,0,0,0,0
04729760,21,4,17,0,1,1,0,1,1
04729800,42,10,32,0,0,0,0,0,1
04729859,9,3,6,0,1,1,0,1,1
04730530,5,0,5,0,0,0,0,0,1
04730543,4,2,2,0,1,1,0,0,0
04730740,8,2,6,0,1,1,0,0,1
04730882,25,0,25,0,0,0,0,0,1
04731234,12,2,10,0,1,0,1,1,1
04731343,28,8,20,0,1,1,0,0,1
04731536,22,0,22,0,0,0,0,0,1
04731822,14,0,14,0,0,0,0,0,1
04732003,21,3,18,0,0,0,0,0,1
04732063,12,0,12,0,0,0,0,0,1
04732286,15,0,15,0,0,0,0,0,1
04732392,7,0,7,0,0,0,0,0,1
04732444,7,1,6,0,1,1,0,0,1
04732566,11,0,11,0,0,0,0,0,1
04732764,6,3,3,0,2,2,0,0,0
04733475,12,3,9,0,6,1,5,0,0
04733479,29,0,29,0,1,1,0,1,1
04733935,8,4,4,0,4,2,2,1,0
04734379,10,0,10,0,0,0,0,0,0
04734422,6,2,4,0,3,1,2,0,1
04734592,34,15,19,0,0,0,0,0,1
04734618,18,4,14,0,0,0,0,0,0
04734624,4,2,2,0,1,1,0,0,0
04735033,2,2,0,0,2,2,0,0,0
04735295,5,1,4,0,0,0,0,0,1
04735446,8,2,6,0,0,0,0,0,1
04735716,5,3,2,0,2,2,0,0,1
04735891,5,3,2,0,2,2,0,0,0
04736251,5,3,2,0,2,2,0,0,0
04736319,32,7,25,0,1,1,0,0,0
04736430,16,3,13,0,1,1,0,1,1
04736466,15,4,11,0,1,1,0,1,1
04736489,12,3,9,0,0,0,0,0,0
04736566,23,0,23,0,0,0,0,0,0
04736639,32,9,23,0,1,1,0,1,1
04736751,41,11,30,0,0,0,0,0,1
04736776,14,4,10,0,0,0,0,0,0
04736787,22,3,19,0,1,1,0,1,1
04736903,20,3,17,0,2,1,1,2,1
04737100,5,3,2,0,2,2,0,0,0
04737491,8,0,8,0,0,0,0,0,1
04737734,4,1,3,0,1,1,0,0,1
04737882,8,3,5,0,2,2,0,0,1
04737956,14,2,12,0,2,1,1,0,1
04738057,37,9,28,0,0,0,0,0,1
04738098,21,6,15,0,0,0,0,0,0
04738105,10,2,8,0,0,0,0,0,1
04738167,6,1,5,0,1,1,0,0,0
04738237,5,2,3,0,1,1,0,0,0
04738406,17,8,9,0,1,1,0,0,0
04738932,5,2,3,0,1,1,0,0,0
04739080,17,0,17,0,0,0,0,0,1
04739205,6,2,4,0,1,1,0,0,0
04739237,5,3,2,0,2,2,0,0,0
04739247,5,0,5,0,0,0,0,0,1
04739683,3,1,2,0,1,1,0,0,1
04739754,7,2,5,0,1,1,0,0,1
04739908,6,2,4,0,1,1,0,0,0
04740273,5,3,2,0,2,2,0,0,0
04740289,6,3,3,0,1,1,0,0,1
04740334,5,2,3,0,1,1,0,0,0
04740371,8,3,5,0,4,2,2,0,1
04740401,19,0,19,0,0,0,0,0,1
04740407,5,0,5,0,0,0,0,0,1
04740553,101,19,82,0,0,0,0,0,1
04741524,7,1,6,0,2,1,1,1,1
04741583,31,10,21,0,0,0,0,0,1
04741637,9,0,9,0,0,0,0,0,1
04742072,5,3,2,0,2,2,0,0,0
04742317,5,3,2,0,1,1,0,0,0
04742451,18,4,14,0,2,2,0,1,1
04742505,13,3,10,0,0,0,0,0,1
04742906,23,0,23,0,0,0,0,0,1
04742914,12,3,9,0,1,1,0,0,1
04743106,5,1,4,1,1,1,0,1,0
04743602,99,16,83,0,1,1,0,1,1
04743753,8,0,8,0,0,0,0,0,1
04743833,5,2,3,0,1,1,0,0,0
04743955,4,2,2,0,1,1,0,0,1
04744160,3,2,1,0,0,0,0,0,0
04744692,6,0,6,0,0,0,0,0,1
04744791,19,0,19,0,0,0,0,0,1
04744815,4,2,2,0,2,2,0,0,0
04745717,18,4,14,0,1,1,0,1,1
04746186,5,0,5,0,0,0,0,0,1
04746877,5,1,4,0,1,1,0,0,0
04747359,12,1,11,0,1,1,0,1,1
04747651,4,2,2,0,1,1,0,0,0
04748264,6,3,3,0,2,1,1,2,0
04748497,7,1,6,0,1,1,0,0,1
04748656,4,2,2,0,1,1,0,0,1
04749030,36,11,25,0,1,1,0,1,1
04749394,13,0,13,0,0,0,0,0,1
04749627,10,4,6,0,1,1,0,0,1
04749705,4,2,2,0,1,1,0,0,0
04750144,5,2,3,0,2,2,0,0,0
04750292,10,6,4,0,0,0,0,0,1
04750371,17,3,14,0,1,1,0,1,1
04750372,8,0,8,0,0,0,0,0,1
04750373,8,0,8,0,0,0,0,0,1
04750376,17,0,17,0,0,0,0,0,1
04750688,16,7,9,0,2,2,0,0,1
04750697,6,2,4,0,3,1,2,1,1
04750737,7,3,4,0,0,0,0,0,1
04751303,16,0,16,0,0,0,0,0,1
04751559,3,3,0,0,2,2,0,0,0
04752037,11,1,10,0,0,0,0,0,1
04752424,3,2,1,0,0,0,0,0,0
04753081,4,0,4,0,0,0,0,0,1
04753249,12,4,8,0,0,0,0,0,0
04753552,3,1,2,0,1,1,0,0,0
04753755,11,5,6,0,2,2,0,1,1
04753931,9,0,9,0,2,2,0,2,1
04754197,18,0,18,0,0,0,0,0,0
04754248,4,1,3,0,1,1,0,0,1
04754332,8,2,6,0,1,1,0,0,0
04755080,5,2,3,0,1,1,0,0,1
04755140,31,5,26,0,0,0,0,0,1
04755254,5,1,4,0,1,1,0,0,0
04755383,7,0,7,0,1,1,0,0,0
04755625,10,3,7,0,1,1,0,1,1
04755814,21,2,19,0,1,1,0,1,1
04756179,7,2,5,0,4,2,2,0,1
04756274,5,3,2,0,2,2,0,0,0
04756742,12,2,10,0,1,1,0,0,1
04756765,18,0,18,0,1,1,0,0,1
04757301,25,7,18,0,1,1,0,1,1
04757833,13,6,7,0,0,0,0,0,1
04758033,5,3,2,0,2,2,0,0,0
04758041,5,3,2,0,2,2,0,0,0
04758449,7,4,3,0,1,1,0,0,0
04758915,35,9,26,0,0,0,0,0,1
04758927,11,4,7,0,3,1,2,0,0
04759588,41,9,32,0,0,0,0,0,0
04759650,8,1,7,0,1,1,0,1,1
04759686,5,3,2,0,2,2,0,0,0
04759797,5,0,5,0,0,0,0,0,1
04759878,8,3,5,0,2,2,0,0,1
04759881,10,2,8,0,3,3,0,1,1
04760749,5,2,3,0,1,1,0,0,0
04761892,5,1,4,0,1,1,0,0,0
04762076,6,4,2,0,3,3,0,0,0
04762223,4,0,4,0,0,0,0,0,1
04762392,6,2,4,0,1,1,0,0,0
04763064,21,7,14,0,1,1,0,1,0
04763144,3,2,1,0,1,1,0,0,0
04763647,5,1,4,0,1,1,0,0,0
04764026,29,6,23,0,0,0,0,0,0
04764232,66,13,53,0,0,0,0,0,1
04764487,6,3,3,0,1,1,0,0,0
04764488,4,3,1,0,0,0,0,0,1
04764875,4,3,1,0,2,2,0,0,0
04765447,12,0,12,0,0,0,0,0,1
04765516,27,7,20,0,1,0,1,0,1
04765754,3,2,1,0,2,2,0,0,1
04765791,48,10,38,0,2,2,0,2,0
04766099,14,3,11,0,1,1,0,1,1
04766391,8,0,8,0,0,0,0,0,1
04766958,5,0,5,0,0,0,0,0,0
04766961,13,3,10,0,1,1,0,1,0
04767683,6,0,6,0,0,0,0,0,0
04767846,7,3,4,0,2,2,0,0,0
IP22044R,0,0,0,0,0,0,0,0,0
IP22059R,0,0,0,0,0,0,0,0,0
IP22134R,0,0,0,0,0,0,0,0,0
IP22145R,0,0,0,0,0,0,0,0,0
IP22277R,0,0,0,0,0,0,0,0,0
IP22279R,0,0,0,0,0,0,0,0,0
IP22288R,0,0,0,0,0,0,0,0,0
IP22313R,0,0,0,0,0,0,0,0,0
IP22345R,0,0,0,0,0,0,0,0,0
IP22387R,0,0,0,0,0,0,0,0,0
IP22410R,0,0,0,0,0,0,0,0,0
IP22466R,0,0,0,0,0,0,0,0,0
IP22477R,0,0,0,0,0,0,0,0,0
IP22512R,0,0,0,0,0,0,0,0,0
IP22633R,0,0,0,0,0,0,0,0,0
IP2272RS,0,0,0,0,0,0,0,0,0
IP22846R,0,0,0,0,0,0,0,0,0
IP22878R,0,0,0,0,0,0,0,0,0
IP22879R,0,0,0,0,0,0,0,0,0
IP23002R,0,0,0,0,0,0,0,0,0
IP23091R,0,0,0,0,0,0,0,0,0
IP23122R,0,0,0,0,0,0,0,0,0
IP23151R,0,0,0,0,0,0,0,0,0
IP23158R,0,0,0,0,0,0,0,0,0
IP23171R,0,0,0,0,0,0,0,0,0
IP23187R,0,0,0,0,0,0,0,0,0
IP23242R,0,0,0,0,0,0,0,0,0
IP23330R,0,0,0,0,0,0,0,0,0
IP23378R,0,0,0,0,0,0,0,0,0
IP23489R,0,0,0,0,0,0,0,0,0
IP23491R,0,0,0,0,0,0,0,0,0
IP23676R,0,0,0,0,0,0,0,0,0
IP23680R,0,0,0,0,0,0,0,0,0
IP23691R,0,0,0,0,0,0,0,0,0
IP23738R,0,0,0,0,0,0,0,0,0
IP23794R,0,0,0,0,0,0,0,0,0
IP23813R,0,0,0,0,0,0,0,0,0
IP23815R,0,0,0,0,0,0,0,0,0
IP23823R,0,0,0,0,0,0,0,0,0
IP23915R,0,0,0,0,0,0,0,0,0
IP24046R,0,0,0,0,0,0,0,0,0
IP24086R,0,0,0,0,0,0,0,0,0
IP24489R,0,0,0,0,0,0,0,0,0
IP24493R,0,0,0,0,0,0,0,0,0
IP25333R,0,0,0,0,0,0,0,0,0
IP25375R,0,0,0,0,0,0,0,0,0
IP25465R,0,0,0,0,0,0,0,0,0
IP25481R,0,0,0,0,0,0,0,0,0
IP25490R,0,0,0,0,0,0,0,0,0
IP26040R,0,0,0,0,0,0,0,0,0
IP26055R,0,0,0,0,0,0,0,0,0
IP26095R,0,0,0,0,0,0,0,0,0
IP26345R,0,0,0,0,0,0,0,0,0
IP26379R,0,0,0,0,0,0,0,0,0
IP26469R,0,0,0,0,0,0,0,0,0
IP26833R,0,0,0,0,0,0,0,0,0
IP26838R,0,0,0,0,0,0,0,0,0
IP26992R,0,0,0,0,0,0,0,0,0
IP27063R,0,0,0,0,0,0,0,0,0
IP27073R,0,0,0,0,0,0,0,0,0
IP27080R,0,0,0,0,0,0,0,0,0
IP27117R,0,0,0,0,0,0,0,0,0
IP27231R,0,0,0,0,0,0,0,0,0
IP27328R,0,0,0,0,0,0,0,0,0
IP27362R,0,0,0,0,0,0,0,0,0
IP27385R,0,0,0,0,0,0,0,0,0
IP27452R,0,0,0,0,0,0,0,0,0
IP27456R,0,0,0,0,0,0,0,0,0
IP27459R,0,0,0,0,0,0,0,0,0
IP27643R,0,0,0,0,0,0,0,0,0
IP27652R,0,0,0,0,0,0,0,0,0
IP27663R,0,0,0,0,0,0,0,0,0
IP27669R,0,0,0,0,0,0,0,0,0
IP27682R,0,0,0,0,0,0,0,0,0
IP27771R,0,0,0,0,0,0,0,0,0
IP27827R,0,0,0,0,0,0,0,0,0
IP27854R,0,0,0,0,0,0,0,0,0
IP27856R,0,0,0,0,0,0,0,0,0
IP27866R,0,0,0,0,0,0,0,0,0
IP27877R,0,0,0,0,0,0,0,0,0
IP27937R,0,0,0,0,0,0,0,0,0
IP28008R,0,0,0,0,0,0,0,0,0
IP28016R,0,0,0,0,0,0,0,0,0
IP28032R,0,0,0,0,0,0,0,0,0
IP28042R,0,0,0,0,0,0,0,0,0
IP28055R,0,0,0,0,0,0,0,0,0
IP28102R,0,0,0,0,0,0,0,0,0
IP28108R,0,0,0,0,0,0,0,0,0
IP28164R,0,0,0,0,0,0,0,0,0
IP28202R,0,0,0,0,0,0,0,0,0
IP28206R,0,0,0,0,0,0,0,0,0
IP28265R,0,0,0,0,0,0,0,0,0
IP28268R,0,0,0,0,0,0,0,0,0
IP28293R,0,0,0,0,0,0,0,0,0
IP28355R,0,0,0,0,0,0,0,0,0
IP28365R,0,0,0,0,0,0,0,0,0
IP28383R,0,0,0,0,0,0,0,0,0
IP28386R,0,0,0,0,0,0,0,0,0
IP28448R,0,0,0,0,0,0,0,0,0
IP28508R,0,0,0,0,0,0,0,0,0
IP28512R,0,0,0,0,0,0,0,0,0
IP28659R,0,0,0,0,0,0,0,0,0
IP28666R,0,0,0,0,0,0,0,0,0
IP28688R,0,0,0,0,0,0,0,0,0
IP28712R,0,0,0,0,0,0,0,0,0
IP28798R,0,0,0,0,0,0,0,0,0
IP28799R,0,0,0,0,0,0,0,0,0
IP28805R,0,0,0,0,0,0,0,0,0
IP28828R,0,0,0,0,0,0,0,0,0
IP28832R,0,0,0,0,0,0,0,0,0
IP28854R,0,0,0,0,0,0,0,0,0
IP28857R,0,0,0,0,0,0,0,0,0
IP28898R,0,0,0,0,0,0,0,0,0
IP28917R,0,0,0,0,0,0,0,0,0
IP29006R,0,0,0,0,0,0,0,0,0
IP29014R,0,0,0,0,0,0,0,0,0
IP29037R,0,0,0,0,0,0,0,0,0
IP29041R,0,0,0,0,0,0,0,0,0
IP29132R,0,0,0,0,0,0,0,0,0
IP29152R,0,0,0,0,0,0,0,0,0
IP29178R,0,0,0,0,0,0,0,0,0
IP29214R,0,0,0,0,0,0,0,0,0
IP29218R,0,0,0,0,0,0,0,0,0
IP29220R,0,0,0,0,0,0,0,0,0
IP29244R,0,0,0,0,0,0,0,0,0
IP29246R,0,0,0,0,0,0,0,0,0
IP29256R,0,0,0,0,0,0,0,0,0
IP29275R,0,0,0,0,0,0,0,0,0
IP29287R,0,0,0,0,0,0,0,0,0
IP29293R,0,0,0,0,0,0,0,0,0
IP29299R,0,0,0,0,0,0,0,0,0
IP29322R,0,0,0,0,0,0,0,0,0
IP29327R,0,0,0,0,0,0,0,0,0
IP29343R,0,0,0,0,0,0,0,0,0
IP29347R,0,0,0,0,0,0,0,0,0
IP29348R,0,0,0,0,0,0,0,0,0
IP29384R,0,0,0,0,0,0,0,0,0
IP29394R,0,0,0,0,0,0,0,0,0
IP29415R,0,0,0,0,0,0,0,0,0
IP29418R,0,0,0,0,0,0,0,0,0
IP29434R,0,0,0,0,0,0,0,0,0
IP29469R,0,0,0,0,0,0,0,0,0
IP29473R,0,0,0,0,0,0,0,0,0
IP29490R,0,0,0,0,0,0,0,0,0
IP29523R,0,0,0,0,0,0,0,0,0
IP29560R,0,0,0,0,0,0,0,0,0
IP29572R,0,0,0,0,0,0,0,0,0
IP29597R,0,0,0,0,0,0,0,0,0
IP29604R,0,0,0,0,0,0,0,0,0
IP29672R,0,0,0,0,0,0,0,0,0
IP29677R,0,0,0,0,0,0,0,0,0
IP29689R,0,0,0,0,0,0,0,0,0
IP29719R,0,0,0,0,0,0,0,0,0
IP29739R,0,0,0,0,0,0,0,0,0
IP29755R,0,0,0,0,0,0,0,0,0
IP29800R,0,0,0,0,0,0,0,0,0
IP29859R,0,0,0,0,0,0,0,0,0
IP29892R,0,0,0,0,0,0,0,0,0
IP29914R,0,0,0,0,0,0,0,0,0
IP29966R,0,0,0,0,0,0,0,0,0
IP30034R,0,0,0,0,0,0,0,0,0
IP30046R,0,0,0,0,0,0,0,0,0
IP30074R,0,0,0,0,0,0,0,0,0
IP30076R,0,0,0,0,0,0,0,0,0
IP30095R,0,0,0,0,0,0,0,0,0
IP30106R,0,0,0,0,0,0,0,0,0
IP30123R,0,0,0,0,0,0,0,0,0
IP30155R,0,0,0,0,0,0,0,0,0
IP30157R,0,0,0,0,0,0,0,0,0
IP30160R,0,0,0,0,0,0,0,0,0
IP30223R,0,0,0,0,0,0,0,0,0
IP30231R,0,0,0,0,0,0,0,0,0
IP30258R,0,0,0,0,0,0,0,0,0
IP30302R,0,0,0,0,0,0,0,0,0
IP30316R,0,0,0,0,0,0,0,0,0
IP30318R,0,0,0,0,0,0,0,0,0
IP30322R,0,0,0,0,0,0,0,0,0
IP30325R,0,0,0,0,0,0,0,0,0
IP30409R,0,0,0,0,0,0,0,0,0
LP002510,0,0,0,0,0,0,0,0,0
LP002762,0,0,0,0,0,0,0,0,0
LP002801,0,0,0,0,0,0,0,0,0
LP003148,0,0,0,0,0,0,0,0,0
LP003386,0,0,0,0,0,0,0,0,0
LP003538,0,0,0,0,0,0,0,0,0
LP003545,0,0,0,0,0,0,0,0,0
LP003836,0,0,0,0,0,0,0,0,0
LP003931,0,0,0,0,0,0,0,0,0
LP004086,0,0,0,0,0,0,0,0,0
LP004352,0,0,0,0,0,0,0,0,0
LP004561,0,0,0,0,0,0,0,0,0
LP004574,0,0,0,0,0,0,0,0,0
LP004724,0,0,0,0,0,0,0,0,0
LP004851,0,0,0,0,0,0,0,0,0
LP004888,0,0,0,0,0,0,0,0,0
LP004910,0,0,0,0,0,0,0,0,0
LP004963,0,0,0,0,0,0,0,0,0
LP005206,0,0,0,0,0,0,0,0,0
LP005415,0,0,0,0,0,0,0,0,0
LP005539,0,0,0,0,0,0,0,0,0
LP005584,0,0,0,0,0,0,0,0,0
LP005947,0,0,0,0,0,0,0,0,0
LP006198,0,0,0,0,0,0,0,0,0
LP006651,0,0,0,0,0,0,0,0,0
LP006953,0,0,0,0,0,0,0,0,0
LP007808,0,0,0,0,0,0,0,0,0
LP007815,0,0,0,0,0,0,0,0,0
LP007953,0,0,0,0,0,0,0,0,0
LP008324,0,0,0,0,0,0,0,0,0
LP008668,0,0,0,0,0,0,0,0,0
LP008804,0,0,0,0,0,0,0,0,0
LP009314,0,0,0,0,0,0,0,0,0
LP009330,0,0,0,0,0,0,0,0,0
LP009383,0,0,0,0,0,0,0,0,0
LP009558,0,0,0,0,0,0,0,0,0
LP009570,0,0,0,0,0,0,0,0,0
LP010555,0,0,0,0,0,0,0,0,0
LP010616,0,0,0,0,0,0,0,0,0
LP010996,0,0,0,0,0,0,0,0,0
LP011539,0,0,0,0,0,0,0,0,0
LP011627,0,0,0,0,0,0,0,0,0
LP011800,0,0,0,0,0,0,0,0,0
LP012966,0,0,0,0,0,0,0,0,0
LP013254,0,0,0,0,0,0,0,0,0
LP013312,0,0,0,0,0,0,0,0,0
LP013525,0,0,0,0,0,0,0,0,0
LP013657,0,0,0,0,0,0,0,0,0
LP013863,0,0,0,0,0,0,0,0,0
LP013884,0,0,0,0,0,0,0,0,0
LP014214,0,0,0,0,0,0,0,0,0
LP014287,0,0,0,0,0,0,0,0,0
LP014401,0,0,0,0,0,0,0,0,0
LP014467,0,0,0,0,0,0,0,0,0
LP014587,0,0,0,0,0,0,0,0,0
LP015152,0,0,0,0,0,0,0,0,0
LP015372,0,0,0,0,0,0,0,0,0
LP015382,0,0,0,0,0,0,0,0,0
LP015528,0,0,0,0,0,0,0,0,0
LP015594,0,0,0,0,0,0,0,0,0
LP015667,0,0,0,0,0,0,0,0,0
LP015717,0,0,0,0,0,0,0,0,0
LP016040,0,0,0,0,0,0,0,0,0
LP016175,0,0,0,0,0,0,0,0,0
LP016622,0,0,0,0,0,0,0,0,0
LP017469,0,0,0,0,0,0,0,0,0
LP018019,0,0,0,0,0,0,0,0,0
LP018032,0,0,0,0,0,0,0,0,0
LP018468,0,0,0,0,0,0,0,0,0
LP018499,0,0,0,0,0,0,0,0,0
LP018782,0,0,0,0,0,0,0,0,0
LP018841,0,0,0,0,0,0,0,0,0
LP019091,0,0,0,0,0,0,0,0,0
LP019284,0,0,0,0,0,0,0,0,0
LP019700,0,0,0,0,0,0,0,0,0
LP019758,0,0,0,0,0,0,0,0,0
LP019861,0,0,0,0,0,0,0,0,0
LP019872,0,0,0,0,0,0,0,0,0
LP020016,0,0,0,0,0,0,0,0,0
CE007017,0,0,0,0,0,0,0,0,0
CE007057,0,0,0,0,0,0,0,0,0
CE007060,0,0,0,0,0,0,0,0,0
CE007106,0,0,0,0,0,0,0,0,0
CE007112,0,0,0,0,0,0,0,0,0
CE007279,0,0,0,0,0,0,0,0,0
CE007290,0,0,0,0,0,0,0,0,0
CE007321,0,0,0,0,0,0,0,0,0
CE007325,0,0,0,0,0,0,0,0,0
CE007339,0,0,0,0,0,0,0,0,0
CE007353,0,0,0,0,0,0,0,0,0
CE007369,0,0,0,0,0,0,0,0,0
CE007371,0,0,0,0,0,0,0,0,0
CE007385,0,0,0,0,0,0,0,0,0
CE007389,0,0,0,0,0,0,0,0,0
CE007393,0,0,0,0,0,0,0,0,0
CE007403,0,0,0,0,0,0,0,0,0
CE007404,0,0,0,0,0,0,0,0,0
CE007478,0,0,0,0,0,0,0,0,0
CE007552,0,0,0,0,0,0,0,0,0
CE007566,0,0,0,0,0,0,0,0,0
CE007674,0,0,0,0,0,0,0,0,0
CE007680,0,0,0,0,0,0,0,0,0
CE007712,0,0,0,0,0,0,0,0,0
CE007742,0,0,0,0,0,0,0,0,0
CE007745,0,0,0,0,0,0,0,0,0
CE007751,0,0,0,0,0,0,0,0,0
CE007758,0,0,0,0,0,0,0,0,0
CE007762,0,0,0,0,0,0,0,0,0
CE007856,0,0,0,0,0,0,0,0,0
CE007886,0,0,0,0,0,0,0,0,0
CE007902,0,0,0,0,0,0,0,0,0
CE007928,0,0,0,0,0,0,0,0,0
CE007929,0,0,0,0,0,0,0,0,0
CE007960,0,0,0,0,0,0,0,0,0
CE007988,0,0,0,0,0,0,0,0,0
CE008016,0,0,0,0,0,0,0,0,0
CE008018,0,0,0,0,0,0,0,0,0
CE008068,0,0,0,0,0,0,0,0,0
CE008078,0,0,0,0,0,0,0,0,0
CE008090,0,0,0,0,0,0,0,0,0
CE008096,0,0,0,0,0,0,0,0,0
CE008137,0,0,0,0,0,0,0,0,0
CE008147,0,0,0,0,0,0,0,0,0
CE008148,0,0,0,0,0,0,0,0,0
CE008171,0,0,0,0,0,0,0,0,0
CE008237,0,0,0,0,0,0,0,0,0
CE008299,0,0,0,0,0,0,0,0,0
CE008304,0,0,0,0,0,0,0,0,0
CE008320,0,0,0,0,0,0,0,0,0
CE008335,0,0,0,0,0,0,0,0,0
CE008364,0,0,0,0,0,0,0,0,0
CE008382,0,0,0,0,0,0,0,0,0
CE008388,0,0,0,0,0,0,0,0,0
CE008391,0,0,0,0,0,0,0,0,0
CE008464,0,0,0,0,0,0,0,0,0
CE008501,0,0,0,0,0,0,0,0,0
CE008538,0,0,0,0,0,0,0,0,0
CE008556,0,0,0,0,0,0,0,0,0
CE008560,0,0,0,0,0,0,0,0,0
CE008577,0,0,0,0,0,0,0,0,0
CE008584,0,0,0,0,0,0,0,0,0
CE008600,0,0,0,0,0,0,0,0,0
CE008615,0,0,0,0,0,0,0,0,0
CE008617,0,0,0,0,0,0,0,0,0
CE008632,0,0,0,0,0,0,0,0,0
CE008644,0,0,0,0,0,0,0,0,0
CE008645,0,0,0,0,0,0,0,0,0
CE008648,0,0,0,0,0,0,0,0,0
CE008670,0,0,0,0,0,0,0,0,0
CE008686,0,0,0,0,0,0,0,0,0
CE008710,0,0,0,0,0,0,0,0,0
CE008736,0,0,0,0,0,0,0,0,0
CE008755,0,0,0,0,0,0,0,0,0
CE008772,0,0,0,0,0,0,0,0,0
CE008787,0,0,0,0,0,0,0,0,0
CE008798,0,0,0,0,0,0,0,0,0
CE008814,0,0,0,0,0,0,0,0,0
CE008819,0,0,0,0,0,0,0,0,0
CE008838,0,0,0,0,0,0,0,0,0
CE008882,0,0,0,0,0,0,0,0,0
CE008907,0,0,0,0,0,0,0,0,0
CE008962,0,0,0,0,0,0,0,0,0
CE008980,0,0,0,0,0,0,0,0,0
CE009000,0,0,0,0,0,0,0,0,0
CE009009,0,0,0,0,0,0,0,0,0
CE009043,0,0,0,0,0,0,0,0,0
CE009110,0,0,0,0,0,0,0,0,0
CE009139,0,0,0,0,0,0,0,0,0
CE009182,0,0,0,0,0,0,0,0,0
CE009201,0,0,0,0,0,0,0,0,0
CE009210,0,0,0,0,0,0,0,0,0
CE009217,0,0,0,0,0,0,0,0,0
CE009219,0,0,0,0,0,0,0,0,0
CE009224,0,0,0,0,0,0,0,0,0
CE009298,0,0,0,0,0,0,0,0,0
CE009301,0,0,0,0,0,0,0,0,0
CE009305,0,0,0,0,0,0,0,0,0
CE009315,0,0,0,0,0,0,0,0,0
CE009333,0,0,0,0,0,0,0,0,0
CE009343,0,0,0,0,0,0,0,0,0
CE009348,0,0,0,0,0,0,0,0,0
CE009391,0,0,0,0,0,0,0,0,0
CE009419,0,0,0,0,0,0,0,0,0
CE009454,0,0,0,0,0,0,0,0,0
CE009498,0,0,0,0,0,0,0,0,0
CE009531,0,0,0,0,0,0,0,0,0
CE009538,0,0,0,0,0,0,0,0,0
CE009548,0,0,0,0,0,0,0,0,0
CE009575,0,0,0,0,0,0,0,0,0
CE009577,0,0,0,0,0,0,0,0,0
CE009606,0,0,0,0,0,0,0,0,0
CE009611,0,0,0,0,0,0,0,0,0
CE009616,0,0,0,0,0,0,0,0,0
CE009632,0,0,0,0,0,0,0,0,0
CE009668,0,0,0,0,0,0,0,0,0
CE009674,0,0,0,0,0,0,0,0,0
CE009699,0,0,0,0,0,0,0,0,0
CE009705,0,0,0,0,0,0,0,0,0
CE009707,0,0,0,0,0,0,0,0,0
CE009721,0,0,0,0,0,0,0,0,0
CE009741,0,0,0,0,0,0,0,0,0
CE009746,0,0,0,0,0,0,0,0,0
CE009749,0,0,0,0,0,0,0,0,0
CE009775,0,0,0,0,0,0,0,0,0
CE009784,0,0,0,0,0,0,0,0,0
CE009818,0,0,0,0,0,0,0,0,0
CE009821,0,0,0,0,0,0,0,0,0
CE009833,0,0,0,0,0,0,0,0,0
CE009852,0,0,0,0,0,0,0,0,0
CE009861,0,0,0,0,0,0,0,0,0
CE009871,0,0,0,0,0,0,0,0,0
CE009910,0,0,0,0,0,0,0,0,0
CE009924,0,0,0,0,0,0,0,0,0
CE009932,0,0,0,0,0,0,0,0,0
CE009937,0,0,0,0,0,0,0,0,0
CE009942,0,0,0,0,0,0,0,0,0
CE009961,0,0,0,0,0,0,0,0,0
CE009985,0,0,0,0,0,0,0,0,0
CE010002,0,0,0,0,0,0,0,0,0
CE010026,0,0,0,0,0,0,0,0,0
CE010031,0,0,0,0,0,0,0,0,0
CE010087,0,0,0,0,0,0,0,0,0
CE010098,0,0,0,0,0,0,0,0,0
CE010125,0,0,0,0,0,0,0,0,0
CE010176,0,0,0,0,0,0,0,0,0
CE010229,0,0,0,0,0,0,0,0,0
CE010231,0,0,0,0,0,0,0,0,0
CE010261,0,0,0,0,0,0,0,0,0
CE010284,0,0,0,0,0,0,0,0,0
CE010313,0,0,0,0,0,0,0,0,0
CE010328,0,0,0,0,0,0,0,0,0
CE010348,0,0,0,0,0,0,0,0,0
CE010379,0,0,0,0,0,0,0,0,0
CE010409,0,0,0,0,0,0,0,0,0
CE010412,0,0,0,0,0,0,0,0,0
CE010450,0,0,0,0,0,0,0,0,0
CE010496,0,0,0,0,0,0,0,0,0
CE010510,0,0,0,0,0,0,0,0,0
CE010547,0,0,0,0,0,0,0,0,0
CE010578,0,0,0,0,0,0,0,0,0
CE010579,0,0,0,0,0,0,0,0,0
CE010696,0,0,0,0,0,0,0,0,0
CE010703,0,0,0,0,0,0,0,0,0
CE010728,0,0,0,0,0,0,0,0,0
CE010734,0,0,0,0,0,0,0,0,0
CE010752,0,0,0,0,0,0,0,0,0
CE010825,0,0,0,0,0,0,0,0,0
CE010858,0,0,0,0,0,0,0,0,0
CE010882,0,0,0,0,0,0,0,0,0
CE010918,0,0,0,0,0,0,0,0,0
CE010977,0,0,0,0,0,0,0,0,0
CE010979,0,0,0,0,0,0,0,0,0
CE010981,0,0,0,0,0,0,0,0,0
CE011007,0,0,0,0,0,0,0,0,0
CE011016,0,0,0,0,0,0,0,0,0
CE011069,0,0,0,0,0,0,0,0,0
CE011078,0,0,0,0,0,0,0,0,0
CE011100,0,0,0,0,0,0,0,0,0
CE011113,0,0,0,0,0,0,0,0,0
CE011139,0,0,0,0,0,0,0,0,0
CE011162,0,0,0,0,0,0,0,0,0
CE011188,0,0,0,0,0,0,0,0,0
CE011243,0,0,0,0,0,0,0,0,0
CE011250,0,0,0,0,0,0,0,0,0
CE011262,0,0,0,0,0,0,0,0,0
CE011269,0,0,0,0,0,0,0,0,0
CE011279,0,0,0,0,0,0,0,0,0
CE011286,0,0,0,0,0,0,0,0,0
CE011316,0,0,0,0,0,0,0,0,0
CE011319,0,0,0,0,0,0,0,0,0
CE011342,0,0,0,0,0,0,0,0,0
CE011346,0,0,0,0,0,0,0,0,0
CE011351,0,0,0,0,0,0,0,0,0
CE011362,0,0,0,0,0,0,0,0,0
CE011381,0,0,0,0,0,0,0,0,0
CE011384,0,0,0,0,0,0,0,0,0
CE011389,0,0,0,0,0,0,0,0,0
CE011445,0,0,0,0,0,0,0,0,0
CE011458,0,0,0,0,0,0,0,0,0
CE011463,0,0,0,0,0,0,0,0,0
CE011469,0,0,0,0,0,0,0,0,0
CE011476,0,0,0,0,0,0,0,0,0
CE011477,0,0,0,0,0,0,0,0,0
CE011500,0,0,0,0,0,0,0,0,0
CE011510,0,0,0,0,0,0,0,0,0
CE011520,0,0,0,0,0,0,0,0,0
CE011522,0,0,0,0,0,0,0,0,0
CE011526,0,0,0,0,0,0,0,0,0
CE011560,0,0,0,0,0,0,0,0,0
CE011566,0,0,0,0,0,0,0,0,0
CE011577,0,0,0,0,0,0,0,0,0
CE011589,0,0,0,0,0,0,0,0,0
CE011650,0,0,0,0,0,0,0,0,0
CE011676,0,0,0,0,0,0,0,0,0
CE011708,0,0,0,0,0,0,0,0,0
CE011717,0,0,0,0,0,0,0,0,0
CE011729,0,0,0,0,0,0,0,0,0
CE011732,0,0,0,0,0,0,0,0,0
CE011742,0,0,0,0,0,0,0,0,0
CE011755,0,0,0,0,0,0,0,0,0
CE011757,0,0,0,0,0,0,0,0,0
CE011818,0,0,0,0,0,0,0,0,0
CE011820,0,0,0,0,0,0,0,0,0
CE011823,0,0,0,0,0,0,0,0,0
CE011825,0,0,0,0,0,0,0,0,0
CE011839,0,0,0,0,0,0,0,0,0
CE011906,0,0,0,0,0,0,0,0,0
CE011912,0,0,0,0,0,0,0,0,0
CE011945,0,0,0,0,0,0,0,0,0
CE011951,0,0,0,0,0,0,0,0,0
CE011968,0,0,0,0,0,0,0,0,0
CE011969,0,0,0,0,0,0,0,0,0
CE011978,0,0,0,0,0,0,0,0,0
CE011994,0,0,0,0,0,0,0,0,0
CE011998,0,0,0,0,0,0,0,0,0
SC480041,2,0,2,0,1,1,0,0,0
SC480127,1,0,1,0,0,0,0,0,0
SC480181,1,0,1,0,0,0,0,0,0
SC480214,4,2,2,0,1,1,0,0,0
SC480395,1,0,1,0,0,0,0,0,0
SC480452,3,3,0,0,2,2,0,0,1
SC480472,4,0,4,0,0,0,0,0,1
SC480712,3,3,0,0,2,2,0,0,0
SC480843,3,2,1,0,1,1,0,0,1
SC481291,4,2,2,0,1,1,0,1,1
SC481338,3,2,1,0,2,2,0,0,0
SC481387,4,2,2,0,2,1,1,0,0
SC481479,3,2,1,0,4,2,2,0,0
SC481544,8,4,4,0,1,0,1,0,1
SC481744,2,0,2,0,0,0,0,0,0
SC481791,2,1,1,0,1,1,0,0,0
SC481796,1,0,1,0,0,0,0,0,0
SC481919,4,2,2,0,3,2,1,0,0
SC481943,1,1,0,0,1,1,0,0,0
SC482238,5,5,0,0,4,4,0,0,1
SC482252,1,0,1,0,0,0,0,0,0
SC482726,1,1,0,0,1,1,0,1,0
SC482793,2,2,0,0,1,1,0,0,0
SC482875,2,0,2,0,2,2,0,0,0
SC483046,16,8,8,0,1,1,0,1,0
SC483352,2,2,0,0,2,2,0,0,0
SC483362,2,2,0,0,1,1,0,0,0
SC483446,2,2,0,0,2,2,0,0,0
SC483484,13,10,3,0,2,2,0,0,1
SC483496,1,0,1,0,1,1,0,0,0
SC483549,2,0,2,0,2,2,0,0,0
SC483608,1,0,1,0,0,0,0,0,0
SC483627,2,2,0,0,2,2,0,0,0
SC483672,1,1,0,0,1,1,0,0,0
SC483676,2,2,0,0,2,2,0,0,0
SC483792,1,0,1,0,0,0,0,0,1
SC483828,4,2,2,0,3,2,1,0,0
SC483869,20,11,9,0,1,1,0,1,1
SC483933,2,0,2,0,1,1,0,0,0
SC484064,7,3,4,0,1,1,0,1,1
SC484160,5,4,1,0,2,1,1,1,1
SC484191,1,1,0,0,1,1,0,0,0
SC484400,16,8,8,0,1,1,0,1,0
SC484479,1,1,0,0,2,2,0,0,0
SC484608,2,2,0,0,2,2,0,0,0
SC484957,2,2,0,0,2,2,0,0,1
SC484968,2,2,0,0,1,1,0,0,0
SC485118,2,2,0,0,2,2,0,0,1
SC485593,4,4,0,0,2,2,0,0,1
SC485726,21,8,13,0,0,0,0,0,1
SC486063,3,3,0,0,2,2,0,0,0
SC486188,1,1,0,0,1,1,0,0,1
SC486262,2,0,2,0,0,0,0,0,0
SC486374,2,2,0,0,2,2,0,0,0
SC486460,1,0,1,0,0,0,0,0,0
SC486507,4,0,4,0,1,1,0,0,0
SC486582,6,4,2,0,1,1,0,1,1
SC487110,1,1,0,0,1,1,0,0,0
SC487164,4,0,4,0,0,0,0,0,0
SC487166,2,2,0,0,1,1,0,0,0
SC487281,3,2,1,0,1,1,0,0,1
SC487316,4,4,0,0,1,1,0,1,1
SC487324,1,0,1,0,0,0,0,0,0
SC487609,12,7,5,0,0,0,0,0,0
SC487739,2,0,2,0,1,1,0,0,0
SC487870,1,0,1,0,1,1,0,0,0
SC487941,3,1,2,0,2,2,0,0,0
SC488309,9,3,6,0,3,1,2,2,0
SC488368,3,3,0,0,2,2,0,0,0
SC488699,2,2,0,0,1,1,0,0,0
SC488882,1,0,1,0,0,0,0,0,0
SC489164,3,0,3,0,0,0,0,0,1
SC489172,5,3,2,0,3,2,1,0,0
SC489175,2,2,0,0,2,2,0,0,1
SC489194,2,1,1,0,2,1,1,0,1
SC489210,1,1,0,0,1,1,0,0,0
SC489364,3,2,1,0,1,1,0,1,0
SC489402,1,1,0,0,1,1,0,0,0
SC489572,3,3,0,0,2,2,0,0,0
SC489595,4,3,1,0,1,1,0,1,1
SC489602,1,1,0,0,1,1,0,0,0
SC489706,2,0,2,0,1,1,0,0,1
SC490048,9,2,7,0,0,0,0,0,0
SC490052,2,0,2,0,0,0,0,0,1
SC490053,5,2,3,0,1,1,0,0,1
SC490850,2,2,0,0,2,2,0,0,0
SC490930,3,0,3,0,0,0,0,0,0
SC491012,19,5,14,0,0,0,0,0,0
SC491148,3,2,1,0,2,2,0,0,1
SC491174,1,0,1,0,1,1,0,0,0
SC491233,1,0,1,0,2,1,1,0,0
SC491349,2,2,0,0,2,2,0,0,1
SC491432,1,0,1,0,0,0,0,0,0
SC491456,2,1,1,0,1,1,0,0,0
SC491674,3,0,3,1,0,0,0,0,1
SC491878,2,2,0,0,1,1,0,0,0
SC491898,4,1,3,0,1,1,0,1,1
SC491983,6,4,2,0,0,0,0,0,0
SC492001,5,2,3,0,4,2,2,0,1
SC492006,4,0,4,0,4,3,1,0,1
SC492662,1,1,0,0,1,1,0,0,0
SC492752,2,0,2,0,0,0,0,0,1
SC492795,2,2,0,0,2,2,0,0,1
SC492879,3,0,3,0,0,0,0,0,0
SC492892,5,2,3,0,2,1,1,1,0
SC492896,2,2,0,0,1,1,0,0,0
SC492945,2,0,2,0,0,0,0,0,0
SC493420,22,9,13,0,0,0,0,0,1
SC493436,1,1,0,0,1,1,0,0,0
SC493501,11,6,5,0,1,1,0,1,1
SC493516,3,2,1,0,1,1,0,1,1
SC493535,6,5,1,0,1,1,0,0,1
SC493682,1,1,0,0,1,1,0,0,0
SC493684,1,1,0,0,1,1,0,0,0
SC493774,22,9,13,0,0,0,0,0,1
SC493823,3,3,0,0,1,1,0,1,1
SC493884,5,5,0,0,2,1,1,0,1
SC493926,3,0,3,1,0,0,0,0,1
SC493937,3,0,3,1,0,0,0,0,1
SC493971,18,6,12,0,0,0,0,0,0
SC494118,2,0,2,0,1,1,0,0,0
SC494173,1,0,1,0,1,1,0,0,0
SC494326,2,2,0,0,2,2,0,0,0
SC494438,2,2,0,0,2,2,0,0,0
SC494466,1,0,1,0,0,0,0,0,0
SC494627,1,0,1,0,1,1,0,0,1
SC494629,2,1,1,0,2,1,1,0,1
SC494642,1,0,1,0,0,0,0,0,0
SC494656,1,0,1,0,1,1,0,0,0
SC494775,2,2,0,0,2,2,0,0,0
SC494838,1,1,0,0,1,1,0,0,0
SC494896,6,4,2,0,2,2,0,0,0
SC495108,3,2,1,0,1,1,0,0,0
SC495377,1,0,1,0,0,0,0,0,0
SC495874,3,0,3,0,0,0,0,0,0
SC495997,2,2,0,0,1,1,0,0,1
SC496181,6,4,2,0,4,3,1,1,1
SC496220,1,0,1,0,0,0,0,0,0
SC496532,7,4,3,0,1,1,0,0,1
SC496553,2,2,0,0,2,2,0,0,0
SC496577,2,2,0,0,0,0,0,0,1
SC497043,6,4,2,0,1,1,0,1,1
SC497086,1,1,0,0,1,1,0,0,0
SC497267,2,1,1,0,0,0,0,0,0
SC497454,2,2,0,0,2,2,0,0,0
SC497457,1,1,0,0,1,1,0,0,1
SC497591,4,4,0,0,1,1,0,0,0
SC498283,1,0,1,0,0,0,0,0,0
SC498407,3,0,3,0,0,0,0,0,0
SC498411,3,3,0,0,1,1,0,0,0
SC498513,1,1,0,0,1,1,0,0,0
SC498542,2,0,2,0,0,0,0,0,1
SC498581,2,2,0,0,2,2,0,0,1
SC498582,3,0,3,0,0,0,0,0,0
SC498800,1,1,0,0,1,1,0,0,0
SC498897,2,2,0,0,2,2,0,0,0
SC499460,2,0,2,0,0,0,0,0,0
SC499564,3,3,0,0,1,1,0,0,1
SC499607,2,2,0,0,1,1,0,0,0
SC499651,1,0,1,0,0,0,0,0,0
SC499672,3,2,1,0,1,1,0,0,0
SC500074,6,4,2,0,1,1,0,1,1
SC500098,3,2,1,0,2,2,0,0,0
SC500555,2,2,0,0,1,1,0,0,1
SC500710,22,12,10,0,0,0,0,0,1
SC500769,1,1,0,0,1,1,0,0,0
SC500916,1,1,0,0,1,1,0,0,0
SC501098,2,2,0,0,1,1,0,0,0
SC501155,1,1,0,0,1,1,0,0,0
SC501232,2,2,0,0,2,2,0,0,1
SC501351,2,2,0,0,1,1,0,0,1
SC501519,1,1,0,0,2,2,0,0,0
SC501964,2,0,2,0,1,1,0,1,0
SC502326,1,1,0,0,1,1,0,0,0
SC502698,8,7,1,1,2,2,0,1,1
SC502732,2,0,2,0,2,2,0,0,0
SC502878,3,0,3,0,0,0,0,0,1
SC502945,2,1,1,0,1,1,0,0,0
SC502987,1,0,1,0,0,0,0,0,0
SC503199,1,1,0,0,1,1,0,0,0
SC503736,1,0,1,0,0,0,0,0,0
SC504259,2,0,2,0,1,1,0,0,0
SC504433,8,7,1,0,2,2,0,1,1
SC504497,1,0,1,0,0,0,0,0,0
SC504508,2,2,0,0,1,1,0,0,1
SC504512,4,0,4,0,0,0,0,0,0
SC504557,4,4,0,0,4,4,0,0,0
SC505023,1,0,1,0,0,0,0,0,1
SC505093,5,4,1,0,1,1,0,1,1
SC505430,2,0,2,0,1,1,0,0,0
SC505533,7,0,7,0,0,0,0,0,1
SC506006,2,2,0,0,1,1,0,0,0
SC506012,17,8,9,0,1,1,0,1,0
SC506019,17,8,9,0,1,1,0,1,0
SC506493,2,2,0,0,1,1,0,0,1
SC506626,9,8,1,0,0,0,0,0,1
SC506701,8,5,3,0,3,3,0,0,0
SC507098,7,0,7,0,0,0,0,0,0
SC507181,9,3,6,0,1,1,0,0,1
SC507227,2,2,0,0,1,1,0,0,1
SC507654,1,1,0,0,1,1,0,1,0
SC507868,1,0,1,0,0,0,0,0,0
SC508017,2,2,0,0,1,1,0,0,0
SC508139,1,1,0,0,1,1,0,0,0
SC508237,1,0,1,0,0,0,0,0,0
SC508669,3,0,3,0,0,0,0,0,1
SC508671,3,0,3,0,0,0,0,0,1
SC508677,3,0,3,0,0,0,0,0,1
SC508678,3,0,3,0,0,0,0,0,1
SC508680,3,0,3,0,0,0,0,0,1
SC508682,3,0,3,0,0,0,0,0,1
SC508753,1,1,0,0,1,1,0,0,0
SC508765,1,0,1,0,1,1,0,0,0
SC508840,8,5,3,0,1,1,0,1,1
SC508993,1,0,1,0,1,1,0,0,0
SC509198,8,7,1,0,0,0,0,0,0
SC509587,2,2,0,0,1,1,0,0,1
SC509627,2,1,1,0,2,1,1,0,0
SC509681,7,0,7,0,0,0,0,0,0
SC509686,12,0,12,0,1,1,0,1,1
SC509984,2,2,0,0,2,2,0,0,0
SC510040,22,12,10,0,0,0,0,0,0
SC510219,2,0,2,0,1,1,0,0,0
SC510265,4,3,1,0,2,2,0,0,0
SC510295,2,2,0,0,1,1,0,0,0
SC510307,1,0,1,0,0,0,0,0,1
SC510864,5,4,1,0,2,1,1,1,1
SC510887,11,6,5,0,0,0,0,0,0
SC511007,3,2,1,0,1,1,0,1,1
SC511087,1,1,0,0,1,1,0,0,0
SC511105,4,3,1,0,1,1,0,1,0
SC511169,9,3,6,0,1,1,0,1,1
SC511178,2,2,0,0,1,1,0,0,1
SC511260,3,2,1,0,2,2,0,0,0
SC511583,2,1,1,0,1,1,0,0,0
SC511893,1,0,1,0,1,1,0,0,0
SC511957,7,4,3,0,1,1,0,1,1
SC512022,2,0,2,0,0,0,0,0,0
SC512199,19,10,9,0,0,0,0,0,0
SC512201,1,0,1,0,1,1,0,0,0
SC512206,4,1,3,0,2,2,0,0,0
SC512555,2,0,2,0,1,1,0,0,0
SC512632,1,1,0,0,1,1,0,0,0
SC512680,2,1,1,0,1,1,0,0,0
SC512797,4,1,3,0,1,1,0,0,0
01399023,10,5,5,0,1,1,0,1,0
01399306,14,1,13,0,1,1,0,1,1
01399452,59,0,59,0,1,1,0,0,1
01399560,39,10,29,0,0,0,0,0,1
01399732,68,15,53,0,0,0,0,0,1
01399817,7,4,3,0,2,2,0,0,1
01400213,57,7,50,0,0,0,0,0,1
01400345,12,3,9,0,1,1,0,1,1
01400366,3,0,3,0,0,0,0,0,1
01400520,12,3,9,0,1,1,0,1,0
01401075,16,5,11,0,1,1,0,1,1
01401164,16,0,16,0,0,0,0,0,1
01401278,14,5,9,0,0,0,0,0,1
01401298,19,0,19,0,1,1,0,1,1
01402091,15,3,12,0,0,0,0,0,1
01402147,21,8,13,0,0,0,0,0,1
01402197,45,11,34,0,0,0,0,0,1
01402218,10,3,7,0,1,1,0,1,1
01402483,45,8,37,0,0,0,0,0,1
01402692,56,8,48,0,0,0,0,0,1
01402702,45,11,34,0,0,0,0,0,1
01403035,12,3,9,0,2,2,0,0,1
01403177,19,8,11,0,2,2,0,1,1
01403405,38,0,38,0,0,0,0,0,1
01403757,3,3,0,0,2,2,0,0,0
01403985,7,3,4,0,2,2,0,0,1
01404027,32,4,28,0,0,0,0,0,1
01404114,12,2,10,0,1,1,0,1,1
01404175,23,5,18,0,0,0,0,0,1
01404713,16,4,12,0,1,1,0,1,1
01404718,49,4,45,0,1,1,0,1,1
01405035,12,5,7,0,2,2,0,0,0
01405334,20,6,14,0,0,0,0,0,1
01405493,9,0,9,0,0,0,0,0,1
01406214,11,4,7,0,2,2,0,0,1
01406599,34,4,30,0,1,1,0,1,1
01407013,49,3,46,0,1,1,0,1,1
01407177,5,2,3,0,1,1,0,0,1
01407381,9,5,4,0,1,1,0,0,1
01407422,27,6,21,0,9,5,4,0,0
01407540,24,0,24,0,1,1,0,1,1
01407770,33,4,29,0,1,1,0,1,1
01407996,18,7,11,0,1,1,0,1,1
01408465,24,9,15,0,1,1,0,1,1
01408467,21,0,21,0,0,0,0,0,1
01408968,12,5,7,0,4,4,0,0,1
01409066,80,8,72,0,0,0,0,0,1
01409133,19,4,15,0,1,1,0,0,1
01410252,6,5,1,0,1,1,0,0,1
01410401,33,3,30,0,1,1,0,0,1
01410904,8,3,5,0,2,2,0,0,0
01411417,55,11,44,0,0,0,0,0,1
01411819,16,5,11,0,1,1,0,1,1
01411870,4,3,1,0,2,2,0,0,0
01412221,3,3,0,0,1,1,0,0,0
01412252,29,0,29,0,1,1,0,1,1
01412599,41,11,30,0,10,9,1,0,1
01412696,14,3,11,0,0,0,0,0,0
01412704,37,3,34,0,1,1,0,1,1
01412722,5,3,2,0,2,2,0,0,1
01413059,17,7,10,0,3,3,0,0,0
01413671,31,4,27,0,1,1,0,1,1
01415347,29,2,27,0,1,1,0,1,1
01415547,74,16,58,0,0,0,0,0,1
01415654,52,16,36,0,0,0,0,0,1
01415677,25,5,20,0,0,0,0,0,0
01416179,15,8,7,0,1,1,0,0,1
01416448,64,9,55,0,0,0,0,0,1
01416667,4,4,0,0,0,0,0,0,1
01416732,13,0,13,0,1,1,0,1,1
01416871,121,23,98,0,0,0,0,0,1
01416983,4,3,1,0,2,2,0,0,1
01417024,33,6,27,0,0,0,0,0,1
01417048,49,8,41,0,1,1,0,1,1
01417162,63,12,51,0,0,0,0,0,1
01417213,29,0,29,0,1,1,0,1,1
01417407,12,5,7,0,1,1,0,0,1
01417703,23,0,23,0,1,1,0,1,1
01417802,51,0,51,0,0,0,0,0,1
01418179,17,6,11,0,0,0,0,0,0
01418340,22,0,22,0,0,0,0,0,1
01418513,21,3,18,0,1,1,0,0,0
01418579,20,6,14,0,3,1,2,1,1
01418926,21,0,21,0,1,1,0,1,1
01419872,3,3,0,0,2,2,0,0,0
01419899,108,13,95,0,0,0,0,0,1
01420136,40,2,38,0,1,1,0,1,1
01420459,37,4,33,0,0,0,0,0,1
01420941,5,4,1,0,2,2,0,0,1
01421303,24,1,23,0,1,1,0,0,1
01421448,13,4,9,0,3,3,0,0,1
01421490,54,4,50,0,1,1,0,1,1
01421883,8,2,6,0,1,1,0,1,1
01422772,24,4,20,0,1,1,0,1,1
01423001,51,3,48,0,1,1,0,1,1
01423757,60,4,56,0,1,1,0,1,1
01424399,75,7,68,0,1,1,0,1,1
01424400,32,4,28,0,1,1,0,1,1
01424836,12,4,8,0,1,1,0,1,1
01425125,16,0,16,0,2,1,1,2,1
01425226,11,3,8,0,1,1,0,0,1
01425355,38,10,28,0,0,0,0,0,1
01425549,4,0,4,0,0,0,0,0,1
01425685,5,2,3,0,0,0,0,0,0
01425706,0,0,0,0,0,0,0,0,0
01425839,6,3,3,0,1,0,1,0,1
01425856,24,4,20,0,1,1,0,1,1
01425972,12,5,7,0,2,2,0,0,0
01426227,19,3,16,0,1,1,0,1,1
01426337,11,6,5,0,1,1,0,1,0
01426546,46,4,42,0,1,1,0,1,1
01426900,0,0,0,0,0,0,0,0,1
01427355,7,3,4,0,2,2,0,0,0
01427551,8,4,4,0,1,1,0,0,1
01428119,9,0,9,0,0,0,0,0,1
01428237,30,3,27,0,1,1,0,1,1
01428247,8,6,2,0,1,1,0,1,1
01428640,26,5,21,0,1,1,0,1,1
01428924,11,0,11,0,0,0,0,0,1
01429063,11,2,9,0,1,1,0,1,1
01429958,5,2,3,0,1,1,0,0,0
01430090,55,14,41,0,17,13,4,0,1
01430201,8,6,2,0,1,1,0,0,1
01430259,10,1,9,0,1,1,0,0,1
01430526,29,5,24,0,1,1,0,1,1
01430772,4,3,1,0,0,0,0,0,0
01430799,6,5,1,0,0,0,0,0,1
01430865,14,2,12,0,1,1,0,1,1
01430918,27,10,17,0,0,0,0,0,1
01431132,42,0,42,0,1,1,0,1,1
01431773,38,2,36,0,1,1,0,1,1
01431784,8,6,2,0,2,2,0,0,1
01432027,3,2,1,0,1,1,0,0,1
01432126,55,10,45,0,0,0,0,0,1
01432376,11,5,6,0,0,0,0,0,1
01432398,18,3,15,0,0,0,0,0,1
01432634,33,10,23,0,0,0,0,0,1
01433033,8,0,8,0,1,1,0,0,1
01433085,3,3,0,0,2,2,0,0,1
01433512,3,2,1,0,1,1,0,0,0
01433594,10,0,10,0,3,3,0,3,1
01433698,18,4,14,0,1,1,0,1,1
01434047,4,3,1,0,1,1,0,0,0
01434157,27,4,23,0,1,1,0,1,1
01434201,24,0,24,0,0,0,0,0,1
01434539,34,0,34,0,1,1,0,1,1
01434984,17,0,17,0,0,0,0,0,1
01435022,14,6,8,0,1,1,0,1,1
01435088,9,3,6,0,2,1,1,0,1
01435682,13,0,13,0,0,0,0,0,1
01435887,43,4,39,0,1,1,0,1,1
01436945,220,13,207,0,0,0,0,0,1
01437526,36,17,19,0,0,0,0,0,1
01437656,30,3,27,0,0,0,0,0,1
01437998,24,4,20,0,1,1,0,1,1
01438169,41,4,37,0,0,0,0,0,1
01438185,59,10,49,0,1,1,0,1,1
01438339,3,2,1,0,2,1,1,0,0
01438358,0,0,0,0,0,0,0,0,0
01438369,14,3,11,0,0,0,0,0,1
01438662,22,3,19,0,1,1,0,1,1
01438761,10,2,8,0,1,1,0,1,1
01439945,4,3,1,0,0,0,0,0,0
01440117,23,3,20,0,0,0,0,0,1
01440569,9,3,6,0,0,0,0,0,1
01440570,21,10,11,0,1,1,0,0,1
01441138,6,4,2,0,0,0,0,0,0
01441161,20,2,18,0,1,1,0,1,1
01441497,35,11,24,0,0,0,0,0,1
01441517,33,12,21,0,0,0,0,0,0
01441728,19,3,16,0,1,1,0,0,0
01441972,3,3,0,0,2,2,0,0,1
01442438,12,4,8,0,3,3,0,0,1
01442927,12,0,12,0,0,0,0,0,1
01442978,23,3,20,0,2,1,1,2,1
01443052,5,3,2,0,1,1,0,1,1
01443223,22,9,13,0,1,1,0,0,1
01443344,61,10,51,0,1,1,0,0,0
01443809,87,12,75,0,0,0,0,0,1
01444594,23,6,17,0,5,5,0,0,0
01444607,25,0,25,0,0,0,0,0,1
01445212,15,0,15,0,1,1,0,1,1
01445322,97,2,95,0,1,1,0,1,1
01445936,31,0,31,0,0,0,0,0,1
01446230,31,0,31,0,1,1,0,1,1
01446739,15,4,11,0,2,2,0,2,1
01446825,41,4,37,0,2,1,1,2,1
01447042,12,0,12,0,0,0,0,0,1
01447100,0,0,0,0,0,0,0,0,0
01447391,33,0,33,0,1,1,0,1,1
01448008,5,1,4,0,1,1,0,1,1
01448449,8,0,8,0,0,0,0,0,0
01448616,5,3,2,0,0,0,0,0,1
01449248,14,1,13,0,0,0,0,0,1
01449443,22,0,22,0,0,0,0,0,1
01449636,17,1,16,0,1,1,0,0,0
01450199,25,0,25,0,0,0,0,0,1
01450669,25,2,23,0,1,1,0,1,1
01450855,16,2,14,0,2,1,1,2,1
01451007,33,4,29,0,1,1,0,1,1
01451035,15,2,13,0,1,1,0,1,1
01451435,37,3,34,0,1,1,0,1,1
01451599,11,3,8,0,1,1,0,1,1
01451644,38,10,28,1,0,0,0,0,1
01451862,14,6,8,0,1,0,1,0,0
01452037,51,4,47,0,1,1,0,1,1
01452482,61,8,53,0,0,0,0,0,1
01453049,44,6,38,0,1,1,0,0,1
01453123,46,0,46,0,0,0,0,0,1
01453469,18,4,14,0,0,0,0,0,1
01453781,29,4,25,0,2,1,1,1,1
01453782,49,4,45,0,1,1,0,1,1
01453811,51,14,37,0,1,1,0,0,1
01453893,23,3,20,0,1,1,0,1,0
01454107,0,0,0,0,0,0,0,0,0
01454176,11,2,9,0,1,1,0,0,1
01454225,9,4,5,0,1,1,0,1,1
01454959,19,0,19,0,1,1,0,1,1
01455051,16,4,12,0,1,1,0,1,1
01455136,115,12,103,0,2,2,0,0,1
01455176,9,3,6,0,1,1,0,0,1
01455295,19,0,19,0,0,0,0,0,1
01455601,14,4,10,0,1,1,0,1,1
01455931,10,1,9,0,1,1,0,1,0
01456070,0,0,0,0,0,0,0,0,0
01457480,15,4,11,0,1,1,0,1,1
01457819,16,4,12,0,1,1,0,1,1
01457922,57,0,57,0,2,1,1,2,1
01458063,15,4,11,0,0,0,0,0,1
01458147,22,4,18,0,3,2,1,0,1
01458501,54,12,42,0,0,0,0,0,1
00810262,101,0,101,0,0,0,0,0,1
00812000,15,5,10,0,1,1,0,1,1
00812083,4,0,4,0,0,0,0,0,0
00812104,40,6,34,0,2,2,0,1,1
00812217,0,0,0,0,0,0,0,0,0
00812470,8,0,8,0,0,0,0,0,1
00813187,41,6,35,0,1,1,0,1,1
00813430,22,0,22,0,0,0,0,0,1
00813541,12,8,4,0,1,1,0,0,0
00813564,19,3,16,0,0,0,0,0,1
00813569,12,5,7,0,1,1,0,0,0
00813701,18,2,16,0,1,1,0,1,1
00813712,17,2,15,0,1,1,0,1,1
00813847,83,0,83,0,0,0,0,0,1
00813887,30,0,30,0,0,0,0,0,1
00813906,22,0,22,0,0,0,0,0,1
00814291,13,4,9,0,0,0,0,0,1
00814448,4,0,4,0,0,0,0,0,0
00814814,3,0,3,0,0,0,0,0,1
00815161,6,2,4,0,1,1,0,0,1
00815227,75,13,62,0,0,0,0,0,1
00816183,5,4,1,0,1,1,0,0,1
00816255,6,4,2,0,1,1,0,0,0
00816437,12,5,7,0,1,1,0,0,1
00816747,6,3,3,0,1,1,0,0,0
00816878,5,0,5,0,0,0,0,0,0
00816895,16,0,16,0,1,1,0,1,1
00817571,12,3,9,0,2,2,0,0,1
00817692,51,7,44,0,1,1,0,1,1
00817695,16,3,13,0,1,1,0,0,1
00817717,37,3,34,0,5,4,1,0,1
00818359,49,6,43,0,1,1,0,1,1
00818389,56,17,39,0,0,0,0,0,1
00818452,46,12,34,0,1,1,0,0,0
00819092,14,5,9,0,4,3,1,0,1
00819182,22,0,22,0,0,0,0,0,1
00819787,49,2,47,0,0,0,0,0,1
00819788,56,10,46,0,0,0,0,0,1
00819892,53,17,36,0,0,0,0,0,1
00820590,12,3,9,0,1,1,0,1,1
00820631,30,6,24,0,1,1,0,1,1
00820660,56,16,40,0,0,0,0,0,1
00821571,6,3,3,0,2,2,0,0,0
00821923,5,3,2,0,1,1,0,0,0
00821959,4,2,2,0,1,1,0,0,0
00822257,9,3,6,0,4,2,2,0,0
00822558,16,0,16,0,0,0,0,0,1
00822892,6,2,4,0,1,1,0,0,1
00823009,30,6,24,0,2,2,0,2,1
00823048,14,3,11,0,0,0,0,0,1
00823132,54,2,52,0,1,1,0,0,1
00823766,36,6,30,0,0,0,0,0,1
00823988,97,24,73,0,0,0,0,0,1
00824422,13,4,9,0,1,1,0,0,0
00824610,18,5,13,0,1,1,0,1,1
00824611,72,10,62,0,0,0,0,0,1
00824951,31,5,26,0,1,1,0,1,1
00825036,70,6,64,0,0,0,0,0,1
00825154,6,2,4,0,1,1,0,0,0
00825224,4,2,2,0,1,1,0,0,0
00825401,5,0,5,0,0,0,0,0,0
00825522,4,3,1,0,3,3,0,0,0
00825828,66,6,60,0,2,2,0,2,1
00826148,14,4,10,0,1,1,0,1,1
00826179,47,10,37,0,0,0,0,0,1
00826740,51,9,42,0,1,1,0,1,1
00827218,12,2,10,0,1,1,0,1,1
00827389,6,3,3,0,1,1,0,0,0
00827432,10,3,7,0,1,1,0,1,1
00827462,12,2,10,0,1,1,0,0,1
00827982,140,11,129,0,1,1,0,1,1
00828154,19,0,19,0,1,1,0,1,1
00828750,30,3,27,0,1,1,0,1,1
00829109,11,5,6,0,1,1,0,0,0
00829763,72,17,55,0,0,0,0,0,0
00829802,36,3,33,0,2,2,0,2,1
00830143,26,0,26,0,0,0,0,0,1
00830519,11,8,3,0,0,0,0,0,0
00830735,38,9,29,0,0,0,0,0,1
00831092,33,5,28,0,0,0,0,0,1
00831409,18,4,14,0,1,1,0,1,1
00831497,23,5,18,0,1,1,0,1,1
00831550,43,10,33,0,1,1,0,1,1
00831817,38,0,38,0,0,0,0,0,1
00831990,15,4,11,0,4,1,3,1,1
00832132,52,9,43,0,0,0,0,0,1
00832291,16,3,13,0,1,1,0,1,1
00832293,13,4,9,0,1,1,0,1,1
00832566,26,5,21,0,1,1,0,1,1
00832799,7,4,3,0,2,2,0,0,0
00832800,19,0,19,0,0,0,0,0,1
00833417,4,3,1,0,2,1,1,0,0
00833987,18,8,10,0,1,1,0,1,1
00834033,9,4,5,0,1,1,0,0,1
00834213,5,3,2,0,1,1,0,0,0
00834616,11,0,11,0,1,1,0,1,1
00835158,33,3,30,0,0,0,0,0,1
00835252,86,10,76,0,0,0,0,0,1
00835349,7,4,3,0,1,1,0,1,1
00835358,4,2,2,0,2,2,0,0,0
00835372,5,3,2,0,1,1,0,1,0
00836065,26,3,23,0,0,0,0,0,0
00836184,8,4,4,0,5,5,0,2,0
00836481,26,3,23,0,0,0,0,0,1
00836717,13,2,11,0,1,1,0,0,1
00836826,28,0,28,0,1,1,0,1,1
00837194,19,3,16,0,3,1,2,1,0
00837751,23,3,20,0,1,1,0,0,1
00838046,44,3,41,0,1,1,0,1,1
00838308,32,5,27,0,1,1,0,1,1
00838839,8,3,5,0,1,1,0,0,0
00839971,3,3,0,0,2,2,0,0,0
00840236,15,4,11,0,1,1,0,1,1
00840237,17,4,13,0,1,1,0,1,1
00840520,6,4,2,0,1,1,0,0,0
00840590,63,1,62,0,1,1,0,1,1
00840800,9,5,4,0,0,0,0,0,0
00841127,16,9,7,0,0,0,0,0,1
00841210,6,3,3,0,1,1,0,0,0
00841289,20,2,18,0,1,1,0,1,1
00841421,22,2,20,0,1,1,0,1,1
00841611,7,3,4,0,0,0,0,0,1
00841648,13,0,13,0,1,1,0,1,1
00842029,28,6,22,0,0,0,0,0,0
00842860,25,3,22,0,1,1,0,1,1
00843327,131,17,114,0,0,0,0,0,0
00843359,11,0,11,0,2,2,0,2,1
00843464,11,8,3,0,0,0,0,0,1
00843715,13,4,9,0,0,0,0,0,1
00843732,7,3,4,0,1,1,0,0,1
00844283,23,3,20,0,0,0,0,0,0
00845501,16,0,16,0,0,0,0,0,1
00846150,18,0,18,0,1,1,0,1,1
00846152,8,3,5,0,1,1,0,0,0
00846378,17,2,15,0,1,1,0,1,1
00846881,43,2,41,0,1,1,0,1,1
00846922,37,0,37,0,0,0,0,0,1
00847863,22,10,12,0,1,1,0,0,1
00848990,25,11,14,0,0,0,0,0,1
00849279,40,13,27,0,0,0,0,0,1
00849435,6,3,3,0,2,2,0,1,0
00849553,33,2,31,0,2,1,1,2,1
00849944,16,3,13,0,1,1,0,1,1
00850195,32,7,25,0,1,1,0,1,1
00850299,4,3,1,0,2,2,0,0,1
00850883,26,1,25,0,0,0,0,0,1
00851307,20,0,20,0,0,0,0,0,1
00851407,19,4,15,0,0,0,0,0,0
00851579,31,4,27,0,0,0,0,0,1
00851853,31,3,28,0,1,1,0,1,1
00852006,15,0,15,0,0,0,0,0,1
00852040,27,4,23,0,1,1,0,1,1
00852439,30,3,27,0,1,1,0,0,1
00852510,41,11,30,0,0,0,0,0,1
00852588,10,4,6,0,1,1,0,1,0
00852647,8,3,5,0,1,1,0,0,0
00852679,11,4,7,0,3,3,0,0,1
00853008,32,4,28,0,1,1,0,1,1
00853044,20,3,17,0,1,1,0,1,1
00853260,22,3,19,0,1,1,0,1,1
00853270,35,0,35,0,1,1,0,1,1
00854475,1,1,0,0,0,0,0,0,0
00854758,8,4,4,0,3,3,0,0,1
00854919,1,0,1,0,0,0,0,0,0
00855291,18,2,16,0,1,1,0,1,1
00855309,41,0,41,0,0,0,0,0,1
00855332,17,3,14,0,1,1,0,1,1
00855383,12,0,12,0,0,0,0,0,1
00855389,11,3,8,0,3,3,0,1,0
00855603,16,3,13,0,1,1,0,1,1
00855607,14,0,14,0,1,1,0,0,1
00855790,17,6,11,0,3,3,0,0,1
00856068,5,4,1,0,3,3,0,0,0
00856081,8,3,5,0,1,1,0,0,1
00856222,36,15,21,0,1,1,0,0,1
00856225,55,6,49,0,0,0,0,0,1
00856706,63,6,57,0,2,2,0,2,1
00856789,21,3,18,0,1,1,0,1,1
00856909,31,11,20,0,0,0,0,0,0
00856976,28,8,20,0,0,0,0,0,0
00857233,17,2,15,0,2,2,0,0,1
00857498,3,0,3,0,2,2,0,0,0
00857700,49,14,35,0,0,0,0,0,0
00857789,60,5,55,0,1,1,0,1,1
00858029,71,10,61,0,0,0,0,0,1
00858419,29,2,27,0,1,1,0,1,1
00858511,50,0,50,0,0,0,0,0,1
00858715,16,4,12,0,0,0,0,0,0
00858805,17,3,14,0,1,1,0,1,1
00858833,21,3,18,0,1,1,0,1,1
00858857,17,0,17,0,1,1,0,1,1
00859061,7,5,2,0,0,0,0,0,1
00859081,12,3,9,0,1,1,0,1,1
00859087,22,5,17,0,1,1,0,1,1
00859204,10,3,7,0,0,0,0,0,1
00859209,13,1,12,0,1,1,0,1,1
00859223,45,12,33,0,0,0,0,0,1
00860085,5,3,2,0,1,1,0,0,0
00860093,48,3,45,0,0,0,0,0,1
00860214,25,0,25,0,1,1,0,1,1
00860235,21,5,16,0,1,1,0,1,1
00860290,5,3,2,0,2,2,0,0,0
00860492,24,0,24,0,0,0,0,0,1
00860691,21,1,20,0,1,1,0,1,1
00860702,182,9,173,0,0,0,0,0,1
00860902,49,9,40,0,1,1,0,1,1
00861097,34,9,25,0,1,1,0,1,1
00861590,57,5,52,0,1,1,0,1,1
00861772,18,3,15,0,1,1,0,1,1
00862054,28,2,26,0,1,1,0,1,1
00862203,29,4,25,0,0,0,0,0,1
00862661,46,8,38,0,0,0,0,0,1
00862851,27,10,17,0,1,1,0,1,0
00863087,28,3,25,0,2,2,0,2,1
00863156,32,3,29,0,0,0,0,0,0
00863291,19,0,19,0,0,0,0,0,1
00863503,15,3,12,0,1,1,0,1,1
00864054,25,5,20,0,0,0,0,0,1
00864097,116,17,99,0,0,0,0,0,1
00864474,17,2,15,0,1,1,0,1,1
00864925,7,3,4,0,1,1,0,1,1
00865004,16,0,16,0,0,0,0,0,1
00865292,67,3,64,0,2,2,0,2,1
00865293,15,3,12,0,2,2,0,0,1
00865402,39,4,35,0,2,1,1,2,1
00865652,7,0,7,0,0,0,0,0,1
00865724,13,6,7,0,6,6,0,1,1
00865777,4,2,2,0,2,2,0,0,0
00866006,11,0,11,0,1,1,0,1,1
00866396,97,5,92,0,8,4,4,0,0
00866461,6,3,3,0,0,0,0,0,0
00866631,14,6,8,0,3,0,3,1,1
00866751,45,10,35,0,0,0,0,0,1
00866802,20,3,17,0,1,1,0,1,1
00866911,26,2,24,0,1,1,0,1,0
03507044,20,4,16,0,1,1,0,1,1
03507093,49,9,40,0,0,0,0,0,0
03507334,73,12,61,0,2,2,0,2,1
03507379,42,7,35,0,1,1,0,1,1
03507468,20,5,15,0,1,1,0,1,1
03507542,44,11,33,0,0,0,0,0,0
03508068,3,0,3,0,0,0,0,0,1
03508522,16,0,16,0,0,0,0,0,1
03508607,19,6,13,0,0,0,0,0,1
03508646,18,7,11,0,2,2,0,2,1
03509076,7,2,5,0,1,1,0,1,0
03509183,57,12,45,0,0,0,0,0,1
03509206,41,0,41,0,1,1,0,0,1
03509322,31,9,22,0,0,0,0,0,1
03509864,28,4,24,0,1,1,0,1,1
03510104,56,9,47,0,0,0,0,0,0
03510118,8,0,8,0,2,2,0,0,1
03510380,6,4,2,0,1,1,0,0,0
03510495,17,0,17,0,0,0,0,0,1
03510750,8,3,5,0,2,2,0,0,0
03510818,12,0,12,0,1,1,0,0,1
03510923,12,5,7,0,1,1,0,1,1
03510939,24,7,17,0,0,0,0,0,1
03510959,31,5,26,0,0,0,0,0,0
03510967,35,3,32,0,1,1,0,1,1
03511144,9,0,9,0,0,0,0,0,1
03511176,13,0,13,0,1,1,0,1,1
03511188,8,3,5,0,2,2,0,0,0
03511192,4,2,2,0,1,1,0,0,0
03511411,8,4,4,0,1,1,0,0,1
03511449,4,0,4,0,0,0,0,0,1
03511488,7,2,5,0,1,1,0,0,0
03512180,5,2,3,0,2,2,0,1,1
03512598,41,3,38,0,1,1,0,1,1
03512626,36,4,32,0,2,2,0,2,1
03512742,15,0,15,0,0,0,0,0,1
03512877,24,3,21,0,0,0,0,0,1
03512914,41,9,32,0,2,2,0,0,1
03513138,22,8,14,0,7,6,1,0,1
03513280,33,8,25,0,6,5,1,0,1
03513833,5,3,2,0,2,2,0,0,1
03514100,15,2,13,0,0,0,0,0,1
03514158,16,0,16,0,0,0,0,0,1
03514506,36,8,28,0,3,3,0,3,1
03514509,9,3,6,0,0,0,0,0,0
03514627,4,2,2,0,1,1,0,0,0
03514631,4,2,2,0,1,1,0,0,0
03514635,89,10,79,0,0,0,0,0,1
03514872,9,4,5,0,1,1,0,1,0
03515202,24,4,20,0,1,1,0,1,1
03515427,15,0,15,0,0,0,0,0,1
03515512,81,25,56,0,0,0,0,0,1
03515716,16,4,12,0,1,1,0,1,0
03516255,14,2,12,0,1,1,0,1,1
03516328,49,9,40,0,0,0,0,0,1
03516648,17,6,11,0,1,1,0,1,1
03516662,17,6,11,0,1,1,0,1,1
03516836,18,3,15,0,0,0,0,0,1
03516953,5,0,5,0,0,0,0,0,1
03517244,68,11,57,0,0,0,0,0,1
03517260,6,0,6,0,1,1,0,0,1
03517453,11,4,7,0,1,1,0,0,1
03517633,9,0,9,0,0,0,0,0,1
03517809,7,1,6,0,1,1,0,0,0
03518282,6,4,2,0,1,1,0,0,0
03518746,5,2,3,0,1,1,0,0,1
03518755,41,10,31,0,0,0,0,0,1
03518878,7,0,7,0,1,1,0,1,1
03518937,5,0,5,0,1,1,0,0,1
03519194,6,3,3,0,2,2,0,0,1
03519820,5,2,3,0,2,2,0,0,0
03519883,9,3,6,0,1,1,0,1,1
03520254,37,0,37,0,0,0,0,0,0
03520281,167,18,149,0,0,0,0,0,1
03520491,5,2,3,0,1,1,0,0,1
03520500,12,2,10,0,0,0,0,0,0
03520619,52,8,44,0,0,0,0,0,1
03521031,29,0,29,0,1,1,0,1,1
03521224,13,0,13,0,0,0,0,0,1
03521327,23,5,18,0,0,0,0,0,0
03521378,21,2,19,0,1,1,0,1,1
03521640,38,11,27,0,0,0,0,0,1
03521811,35,3,32,0,1,1,0,1,1
03522033,20,5,15,0,1,1,0,1,1
03522043,6,0,6,0,2,2,0,0,1
03522144,74,12,62,0,0,0,0,0,1
03522472,9,1,8,0,1,1,0,0,1
03522889,25,4,21,0,2,1,1,2,1
03523004,15,7,8,0,1,1,0,0,0
03523419,17,0,17,0,0,0,0,0,1
03523583,12,3,9,0,4,1,3,0,1
03523717,36,0,36,0,0,0,0,0,1
03523822,8,3,5,0,1,1,0,0,1
03523928,12,0,12,0,0,0,0,0,1
03523969,12,4,8,0,1,1,0,0,1
03524013,64,10,54,0,0,0,0,0,1
03524063,60,13,47,0,0,0,0,0,1
03524099,25,3,22,0,0,0,0,0,0
03524496,13,0,13,0,1,1,0,1,1
03524532,12,0,12,0,0,0,0,0,1
03524593,26,0,26,0,0,0,0,0,1
03524804,16,0,16,0,0,0,0,0,1
03524903,33,4,29,0,1,1,0,1,1
03524909,45,4,41,0,1,1,0,1,1
03524915,18,0,18,0,0,0,0,0,1
03524920,32,2,30,0,1,1,0,1,1
03524921,22,0,22,0,0,0,0,0,1
03525045,21,3,18,0,1,1,0,1,1
03525080,6,3,3,0,1,1,0,0,1
03525111,29,3,26,0,1,1,0,1,1
03525361,17,8,9,0,0,0,0,0,1
03525773,5,3,2,0,0,0,0,0,1
03525786,23,6,17,0,2,2,0,0,1
03525789,9,3,6,0,2,2,0,0,0
03525870,39,3,36,1,1,1,0,1,1
03525911,14,3,11,0,0,0,0,0,1
03526107,43,0,43,1,0,0,0,0,1
03526126,21,1,20,0,1,1,0,1,1
03526170,17,2,15,0,1,1,0,1,1
03526395,10,2,8,0,2,2,0,1,1
03526611,5,2,3,0,2,2,0,0,1
03526821,6,2,4,0,1,1,0,0,0
03526845,10,2,8,0,1,1,0,0,1
03526992,9,3,6,0,1,1,0,1,1
03527034,23,1,22,0,2,1,1,1,1
03527213,4,1,3,0,1,1,0,0,1
03527481,8,4,4,0,1,1,0,0,1
03527746,66,13,53,0,0,0,0,0,1
03527752,19,3,16,0,1,1,0,1,1
03527762,3,2,1,0,1,1,0,0,0
03527779,12,0,12,0,1,1,0,1,1
03528049,28,0,28,0,1,1,0,1,1
03528097,19,2,17,0,1,1,0,0,1
03528214,15,0,15,0,0,0,0,0,1
03528320,25,4,21,0,2,1,1,2,1
03528387,20,3,17,0,1,1,0,1,1
03528416,64,4,60,0,2,1,1,2,1
03528476,22,3,19,0,0,0,0,0,1
03528482,6,2,4,0,1,1,0,0,1
03528645,6,4,2,0,2,2,0,0,1
03528682,20,6,14,0,0,0,0,0,0
03529026,24,2,22,0,1,1,0,1,1
03529785,22,0,22,0,0,0,0,0,1
03529839,5,2,3,0,1,1,0,0,0
03530011,7,3,4,0,2,2,0,0,0
03530054,5,3,2,0,1,1,0,0,1
03530244,8,0,8,0,0,0,0,0,1
03530359,14,2,12,0,1,1,0,1,1
03530632,5,2,3,0,2,2,0,0,1
03530777,28,0,28,0,0,0,0,0,1
03530868,54,8,46,0,0,0,0,0,1
03530898,38,10,28,0,0,0,0,0,0
03531314,7,3,4,0,0,0,0,0,1
03531768,4,2,2,0,1,1,0,0,1
03531973,8,0,8,0,0,0,0,0,1
03532224,15,7,8,0,1,1,0,0,1
03532258,5,3,2,0,2,2,0,0,1
03532685,9,2,7,0,1,1,0,0,0
03532799,19,5,14,0,0,0,0,0,1
03532841,18,5,13,0,1,1,0,1,1
03532867,48,9,39,0,16,0,16,0,1
03533450,5,0,5,0,0,0,0,0,1
03533536,14,4,10,0,1,1,0,0,0
03533566,4,2,2,0,1,1,0,0,1
03533571,28,5,23,0,0,0,0,0,1
03533628,8,0,8,0,1,1,0,1,1
03533639,27,0,27,0,0,0,0,0,1
03533651,17,0,17,0,0,0,0,0,1
03533713,5,3,2,0,0,0,0,0,1
03533727,8,0,8,0,0,0,0,0,1
03533990,6,1,5,0,1,1,0,0,1
03534393,45,6,39,0,3,1,2,0,1
03534473,4,2,2,0,2,2,0,0,0
03534686,27,5,22,0,2,2,0,2,1
03534827,27,4,23,0,1,1,0,1,1
03534972,10,3,7,0,1,1,0,1,1
03535009,7,3,4,0,0,0,0,0,1
03535168,37,11,26,0,1,1,0,0,0
03535393,42,8,34,0,0,0,0,0,1
03535423,13,3,10,0,0,0,0,0,1
03535585,21,3,18,0,1,1,0,1,1
03536054,6,4,2,0,0,0,0,0,1
03536062,15,3,12,0,1,1,0,1,1
03536243,68,8,60,0,0,0,0,0,1
03536370,40,13,27,0,14,0,14,0,1
03536421,9,3,6,0,0,0,0,0,1
03536588,5,2,3,0,1,1,0,0,0
03536595,30,0,30,0,0,0,0,0,1
03536672,8,4,4,0,1,1,0,0,0
03537026,12,0,12,0,1,1,0,1,1
03537076,31,3,28,0,4,3,1,0,1
03537225,34,11,23,0,1,1,0,1,1
03537269,10,0,10,0,0,0,0,0,1
03537370,5,0,5,0,1,1,0,0,1
03537527,3,2,1,0,1,1,0,0,1
03537548,11,3,8,0,1,1,0,0,1
03537709,10,2,8,0,1,1,0,0,1
03538348,13,0,13,0,0,0,0,0,1
03538665,33,7,26,0,0,0,0,0,1
03538705,31,4,27,0,1,1,0,1,1
03538785,50,3,47,0,1,1,0,1,1
03538912,5,3,2,0,1,1,0,0,1
03538930,11,0,11,0,0,0,0,0,1
03539094,5,3,2,0,2,2,0,0,1
03539247,7,0,7,0,0,0,0,0,1
03539266,9,0,9,0,0,0,0,0,1
03539284,6,3,3,0,1,1,0,0,1
03539298,4,2,2,0,2,2,0,0,1
03539352,25,12,13,0,1,1,0,1,1
03539382,4,2,2,0,2,2,0,0,1
03539410,23,2,21,0,0,0,0,0,0
03539413,53,5,48,0,0,0,0,0,1
03539460,8,4,4,0,3,3,0,0,1
03539665,51,8,43,0,2,2,0,2,1
03539724,16,6,10,0,1,1,0,0,0
03539832,13,6,7,0,1,1,0,1,1
05322105,8,3,5,0,3,3,0,1,1
05322188,5,1,4,0,0,0,0,0,0
05322228,6,2,4,0,2,2,0,0,1
05322254,9,0,9,0,0,0,0,0,1
05322255,9,0,9,0,0,0,0,0,1
05322443,19,5,14,0,1,1,0,1,1
05322623,4,2,2,0,1,1,0,0,0
05323355,4,2,2,0,1,1,0,0,1
05323703,6,3,3,0,1,1,0,0,1
05323828,6,2,4,0,1,1,0,1,0
05324416,32,8,24,0,0,0,0,0,1
05324439,16,0,16,0,0,0,0,0,1
05324546,10,5,5,0,0,0,0,0,0
05325181,22,6,16,0,1,1,0,1,1
05325188,6,0,6,0,0,0,0,0,1
05325384,15,0,15,0,0,0,0,0,1
05325492,7,3,4,0,1,1,0,1,1
05325564,20,2,18,0,1,1,0,1,0
05325716,5,0,5,0,0,0,0,0,1
05325867,14,3,11,0,1,1,0,1,1
05325983,4,2,2,0,1,1,0,0,0
05326185,3,3,0,0,1,1,0,0,1
05326363,8,3,5,0,1,1,0,0,1
05326437,5,3,2,0,2,2,0,0,1
05326670,17,6,11,0,1,1,0,1,1
05327520,4,0,4,0,1,1,0,0,0
05327589,15,2,13,0,0,0,0,0,1
05328134,20,4,16,0,0,0,0,0,1
05328145,8,2,6,0,1,1,0,0,1
05328246,14,0,14,0,0,0,0,0,1
05328847,35,7,28,0,0,0,0,0,1
05328907,9,0,9,0,0,0,0,0,1
05329371,2,1,1,0,1,1,0,0,0
05329636,5,2,3,0,1,1,0,0,0
05329968,8,5,3,0,1,1,0,1,0
05330204,2,0,2,0,1,1,0,0,0
05330318,12,4,8,0,3,3,0,0,1
05330706,13,6,7,0,1,1,0,1,1
05331193,15,4,11,0,0,0,0,0,0
05331237,5,3,2,0,1,1,0,0,0
05331315,7,0,7,0,0,0,0,0,1
05331368,13,6,7,0,0,0,0,0,0
05331403,33,6,27,0,1,0,1,0,1
05331412,33,9,24,0,0,0,0,0,1
05332012,25,9,16,0,0,0,0,0,0
05332361,14,3,11,0,2,1,1,2,1
05332857,48,14,34,0,1,1,0,0,1
05333270,3,3,0,0,1,1,0,0,0
05333733,3,3,0,0,2,2,0,0,0
05333912,6,1,5,0,0,0,0,0,0
05334057,5,2,3,0,0,0,0,0,0
05334580,34,5,29,3,1,1,0,0,1
05335486,3,0,3,0,1,1,0,0,1
05335619,7,5,2,0,1,1,0,1,0
05335695,27,5,22,0,2,1,1,2,1
05335752,2,0,2,0,0,0,0,0,1
05335933,15,7,8,0,1,1,0,1,1
05336078,50,13,37,0,0,0,0,0,0
05337412,33,6,27,0,5,5,0,0,0
05337766,14,3,11,0,0,0,0,0,1
05337991,5,0,5,0,0,0,0,0,0
05338080,12,5,7,0,1,1,0,0,0
05338120,17,3,14,0,1,1,0,1,1
05338567,6,1,5,0,1,1,0,0,0
05338637,3,3,0,0,1,1,0,0,0
05338648,8,0,8,0,0,0,0,0,1
05338707,12,0,12,0,0,0,0,0,1
05338710,10,0,10,0,0,0,0,0,1
05338733,5,3,2,0,1,1,0,0,0
05338824,2,2,0,0,2,2,0,0,0
05338872,10,4,6,0,3,1,2,1,1
05339062,33,3,30,0,1,1,0,1,1
05339355,2,2,0,0,1,1,0,0,0
05339919,3,2,1,0,1,1,0,0,0
05340068,7,3,4,0,1,1,0,1,1
05340080,7,3,4,0,1,1,0,1,1
05340083,7,3,4,0,0,0,0,0,0
05340180,9,2,7,0,1,1,0,0,1
05340186,31,7,24,0,3,2,1,3,1
05340328,46,10,36,0,1,1,0,0,0
05340414,4,2,2,0,1,1,0,0,1
05340573,18,0,18,0,0,0,0,0,1
05341124,6,3,3,0,2,2,0,0,0
05341126,10,2,8,0,2,2,0,0,1
05341664,15,7,8,0,1,1,0,1,1
05341971,12,7,5,0,2,2,0,0,1
05342156,7,2,5,0,0,0,0,0,1
05342157,8,2,6,0,0,0,0,0,0
05342677,6,3,3,0,0,0,0,0,0
05343007,5,0,5,0,0,0,0,0,1
05343088,28,7,21,0,1,1,0,1,1
05343261,3,3,0,0,0,0,0,0,0
05343551,9,3,6,0,2,2,0,0,1
05343735,11,6,5,0,0,0,0,0,1
05343745,4,2,2,0,2,2,0,0,1
05344280,5,3,2,0,0,0,0,0,1
05344517,14,4,10,0,1,1,0,1,1
05344552,6,0,6,0,0,0,0,0,1
05344714,19,8,11,0,0,0,0,0,1
05344996,4,2,2,0,1,1,0,0,0
05345003,3,1,2,0,1,1,0,0,0
05345104,9,2,7,0,2,2,0,0,1
05345129,5,3,2,0,1,1,0,1,1
05345693,7,3,4,0,1,1,0,1,1
05345740,5,2,3,0,2,2,0,0,1
05346220,11,2,9,0,2,2,0,0,0
05346566,5,2,3,0,2,2,0,0,1
05346608,3,0,3,0,0,0,0,0,1
05346630,4,2,2,0,1,1,0,0,1
05346727,15,3,12,0,1,1,0,1,1
05346833,6,3,3,0,2,2,0,1,1
05347441,26,0,26,0,0,0,0,0,1
05347497,5,3,2,0,1,1,0,0,0
05347511,39,8,31,0,0,0,0,0,1
05347584,16,8,8,0,0,0,0,0,1
05347587,12,4,8,0,1,1,0,1,1
05347642,15,3,12,0,1,1,0,1,1
05347651,29,0,29,0,0,0,0,0,1
05347667,24,0,24,0,0,0,0,0,1
05347810,35,0,35,0,0,0,0,0,1
05347937,6,3,3,0,1,1,0,0,0
05347971,9,0,9,0,0,0,0,0,1
05348309,9,2,7,0,1,1,0,1,0
05348311,6,0,6,0,0,0,0,0,0
05348373,6,3,3,0,1,1,0,0,0
05349418,17,3,14,0,2,2,0,2,1
05349437,5,3,2,0,2,2,0,0,0
05349447,28,4,24,0,1,1,0,1,1
05349451,10,3,7,0,0,0,0,0,1
05349599,7,0,7,0,1,1,0,0,1
05350401,6,1,5,0,2,1,1,0,0
05350666,4,2,2,0,1,1,0,0,0
05351573,4,3,1,0,2,2,0,0,0
05351618,22,2,20,0,1,1,0,1,1
05352166,5,4,1,0,2,2,0,0,0
05352510,10,6,4,0,1,1,0,0,1
05352524,14,0,14,0,0,0,0,0,1
05352542,19,3,16,0,0,0,0,0,1
05352638,4,2,2,0,1,1,0,0,0
05353085,14,5,9,0,0,0,0,0,1
05353089,10,3,7,0,1,1,0,1,0
05353100,7,0,7,0,0,0,0,0,1
05353354,12,5,7,0,1,1,0,1,0
05353387,29,7,22,0,0,0,0,0,1
05353612,8,2,6,0,1,1,0,1,1
05354203,12,0,12,0,1,1,0,0,0
05354227,10,6,4,0,3,1,2,1,1
05354254,19,7,12,0,0,0,0,0,0
05354903,4,1,3,0,2,2,0,0,0
05354951,4,2,2,0,2,2,0,0,0
05354994,5,3,2,0,2,2,0,0,1
05355084,2,2,0,0,1,1,0,0,0
05355110,27,5,22,0,2,2,0,2,1
05355195,15,5,10,0,1,1,0,1,1
05355303,19,0,19,0,0,0,0,0,1
05355912,5,3,2,0,2,2,0,0,0
05356099,9,4,5,0,0,0,0,0,1
05356632,5,3,2,0,1,1,0,0,0
05356743,5,0,5,0,0,0,0,0,1
05357259,21,1,20,0,1,1,0,1,1
05357529,5,2,3,0,2,2,0,0,0
05357550,5,2,3,0,1,1,0,0,1
05357662,2,2,0,0,0,0,0,0,0
05358690,13,1,12,0,1,1,0,0,1
05358703,8,1,7,0,0,0,0,0,1
05358886,13,4,9,0,0,0,0,0,1
05359150,16,5,11,0,1,1,0,0,1
05359816,3,2,1,0,1,1,0,0,0
05359842,31,4,27,0,1,1,0,1,1
05359848,33,4,29,0,1,1,0,1,1
05359852,34,4,30,0,1,1,0,1,1
05360223,4,2,2,0,1,1,0,0,0
05360430,14,2,12,0,1,1,0,1,1
05360492,25,6,19,0,0,0,0,0,0
05360864,29,5,24,0,1,1,0,1,1
05360879,19,0,19,0,0,0,0,0,1
05361095,14,6,8,0,0,0,0,0,1
05361393,15,3,12,0,1,1,0,1,1
05361477,5,3,2,0,2,2,0,0,0
05361660,19,2,17,0,1,1,0,1,0
05361760,14,0,14,0,0,0,0,0,1
05361817,14,7,7,0,0,0,0,0,1
05362634,8,2,6,0,1,1,0,0,1
05362736,8,4,4,0,2,2,0,0,0
05362974,15,2,13,0,0,0,0,0,1
05363116,8,4,4,0,1,1,0,0,1
05363273,16,3,13,0,1,1,0,0,1
05363415,5,3,2,0,0,0,0,0,0
05363656,6,1,5,0,2,1,1,1,1
05363946,36,7,29,0,1,1,0,0,1
05364029,5,2,3,0,1,1,0,1,1
05364470,12,3,9,0,2,2,0,1,1
05364471,7,3,4,0,1,1,0,0,0
05365585,23,11,12,0,0,0,0,0,0
05365587,7,4,3,0,2,2,0,0,1
05365645,14,4,10,0,1,1,0,1,1
05365791,7,0,7,0,1,1,0,0,1
05366034,6,2,4,0,1,1,0,0,0
05366077,26,8,18,0,1,1,0,1,1
05366115,6,4,2,0,1,1,0,0,1
05366157,6,3,3,0,2,2,0,0,1
05366164,5,0,5,0,0,0,0,0,1
05366206,3,3,0,0,2,2,0,0,0
05366805,6,2,4,0,2,1,1,0,0
05367146,5,0,5,0,0,0,0,0,1
05367467,7,4,3,0,1,1,0,0,0
05367648,4,1,3,0,1,1,0,0,1
05367662,7,0,7,0,0,0,0,0,1
05367753,14,8,6,0,2,2,0,0,1
05368102,14,0,14,0,0,0,0,0,1
05368125,9,5,4,0,0,0,0,0,0
05368340,7,0,7,0,0,0,0,0,0
05368409,51,14,37,0,0,0,0,0,1
05369106,44,14,30,0,0,0,0,0,1
05369193,14,8,6,0,0,0,0,0,1
05369515,12,7,5,0,0,0,0,0,1
05369725,37,13,24,0,0,0,0,0,1
11478025,4,3,1,0,3,1,2,1,1
11478310,2,2,0,0,1,1,0,0,0
11478464,1,1,0,0,2,2,0,1,0
11478477,2,0,2,0,2,2,0,0,0
11478657,10,10,0,0,0,0,0,0,1
11479336,1,1,0,0,1,1,0,0,0
11480315,1,1,0,0,1,1,0,0,0
11480690,4,3,1,0,1,1,0,0,1
11480743,10,9,1,0,1,1,0,0,1
11480768,1,0,1,0,1,1,0,0,1
11480812,3,3,0,0,1,1,0,0,1
11481176,3,3,0,0,1,1,0,0,1
11481442,1,1,0,0,1,1,0,0,0
11481594,3,3,0,0,1,1,0,1,1
11481749,1,1,0,0,1,1,0,0,0
11481801,4,4,0,2,1,1,0,1,0
11481816,4,4,0,2,1,1,0,1,0
11482646,7,4,3,0,2,1,1,2,1
11482736,1,1,0,0,1,1,0,0,0
11482758,1,1,0,0,1,1,0,0,0
11483032,1,1,0,0,1,1,0,0,0
11483118,1,1,0,0,1,1,0,0,0
11483431,2,2,0,0,2,2,0,1,0
11483443,2,2,0,0,2,2,0,1,0
11483520,2,2,0,0,2,2,0,1,0
11483715,1,1,0,0,1,1,0,0,0
11483908,2,2,0,0,2,2,0,0,0
11484050,2,2,0,0,2,2,0,0,0
11484440,2,2,0,0,2,2,0,0,0
11484899,1,1,0,0,1,1,0,0,0
11485003,4,4,0,2,1,1,0,1,0
11485236,2,2,0,0,2,2,0,0,0
11485271,6,5,1,2,1,1,0,1,0
11485814,1,1,0,0,1,1,0,0,0
11485916,10,5,5,0,2,1,1,2,1
11485917,1,1,0,0,1,1,0,0,0
11485925,4,2,2,0,0,0,0,0,0
11486251,2,1,1,0,2,1,1,0,0
11486538,2,2,0,0,1,1,0,0,0
11487167,2,2,0,0,2,2,0,0,0
11487305,1,1,0,0,1,1,0,0,0
11487519,1,1,0,0,1,1,0,0,0
11487770,2,1,1,0,3,2,1,0,1
11488206,1,1,0,0,1,1,0,0,0
11488720,1,1,0,0,1,1,0,0,0
11488898,1,1,0,0,1,1,0,0,0
11488901,1,1,0,0,1,1,0,0,0
11488988,6,6,0,0,2,1,1,1,0
11489265,2,2,0,0,1,1,0,1,0
11489393,1,1,0,0,1,1,0,0,0
11489683,1,1,0,0,1,1,0,0,0
11490655,4,3,1,0,1,1,0,0,0
11491236,5,4,1,0,1,1,0,1,1
11491576,2,2,0,0,1,1,0,0,0
11491624,2,2,0,0,2,2,0,0,0
11491776,1,1,0,0,1,1,0,0,0
11491875,1,1,0,0,1,1,0,0,0
11492336,2,2,0,0,1,1,0,0,1
11492870,1,1,0,0,1,1,0,0,0
11492977,1,1,0,0,1,1,0,0,0
11492985,3,3,0,0,2,2,0,0,1
11493059,1,1,0,0,1,1,0,0,0
11493249,7,5,2,0,1,1,0,1,0
11493460,9,4,5,0,1,1,0,1,1
11493526,1,1,0,0,1,1,0,1,1
11493689,3,1,2,0,3,1,2,0,0
11493725,9,4,5,0,1,1,0,1,1
11493916,9,4,5,0,1,1,0,1,1
11493983,9,4,5,0,1,1,0,1,1
11493990,2,2,0,0,2,2,0,0,0
11494508,1,1,0,0,1,1,0,0,0
11495192,1,1,0,0,1,1,0,0,0
11495448,1,1,0,0,1,1,0,0,0
11495490,4,4,0,0,1,1,0,0,1
11495691,2,2,0,0,2,2,0,0,0
11495876,3,3,0,0,2,2,0,0,0
11496268,2,2,0,0,1,1,0,1,1
11496480,1,1,0,0,1,1,0,0,0
11496951,1,1,0,0,1,1,0,0,0
11497159,2,2,0,0,2,2,0,0,0
11497301,2,2,0,0,2,2,0,0,1
11497308,1,1,0,0,1,1,0,0,0
11497674,1,1,0,0,1,1,0,1,0
11497823,2,2,0,0,1,1,0,1,1
11497957,1,1,0,0,1,1,0,0,0
11498113,2,2,0,0,2,2,0,0,0
11498228,1,1,0,0,1,1,0,0,0
11498449,4,2,2,0,3,2,1,3,0
11498481,4,4,0,0,2,2,0,2,1
11498519,1,1,0,0,1,1,0,0,0
11498686,2,2,0,0,1,1,0,0,0
11499131,1,1,0,0,1,1,0,0,0
11499341,2,2,0,0,2,2,0,2,0
11499533,5,3,2,0,0,0,0,0,1
11499536,2,1,1,0,1,1,0,0,0
11499718,1,1,0,0,0,0,0,0,0
11499835,1,1,0,0,1,1,0,0,0
11500311,1,1,0,0,1,1,0,0,0
11500635,1,1,0,0,1,1,0,0,0
11500875,1,1,0,0,1,1,0,0,0
11501088,6,6,0,0,0,0,0,0,1
11501348,2,2,0,0,2,2,0,2,0
11501710,4,4,0,0,1,1,0,0,1
11501746,4,4,0,0,0,0,0,0,1
11502098,1,1,0,0,1,1,0,0,0
11502156,2,2,0,0,2,2,0,0,0
11502592,1,0,1,0,1,1,0,0,0
11502983,4,4,0,0,1,1,0,1,1
11503026,2,2,0,0,2,2,0,0,0
11503032,1,1,0,0,1,1,0,0,0
11503490,3,3,0,0,3,3,0,1,0
11503545,2,2,0,0,1,1,0,0,1
11503679,1,1,0,0,1,1,0,0,0
11503693,2,2,0,0,3,3,0,1,0
11503738,4,3,1,0,1,1,0,0,1
11503965,1,1,0,0,1,1,0,1,0
11503996,1,1,0,0,1,1,0,0,0
11504181,1,1,0,0,1,1,0,0,0
11504370,2,2,0,0,2,2,0,0,1
11504605,2,2,0,0,1,1,0,0,0
11505233,2,2,0,0,1,1,0,1,0
11505738,1,1,0,0,1,1,0,0,0
11505764,1,1,0,0,1,1,0,0,0
11505767,2,2,0,0,2,2,0,0,0
11505802,2,2,0,0,2,2,0,0,0
11505955,1,0,1,0,1,1,0,0,0
11506023,1,1,0,0,1,1,0,0,0
11506188,2,2,0,0,2,2,0,0,1
11506356,1,1,0,0,2,2,0,0,0
11506730,2,2,0,0,1,1,0,1,1
11507083,1,1,0,0,1,1,0,0,0
11507717,5,4,1,0,0,0,0,0,1
11507757,3,3,0,0,1,1,0,0,0
11507847,2,1,1,0,1,1,0,0,0
11508217,1,1,0,0,1,1,0,0,1
11508464,3,3,0,0,1,1,0,0,0
11508926,1,1,0,0,1,1,0,0,0
11508979,2,2,0,0,1,1,0,0,1
11509051,3,3,0,0,1,1,0,1,1
11509196,3,3,0,0,1,1,0,1,1
11509202,3,3,0,0,1,1,0,1,1
11509210,3,3,0,0,1,1,0,1,1
11509237,3,3,0,0,1,1,0,1,1
11509248,3,3,0,0,1,1,0,1,1
11509563,1,1,0,0,1,1,0,0,0
11509725,1,1,0,0,1,1,0,0,0
11509774,6,6,0,0,2,1,1,2,1
11510216,2,2,0,0,1,1,0,0,0
11510353,7,7,0,0,1,1,0,1,1
11510463,2,1,1,0,2,1,1,0,0
11510555,1,1,0,0,1,1,0,0,0
11510737,1,1,0,0,1,1,0,0,0
11511011,2,2,0,0,2,2,0,0,1
11511111,1,1,0,0,1,1,0,0,0
11511188,11,9,2,0,0,0,0,0,0
11511557,2,1,1,0,2,1,1,0,0
11511747,2,2,0,0,2,2,0,0,0
11511933,2,2,0,0,2,2,0,0,0
11512052,2,2,0,0,2,2,0,0,1
11512215,1,1,0,0,2,2,0,0,0
11512425,2,2,0,0,1,1,0,0,0
11512543,3,3,0,0,0,0,0,0,0
11512651,4,4,0,0,2,1,1,1,1
11512711,4,4,0,0,2,1,1,1,1
11513149,2,1,1,0,2,1,1,0,0
11513400,2,1,1,0,3,1,2,1,0
11513686,2,1,1,0,2,1,1,0,0
11513859,2,2,0,0,2,2,0,0,0
11514519,2,1,1,0,2,1,1,0,0
11514520,2,2,0,0,2,2,0,0,1
11514576,2,1,1,0,2,1,1,0,0
11514580,2,1,1,0,2,1,1,0,0
11514601,1,1,0,0,1,1,0,0,0
11515000,2,1,1,0,2,1,1,0,0
11515123,2,1,1,0,2,1,1,0,0
11515235,2,1,1,0,2,1,1,0,0
11516067,2,1,1,0,2,1,1,0,0
11516189,1,1,0,0,1,1,0,0,0
11516411,5,5,0,0,0,0,0,0,0
11516576,2,0,2,0,3,1,2,0,0
11517267,6,6,0,0,4,3,1,0,1
11518391,1,0,1,0,1,1,0,0,0
11518496,2,2,0,0,1,1,0,1,0
11518913,3,1,2,0,3,1,2,0,0
11520028,4,3,1,0,1,1,0,1,1
11520277,1,0,1,0,1,1,0,1,0
11520459,4,4,0,0,0,0,0,0,0
11520461,2,2,0,0,1,1,0,1,1
11520520,1,1,0,0,1,1,0,0,0
11520627,1,1,0,0,1,1,0,0,0
11520687,1,1,0,0,0,0,0,0,0
11520748,1,1,0,0,1,1,0,0,0
11520933,4,3,1,0,1,1,0,1,1
11521035,4,3,1,0,1,1,0,1,1
11521141,1,1,0,0,1,1,0,0,0
11521524,1,1,0,0,1,1,0,0,0
11521705,1,1,0,0,1,1,0,0,1
11522080,3,2,1,0,0,0,0,0,0
11522118,7,7,0,0,3,0,3,0,0
11522126,2,2,0,0,1,1,0,0,0
11522241,1,1,0,0,1,1,0,0,0
11522546,1,1,0,0,1,1,0,0,0
11522560,2,2,0,0,2,2,0,0,0
11523531,1,1,0,0,1,1,0,0,0
11523800,3,2,1,0,2,2,0,0,1
11523808,3,1,2,0,2,1,1,0,0
11524889,1,1,0,0,1,1,0,0,0
11525403,2,2,0,0,2,2,0,0,0
11526953,1,1,0,0,1,1,0,0,0
11527021,1,1,0,0,1,1,0,0,0
11527030,1,1,0,0,1,1,0,0,0
11527294,2,2,0,0,2,2,0,0,0
11527412,2,1,1,0,2,1,1,0,0
11527418,2,1,1,0,2,1,1,0,0
11527794,1,1,0,0,1,1,0,0,0
11528198,1,1,0,0,0,0,0,0,0
11528381,2,2,0,0,1,1,0,0,0
11528436,2,2,0,0,2,2,0,0,1
11528605,9,8,1,0,0,0,0,0,0
11528712,1,1,0,0,1,1,0,0,0
11528835,1,1,0,0,1,1,0,0,0
11528935,1,1,0,0,1,1,0,0,0
11528948,8,8,0,0,1,0,1,0,0
11529072,3,3,0,0,2,2,0,0,0
11529286,4,4,0,0,0,0,0,0,0
11530355,1,1,0,0,2,2,0,0,0
11530525,1,1,0,0,1,1,0,0,0
11530711,1,1,0,0,1,1,0,0,0
11530771,2,2,0,0,2,2,0,0,0
11530984,3,3,0,0,3,3,0,0,0
11530996,1,1,0,0,1,1,0,0,0
11531377,5,5,0,0,2,2,0,0,1
11531390,3,3,0,0,2,2,0,0,0
11531410,5,5,0,0,2,2,0,0,1
11531481,5,5,0,0,2,2,0,0,1
11531536,5,5,0,0,2,2,0,0,1
11531543,5,5,0,0,2,2,0,0,1
11531546,5,5,0,0,2,2,0,0,1
11531608,5,5,0,0,2,2,0,0,1
11531614,5,5,0,0,2,2,0,0,1
11531658,2,2,0,0,1,1,0,1,1
11531663,2,2,0,0,2,2,0,0,0
11531668,1,1,0,0,1,1,0,0,0
11531689,5,5,0,0,2,2,0,0,1
11531711,5,5,0,0,2,2,0,0,1
11531712,5,1,4,0,3,0,3,0,0
11531754,1,1,0,0,1,1,0,1,1
11532061,1,1,0,0,1,1,0,0,0
11532338,12,9,3,0,9,9,0,0,0
11532505,1,1,0,0,1,1,0,0,1
11532535,4,4,0,0,3,3,0,0,1
11532538,4,4,0,0,3,3,0,0,1
11532679,1,1,0,0,0,0,0,0,0
11532987,1,1,0,0,0,0,0,0,0
11533373,1,1,0,0,1,1,0,0,0
11533547,4,4,0,0,1,1,0,1,0
11533582,1,1,0,0,1,1,0,0,0
11533583,1,0,1,0,1,1,0,0,0
11533699,1,1,0,0,1,1,0,0,0
11534076,1,1,0,0,1,1,0,0,0
11534291,2,2,0,0,1,1,0,0,0
11535090,2,2,0,0,2,2,0,0,0
11535116,5,0,5,0,1,1,0,1,0
11535274,2,2,0,0,2,2,0,0,0
11535361,3,3,0,0,2,2,0,0,0
11535719,3,3,0,0,2,2,0,0,1
11535763,1,1,0,0,1,1,0,0,0
11535957,6,5,1,0,1,1,0,1,1
11536220,2,2,0,0,1,1,0,1,1
11536483,2,0,2,0,2,2,0,0,0
11536507,1,1,0,0,2,2,0,0,0
11536769,4,3,1,0,1,1,0,1,0
11536875,1,1,0,0,1,1,0,0,0
11536969,2,1,1,0,1,1,0,0,0
11538016,2,2,0,0,1,1,0,0,0
11538306,1,1,0,0,1,1,0,0,0
11538468,1,1,0,0,2,1,1,0,0
11538561,1,1,0,0,1,1,0,0,0
11539076,2,2,0,0,1,1,0,0,0
11539835,3,3,0,0,1,1,0,0,1
11539943,7,7,0,0,0,0,0,0,1
11539991,1,1,0,0,1,1,0,0,0
11540429,4,4,0,0,0,0,0,0,0
11540453,1,1,0,0,1,1,0,0,0
11540795,2,2,0,0,1,1,0,0,0
11540799,1,1,0,0,1,1,0,0,0
11541207,2,2,0,0,1,1,0,0,1
11541362,3,3,0,0,1,1,0,1,0
11541390,3,3,0,0,1,1,0,1,1
11541926,3,3,0,0,1,1,0,1,1
11542503,1,1,0,0,1,1,0,0,0
11542560,2,2,0,0,4,4,0,1,0
11542594,2,2,0,0,1,1,0,0,0
11542944,3,3,0,0,1,1,0,1,1
11543247,1,1,0,0,1,1,0,0,0
11543773,1,1,0,0,1,1,0,0,0
11543900,1,1,0,0,1,1,0,0,0
11543926,1,1,0,0,1,1,0,0,0
11544309,2,2,0,0,1,1,0,1,0
11544364,1,1,0,0,1,1,0,0,0
11544481,3,3,0,0,2,1,1,0,1
11544650,1,1,0,0,1,1,0,0,0
11544768,8,7,1,2,1,1,0,1,0
11544778,7,5,2,0,1,1,0,1,0
11544897,1,1,0,0,1,1,0,0,0
11544931,2,2,0,0,1,1,0,0,0
08983000,7,0,7,0,1,1,0,0,0
08983032,2,0,2,0,0,0,0,0,0
08983138,2,0,2,0,0,0,0,0,0
08983334,11,0,11,0,1,1,0,0,0
08983354,4,0,4,0,2,1,1,0,0
08983360,7,5,2,0,1,1,0,1,1
08983608,4,0,4,0,1,1,0,0,1
08983669,2,0,2,0,0,0,0,0,0
08983681,3,3,0,0,2,2,0,0,0
08983835,2,0,2,0,0,0,0,0,0
08983844,2,0,2,0,0,0,0,0,0
08983946,2,0,2,0,0,0,0,0,0
08983957,2,0,2,0,0,0,0,0,0
08983982,2,0,2,0,0,0,0,0,0
08984010,2,0,2,0,0,0,0,0,0
08984012,2,0,2,0,0,0,0,0,0
08984051,2,0,2,0,0,0,0,0,0
08984079,2,0,2,0,0,0,0,0,0
08984115,2,0,2,0,0,0,0,0,0
08984134,2,0,2,0,0,0,0,0,0
08984136,2,0,2,0,0,0,0,0,0
08984156,2,0,2,0,0,0,0,0,0
08984176,2,0,2,0,0,0,0,0,0
08984193,2,0,2,0,0,0,0,0,0
08984202,2,0,2,0,0,0,0,0,0
08984206,2,0,2,0,0,0,0,0,0
08984296,2,0,2,0,0,0,0,0,0
08984328,2,0,2,0,0,0,0,0,0
08984340,2,0,2,0,0,0,0,0,0
08984361,2,0,2,0,0,0,0,0,0
08984379,2,0,2,0,0,0,0,0,0
08984393,2,0,2,0,0,0,0,0,0
08984422,2,0,2,0,0,0,0,0,0
08984438,3,3,0,0,2,2,0,0,0
08984441,2,0,2,0,0,0,0,0,1
08984444,2,0,2,0,0,0,0,0,0
08984474,2,0,2,0,0,0,0,0,0
08984531,2,0,2,0,0,0,0,0,0
08984568,2,0,2,0,0,0,0,0,0
08984571,2,0,2,0,0,0,0,0,0
08984581,2,0,2,0,0,0,0,0,0
08984611,2,0,2,0,0,0,0,0,0
08984618,2,0,2,0,0,0,0,0,0
08984673,2,0,2,0,0,0,0,0,0
08984674,2,0,2,0,0,0,0,0,0
08984679,2,0,2,0,0,0,0,0,0
08984750,2,0,2,0,0,0,0,0,0
08984791,2,0,2,0,0,0,0,0,0
08984801,2,0,2,0,0,0,0,0,0
08984835,2,0,2,0,0,0,0,0,0
08984842,2,0,2,0,0,0,0,0,0
08984881,2,0,2,0,0,0,0,0,0
08984889,2,0,2,0,0,0,0,0,0
08984901,2,0,2,0,0,0,0,0,0
08984911,2,0,2,0,0,0,0,0,0
08984913,2,0,2,0,0,0,0,0,0
08984928,2,0,2,0,0,0,0,0,0
08984945,2,0,2,0,0,0,0,0,0
08985015,2,0,2,0,0,0,0,0,0
08985019,2,0,2,0,0,0,0,0,0
08985052,2,0,2,0,0,0,0,0,0
08985062,2,0,2,0,0,0,0,0,0
08985092,2,0,2,0,0,0,0,0,0
08985624,2,0,2,0,0,0,0,0,0
08985626,2,0,2,0,0,0,0,0,0
08985693,2,0,2,0,0,0,0,0,0
08985746,2,0,2,0,0,0,0,0,0
08985861,15,1,14,0,5,1,4,0,0
08985865,2,0,2,0,0,0,0,0,0
08985872,2,0,2,0,0,0,0,0,0
08985933,2,0,2,0,0,0,0,0,0
08985937,2,0,2,0,0,0,0,0,0
08985950,2,0,2,0,0,0,0,0,0
08986034,2,0,2,0,0,0,0,0,0
08986106,2,0,2,0,0,0,0,0,0
08986110,1,1,0,0,1,1,0,0,1
08986118,2,0,2,0,0,0,0,0,0
08986157,8,0,8,0,2,1,1,0,0
08986224,2,0,2,0,0,0,0,0,0
08986243,23,5,18,0,0,0,0,0,0
08986266,7,6,1,0,1,1,0,0,1
08986331,2,0,2,0,0,0,0,0,0
08986334,8,5,3,0,0,0,0,0,0
08986377,2,0,2,0,0,0,0,0,0
08986380,2,0,2,0,0,0,0,0,0
08986416,2,0,2,0,0,0,0,0,0
08986418,2,0,2,0,0,0,0,0,0
08986430,2,0,2,0,0,0,0,0,0
08986435,2,0,2,0,0,0,0,0,0
08986439,2,0,2,0,0,0,0,0,0
08986474,2,0,2,0,0,0,0,0,0
08986487,2,0,2,0,0,0,0,0,0
08986535,1,1,0,0,1,1,0,0,1
08986583,2,0,2,0,0,0,0,0,0
08986593,2,2,0,0,1,1,0,1,0
08986641,7,1,6,1,1,1,0,0,1
08986650,2,0,2,0,0,0,0,0,0
08986661,7,1,6,1,1,1,0,0,1
08986705,1,1,0,0,2,2,0,1,1
08986719,2,0,2,0,0,0,0,0,0
08986750,2,0,2,0,0,0,0,0,0
08986792,2,0,2,0,0,0,0,0,0
08986820,2,0,2,0,0,0,0,0,0
08986825,2,0,2,0,0,0,0,0,0
08986867,2,0,2,0,0,0,0,0,0
08986942,2,0,2,0,0,0,0,0,0
08986972,2,0,2,0,0,0,0,0,0
08986979,2,0,2,0,0,0,0,0,0
08987048,2,2,0,0,2,2,0,0,0
08987669,2,0,2,0,0,0,0,0,0
08987865,2,2,0,0,2,2,0,0,0
08987876,1,1,0,0,1,1,0,0,0
08987923,2,2,0,0,2,2,0,0,0
08987993,1,1,0,0,3,3,0,0,1
08988062,3,0,3,0,0,0,0,0,1
08988310,1,1,0,0,1,1,0,0,1
08988550,8,6,2,0,5,5,0,0,1
08988822,3,1,2,0,0,0,0,0,1
08988882,8,0,8,0,0,0,0,0,0
08988965,2,1,1,0,1,1,0,0,0
08989351,5,3,2,0,1,1,0,0,1
08989418,2,2,0,0,2,2,0,0,1
08989950,1,1,0,0,2,1,1,0,0
08990313,7,1,6,0,3,1,2,0,0
08990362,2,2,0,0,2,2,0,0,0
08990524,3,1,2,0,1,1,0,0,0
08990532,2,1,1,0,1,1,0,0,0
08991099,16,5,11,0,0,0,0,0,1
08991117,4,0,4,0,0,0,0,0,1
08991208,2,2,0,0,2,2,0,0,0
08991220,12,6,6,0,1,1,0,1,1
08991232,3,2,1,0,1,1,0,0,0
08991511,15,6,9,0,0,0,0,0,0
08991513,3,3,0,0,2,2,0,0,1
08991827,8,6,2,0,1,1,0,1,1
08991829,3,0,3,0,0,0,0,0,1
08992057,2,0,2,0,0,0,0,0,1
08992064,1,1,0,0,1,1,0,0,0
08992129,6,5,1,0,1,1,0,1,1
08992161,7,6,1,0,1,1,0,1,1
08992637,4,4,0,0,1,1,0,0,1
08992644,6,0,6,0,2,1,1,0,0
08992719,8,1,7,0,2,1,1,0,0
08992784,6,0,6,0,3,1,2,0,0
08993342,8,3,5,0,1,1,0,1,0
08993347,8,3,5,0,1,1,0,1,0
08993533,5,3,2,0,1,1,0,1,1
08993679,2,2,0,0,2,2,0,0,0
08994093,3,2,1,0,1,1,0,1,1
08994227,2,2,0,0,2,2,0,0,0
08994663,2,2,0,0,2,2,0,0,0
08994735,2,2,0,0,1,1,0,0,0
08995162,3,3,0,0,2,2,0,0,0
08995483,1,0,1,0,0,0,0,0,0
08996011,2,2,0,0,2,2,0,0,0
08996103,10,5,5,0,1,1,0,1,1
08996352,10,6,4,0,0,0,0,0,1
08996564,24,16,8,0,0,0,0,0,1
08996955,3,3,0,0,1,1,0,0,1
08997089,4,4,0,0,0,0,0,0,1
08997391,4,4,0,0,0,0,0,0,1
08997459,4,4,0,0,0,0,0,0,1
08997482,1,1,0,0,1,1,0,0,0
08997616,1,0,1,0,1,1,0,0,0
08997863,7,0,7,0,3,1,2,0,0
08997871,10,1,9,0,5,1,4,0,0
08997910,5,0,5,0,2,1,1,0,0
08997915,8,0,8,0,3,1,2,0,0
08997980,2,0,2,0,1,1,0,0,0
08998436,3,3,0,0,1,1,0,0,0
08998445,10,5,5,0,0,0,0,0,0
08998669,13,0,13,1,0,0,0,0,1
08998676,8,3,5,0,1,1,0,1,0
08998947,3,2,1,0,1,1,0,1,1
08999061,3,3,0,0,1,1,0,1,1
08999247,1,1,0,0,1,1,0,0,1
08999258,5,5,0,0,6,6,0,1,1
08999318,5,5,0,0,6,6,0,1,1
08999336,5,5,0,0,6,6,0,1,1
08999348,5,5,0,0,6,6,0,1,1
08999365,5,5,0,0,6,6,0,1,1
08999413,5,5,0,0,6,6,0,1,1
08999416,5,5,0,0,6,6,0,1,1
08999455,7,3,4,0,7,3,4,1,1
08999481,5,5,0,0,6,6,0,1,1
08999758,1,1,0,0,1,1,0,0,0
08999800,1,0,1,0,0,0,0,0,0
09000032,1,1,0,0,1,1,0,0,0
09000163,4,0,4,0,1,0,1,0,0
09000390,6,4,2,0,1,1,0,1,1
09000480,2,2,0,0,1,1,0,0,0
09000503,7,2,5,0,1,1,0,0,1
09000531,6,1,5,0,0,0,0,0,0
09000557,1,1,0,0,1,1,0,0,0
09000568,5,0,5,0,0,0,0,0,1
09000891,12,6,6,0,0,0,0,0,1
09002406,2,2,0,0,1,1,0,0,1
09002678,14,9,5,0,1,1,0,1,1
09002688,4,4,0,0,1,1,0,1,0
09002813,2,2,0,0,2,2,0,0,0
09003422,2,2,0,0,1,1,0,0,0
09004093,4,2,2,0,2,2,0,0,1
09004332,1,1,0,0,1,1,0,0,0
09004661,1,1,0,0,1,1,0,0,0
09004911,2,2,0,0,1,1,0,0,0
09004994,1,1,0,0,1,1,0,0,0
09005031,3,1,2,0,1,1,0,0,0
09005648,2,0,2,0,0,0,0,0,1
09005814,2,0,2,0,0,0,0,0,1
09006002,1,1,0,0,0,0,0,0,0
09006258,1,1,0,0,1,1,0,0,0
09006269,4,3,1,0,0,0,0,0,0
09006840,1,0,1,0,0,0,0,0,1
09007095,3,0,3,0,0,0,0,0,1
09007658,13,7,6,0,5,0,5,0,1
09007661,2,2,0,0,1,1,0,0,0
09007964,4,3,1,0,0,0,0,0,1
09008176,4,1,3,0,1,1,0,1,1
09008680,27,10,17,0,0,0,0,0,1
09008935,2,0,2,0,0,0,0,0,0
09009000,2,0,2,0,0,0,0,0,0
09009007,9,8,1,0,0,0,0,0,0
09009211,5,2,3,0,2,2,0,0,0
09009298,3,1,2,0,1,1,0,0,1
09009519,6,3,3,0,2,2,0,1,0
09010354,8,6,2,0,8,5,3,2,1
09010896,1,0,1,0,1,1,0,1,1
09010946,1,0,1,0,1,1,0,1,1
09011197,5,1,4,0,0,0,0,0,0
09011881,4,4,0,0,0,0,0,0,1
09011897,2,2,0,0,1,1,0,0,0
09012347,5,3,2,0,1,1,0,0,0
09012390,1,1,0,0,2,2,0,0,0
09012505,5,5,0,0,1,1,0,1,1
09012635,12,4,8,0,4,1,3,2,1
09012642,12,4,8,0,4,1,3,2,1
09012658,1,1,0,0,1,1,0,1,0
09012674,6,4,2,0,0,0,0,0,1
09012680,2,2,0,0,1,1,0,1,0
09012705,2,2,0,0,1,1,0,1,0
09012840,1,0,1,0,0,0,0,0,1
09013327,2,0,2,0,0,0,0,0,1
09013588,2,1,1,0,1,1,0,0,0
09015536,9,3,6,0,1,1,0,1,1
09015666,2,0,2,0,0,0,0,0,0
09016050,2,0,2,0,0,0,0,0,1
09016279,3,1,2,0,1,1,0,0,0
09016443,4,4,0,0,0,0,0,0,0
09016631,3,2,1,0,1,1,0,1,1
09017123,6,2,4,0,1,1,0,1,1
09017702,5,0,5,0,0,0,0,0,1
09018228,5,5,0,0,3,3,0,2,1
09018263,1,0,1,0,1,1,0,0,1
09018470,1,0,1,0,0,0,0,0,0
09018471,2,2,0,0,1,1,0,0,1
09018512,5,0,5,0,0,0,0,0,0
09018933,1,1,0,0,1,1,0,0,0
09018944,4,4,0,0,2,2,0,0,0
09019045,2,0,2,0,0,0,0,0,1
09019175,1,0,1,0,0,0,0,0,0
09019450,10,7,3,0,1,0,1,0,0
09019619,3,0,3,1,0,0,0,0,1
09020143,3,3,0,0,3,3,0,0,0
09020678,1,1,0,0,1,1,0,0,0
09020731,1,1,0,0,1,1,0,0,1
09020887,1,1,0,0,1,1,0,0,0
09020955,1,1,0,0,1,1,0,0,0
09021380,1,0,1,0,0,0,0,0,0
09021577,3,3,0,0,1,1,0,0,0
09021630,2,2,0,0,2,2,0,0,1
09021839,2,0,2,0,1,1,0,0,1
09021886,1,1,0,0,1,1,0,1,0
09022283,2,2,0,0,2,2,0,0,1
09022406,1,1,0,0,1,1,0,0,0
09022527,1,1,0,0,1,1,0,0,0
09022750,15,8,7,0,2,1,1,2,1
09022829,2,1,1,0,2,1,1,0,1
09022986,22,7,15,0,2,2,0,2,1
09023564,4,4,0,0,1,1,0,0,1
09023596,2,0,2,0,0,0,0,0,1
09023681,2,2,0,0,2,2,0,0,0
09023805,21,14,7,0,0,0,0,0,0
09023943,5,2,3,0,2,2,0,1,0
09024069,10,10,0,0,1,1,0,0,0
09024075,4,2,2,0,2,2,0,1,1
09024278,17,9,8,0,1,0,1,0,1
09024402,2,0,2,0,0,0,0,0,1
09024474,2,2,0,0,2,2,0,0,0
09024483,2,0,2,0,1,1,0,0,0
09026251,2,2,0,0,1,1,0,0,0
09026314,3,0,3,0,0,0,0,0,1
09026438,1,1,0,0,1,1,0,0,0
09026478,8,6,2,0,0,0,0,0,1
09026506,2,1,1,0,3,1,2,1,0
09026542,4,3,1,1,0,0,0,0,0
09026671,2,2,0,0,1,1,0,0,0
09026697,15,11,4,0,0,0,0,0,1
09026938,2,1,1,0,1,1,0,0,0
09027050,9,7,2,0,1,1,0,1,1
09027103,13,5,8,0,0,0,0,0,1
09027131,12,7,5,0,3,0,3,0,1
09027149,2,1,1,0,1,1,0,0,1
09027198,1,1,0,0,1,1,0,0,0
09027498,20,11,9,1,0,0,0,0,1
09027723,4,4,0,0,2,2,0,0,0
09027975,3,3,0,0,3,2,1,0,0
09028292,3,1,2,0,1,1,0,0,0
09028327,7,2,5,0,1,1,0,0,1
09028423,1,0,1,0,0,0,0,0,0
09028455,1,1,0,0,2,2,0,0,0
09028598,11,3,8,0,1,1,0,1,1
09028611,10,10,0,0,1,1,0,1,1
09028775,4,3,1,0,1,1,0,1,0
09029318,1,0,1,0,0,0,0,0,0
09029487,4,2,2,0,3,1,2,3,0
09416251,2,2,0,0,1,1,0,0,0
09416370,1,0,1,0,0,0,0,0,0
09416703,2,2,0,0,2,2,0,0,0
09416929,15,9,6,0,2,2,0,1,1
09417906,9,3,6,0,1,1,0,1,1
09417964,2,0,2,0,2,2,0,0,1
09418019,1,0,1,0,0,0,0,0,1
09418239,1,1,0,0,1,1,0,0,0
09418413,1,1,0,0,1,1,0,0,0
09418518,2,0,2,0,2,2,0,0,1
09418935,2,1,1,0,1,1,0,0,0
09419213,1,1,0,0,1,1,0,0,0
09419242,6,4,2,0,0,0,0,0,1
09419305,2,0,2,0,1,1,0,0,0
09419315,3,1,2,0,1,1,0,0,0
09419407,6,4,2,0,0,0,0,0,0
09419625,1,1,0,0,2,2,0,0,0
09419963,1,1,0,0,1,1,0,0,0
09420311,1,1,0,0,1,1,0,0,1
09420316,1,1,0,0,1,1,0,0,1
09420337,1,0,1,0,0,0,0,0,0
09420344,2,2,0,0,2,2,0,0,1
09420444,1,1,0,0,1,1,0,0,0
09420477,2,2,0,0,2,2,0,0,0
09420637,2,2,0,0,1,1,0,0,1
09420724,6,4,2,0,1,1,0,0,1
09420946,2,0,2,0,0,0,0,0,0
09420967,2,0,2,0,2,2,0,0,0
09421063,8,5,3,0,2,1,1,0,0
09421270,18,8,10,0,1,1,0,1,1
09421352,1,1,0,0,1,1,0,0,0
09421579,6,5,1,0,3,3,0,0,0
09421678,1,1,0,0,1,1,0,0,0
09421831,1,1,0,0,1,1,0,0,0
09422439,5,5,0,0,0,0,0,0,0
09422470,5,3,2,0,1,1,0,1,1
09422758,3,1,2,0,3,1,2,0,0
09422949,3,0,3,0,1,1,0,0,0
09423076,2,2,0,0,1,1,0,0,1
09423086,2,2,0,0,2,2,0,0,0
09423093,2,0,2,0,0,0,0,0,1
09423113,3,3,0,0,1,1,0,0,0
09423215,2,0,2,0,0,0,0,0,1
09423622,2,0,2,0,0,0,0,0,1
09423672,1,1,0,0,1,1,0,0,0
09423756,2,0,2,0,1,1,0,1,0
09423770,2,2,0,0,3,2,1,0,0
09424252,1,1,0,0,1,1,0,0,1
09424505,1,1,0,0,2,2,0,1,1
09425040,2,2,0,0,1,1,0,0,0
09425081,2,0,2,0,0,0,0,0,1
09425260,4,0,4,0,3,1,2,0,0
09425326,2,0,2,0,0,0,0,0,1
09425384,2,2,0,0,2,2,0,0,0
09425475,2,2,0,0,1,1,0,0,0
09425598,2,0,2,0,2,2,0,0,1
09425694,1,1,0,0,1,1,0,0,0
09426029,1,1,0,0,1,1,0,0,0
09426133,3,2,1,0,1,1,0,0,0
09426290,2,2,0,0,2,2,0,0,1
09426356,3,3,0,0,1,1,0,1,0
09426545,2,0,2,0,1,1,0,0,0
09427214,3,0,3,0,0,0,0,0,1
09427358,3,3,0,0,0,0,0,0,1
09427389,7,7,0,0,2,2,0,0,1
09427434,3,2,1,0,1,1,0,0,1
09427772,7,7,0,0,3,1,2,1,1
09427806,8,8,0,0,3,1,2,1,1
09428416,1,1,0,0,1,1,0,0,0
09428474,2,2,0,0,2,2,0,0,1
09428893,2,2,0,0,1,1,0,0,1
09429240,3,2,1,0,1,1,0,0,1
09429768,1,1,0,0,0,0,0,0,0
09429811,4,1,3,0,0,0,0,0,0
09429984,2,2,0,0,1,1,0,0,0
09430026,5,3,2,0,2,1,1,2,1
09430213,7,3,4,0,1,1,0,1,1
09430370,3,0,3,0,0,0,0,0,1
09430670,2,0,2,0,0,0,0,0,1
09430699,2,2,0,0,1,1,0,0,1
09430709,1,1,0,0,1,1,0,0,0
09430710,3,1,2,0,1,1,0,0,1
09431669,7,4,3,0,0,0,0,0,1
09432073,5,4,1,0,1,1,0,1,1
09432082,6,2,4,0,3,3,0,1,1
09432360,2,2,0,0,2,2,0,0,0
09432372,1,1,0,0,1,1,0,0,0
09432644,2,2,0,0,2,2,0,0,0
09432697,7,3,4,0,1,1,0,1,1
09432701,7,3,4,0,0,0,0,0,1
09432722,16,9,7,0,0,0,0,0,0
09432751,5,3,2,0,1,1,0,1,1
09433196,2,2,0,0,2,2,0,0,0
09433814,6,0,6,0,0,0,0,0,1
09433902,8,5,3,0,1,1,0,0,0
09434057,2,2,0,0,2,2,0,0,0
09434153,2,2,0,0,2,2,0,0,0
09434196,5,0,5,0,0,0,0,0,1
09434221,4,2,2,0,1,1,0,0,0
09434888,5,5,0,0,0,0,0,0,1
09436039,2,0,2,0,0,0,0,0,0
09436070,2,1,1,0,1,1,0,0,0
09436132,2,2,0,0,2,2,0,0,1
09436198,1,0,1,0,0,0,0,0,0
09436413,1,1,0,0,1,1,0,0,0
09436524,2,0,2,0,1,1,0,1,1
09436668,7,5,2,0,1,1,0,1,1
09437172,2,1,1,0,1,1,0,0,0
09437526,2,1,1,0,0,0,0,0,1
09438468,2,2,0,0,1,1,0,0,0
09438527,1,1,0,0,1,1,0,0,0
09438693,2,2,0,0,1,1,0,0,1
09438822,6,5,1,0,1,1,0,1,1
09438858,1,1,0,0,2,2,0,0,0
09438903,11,3,8,0,1,1,0,1,1
09439949,3,3,0,0,3,3,0,0,0
09441224,5,4,1,0,2,2,0,0,1
09441327,4,2,2,0,1,1,0,0,0
09441375,2,0,2,0,1,1,0,0,0
09441581,7,6,1,0,6,5,1,0,0
09442187,3,1,2,0,1,0,1,0,0
09442331,6,4,2,0,5,4,1,0,0
09442363,2,0,2,0,0,0,0,0,0
09442376,3,0,3,0,1,1,0,0,0
09442537,5,5,0,0,1,1,0,0,0
09442849,3,0,3,0,0,0,0,0,1
09442951,2,0,2,0,0,0,0,0,0
09443229,4,1,3,0,1,1,0,0,1
09443312,3,3,0,0,1,1,0,0,0
09443401,1,1,0,0,0,0,0,0,0
09443606,1,1,0,0,1,1,0,0,0
09443673,1,0,1,0,0,0,0,0,0
09445220,5,2,3,0,3,3,0,0,0
09445266,2,2,0,0,1,1,0,0,0
09445484,1,1,0,0,1,1,0,0,0
09445624,1,0,1,0,1,1,0,0,0
09446304,3,0,3,0,1,1,0,0,0
09446308,5,1,4,0,0,0,0,0,1
09446551,2,0,2,0,2,2,0,0,1
09446618,1,1,0,0,1,1,0,0,0
09446808,8,4,4,0,0,0,0,0,1
09446993,1,0,1,0,1,1,0,0,0
09446994,2,2,0,0,2,2,0,0,1
09447015,2,2,0,0,1,1,0,0,1
09447152,1,1,0,0,1,1,0,0,0
09447156,3,0,3,0,0,0,0,0,1
09447166,1,0,1,0,1,1,0,0,0
09448639,1,1,0,0,1,1,0,0,0
09448742,10,8,2,0,1,1,0,0,1
09448815,1,1,0,0,2,2,0,0,0
09448819,1,0,1,0,1,1,0,0,0
09448827,1,1,0,0,2,2,0,0,1
09448845,3,0,3,0,2,2,0,0,1
09448940,2,2,0,0,1,1,0,1,0
09448972,2,2,0,0,2,1,1,0,0
09449695,2,2,0,0,2,2,0,0,0
09449752,1,1,0,0,1,1,0,1,1
09450110,1,1,0,0,1,1,0,0,0
09450322,8,3,5,0,3,1,2,1,0
09450542,4,3,1,0,1,1,0,1,1
09451398,3,3,0,0,2,2,0,0,0
09451790,2,2,0,0,2,2,0,0,0
09452014,7,3,4,0,1,1,0,0,0
09452136,2,2,0,0,1,1,0,0,0
09452388,2,0,2,0,0,0,0,0,1
09452653,1,1,0,0,1,1,0,0,1
09452725,1,1,0,0,1,1,0,0,0
09452974,2,0,2,0,0,0,0,0,0
09453212,1,1,0,0,1,1,0,0,1
09453406,1,1,0,0,1,1,0,0,0
09454101,28,15,13,0,0,0,0,0,1
09454361,2,0,2,0,0,0,0,0,0
09454582,3,2,1,0,1,1,0,1,0
09454666,3,3,0,0,2,2,0,0,0
09454789,1,0,1,0,0,0,0,0,0
09454858,2,0,2,0,1,1,0,1,0
09455134,4,3,1,0,2,2,0,0,1
09455775,1,0,1,0,1,1,0,0,1
09456504,5,4,1,0,0,0,0,0,1
09456700,4,4,0,0,1,1,0,1,1
09456829,3,2,1,0,2,2,0,0,0
09456947,2,2,0,0,1,1,0,0,0
09457247,1,1,0,0,1,1,0,0,0
09457255,5,3,2,0,1,1,0,1,0
09457307,1,1,0,0,1,1,0,0,0
09457393,2,2,0,0,2,2,0,0,1
09457855,1,1,0,0,2,1,1,2,0
09458513,10,3,7,0,2,2,0,2,0
09458527,1,1,0,0,2,1,1,2,0
09458564,4,4,0,0,1,1,0,1,1
09458649,1,1,0,0,1,1,0,0,1
09458701,3,0,3,0,3,3,0,0,1
09458725,4,3,1,0,1,1,0,1,1
09458948,5,4,1,0,1,0,1,0,1
09459127,4,3,1,0,3,1,2,3,1
09459310,1,0,1,0,1,1,0,0,0
09459388,3,3,0,0,2,2,0,0,0
09461008,1,1,0,0,1,1,0,0,0
09461250,6,6,0,0,1,1,0,1,1
09461251,7,5,2,0,1,1,0,1,1
09461309,1,1,0,0,1,1,0,0,0
09461411,9,4,5,0,4,3,1,3,1
09461433,4,3,1,2,1,1,0,1,1
09461717,4,3,1,0,2,2,0,0,1
09462069,1,1,0,0,1,1,0,0,1
09462616,6,2,4,0,1,1,0,1,1
09462641,6,0,6,0,0,0,0,0,1
09462755,10,7,3,0,1,1,0,1,1
09462971,2,2,0,0,1,1,0,0,0
09463225,1,1,0,0,2,2,0,0,1
09463485,1,1,0,0,1,1,0,0,0
09463570,4,3,1,1,1,1,0,1,1
09464066,2,0,2,0,0,0,0,0,0
09464418,3,3,0,0,2,2,0,0,0
09465004,2,2,0,0,1,1,0,0,1
09465356,2,0,2,0,0,0,0,0,1
09465639,1,1,0,0,1,1,0,0,0
09465895,1,1,0,0,1,1,0,0,0
CE016707,0,0,0,0,0,0,0,0,0
CE016709,0,0,0,0,0,0,0,0,0
CE016733,0,0,0,0,0,0,0,0,0
CE016738,0,0,0,0,0,0,0,0,0
CE016739,0,0,0,0,0,0,0,0,0
CE016761,0,0,0,0,0,0,0,0,0
CE016762,0,0,0,0,0,0,0,0,0
CE016767,0,0,0,0,0,0,0,0,0
CE016786,0,0,0,0,0,0,0,0,0
CE016819,0,0,0,0,0,0,0,0,0
CE016828,0,0,0,0,0,0,0,0,0
CE016844,0,0,0,0,0,0,0,0,0
CE016853,0,0,0,0,0,0,0,0,0
CE016860,0,0,0,0,0,0,0,0,0
CE016881,0,0,0,0,0,0,0,0,0
CE016890,0,0,0,0,0,0,0,0,0
CE016903,0,0,0,0,0,0,0,0,0
CE016922,0,0,0,0,0,0,0,0,0
CE016934,0,0,0,0,0,0,0,0,0
CE016992,0,0,0,0,0,0,0,0,0
CE017003,0,0,0,0,0,0,0,0,0
CE017075,0,0,0,0,0,0,0,0,0
CE017141,0,0,0,0,0,0,0,0,0
CE017250,0,0,0,0,0,0,0,0,0
CE017268,0,0,0,0,0,0,0,0,0
CE017270,0,0,0,0,0,0,0,0,0
CE017299,0,0,0,0,0,0,0,0,0
CE017354,0,0,0,0,0,0,0,0,0
CE017416,0,0,0,0,0,0,0,0,0
CE017473,0,0,0,0,0,0,0,0,0
CE017485,0,0,0,0,0,0,0,0,0
CE017508,0,0,0,0,0,0,0,0,0
CE017522,0,0,0,0,0,0,0,0,0
CE017574,0,0,0,0,0,0,0,0,0
CE017579,0,0,0,0,0,0,0,0,0
CE017593,0,0,0,0,0,0,0,0,0
CE017596,0,0,0,0,0,0,0,0,0
CS000025,0,0,0,0,0,0,0,0,0
CS000029,0,0,0,0,0,0,0,0,0
CS000040,0,0,0,0,0,0,0,0,0
CS000093,0,0,0,0,0,0,0,0,0
CS000095,0,0,0,0,0,0,0,0,0
CS000098,0,0,0,0,0,0,0,0,0
CS000120,0,0,0,0,0,0,0,0,0
CS000147,0,0,0,0,0,0,0,0,0
CS000157,0,0,0,0,0,0,0,0,0
CS000175,0,0,0,0,0,0,0,0,0
CS000176,0,0,0,0,0,0,0,0,0
CS000179,0,0,0,0,0,0,0,0,0
CS000184,0,0,0,0,0,0,0,0,0
CS000199,0,0,0,0,0,0,0,0,0
CS000201,0,0,0,0,0,0,0,0,0
CS000202,0,0,0,0,0,0,0,0,0
CS000225,0,0,0,0,0,0,0,0,0
CS000232,0,0,0,0,0,0,0,0,0
CS000245,0,0,0,0,0,0,0,0,0
CS000248,0,0,0,0,0,0,0,0,0
CS000269,0,0,0,0,0,0,0,0,0
CS000293,0,0,0,0,0,0,0,0,0
CS000313,0,0,0,0,0,0,0,0,0
CS000329,0,0,0,0,0,0,0,0,0
CS000331,0,0,0,0,0,0,0,0,0
CS000340,0,0,0,0,0,0,0,0,0
CS000362,0,0,0,0,0,0,0,0,0
CS000369,0,0,0,0,0,0,0,0,0
CS000437,0,0,0,0,0,0,0,0,0
CS000455,0,0,0,0,0,0,0,0,0
CS000468,0,0,0,0,0,0,0,0,0
CS000471,0,0,0,0,0,0,0,0,0
CS000472,0,0,0,0,0,0,0,0,0
CS000478,0,0,0,0,0,0,0,0,0
CS000506,0,0,0,0,0,0,0,0,0
CS000513,0,0,0,0,0,0,0,0,0
CS000514,0,0,0,0,0,0,0,0,0
CS000518,0,0,0,0,0,0,0,0,0
CS000521,0,0,0,0,0,0,0,0,0
CS000530,0,0,0,0,0,0,0,0,0
CS000533,0,0,0,0,0,0,0,0,0
CS000540,0,0,0,0,0,0,0,0,0
CS000544,0,0,0,0,0,0,0,0,0
CS000552,0,0,0,0,0,0,0,0,0
CS000560,0,0,0,0,0,0,0,0,0
CS000565,0,0,0,0,0,0,0,0,0
CS000566,0,0,0,0,0,0,0,0,0
CS000572,0,0,0,0,0,0,0,0,0
CS000579,0,0,0,0,0,0,0,0,0
CS000583,0,0,0,0,0,0,0,0,0
CS000591,0,0,0,0,0,0,0,0,0
CS000601,0,0,0,0,0,0,0,0,0
CS000605,0,0,0,0,0,0,0,0,0
CS000621,0,0,0,0,0,0,0,0,0
CS000633,0,0,0,0,0,0,0,0,0
CS000718,0,0,0,0,0,0,0,0,0
CS000719,0,0,0,0,0,0,0,0,0
CS000738,0,0,0,0,0,0,0,0,0
CS000760,0,0,0,0,0,0,0,0,0
CS000769,0,0,0,0,0,0,0,0,0
CS000786,0,0,0,0,0,0,0,0,0
CS000787,0,0,0,0,0,0,0,0,0
CS000809,0,0,0,0,0,0,0,0,0
CS000870,0,0,0,0,0,0,0,0,0
CS000873,0,0,0,0,0,0,0,0,0
CS000887,0,0,0,0,0,0,0,0,0
CS000916,0,0,0,0,0,0,0,0,0
CS000918,0,0,0,0,0,0,0,0,0
CS000930,0,0,0,0,0,0,0,0,0
CS000954,0,0,0,0,0,0,0,0,0
CS000968,0,0,0,0,0,0,0,0,0
CS000970,0,0,0,0,0,0,0,0,0
CS000981,0,0,0,0,0,0,0,0,0
CS000985,0,0,0,0,0,0,0,0,0
CS000994,0,0,0,0,0,0,0,0,0
CS001006,0,0,0,0,0,0,0,0,0
CS001009,0,0,0,0,0,0,0,0,0
CS001048,0,0,0,0,0,0,0,0,0
CS001053,0,0,0,0,0,0,0,0,0
CS001063,0,0,0,0,0,0,0,0,0
CS001081,0,0,0,0,0,0,0,0,0
CS001120,0,0,0,0,0,0,0,0,0
CS001124,0,0,0,0,0,0,0,0,0
CS001141,0,0,0,0,0,0,0,0,0
CS001149,0,0,0,0,0,0,0,0,0
CS001162,0,0,0,0,0,0,0,0,0
CS001167,0,0,0,0,0,0,0,0,0
CS001184,0,0,0,0,0,0,0,0,0
CS001205,0,0,0,0,0,0,0,0,0
CS001210,0,0,0,0,0,0,0,0,0
CS001255,0,0,0,0,0,0,0,0,0
CS001272,0,0,0,0,0,0,0,0,0
CS001311,0,0,0,0,0,0,0,0,0
CS001332,0,0,0,0,0,0,0,0,0
CS001358,0,0,0,0,0,0,0,0,0
CS001370,0,0,0,0,0,0,0,0,0
CS001384,0,0,0,0,0,0,0,0,0
CS001386,0,0,0,0,0,0,0,0,0
CS001390,0,0,0,0,0,0,0,0,0
CS001402,0,0,0,0,0,0,0,0,0
CS001430,0,0,0,0,0,0,0,0,0
CS001442,0,0,0,0,0,0,0,0,0
CS001447,0,0,0,0,0,0,0,0,0
CS001450,0,0,0,0,0,0,0,0,0
CS001465,0,0,0,0,0,0,0,0,0
CS001470,0,0,0,0,0,0,0,0,0
CS001497,0,0,0,0,0,0,0,0,0
CS001513,0,0,0,0,0,0,0,0,0
CS001524,0,0,0,0,0,0,0,0,0
CS001528,0,0,0,0,0,0,0,0,0
CS001530,0,0,0,0,0,0,0,0,0
CS001566,0,0,0,0,0,0,0,0,0
CS001578,0,0,0,0,0,0,0,0,0
CS001609,0,0,0,0,0,0,0,0,0
CS001623,0,0,0,0,0,0,0,0,0
CS001630,0,0,0,0,0,0,0,0,0
CS001638,0,0,0,0,0,0,0,0,0
CS001671,0,0,0,0,0,0,0,0,0
CS001688,0,0,0,0,0,0,0,0,0
CS001702,0,0,0,0,0,0,0,0,0
CS001719,0,0,0,0,0,0,0,0,0
CS001726,0,0,0,0,0,0,0,0,0
CS001727,0,0,0,0,0,0,0,0,0
CS001743,0,0,0,0,0,0,0,0,0
CS001746,0,0,0,0,0,0,0,0,0
CS001748,0,0,0,0,0,0,0,0,0
CS001750,0,0,0,0,0,0,0,0,0
CS001753,0,0,0,0,0,0,0,0,0
CS001772,0,0,0,0,0,0,0,0,0
CS001787,0,0,0,0,0,0,0,0,0
CS001803,0,0,0,0,0,0,0,0,0
CS001806,0,0,0,0,0,0,0,0,0
CS001812,0,0,0,0,0,0,0,0,0
CS001814,0,0,0,0,0,0,0,0,0
CS001842,0,0,0,0,0,0,0,0,0
CS001846,0,0,0,0,0,0,0,0,0
CS001862,0,0,0,0,0,0,0,0,0
CS001865,0,0,0,0,0,0,0,0,0
CS001866,0,0,0,0,0,0,0,0,0
CS001886,0,0,0,0,0,0,0,0,0
CS001919,0,0,0,0,0,0,0,0,0
CS001922,0,0,0,0,0,0,0,0,0
CS001949,0,0,0,0,0,0,0,0,0
CS001955,0,0,0,0,0,0,0,0,0
CS001961,0,0,0,0,0,0,0,0,0
CS001963,0,0,0,0,0,0,0,0,0
CS001970,0,0,0,0,0,0,0,0,0
CS001972,0,0,0,0,0,0,0,0,0
CS001980,0,0,0,0,0,0,0,0,0
CS001986,0,0,0,0,0,0,0,0,0
CS001988,0,0,0,0,0,0,0,0,0
CS002003,0,0,0,0,0,0,0,0,0
CS002006,0,0,0,0,0,0,0,0,0
CS002007,0,0,0,0,0,0,0,0,0
CS002015,0,0,0,0,0,0,0,0,0
CS002020,0,0,0,0,0,0,0,0,0
CS002028,0,0,0,0,0,0,0,0,0
CS002031,0,0,0,0,0,0,0,0,0
CS002051,0,0,0,0,0,0,0,0,0
CS002062,0,0,0,0,0,0,0,0,0
CS002069,0,0,0,0,0,0,0,0,0
CS002074,0,0,0,0,0,0,0,0,0
CS002078,0,0,0,0,0,0,0,0,0
CS002079,0,0,0,0,0,0,0,0,0
CS002083,0,0,0,0,0,0,0,0,0
CS002085,0,0,0,0,0,0,0,0,0
CS002143,0,0,0,0,0,0,0,0,0
CS002155,0,0,0,0,0,0,0,0,0
CS002156,0,0,0,0,0,0,0,0,0
CS002198,0,0,0,0,0,0,0,0,0
CS002208,0,0,0,0,0,0,0,0,0
CS002213,0,0,0,0,0,0,0,0,0
CS002227,0,0,0,0,0,0,0,0,0
CS002230,0,0,0,0,0,0,0,0,0
CS002231,0,0,0,0,0,0,0,0,0
CS002233,0,0,0,0,0,0,0,0,0
CS002250,0,0,0,0,0,0,0,0,0
CS002251,0,0,0,0,0,0,0,0,0
CS002262,0,0,0,0,0,0,0,0,0
CS002269,0,0,0,0,0,0,0,0,0
CS002270,0,0,0,0,0,0,0,0,0
CS002279,0,0,0,0,0,0,0,0,0
CS002281,0,0,0,0,0,0,0,0,0
CS002283,0,0,0,0,0,0,0,0,0
CS002291,0,0,0,0,0,0,0,0,0
CS002300,0,0,0,0,0,0,0,0,0
CS002311,0,0,0,0,0,0,0,0,0
CS002327,0,0,0,0,0,0,0,0,0
CS002376,0,0,0,0,0,0,0,0,0
CS002417,0,0,0,0,0,0,0,0,0
CS002419,0,0,0,0,0,0,0,0,0
CS002430,0,0,0,0,0,0,0,0,0
CS002431,0,0,0,0,0,0,0,0,0
CS002435,0,0,0,0,0,0,0,0,0
CS002448,0,0,0,0,0,0,0,0,0
CS002451,0,0,0,0,0,0,0,0,0
CS002506,0,0,0,0,0,0,0,0,0
CS002513,0,0,0,0,0,0,0,0,0
CS002514,0,0,0,0,0,0,0,0,0
CS002515,0,0,0,0,0,0,0,0,0
CS002519,0,0,0,0,0,0,0,0,0
CS002523,0,0,0,0,0,0,0,0,0
CS002534,0,0,0,0,0,0,0,0,0
CS002550,0,0,0,0,0,0,0,0,0
CS002605,0,0,0,0,0,0,0,0,0
CS002608,0,0,0,0,0,0,0,0,0
CS002669,0,0,0,0,0,0,0,0,0
CS002678,0,0,0,0,0,0,0,0,0
CS002691,0,0,0,0,0,0,0,0,0
CS002699,0,0,0,0,0,0,0,0,0
CS002708,0,0,0,0,0,0,0,0,0
CS002720,0,0,0,0,0,0,0,0,0
CS002728,0,0,0,0,0,0,0,0,0
CS002743,0,0,0,0,0,0,0,0,0
CS002757,0,0,0,0,0,0,0,0,0
CS002784,0,0,0,0,0,0,0,0,0
CS002802,0,0,0,0,0,0,0,0,0
CS002807,0,0,0,0,0,0,0,0,0
CS002828,0,0,0,0,0,0,0,0,0
CS002840,0,0,0,0,0,0,0,0,0
CS002855,0,0,0,0,0,0,0,0,0
CS002875,0,0,0,0,0,0,0,0,0
CS002925,0,0,0,0,0,0,0,0,0
CS002928,0,0,0,0,0,0,0,0,0
CS002930,0,0,0,0,0,0,0,0,0
CS002942,0,0,0,0,0,0,0,0,0
CS002951,0,0,0,0,0,0,0,0,0
CS002956,0,0,0,0,0,0,0,0,0
CS002973,0,0,0,0,0,0,0,0,0
CS002986,0,0,0,0,0,0,0,0,0
CS002988,0,0,0,0,0,0,0,0,0
11324233,3,3,0,0,2,2,0,0,0
11324439,2,2,0,0,2,2,0,0,1
11324574,1,1,0,0,1,1,0,0,0
11324845,1,1,0,0,1,1,0,0,0
11324883,2,2,0,0,1,1,0,0,0
11325421,2,2,0,0,2,2,0,0,0
11325733,2,2,0,0,1,1,0,0,0
11326414,4,3,1,0,1,1,0,1,1
11326864,1,1,0,0,1,1,0,0,0
11327119,3,1,2,0,0,0,0,0,0
11327121,2,2,0,0,1,1,0,0,0
11327549,1,1,0,0,1,1,0,0,0
11327799,1,1,0,0,1,1,0,0,0
11329096,3,3,0,0,0,0,0,0,0
11329342,2,2,0,0,1,1,0,1,0
11329930,2,2,0,0,2,2,0,0,0
11329949,4,4,0,0,1,1,0,1,0
11330230,1,1,0,0,1,1,0,0,0
11331063,1,1,0,0,1,1,0,0,0
11331313,3,1,2,0,2,1,1,0,0
11331382,3,3,0,0,1,1,0,0,0
11331474,2,2,0,0,1,1,0,0,0
11331597,1,1,0,0,1,1,0,0,0
11331820,5,5,0,0,1,1,0,1,1
11331987,5,5,0,0,0,0,0,0,1
11332002,2,1,1,0,2,1,1,1,0
11332200,2,2,0,0,1,1,0,0,0
11332354,1,1,0,0,2,2,0,0,0
11332654,2,2,0,0,0,0,0,0,0
11332951,3,3,0,0,2,2,0,0,1
11333075,1,1,0,0,1,1,0,0,0
11333222,1,1,0,0,1,1,0,0,0
11333290,1,1,0,0,0,0,0,0,1
11333311,2,1,1,0,1,1,0,0,0
11333643,6,5,1,0,4,2,2,2,1
11333644,1,1,0,0,1,1,0,0,0
11334204,1,1,0,0,1,1,0,0,0
11334244,1,1,0,0,1,1,0,0,1
11334596,4,4,0,0,2,2,0,0,0
11335194,6,6,0,0,0,0,0,0,0
11335221,1,1,0,0,1,1,0,0,1
11335327,2,2,0,0,1,1,0,0,0
11335438,2,2,0,0,0,0,0,0,0
11335489,3,3,0,0,3,3,0,0,0
11335975,1,1,0,0,1,1,0,0,0
11335987,1,1,0,0,1,1,0,0,0
11336333,3,3,0,0,2,2,0,0,0
11336345,5,5,0,0,0,0,0,0,0
11337815,8,4,4,2,1,1,0,1,0
11337976,8,4,4,2,1,1,0,1,0
11338405,2,2,0,0,1,1,0,0,0
11338597,5,5,0,0,0,0,0,0,0
11338675,2,2,0,0,1,1,0,1,1
11338811,2,2,0,0,1,1,0,0,0
11338891,2,2,0,0,2,2,0,0,0
11338976,2,2,0,0,1,1,0,1,1
11339491,1,1,0,0,1,1,0,0,0
11340088,2,2,0,0,2,2,0,0,0
11340301,2,2,0,0,1,1,0,0,0
11340583,1,0,1,0,1,1,0,0,0
11340672,3,3,0,0,2,2,0,0,1
11340846,1,1,0,0,1,1,0,0,1
11341185,2,2,0,0,3,1,2,1,0
11341540,1,1,0,0,1,1,0,0,0
11341628,4,3,1,0,1,1,0,1,1
11341742,1,1,0,0,1,1,0,0,0
11341936,4,3,1,0,1,1,0,1,1
11342291,3,2,1,0,3,2,1,0,0
11342333,3,3,0,0,2,2,0,0,0
11343009,2,2,0,0,1,1,0,1,1
11343063,2,2,0,0,1,1,0,1,1
11343199,2,2,0,0,1,1,0,1,1
11343691,2,2,0,0,1,1,0,0,0
11343875,2,2,0,0,1,1,0,1,0
11344313,1,1,0,0,1,1,0,0,0
11345069,1,1,0,0,1,1,0,0,0
11345278,2,2,0,0,2,2,0,0,0
11345436,1,1,0,0,2,2,0,0,0
11345480,2,2,0,0,0,0,0,0,1
11345604,2,2,0,0,2,2,0,0,0
11346233,1,1,0,0,0,0,0,0,0
11346587,1,1,0,0,1,1,0,0,0
11346671,1,1,0,0,1,1,0,0,0
11347281,3,3,0,0,2,2,0,0,1
11347690,1,1,0,0,2,2,0,0,0
11348495,2,2,0,0,2,2,0,0,0
11348893,1,1,0,0,1,1,0,0,0
11348962,4,4,0,0,2,2,0,0,0
11349051,2,2,0,0,2,2,0,0,0
11349724,2,2,0,0,0,0,0,0,0
11349807,1,1,0,0,1,1,0,0,0
11349894,1,1,0,0,1,1,0,0,0
11350071,1,1,0,0,1,1,0,0,0
11350219,2,2,0,0,1,1,0,0,0
11350443,1,0,1,0,1,1,0,0,0
11350888,8,6,2,0,0,0,0,0,1
11352216,6,6,0,0,2,2,0,0,1
11352334,1,1,0,0,1,1,0,0,0
11352496,3,3,0,0,2,2,0,0,0
11352559,1,1,0,0,1,1,0,0,0
11353008,1,1,0,0,1,1,0,0,0
11353628,2,2,0,0,2,2,0,0,0
11353637,7,6,1,0,0,0,0,0,1
11353943,1,1,0,0,1,1,0,0,0
11353967,2,2,0,0,1,1,0,0,1
11354212,2,2,0,0,1,1,0,0,0
11354432,2,2,0,0,1,1,0,0,1
11354810,2,1,1,0,2,1,1,1,1
11355015,2,2,0,0,2,2,0,0,0
11355699,1,1,0,0,1,1,0,0,0
11355748,4,3,1,0,1,1,0,1,1
11355795,3,3,0,0,2,2,0,0,0
11356642,2,2,0,0,2,2,0,0,0
11356987,10,4,6,0,2,1,1,2,1
11357368,2,2,0,0,1,1,0,0,0
11357490,3,3,0,0,1,1,0,1,0
11357513,1,1,0,0,1,1,0,0,0
11357515,3,3,0,0,3,3,0,0,0
11357728,2,2,0,0,2,2,0,0,0
11357776,1,1,0,0,1,1,0,0,0
11358209,1,1,0,0,1,1,0,0,1
11358354,2,2,0,0,2,2,0,0,0
11358388,2,2,0,0,2,2,0,0,1
11358428,2,2,0,0,1,1,0,0,0
11358573,2,2,0,0,2,2,0,0,0
11358754,1,1,0,0,1,1,0,0,0
11359043,2,2,0,0,1,1,0,0,0
11359058,1,1,0,0,1,1,0,0,0
11359151,3,3,0,0,3,3,0,0,0
11359496,2,2,0,0,1,1,0,1,1
11359737,4,4,0,0,1,1,0,1,1
11359809,1,1,0,0,1,1,0,0,1
11360207,3,3,0,0,2,2,0,0,1
11360242,9,9,0,0,0,0,0,0,0
11360415,1,1,0,0,1,1,0,0,0
11360691,1,1,0,0,1,1,0,0,0
11360861,1,1,0,0,1,1,0,0,0
11361567,1,1,0,0,1,1,0,0,0
11362241,1,1,0,0,1,1,0,0,0
11362299,1,1,0,0,1,1,0,0,0
11362482,1,0,1,0,1,1,0,0,0
11362560,1,1,0,0,1,1,0,0,0
11362738,3,2,1,0,3,2,1,0,0
11364186,1,1,0,0,1,1,0,0,0
11364546,7,6,1,0,1,1,0,1,1
11364575,1,1,0,0,1,1,0,0,0
11364608,7,6,1,0,1,1,0,1,1
11364808,5,3,2,0,1,1,0,1,1
11365183,1,1,0,0,0,0,0,0,0
11365270,4,2,2,0,1,1,0,1,0
11365486,1,1,0,0,2,2,0,0,0
11365652,1,1,0,0,1,1,0,0,0
11365672,3,3,0,0,1,1,0,1,1
11365856,3,3,0,0,1,1,0,1,1
11365933,2,2,0,0,2,2,0,0,0
11366333,1,1,0,0,1,1,0,0,0
11366670,2,2,0,0,1,1,0,0,0
11366753,1,1,0,0,1,1,0,0,0
11366857,2,2,0,0,2,2,0,0,1
11366945,1,1,0,0,1,1,0,0,0
11366964,1,1,0,0,1,1,0,0,0
11367241,2,2,0,0,1,1,0,0,0
11367342,2,2,0,0,1,1,0,0,0
11367447,2,2,0,0,1,1,0,1,1
11367568,2,2,0,0,0,0,0,0,0
11367705,6,4,2,0,1,0,1,1,1
11367846,2,2,0,0,1,1,0,0,0
11367971,3,3,0,0,1,1,0,1,0
11368184,1,1,0,0,1,1,0,0,0
11368424,1,1,0,0,1,1,0,0,0
11368674,3,3,0,0,3,3,0,0,0
11369019,1,1,0,0,1,1,0,0,0
11369299,3,3,0,0,0,0,0,0,0
11369911,4,4,0,0,3,3,0,0,0
11370132,2,1,1,0,2,1,1,0,0
11370186,2,1,1,0,1,1,0,0,0
11370230,2,2,0,0,2,2,0,0,0
11370240,2,2,0,0,3,3,0,0,0
11370399,1,1,0,0,1,1,0,0,0
11370452,3,3,0,0,2,2,0,0,0
11370482,2,2,0,0,1,1,0,0,0
11371642,1,1,0,0,1,1,0,0,0
11371680,1,1,0,0,1,1,0,0,0
11371879,2,2,0,0,2,2,0,0,0
11372167,2,2,0,0,1,1,0,0,0
11372486,2,2,0,0,2,2,0,0,1
11372495,2,2,0,0,1,1,0,0,1
11372570,4,3,1,0,4,3,1,0,1
11372693,9,8,1,0,0,0,0,0,1
11372883,1,1,0,0,1,1,0,0,0
11373439,2,0,2,0,2,2,0,0,0
11373641,2,2,0,0,2,2,0,0,0
11374000,2,0,2,0,0,0,0,0,0
11374199,3,3,0,0,2,2,0,0,0
11374294,1,1,0,0,1,1,0,0,0
11374401,2,2,0,0,1,1,0,0,0
11374721,2,1,1,0,2,1,1,1,0
11374898,1,1,0,0,1,1,0,0,0
11375031,2,2,0,0,2,2,0,0,0
11375352,2,2,0,0,1,1,0,0,0
11375494,1,1,0,0,1,1,0,0,0
11375748,2,2,0,0,1,1,0,1,1
11376008,3,3,0,0,0,0,0,0,1
11376040,3,3,0,0,1,1,0,0,0
11376061,1,1,0,0,1,1,0,0,1
11376376,2,2,0,0,0,0,0,0,1
11376741,1,1,0,0,1,1,0,0,0
11376959,2,2,0,0,2,2,0,0,0
11377590,1,1,0,0,1,1,0,0,0
11377631,3,2,1,0,2,1,1,0,1
11377634,1,1,0,0,1,1,0,0,0
11377925,1,1,0,0,1,1,0,0,0
11378014,1,1,0,0,1,1,0,0,0
11378260,8,4,4,0,2,1,1,2,1
11378271,8,4,4,0,2,1,1,2,1
11378502,1,1,0,0,1,1,0,0,0
11378681,1,1,0,0,1,1,0,0,0
11378863,1,1,0,0,1,1,0,0,0
11379175,2,2,0,0,1,1,0,0,0
11379493,1,1,0,0,1,1,0,0,0
11379983,1,0,1,0,1,1,0,0,0
11380537,1,1,0,0,1,1,0,0,0
11380810,2,2,0,0,1,1,0,0,0
11380827,1,1,0,0,1,1,0,0,0
11381441,3,3,0,0,1,1,0,0,1
11381873,3,3,0,0,2,1,1,2,1
11381960,4,2,2,0,1,1,0,1,1
11382101,3,2,1,0,2,2,0,0,0
11382194,1,1,0,0,1,1,0,0,0
11382231,3,2,1,0,1,1,0,1,1
11382262,1,1,0,0,1,1,0,0,0
11382368,1,1,0,0,1,1,0,0,0
11382430,3,3,0,0,1,1,0,1,1
11382490,1,1,0,0,1,1,0,0,0
11382568,2,2,0,0,1,1,0,0,0
11382806,2,2,0,0,1,1,0,0,0
11383926,4,4,0,0,0,0,0,0,0
11383948,1,1,0,0,1,1,0,0,0
11384233,6,6,0,0,1,1,0,1,1
11384351,1,0,1,0,1,1,0,0,0
11384522,5,5,0,0,2,2,0,2,0
11384703,1,1,0,0,1,1,0,0,0
11384765,3,3,0,0,2,2,0,0,0
11384863,1,1,0,0,2,2,0,0,0
11384884,2,2,0,0,2,2,0,0,0
11385017,2,2,0,0,1,1,0,0,0
11385254,1,1,0,0,1,1,0,0,0
11385327,1,1,0,0,1,1,0,0,0
11385639,1,1,0,0,2,2,0,1,0
11385950,8,5,3,0,1,1,0,1,1
11386816,1,1,0,0,1,1,0,0,0
11386824,1,0,1,0,1,1,0,0,0
11386985,2,2,0,0,2,2,0,0,0
11387216,1,1,0,0,1,1,0,0,0
11387435,1,1,0,0,1,1,0,0,0
11387998,2,2,0,0,2,2,0,0,1
11388224,1,1,0,0,1,1,0,0,0
11388277,3,2,1,0,2,2,0,2,1
11388312,2,2,0,0,1,1,0,0,1
11388327,3,2,1,0,1,0,1,0,0
11388367,1,1,0,0,1,1,0,0,0
11388801,1,1,0,0,1,1,0,0,0
11388829,1,1,0,0,1,1,0,0,0
11388926,1,1,0,0,1,1,0,0,0
11389422,1,1,0,0,1,1,0,0,0
11389838,4,4,0,0,1,1,0,1,0
11389844,4,4,0,0,3,3,0,0,1
11390193,2,2,0,0,2,2,0,0,1
11390483,1,1,0,0,1,1,0,0,0
11390624,2,1,1,0,1,1,0,0,0
11390866,5,5,0,0,1,1,0,1,0
11390879,1,1,0,0,1,1,0,0,0
11391265,2,1,1,0,2,1,1,0,0
11391272,1,1,0,0,1,1,0,0,0
11391350,10,7,3,0,2,1,1,2,1
11391356,3,3,0,0,2,2,0,2,1
11392219,1,1,0,0,1,1,0,0,0
11392394,1,1,0,0,1,1,0,0,0
11392529,1,1,0,0,1,1,0,0,1
11392842,2,2,0,0,1,1,0,0,0
11393109,2,2,0,0,1,1,0,1,1
11393325,2,2,0,0,1,1,0,1,1
11393485,1,1,0,0,1,1,0,0,0
11393533,4,2,2,0,2,2,0,0,1
11394422,1,0,1,0,0,0,0,0,0
11394438,1,1,0,0,1,1,0,0,0
11394474,1,1,0,0,1,1,0,0,0
11394832,1,1,0,0,1,1,0,0,0
11394892,1,1,0,0,1,1,0,0,0
11394898,2,1,1,0,2,1,1,0,1
11394977,2,1,1,0,2,1,1,0,1
11395246,1,0,1,0,1,1,0,0,0
11395485,4,4,0,0,1,1,0,1,1
11395697,2,2,0,0,1,1,0,0,0
11395742,1,1,0,0,1,1,0,0,0
11395912,1,1,0,0,1,1,0,0,0
11396804,1,1,0,0,1,1,0,0,0
11396823,1,1,0,0,1,1,0,0,0
11397184,1,1,0,0,1,1,0,0,0
11397218,1,1,0,0,1,1,0,0,0
11397584,2,2,0,0,0,0,0,0,0
11397651,2,2,0,0,2,2,0,0,1
11397657,2,2,0,0,0,0,0,0,0
11397718,3,3,0,0,2,2,0,2,1
11397719,1,1,0,0,1,1,0,0,0
11397908,3,3,0,0,1,1,0,1,1
11398199,1,1,0,0,1,1,0,0,0
11398299,7,5,2,0,0,0,0,0,0
11398506,1,1,0,0,1,1,0,0,0
11398936,4,4,0,0,2,2,0,0,0
11399028,1,1,0,0,1,1,0,0,0
11399066,1,1,0,0,1,1,0,0,0
11399147,1,1,0,0,1,1,0,0,0
11399474,1,1,0,0,1,1,0,0,1
11399768,1,1,0,0,1,1,0,0,0
11399862,2,2,0,0,2,1,1,1,0
01520131,55,2,53,0,1,1,0,1,1
01520225,34,11,23,0,0,0,0,0,0
01520329,7,3,4,0,2,2,0,0,1
01520658,38,11,27,0,1,1,0,0,0
01520736,13,4,9,0,1,1,0,1,0
01520756,13,3,10,0,0,0,0,0,0
01520770,13,6,7,0,0,0,0,0,0
01521068,15,3,12,0,1,1,0,1,1
01521441,50,17,33,0,0,0,0,0,1
01521506,26,3,23,0,1,1,0,1,1
01521769,23,0,23,0,1,1,0,1,1
01521858,13,4,9,0,0,0,0,0,0
01521948,2,2,0,0,1,1,0,0,0
01522383,11,4,7,0,1,1,0,1,1
01522532,45,6,39,0,2,2,0,2,1
01522736,25,4,21,0,1,1,0,1,1
01522818,26,3,23,0,1,1,0,1,1
01522897,161,15,146,0,0,0,0,0,1
01522908,3,3,0,0,2,2,0,0,1
01523328,67,9,58,0,1,1,0,1,1
01523920,19,3,16,0,2,2,0,2,1
01523953,24,0,24,0,1,1,0,1,1
01524006,18,5,13,0,0,0,0,0,1
01524133,5,2,3,0,1,1,0,1,0
01524164,7,4,3,0,3,3,0,0,1
01524323,30,0,30,0,1,1,0,0,1
01524344,52,3,49,0,1,1,0,1,1
01524390,28,0,28,0,0,0,0,0,1
01524429,5,3,2,0,2,2,0,0,1
01524844,47,6,41,0,1,1,0,1,1
01524979,3,0,3,0,0,0,0,0,1
01525004,19,9,10,0,1,1,0,1,1
01525242,26,5,21,0,1,1,0,1,1
01525617,51,3,48,0,1,1,0,1,1
01525671,9,2,7,0,1,1,0,0,1
01525687,29,5,24,0,3,1,2,1,1
01525919,4,0,4,0,1,1,0,0,0
01526447,27,0,27,0,1,1,0,1,1
01527500,20,0,20,0,0,0,0,0,1
01528035,20,6,14,0,0,0,0,0,0
01528078,18,8,10,0,0,0,0,0,0
01528324,18,4,14,0,2,1,1,2,1
01528870,33,0,33,0,1,1,0,1,1
01529484,153,11,142,0,0,0,0,0,1
01529591,55,0,55,0,0,0,0,0,1
01529735,8,3,5,0,3,2,1,0,1
01529898,19,0,19,0,0,0,0,0,1
01530074,44,0,44,0,0,0,0,0,1
01530527,33,2,31,0,1,1,0,1,1
01531377,6,1,5,0,3,1,2,1,1
01531651,26,0,26,0,0,0,0,0,1
01531702,28,1,27,0,0,0,0,0,1
01531788,36,6,30,0,1,1,0,1,1
01532023,27,0,27,0,0,0,0,0,1
01532141,54,4,50,0,1,1,0,1,1
01534234,6,3,3,0,1,1,0,0,0
01534255,26,5,21,0,0,0,0,0,1
01534394,7,4,3,0,1,1,0,1,1
01534448,19,4,15,0,0,0,0,0,0
01534813,6,2,4,0,1,1,0,0,1
01534990,28,1,27,0,2,2,0,2,1
01535451,8,0,8,0,0,0,0,0,1
01535472,25,4,21,0,0,0,0,0,1
01535477,50,4,46,0,2,1,1,2,1
01535759,32,3,29,0,1,1,0,1,1
01535845,29,3,26,0,1,1,0,1,1
01536367,35,0,35,0,0,0,0,0,1
01536507,23,5,18,0,1,1,0,1,1
01536800,12,3,9,0,1,1,0,1,1
01537085,45,13,32,0,0,0,0,0,1
01537119,11,0,11,0,0,0,0,0,1
01537628,4,0,4,0,0,0,0,0,1
01538278,11,0,11,0,0,0,0,0,1
01538570,42,3,39,0,1,1,0,1,0
01538685,12,2,10,0,1,1,0,0,0
01538817,8,4,4,0,1,1,0,1,0
01538949,16,7,9,0,3,3,0,0,1
01539204,3,3,0,0,3,3,0,1,0
01539241,31,6,25,0,1,1,0,1,1
01539294,36,6,30,0,6,4,2,0,1
01539561,38,15,23,0,0,0,0,0,1
01539660,13,8,5,0,3,3,0,0,1
01539858,0,0,0,0,0,0,0,0,0
01539955,30,5,25,0,0,0,0,0,0
01539958,31,8,23,0,0,0,0,0,1
01540180,38,2,36,0,1,1,0,1,1
01540245,12,4,8,0,1,1,0,1,1
01540271,25,3,22,0,1,1,0,1,1
01541386,25,3,22,0,3,3,0,0,1
01541957,69,4,65,0,2,2,0,2,1
01542206,41,0,41,0,1,1,0,1,1
01542218,12,4,8,0,1,1,0,1,1
01542274,29,0,29,0,0,0,0,0,1
01542330,11,0,11,0,0,0,0,0,1
01542669,6,2,4,0,1,1,0,1,0
01543554,40,3,37,0,1,1,0,1,1
01543704,19,0,19,0,1,1,0,1,1
01543837,28,4,24,0,1,1,0,1,1
01543838,16,0,16,0,0,0,0,0,1
01544009,19,0,19,0,1,1,0,1,1
01544152,48,9,39,0,0,0,0,0,0
01544194,7,2,5,0,1,1,0,1,0
01544609,13,6,7,0,2,1,1,1,1
01546033,67,12,55,0,0,0,0,0,1
01547145,19,0,19,0,0,0,0,0,1
01548306,44,4,40,0,1,1,0,1,1
01548820,36,5,31,0,1,1,0,1,1
01549201,29,3,26,0,2,1,1,2,1
01549542,8,2,6,0,1,1,0,1,1
01549708,17,3,14,0,1,1,0,1,1
01550045,7,2,5,0,1,1,0,0,0
01550489,42,4,38,0,1,1,0,1,1
01550505,71,10,61,0,1,1,0,1,1
01550602,30,5,25,0,0,0,0,0,0
01550741,58,15,43,0,0,0,0,0,1
01550778,66,13,53,0,0,0,0,0,1
01550916,26,2,24,0,1,1,0,1,1
01551220,11,0,11,0,0,0,0,0,1
01551599,38,0,38,0,1,1,0,1,1
01551690,99,18,81,0,0,0,0,0,1
01552113,32,8,24,0,0,0,0,0,0
01552523,42,9,33,0,0,0,0,0,1
01552580,41,5,36,0,1,1,0,1,1
01552582,50,3,47,0,1,1,0,1,1
01552987,20,6,14,0,1,1,0,1,0
01553104,21,7,14,0,1,1,0,1,1
01553290,20,10,10,0,1,1,0,0,0
01553581,21,0,21,0,0,0,0,0,1
01553830,7,3,4,0,2,2,0,0,1
01554286,24,0,24,0,0,0,0,0,1
01555168,39,4,35,0,1,1,0,1,1
01555423,15,4,11,0,3,3,0,1,1
01555662,32,5,27,0,0,0,0,0,1
01555990,39,16,23,0,0,0,0,0,1
01556305,57,6,51,0,1,1,0,1,1
01556325,19,3,16,0,1,1,0,1,1
01556622,18,2,16,0,0,0,0,0,0
01556631,11,4,7,0,0,0,0,0,1
01556775,27,3,24,0,1,1,0,1,1
01557088,30,3,27,0,1,1,0,1,1
01557430,10,2,8,0,2,2,0,0,0
01557489,50,0,50,0,0,0,0,0,1
01557613,26,5,21,0,1,1,0,1,1
01557720,9,2,7,0,0,0,0,0,1
01558015,5,1,4,0,2,1,1,1,0
01558786,16,0,16,0,1,1,0,1,1
01559178,37,0,37,0,0,0,0,0,1
01559224,45,9,36,0,1,1,0,1,1
01559235,15,2,13,0,2,2,0,1,0
01559267,29,8,21,0,5,2,3,2,0
01559880,27,4,23,0,0,0,0,0,1
01560133,5,2,3,0,1,1,0,1,0
01560651,82,8,74,0,0,0,0,0,1
01560674,9,2,7,0,1,1,0,0,1
01561532,23,6,17,0,1,1,0,0,1
01561536,46,4,42,0,0,0,0,0,1
01561562,5,2,3,0,1,1,0,1,0
01561796,11,3,8,0,1,1,0,0,1
01562054,6,5,1,0,1,1,0,0,0
01562170,9,2,7,0,1,1,0,0,1
01562404,24,0,24,0,1,1,0,0,1
01562723,60,8,52,0,0,0,0,0,1
01563323,29,3,26,0,1,1,0,1,1
01564025,26,0,26,0,0,0,0,0,1
01564549,9,2,7,0,1,1,0,0,1
01564812,17,0,17,0,0,0,0,0,1
01564936,30,2,28,0,2,2,0,2,1
01565248,13,0,13,0,0,0,0,0,1
01565317,16,2,14,0,2,1,1,0,1
01565979,12,0,12,0,0,0,0,0,1
01566175,42,5,37,0,1,1,0,1,1
01566274,17,7,10,0,0,0,0,0,0
01566321,42,3,39,0,1,1,0,1,1
01566734,6,2,4,0,2,2,0,1,0
01566806,44,11,33,0,0,0,0,0,1
01566838,38,2,36,0,1,1,0,1,1
01567358,4,4,0,0,1,1,0,1,0
01567549,42,6,36,0,1,1,0,1,1
01567751,41,2,39,0,1,1,0,1,1
01568172,10,2,8,0,1,1,0,1,1
01568781,28,8,20,0,1,1,0,0,0
01568784,4,2,2,0,2,1,1,0,0
01568939,8,4,4,0,1,1,0,1,1
01569115,69,12,57,0,3,2,1,0,1
01569177,32,0,32,0,0,0,0,0,1
01569350,8,3,5,0,1,1,0,1,0
01570100,4,2,2,0,1,1,0,0,0
01570349,27,8,19,0,0,0,0,0,0
01570526,26,5,21,0,2,2,0,2,1
01570797,9,3,6,0,1,1,0,1,1
01571089,21,7,14,0,0,0,0,0,1
01571090,78,9,69,0,0,0,0,0,1
01571323,7,2,5,0,1,1,0,1,0
01571457,59,19,40,0,0,0,0,0,0
01571648,12,0,12,0,1,1,0,1,1
01571721,6,3,3,0,1,1,0,0,1
01571779,18,3,15,0,0,0,0,0,1
01571833,31,0,31,0,0,0,0,0,1
01572075,12,3,9,0,1,1,0,1,1
01572257,6,0,6,0,0,0,0,0,0
01572544,10,0,10,0,1,1,0,1,1
01572720,59,0,59,0,0,0,0,0,1
01573340,5,2,3,0,1,1,0,0,0
01573612,5,4,1,0,1,1,0,0,0
01574043,9,2,7,0,2,1,1,2,1
01574328,12,2,10,0,1,1,0,1,0
01574487,6,3,3,0,1,1,0,0,0
01574821,26,4,22,0,1,1,0,1,1
01575175,46,4,42,0,1,1,0,1,1
01575273,17,3,14,0,0,0,0,0,1
01575437,57,2,55,0,0,0,0,0,1
01576033,32,8,24,0,0,0,0,0,0
01576151,45,0,45,0,0,0,0,0,1
01576203,14,0,14,0,0,0,0,0,1
01576660,31,5,26,0,1,1,0,1,1
01577115,91,6,85,0,0,0,0,0,0
01577202,17,5,12,0,0,0,0,0,1
01577583,17,0,17,0,1,1,0,1,1
01578133,33,13,20,0,1,1,0,0,0
01578389,21,0,21,0,0,0,0,0,1
01578531,14,2,12,0,1,1,0,1,0
01578784,21,3,18,0,1,1,0,1,1
01578801,9,3,6,0,1,1,0,1,1
01578829,17,3,14,0,0,0,0,0,1
01578871,15,4,11,0,1,1,0,1,1
01578956,6,1,5,0,3,1,2,1,1
01578968,24,2,22,0,1,1,0,1,1
01579073,10,2,8,0,2,2,0,0,1
01579375,14,4,10,0,1,1,0,1,1
01579933,10,3,7,0,1,1,0,0,0
04399042,29,3,26,0,1,1,0,1,1
04399052,10,4,6,0,1,1,0,0,1
04399097,7,4,3,0,2,2,0,0,0
04399340,100,13,87,0,0,0,0,0,1
04399460,15,3,12,0,2,0,2,0,0
04399490,10,4,6,0,1,1,0,0,1
04399494,43,17,26,0,0,0,0,0,1
04399829,5,3,2,0,2,2,0,0,0
04400054,10,1,9,0,1,1,0,1,1
04400125,56,16,40,0,0,0,0,0,1
04400469,8,0,8,0,0,0,0,0,1
04400778,12,3,9,0,0,0,0,0,1
04400824,13,5,8,1,0,0,0,0,0
04401075,20,0,20,0,0,0,0,0,1
04401303,11,5,6,0,2,2,0,2,1
04401333,6,3,3,0,2,2,0,0,1
04401634,9,2,7,0,1,1,0,0,0
04401868,7,3,4,0,1,1,0,0,0
04401901,29,9,20,0,1,1,0,1,1
04402201,13,0,13,0,0,0,0,0,1
04402378,3,2,1,0,1,1,0,0,0
04402661,17,0,17,0,0,0,0,0,1
04402687,17,0,17,0,0,0,0,0,1
04403071,24,0,24,0,0,0,0,0,1
04403451,10,4,6,0,0,0,0,0,1
04403746,16,6,10,0,1,1,0,1,1
04404178,22,3,19,0,1,1,0,1,1
04404284,23,0,23,0,0,0,0,0,1
04404419,11,2,9,0,1,1,0,1,1
04404511,31,5,26,0,1,1,0,1,1
04404542,16,4,12,0,1,0,1,1,0
04404869,39,13,26,0,0,0,0,0,0
04405016,20,5,15,0,1,1,0,1,1
04405148,12,5,7,0,1,1,0,1,1
04405628,5,0,5,0,0,0,0,0,1
04405692,4,1,3,0,1,1,0,0,0
04405898,5,3,2,0,2,2,0,0,0
04405950,7,0,7,0,0,0,0,0,1
04406314,51,3,48,0,1,1,0,0,1
04406317,5,3,2,0,1,1,0,0,1
04406576,7,0,7,0,0,0,0,0,1
04406640,17,0,17,0,0,0,0,0,1
04407023,16,0,16,0,0,0,0,0,1
04407537,5,3,2,0,2,2,0,0,0
04407615,6,4,2,0,2,2,0,0,1
04407712,55,11,44,0,0,0,0,0,1
04407733,5,2,3,0,1,1,0,0,1
04407771,8,6,2,0,3,1,2,1,0
04407961,11,1,10,0,0,0,0,0,0
04408422,4,0,4,0,1,1,0,0,0
04408474,9,1,8,0,1,1,0,1,0
04408626,24,4,20,0,0,0,0,0,0
04408844,25,0,25,0,0,0,0,0,1
04409205,7,3,4,0,2,2,0,0,0
04409265,4,2,2,0,2,2,0,0,0
04409592,33,6,27,0,1,1,0,1,1
04409656,7,3,4,0,1,1,0,0,1
04409886,40,11,29,0,0,0,0,0,1
04409933,43,0,43,0,0,0,0,0,1
04410204,11,5,6,0,1,1,0,1,1
04410235,7,0,7,0,0,0,0,0,1
04410862,5,0,5,0,0,0,0,0,1
04410903,14,3,11,0,1,1,0,0,1
04411253,42,11,31,0,0,0,0,0,0
04412072,7,1,6,0,2,1,1,1,1
04412094,8,0,8,0,1,1,0,1,1
04412164,15,2,13,0,1,1,0,1,1
04412305,6,4,2,0,1,1,0,1,1
04412332,19,6,13,0,1,1,0,1,1
04412362,33,10,23,0,0,0,0,0,1
04412405,5,0,5,0,0,0,0,0,1
04412940,5,0,5,0,2,2,0,0,1
04413075,6,4,2,0,3,3,0,0,0
04413112,22,2,20,0,1,1,0,1,1
04413249,2,2,0,0,2,2,0,0,0
04413366,37,13,24,0,0,0,0,0,1
04413528,18,0,18,0,0,0,0,0,1
04413789,22,0,22,0,0,0,0,0,1
04413822,20,2,18,0,1,1,0,1,1
04414086,8,0,8,0,0,0,0,0,1
04414133,13,0,13,0,0,0,0,0,1
04414136,13,0,13,0,0,0,0,0,1
04414221,19,5,14,0,0,0,0,0,0
04414250,26,3,23,0,1,1,0,1,1
04414701,20,3,17,0,2,1,1,2,1
04414742,64,12,52,0,5,2,3,0,1
04415037,17,3,14,0,0,0,0,0,1
04415189,12,0,12,0,0,0,0,0,1
04415366,21,4,17,0,1,1,0,1,1
04415647,29,4,25,0,1,1,0,1,1
04415660,34,6,28,0,1,1,0,1,1
04415674,17,2,15,0,2,1,1,1,1
04415728,25,3,22,0,1,1,0,1,1
04416132,6,0,6,0,0,0,0,0,1
04416151,5,1,4,0,1,1,0,0,1
04416206,5,4,1,0,3,3,0,0,1
04416252,35,7,28,0,1,1,0,1,1
04416359,16,4,12,0,3,2,1,3,1
04416402,10,0,10,0,0,0,0,0,1
04416722,4,3,1,0,4,4,0,0,0
04416778,5,3,2,0,2,2,0,0,0
04417114,27,4,23,0,1,1,0,1,1
04417567,15,2,13,0,2,2,0,0,0
04417789,7,3,4,0,0,0,0,0,1
04417799,9,1,8,0,1,1,0,0,1
04418151,43,12,31,0,2,1,1,0,1
04418528,4,0,4,0,1,1,0,0,0
04418757,22,0,22,0,1,1,0,1,1
04418776,36,14,22,0,0,0,0,0,1
04418784,34,5,29,0,1,1,0,1,1
04418844,10,0,10,0,0,0,0,0,1
04418847,8,2,6,0,2,1,1,1,1
04418878,6,3,3,0,1,1,0,1,0
04418948,12,1,11,0,1,1,0,0,1
04418962,8,2,6,0,1,1,0,1,1
04418963,13,0,13,0,0,0,0,0,1
04419126,5,0,5,0,0,0,0,0,1
04419212,8,0,8,0,1,1,0,1,1
04419586,9,0,9,0,0,0,0,0,1
04419839,6,0,6,0,1,1,0,0,1
04419841,7,2,5,0,1,1,0,0,1
04419874,17,5,12,0,0,0,0,0,1
04420002,11,3,8,0,2,1,1,2,1
04420134,7,4,3,0,3,3,0,0,1
04420245,4,2,2,0,1,1,0,0,0
04420252,7,4,3,0,2,2,0,0,0
04420411,11,6,5,0,1,1,0,1,1
04420519,16,10,6,0,1,1,0,0,0
04420684,29,0,29,0,0,0,0,0,1
04420934,10,0,10,0,0,0,0,0,1
04421012,7,1,6,0,0,0,0,0,1
04421085,28,3,25,0,1,1,0,1,1
04421289,7,3,4,0,1,1,0,1,1
04421338,36,6,30,0,0,0,0,0,1
04421472,18,0,18,0,1,1,0,1,1
04421477,23,0,23,0,0,0,0,0,1
04421511,30,0,30,0,0,0,0,0,1
04421535,6,0,6,0,0,0,0,0,1
04421656,17,0,17,0,0,0,0,0,1
04422071,15,6,9,0,0,0,0,0,1
04422206,9,4,5,0,4,3,1,0,0
04422244,15,0,15,0,0,0,0,0,1
04422287,32,0,32,0,0,0,0,0,1
04422293,22,0,22,0,0,0,0,0,1
04422576,5,0,5,0,1,1,0,0,0
04422591,2,2,0,0,1,1,0,0,1
04422713,6,0,6,0,0,0,0,0,1
04422790,14,4,10,0,1,1,0,0,1
04423088,12,0,12,0,0,0,0,0,1
04423342,5,3,2,0,1,1,0,0,1
04423405,19,9,10,0,2,2,0,2,1
04423445,4,2,2,0,1,1,0,0,1
04423693,5,1,4,0,1,1,0,0,0
04423718,11,3,8,0,1,1,0,1,1
04423967,13,4,9,0,0,0,0,0,1
04424125,11,2,9,0,1,1,0,1,0
04424133,7,2,5,0,1,1,0,0,0
04424270,10,3,7,0,1,1,0,0,1
04424468,9,3,6,0,1,1,0,0,0
04424479,8,3,5,0,1,1,0,0,0
04424488,16,7,9,0,1,1,0,1,1
04424699,4,1,3,0,1,1,0,0,1
04425389,7,0,7,0,1,1,0,1,1
04425595,14,3,11,0,1,1,0,1,1
04425654,6,3,3,0,0,0,0,0,1
04425741,10,1,9,0,2,2,0,1,1
04425892,7,3,4,0,1,1,0,1,1
04426126,11,0,11,0,0,0,0,0,1
04426347,6,3,3,0,1,1,0,1,0
04426385,5,2,3,0,1,1,0,0,0
04426399,21,2,19,0,0,0,0,0,1
04426551,10,4,6,0,0,0,0,0,1
04426564,81,11,70,0,0,0,0,0,1
04426579,5,3,2,0,3,3,0,0,0
04426622,7,4,3,0,2,2,0,0,1
04426706,19,9,10,0,0,0,0,0,1
04426746,9,4,5,0,1,1,0,0,1
04426904,37,0,37,0,0,0,0,0,1
04427043,19,0,19,0,0,0,0,0,1
04427239,7,0,7,0,0,0,0,0,1
04427253,32,6,26,0,0,0,0,0,1
04427467,7,0,7,0,0,0,0,0,1
04427868,16,3,13,0,1,1,0,1,1
04427870,16,3,13,0,1,1,0,1,1
04428083,16,3,13,0,1,1,0,1,1
04428409,12,1,11,0,2,2,0,2,1
04428515,3,1,2,0,1,1,0,0,1
04428550,5,3,2,0,2,2,0,0,0
04428824,19,6,13,0,1,1,0,1,1
04428828,31,9,22,0,2,1,1,2,1
04428832,49,12,37,0,0,0,0,0,1
04428897,44,10,34,0,0,0,0,0,1
04429021,24,6,18,0,0,0,0,0,1
04429056,19,2,17,0,0,0,0,0,1
04429098,6,4,2,0,2,2,0,0,0
04429278,9,2,7,0,2,2,0,0,1
04429326,4,0,4,0,1,1,0,0,1
04429814,42,9,33,0,0,0,0,0,1
04429933,10,5,5,0,1,1,0,0,1
04430133,5,0,5,0,0,0,0,0,0
04430284,9,2,7,0,1,1,0,0,1
04430355,19,2,17,0,2,1,1,0,1
04430434,9,3,6,0,3,2,1,0,1
04430818,22,3,19,0,1,1,0,1,1
04430824,21,3,18,0,1,1,0,1,1
04430828,21,3,18,0,1,1,0,1,1
04430846,19,3,16,0,1,1,0,1,1
04430927,19,3,16,0,1,1,0,1,1
04431236,9,0,9,0,0,0,0,0,1
04431396,4,0,4,0,1,1,0,0,0
04431750,4,2,2,0,1,1,0,0,0
04432122,5,1,4,0,0,0,0,0,1
04432551,7,3,4,0,1,1,0,1,1
04432581,15,6,9,0,0,0,0,0,0
04432677,25,9,16,0,0,0,0,0,1
04433215,5,1,4,0,1,1,0,1,0
04433360,4,1,3,0,1,1,0,0,0
04433508,20,5,15,0,0,0,0,0,1
04434499,76,9,67,0,1,1,0,1,1
04434601,12,0,12,0,0,0,0,0,1
04434824,5,3,2,0,1,1,0,0,0
03909857,11,0,11,0,0,0,0,0,1
03909864,30,3,27,0,3,2,1,1,1
03909874,14,0,14,0,1,1,0,1,1
03909886,45,12,33,0,0,0,0,0,1
03909893,18,5,13,0,1,1,0,1,1
03910581,20,4,16,0,1,1,0,1,1
03911256,35,3,32,0,3,1,2,1,1
03911263,29,3,26,0,1,1,0,1,1
03911278,36,3,33,0,1,1,0,1,1
03911323,19,5,14,0,0,0,0,0,1
03911357,32,5,27,0,1,1,0,1,1
03911862,22,3,19,0,1,1,0,1,1
03911991,9,0,9,0,0,0,0,0,0
03912122,17,5,12,0,1,1,0,1,1
03912189,15,0,15,0,0,0,0,0,1
03912300,18,2,16,0,0,0,0,0,1
03912587,45,6,39,0,0,0,0,0,1
03912619,19,4,15,0,1,1,0,0,1
03913044,10,2,8,0,1,1,0,0,1
03913072,5,3,2,0,2,2,0,0,1
03913153,17,0,17,0,0,0,0,0,1
03913274,57,10,47,0,0,0,0,0,1
03913427,3,2,1,0,2,2,0,1,1
03913873,18,4,14,0,0,0,0,0,0
03913912,19,0,19,0,0,0,0,0,1
03914064,32,3,29,0,1,1,0,1,1
03914289,25,2,23,0,0,0,0,0,1
03914641,15,4,11,0,1,1,0,1,1
03914702,28,9,19,0,0,0,0,0,1
03914735,30,3,27,0,1,1,0,1,1
03914767,36,3,33,0,1,1,0,1,1
03914773,19,5,14,0,1,1,0,0,1
03914814,41,3,38,0,2,1,1,1,1
03914873,38,12,26,0,0,0,0,0,1
03915340,6,3,3,0,2,2,0,0,1
03915388,10,0,10,0,1,1,0,1,1
03915417,10,4,6,0,1,1,0,1,1
03915424,33,7,26,0,1,1,0,1,1
03915426,21,1,20,0,1,1,0,0,1
03915442,8,4,4,0,1,1,0,1,1
03915447,10,0,10,0,0,0,0,0,1
03915820,20,0,20,0,1,1,0,1,1
03915878,23,0,23,0,0,0,0,0,1
03915940,11,2,9,0,3,3,0,1,1
03916024,27,0,27,0,1,1,0,1,1
03916328,4,2,2,0,1,1,0,0,0
03916436,30,2,28,0,1,1,0,1,1
03916496,20,6,14,0,1,1,0,0,1
03916560,13,1,12,0,1,1,0,1,1
03916617,12,5,7,0,0,0,0,0,0
03917033,9,3,6,0,1,1,0,0,1
03917041,8,0,8,0,0,0,0,0,1
03917042,8,3,5,0,1,1,0,0,1
03917216,10,0,10,0,0,0,0,0,1
03917221,8,0,8,0,0,0,0,0,1
03917268,27,3,24,0,2,2,0,2,1
03917679,3,0,3,0,1,1,0,0,0
03917740,18,6,12,0,1,1,0,1,1
03918013,62,4,58,0,1,1,0,1,1
03918022,60,3,57,0,1,1,0,1,1
03918217,22,2,20,0,2,1,1,2,1
03918227,16,4,12,0,1,1,0,0,1
03918295,43,4,39,0,0,0,0,0,0
03918397,20,0,20,0,0,0,0,0,1
03918404,6,3,3,0,1,1,0,0,0
03918557,11,3,8,0,2,1,1,1,1
03918835,12,0,12,0,0,0,0,0,0
03918876,26,3,23,0,2,1,1,0,1
03918877,19,5,14,0,0,0,0,0,1
03918992,62,10,52,0,0,0,0,0,1
03919407,13,6,7,0,1,1,0,1,1
03919619,16,4,12,0,1,1,0,1,1
03920092,33,0,33,0,1,1,0,1,1
03920198,22,0,22,0,0,0,0,0,1
03920217,35,6,29,0,2,2,0,1,1
03920255,46,14,32,0,1,1,0,1,1
03920256,9,0,9,0,1,1,0,1,1
03920330,21,5,16,0,1,1,0,1,1
03920410,46,8,38,0,1,1,0,1,0
03920626,11,2,9,0,2,1,1,1,0
03920711,34,3,31,0,1,1,0,1,1
03920946,56,14,42,0,0,0,0,0,1
03921089,28,2,26,0,1,1,0,1,1
03921203,13,2,11,0,1,1,0,0,0
03921385,5,2,3,0,1,1,0,0,0
03921414,7,3,4,0,2,2,0,0,1
03921435,30,7,23,0,0,0,0,0,1
03921465,8,3,5,0,1,1,0,0,1
03921474,27,2,25,0,1,1,0,0,1
03921522,6,4,2,0,2,2,0,0,1
03921568,41,4,37,0,1,1,0,1,1
03921625,5,2,3,0,2,2,0,0,1
03921701,11,3,8,0,1,1,0,1,1
03921759,33,0,33,0,0,0,0,0,1
03921817,24,4,20,0,1,1,0,0,1
03921914,35,8,27,0,1,1,0,1,1
03922093,7,1,6,0,1,1,0,0,0
03922216,10,3,7,0,1,1,0,1,1
03922227,4,3,1,0,1,1,0,0,0
03922468,19,0,19,0,1,1,0,1,1
03922501,11,0,11,0,0,0,0,0,1
03922841,24,4,20,0,1,1,0,1,1
03922882,16,5,11,0,1,1,0,1,1
03922925,7,0,7,0,1,1,0,0,1
03922981,13,0,13,0,0,0,0,0,1
03923096,6,2,4,0,0,0,0,0,1
03923198,9,3,6,0,1,1,0,0,1
03923275,5,2,3,0,1,1,0,0,1
03923296,14,3,11,0,0,0,0,0,1
03923324,20,0,20,0,0,0,0,0,1
03923336,17,0,17,0,0,0,0,0,1
03923422,19,2,17,0,2,2,0,2,1
03923449,13,5,8,0,4,1,3,2,1
03923542,32,3,29,0,0,0,0,0,1
03923554,7,0,7,0,0,0,0,0,1
03923561,16,0,16,0,0,0,0,0,1
03923606,23,1,22,0,4,4,0,3,1
03924469,14,2,12,0,1,1,0,1,1
03924518,11,7,4,0,1,1,0,0,1
03924806,4,1,3,0,1,1,0,0,0
03924932,15,4,11,0,2,2,0,2,1
03925436,9,0,9,0,0,0,0,0,1
03925556,4,0,4,0,0,0,0,0,1
03925978,5,2,3,0,1,1,0,1,1
03926026,50,9,41,0,0,0,0,0,1
03926192,41,3,38,0,0,0,0,0,1
03926629,45,7,38,0,1,1,0,1,1
03926665,6,2,4,0,2,1,1,0,1
03926686,17,3,14,4,1,1,0,1,1
03926750,6,3,3,0,2,1,1,0,0
03926798,21,7,14,0,1,1,0,1,1
03926849,28,5,23,0,1,1,0,1,1
03927368,11,0,11,0,0,0,0,0,1
03927557,4,1,3,0,1,1,0,0,0
03927594,9,5,4,0,1,1,0,1,0
03927610,4,2,2,0,2,2,0,0,0
03927635,17,3,14,0,1,1,0,1,1
03927637,16,4,12,0,0,0,0,0,1
03927889,25,0,25,0,1,1,0,1,1
03927898,27,0,27,0,1,1,0,1,1
03927901,32,0,32,0,1,1,0,1,1
03927950,6,2,4,0,1,1,0,0,0
03927994,7,3,4,0,0,0,0,0,0
03928037,15,0,15,0,0,0,0,0,1
03928192,26,3,23,0,1,1,0,1,1
03928199,11,0,11,0,0,0,0,0,1
03928315,9,3,6,0,1,1,0,0,0
03928476,17,0,17,0,0,0,0,0,1
03928481,13,3,10,0,3,1,2,1,1
03928638,12,0,12,0,1,1,0,1,1
03928758,9,4,5,0,0,0,0,0,0
03928931,20,4,16,0,1,1,0,1,1
03928932,16,5,11,0,1,1,0,1,0
03929177,18,0,18,0,0,0,0,0,1
03929195,35,14,21,0,1,1,0,1,1
03929585,31,5,26,0,2,2,0,2,0
03929879,8,4,4,0,1,1,0,1,1
03929905,16,3,13,0,1,1,0,1,1
03929939,6,2,4,0,2,1,1,0,0
03930049,15,0,15,0,0,0,0,0,1
03930184,6,1,5,0,1,1,0,0,1
03930306,16,10,6,0,0,0,0,0,0
03930321,17,6,11,0,2,1,1,2,1
03930482,11,1,10,0,1,1,0,0,0
03930855,30,9,21,0,0,0,0,0,0
03930861,31,0,31,0,0,0,0,0,1
03931048,5,0,5,0,0,0,0,0,1
03931085,33,10,23,0,1,1,0,0,1
03931250,51,0,51,0,1,1,0,1,1
03931253,4,2,2,0,1,1,0,0,1
03931258,14,0,14,0,0,0,0,0,1
03931507,47,11,36,0,0,0,0,0,0
03931926,14,0,14,0,0,0,0,0,1
03932073,6,3,3,0,2,2,0,0,0
03932085,15,0,15,0,0,0,0,0,1
03932731,8,4,4,0,2,2,0,1,1
03932752,36,3,33,0,1,1,0,1,1
03932773,28,0,28,0,0,0,0,0,1
03932784,27,0,27,0,0,0,0,0,1
03932792,18,0,18,0,0,0,0,0,1
03932798,16,2,14,0,0,0,0,0,1
03932840,20,3,17,0,2,1,1,2,1
03933096,12,3,9,0,1,1,0,1,1
03933116,7,2,5,0,2,2,0,1,0
03933130,13,1,12,0,1,1,0,0,1
03933241,18,0,18,0,0,0,0,0,1
03933291,14,3,11,0,1,1,0,1,1
03933362,12,3,9,0,0,0,0,0,1
03933534,13,7,6,0,0,0,0,0,1
03933638,21,6,15,0,1,1,0,0,0
03933716,0,0,0,0,0,0,0,0,1
03933986,15,0,15,0,1,1,0,1,1
03934114,14,0,14,0,0,0,0,0,1
03934287,62,22,40,0,2,2,0,0,1
03934288,34,3,31,0,1,1,0,1,1
03934314,11,0,11,0,0,0,0,0,1
03934326,11,0,11,0,0,0,0,0,1
03934339,9,2,7,0,1,1,0,1,1
03934641,23,7,16,0,1,1,0,1,1
03934732,20,3,17,0,2,2,0,1,1
03934744,14,0,14,0,0,0,0,0,1
03934747,8,0,8,0,1,1,0,0,1
03934750,24,4,20,0,1,1,0,1,1
03934761,22,5,17,0,1,1,0,1,1
03934790,15,0,15,0,0,0,0,0,1
03934831,24,0,24,0,0,0,0,0,1
03934833,5,3,2,0,1,1,0,1,1
03934879,12,3,9,0,0,0,0,0,1
03935074,16,3,13,0,0,0,0,0,1
03935288,8,0,8,0,0,0,0,0,1
03935374,19,3,16,0,0,0,0,0,1
03935461,9,0,9,0,0,0,0,0,1
03935677,25,6,19,0,1,1,0,1,1
03935720,26,0,26,0,0,0,0,0,1
03935773,5,0,5,0,0,0,0,0,1
07023043,2,1,1,0,1,1,0,0,0
07023564,3,1,2,0,1,1,0,0,0
07023659,10,6,4,0,1,1,0,0,1
07023927,3,0,3,0,0,0,0,0,1
07024085,2,0,2,0,0,0,0,0,1
07024392,5,1,4,0,1,1,0,0,1
07024394,5,1,4,0,1,1,0,0,1
07024441,2,2,0,0,3,1,2,1,1
07024451,1,1,0,0,1,1,0,0,0
07024763,28,8,20,0,0,0,0,0,1
07024807,4,4,0,0,1,1,0,0,0
07024823,6,3,3,0,1,1,0,1,1
07024874,18,0,18,0,0,0,0,0,1
07024908,6,3,3,0,1,1,0,1,1
07024942,4,2,2,0,2,1,1,1,0
07025023,3,3,0,0,3,3,0,0,1
07025122,4,1,3,0,1,1,0,0,0
07025185,6,0,6,0,0,0,0,0,1
07025221,14,5,9,0,0,0,0,0,0
07025245,11,0,11,0,0,0,0,0,1
07025543,2,1,1,0,1,1,0,0,0
07025673,4,3,1,0,2,2,0,0,1
07025809,2,1,1,0,1,1,0,0,0
07025891,10,7,3,0,0,0,0,0,0
07025937,17,6,11,0,0,0,0,0,1
07026001,31,11,20,0,0,0,0,0,1
07026070,14,4,10,0,1,1,0,1,1
07026256,2,1,1,0,1,1,0,0,0
07026299,1,1,0,0,0,0,0,0,0
07026479,10,7,3,0,2,1,1,1,1
07026602,4,2,2,0,1,1,0,0,1
07027066,4,2,2,0,1,1,0,0,0
07027443,13,5,8,0,1,1,0,0,0
07027893,3,2,1,0,2,2,0,0,1
07027918,7,5,2,0,1,1,0,1,0
07028648,5,5,0,0,0,0,0,0,0
07028838,14,5,9,0,1,0,1,1,1
07029250,2,2,0,0,2,2,0,0,0
07030069,4,1,3,0,2,1,1,0,0
07030519,5,0,5,0,1,1,0,1,1
07030679,37,5,32,0,0,0,0,0,1
07030898,3,0,3,0,0,0,0,0,1
07030995,7,0,7,0,0,0,0,0,1
07031331,2,2,0,0,1,1,0,0,1
07031350,3,0,3,0,0,0,0,0,1
07031458,29,8,21,0,0,0,0,0,0
07031485,8,4,4,0,0,0,0,0,1
07031666,5,1,4,0,1,1,0,0,1
07032583,32,9,23,0,1,1,0,0,1
07032901,2,2,0,0,1,1,0,0,0
07032947,21,21,0,0,1,1,0,0,1
07033045,9,1,8,0,5,2,3,0,1
07033051,3,2,1,0,1,1,0,0,1
07033291,5,3,2,0,5,3,2,0,0
07033475,5,3,2,0,0,0,0,0,1
07033537,5,4,1,0,0,0,0,0,1
07033819,11,4,7,0,1,0,1,0,1
07034095,2,2,0,0,1,1,0,0,0
07034096,13,5,8,0,0,0,0,0,0
07034195,2,0,2,0,0,0,0,0,0
07034540,4,2,2,0,1,1,0,1,1
07034606,15,3,12,0,1,1,0,1,1
07034655,6,5,1,0,0,0,0,0,0
07034820,7,2,5,0,1,1,0,1,1
07034844,6,3,3,0,1,1,0,0,1
07034872,9,0,9,0,0,0,0,0,1
07034937,6,0,6,0,0,0,0,0,1
07034944,1,1,0,0,1,1,0,0,0
07035161,2,1,1,0,2,1,1,1,1
07035290,5,3,2,0,1,1,0,0,0
07035462,8,7,1,0,0,0,0,0,1
07035492,7,0,7,0,0,0,0,0,0
07035552,34,0,34,0,0,0,0,0,1
07035587,11,8,3,0,0,0,0,0,1
07035873,14,0,14,0,0,0,0,0,1
07036341,1,0,1,0,0,0,0,0,1
07036458,1,1,0,0,1,1,0,0,0
07036468,9,2,7,0,1,1,0,1,1
07036566,2,2,0,0,0,0,0,0,0
07036589,23,2,21,0,1,1,0,1,1
07036663,2,2,0,0,3,1,2,1,0
07036875,7,3,4,0,2,2,0,0,0
07036902,5,2,3,0,1,1,0,1,1
07037994,3,2,1,0,2,2,0,0,0
07038029,2,2,0,0,2,2,0,0,0
07038471,2,2,0,0,1,1,0,0,0
07039051,18,0,18,0,0,0,0,0,1
07039272,8,0,8,0,0,0,0,0,1
07039318,2,0,2,0,2,2,0,0,0
07039352,2,0,2,0,1,1,0,0,0
07039690,1,0,1,0,1,1,0,0,0
07039692,1,1,0,0,1,1,0,0,1
07039909,5,0,5,0,0,0,0,0,1
07040154,1,1,0,0,1,1,0,0,0
07040177,1,0,1,0,0,0,0,0,0
07040880,6,5,1,0,2,2,0,0,0
07041030,2,2,0,0,2,2,0,0,0
07041440,1,1,0,0,1,1,0,0,1
07041492,1,1,0,0,1,1,0,0,0
07041767,3,2,1,0,2,2,0,0,0
07041814,2,2,0,0,1,1,0,0,0
07042488,2,2,0,0,1,1,0,0,0
07042873,5,5,0,0,5,5,0,0,0
07043585,3,2,1,0,2,2,0,0,1
07043794,4,3,1,0,1,1,0,0,0
07043847,2,1,1,0,2,2,0,0,1
07044186,3,0,3,0,2,2,0,0,1
07044474,12,7,5,0,0,0,0,0,1
07044564,1,1,0,0,2,2,0,0,0
07044743,6,0,6,0,1,1,0,0,1
07044948,6,2,4,0,2,2,0,0,0
07045498,6,3,3,0,3,2,1,0,1
07045655,2,0,2,0,0,0,0,0,0
07046229,2,0,2,0,0,0,0,0,1
07046487,5,2,3,0,1,1,0,0,1
07046744,3,0,3,0,0,0,0,0,1
07046746,8,0,8,0,0,0,0,0,1
07046835,3,3,0,0,1,1,0,1,0
07047060,13,0,13,0,0,0,0,0,1
07047146,11,2,9,0,3,1,2,3,1
07047255,16,2,14,0,3,1,2,3,1
07047452,5,0,5,0,0,0,0,0,1
07047608,3,3,0,0,2,2,0,0,0
07047899,4,3,1,0,2,2,0,0,0
07048979,14,0,14,0,1,1,0,1,1
07049083,7,2,5,0,7,7,0,0,1
07049747,4,3,1,0,0,0,0,0,1
07049790,2,2,0,0,1,1,0,0,1
07050093,3,2,1,0,1,1,0,0,1
07050272,6,1,5,0,1,1,0,0,0
07050390,2,1,1,0,1,1,0,0,0
07050408,1,0,1,0,0,0,0,0,0
07050499,2,0,2,0,0,0,0,0,0
07050567,5,5,0,0,0,0,0,0,0
07050829,3,0,3,0,0,0,0,0,1
07051108,2,1,1,0,2,1,1,0,0
07051134,16,3,13,0,1,1,0,1,1
07051310,5,2,3,0,3,1,2,1,0
07051395,10,4,6,0,0,0,0,0,1
07051733,5,2,3,0,1,1,0,0,0
07052288,15,3,12,0,2,2,0,2,1
07052320,2,2,0,0,2,2,0,0,0
07052393,2,0,2,0,0,0,0,0,0
07052438,17,4,13,0,2,2,0,2,1
07053030,1,1,0,0,1,1,0,0,0
07053388,4,0,4,0,0,0,0,0,1
07053576,3,3,0,0,1,1,0,0,1
07053625,13,3,10,0,0,0,0,0,1
07053926,3,1,2,0,1,1,0,0,1
07054230,1,1,0,0,1,1,0,0,1
07055916,2,0,2,0,0,0,0,0,1
07056103,3,2,1,0,1,1,0,0,0
07056352,6,0,6,0,1,1,0,1,1
07056653,6,3,3,0,0,0,0,0,1
07056800,16,6,10,0,2,1,1,2,1
07057417,4,0,4,0,0,0,0,0,1
07057465,3,1,2,0,2,1,1,2,1
07057470,17,4,13,0,2,2,0,2,1
07058241,10,0,10,1,2,1,1,1,1
07058287,8,5,3,0,4,4,0,0,1
07058341,4,3,1,0,1,1,0,1,1
07058376,4,3,1,0,1,1,0,1,1
07058666,80,11,69,0,0,0,0,0,1
07058904,8,0,8,0,0,0,0,0,1
07058942,2,2,0,0,1,1,0,0,0
07058988,9,2,7,0,2,1,1,2,1
07059387,6,3,3,0,2,2,0,0,1
07059465,14,11,3,0,1,1,0,1,0
07059524,5,3,2,0,12,11,1,0,0
07059597,11,0,11,0,0,0,0,0,1
07059618,2,2,0,0,2,2,0,0,0
07059656,15,6,9,0,1,1,0,1,1
07059928,3,3,0,0,1,1,0,0,0
07059988,6,1,5,0,1,1,0,0,1
07060118,3,2,1,0,2,2,0,0,0
07060502,2,0,2,0,1,1,0,0,0
07061087,4,0,4,0,0,0,0,0,0
07061232,5,0,5,0,0,0,0,0,1
07061885,1,1,0,0,1,1,0,0,0
07061994,3,2,1,0,1,1,0,0,0
07062172,2,2,0,0,1,1,0,0,0
07062938,2,1,1,0,3,1,2,1,1
07063250,3,2,1,0,2,2,0,0,0
07063593,6,4,2,0,0,0,0,0,1
07063627,3,3,0,0,1,1,0,0,0
07064232,6,2,4,0,0,0,0,0,0
07064254,1,1,0,0,1,1,0,0,0
07064312,32,10,22,0,0,0,0,0,1
07064319,19,4,15,0,1,1,0,1,1
07064488,2,2,0,0,1,1,0,0,1
07064727,7,4,3,0,1,0,1,0,1
07065318,12,2,10,0,0,0,0,0,1
07065599,4,3,1,0,1,1,0,1,1
07065829,2,1,1,0,1,1,0,0,0
07066421,3,2,1,0,1,1,0,0,0
07066687,29,7,22,0,0,0,0,0,1
07066721,2,2,0,0,2,2,0,0,0
07067461,3,2,1,0,2,1,1,1,1
07067769,6,0,6,0,0,0,0,0,1
07067912,3,2,1,0,1,1,0,0,1
07069266,5,5,0,0,0,0,0,0,0
07069347,4,0,4,0,0,0,0,0,1
07069771,1,0,1,0,0,0,0,0,0
07070078,12,4,8,0,2,2,0,2,1
07070487,14,2,12,0,2,2,0,0,1
07071078,3,2,1,0,1,1,0,0,0
07072351,3,0,3,0,0,0,0,0,1
07072454,2,0,2,0,0,0,0,0,0
07072513,1,0,1,0,0,0,0,0,0
07072697,3,2,1,0,1,1,0,0,1
07072938,2,1,1,0,1,1,0,0,0
07073669,2,2,0,0,2,2,0,0,0
07073754,8,3,5,0,0,0,0,0,1
07073928,15,3,12,0,1,1,0,0,0
07074289,3,1,2,0,1,1,0,0,0
07074347,2,0,2,0,0,0,0,0,1
07074637,9,7,2,0,0,0,0,0,1
07074814,6,2,4,0,1,1,0,0,0
07074834,5,2,3,0,1,1,0,0,0
07075047,4,0,4,0,0,0,0,0,0
07075354,4,0,4,0,0,0,0,0,0
07075571,22,10,12,0,1,1,0,1,0
07075579,2,2,0,0,2,2,0,0,0
07075943,8,0,8,0,0,0,0,0,1
07075976,4,1,3,0,1,1,0,1,0
07076052,21,0,21,0,1,1,0,0,1
07076506,5,3,2,0,2,1,1,0,0
07076539,4,0,4,0,0,0,0,0,1
07076564,1,0,1,0,0,0,0,0,0
07076570,14,12,2,0,0,0,0,0,0
07076857,2,0,2,0,0,0,0,0,1
07077288,4,4,0,0,1,1,0,0,1
07077794,6,0,6,0,0,0,0,0,1
07077901,3,1,2,0,2,1,1,2,1
07077945,12,4,8,0,2,2,0,2,1
07078403,4,0,4,0,0,0,0,0,0
07078731,3,2,1,0,2,2,0,0,1
07078823,19,9,10,0,0,0,0,0,1
07078853,1,1,0,0,1,1,0,0,0
07078911,5,3,2,0,2,2,0,0,1
07079508,3,0,3,0,0,0,0,0,1
07079844,19,3,16,0,2,1,1,2,1
07080033,3,2,1,0,1,1,0,0,0
07080096,3,2,1,0,2,2,0,0,0
07080240,4,2,2,0,1,1,0,1,0
07080681,12,3,9,0,1,1,0,0,1
07081433,3,2,1,0,1,1,0,0,1
07081494,3,3,0,0,2,2,0,0,0
07081650,6,2,4,0,1,1,0,0,1
07081892,4,2,2,0,2,2,0,0,0
07082057,2,0,2,0,0,0,0,0,0
07082289,11,0,11,0,3,3,0,0,0
07082580,1,1,0,0,1,1,0,0,0
07082675,10,3,7,0,0,0,0,0,1
07082887,5,0,5,0,1,1,0,0,0
07082890,6,3,3,0,1,1,0,0,0
07082965,3,2,1,0,2,2,0,0,0
07082983,2,2,0,0,2,2,0,0,0
07083059,52,14,38,0,0,0,0,0,0
07083120,4,0,4,0,0,0,0,0,0
07083298,9,4,5,0,0,0,0,0,0
07083460,17,4,13,0,2,2,0,2,1
07083987,2,1,1,0,1,1,0,0,0
07084055,2,1,1,0,0,0,0,0,1
07084184,6,0,6,0,0,0,0,0,1
07084194,4,4,0,0,3,3,0,0,1
07084266,2,1,1,0,1,1,0,0,0
07084938,4,0,4,0,0,0,0,0,1
07085285,4,0,4,0,0,0,0,0,1
07085396,26,9,17,0,0,0,0,0,1
00050484,44,4,40,0,2,2,0,2,1
00051090,133,19,114,0,0,0,0,0,1
00051702,29,6,23,0,4,2,2,2,1
00052016,22,7,15,0,0,0,0,0,0
00052242,34,2,32,0,1,1,0,1,1
00052411,30,8,22,0,0,0,0,0,1
00052457,65,7,58,0,1,1,0,1,1
00052492,16,3,13,0,1,1,0,1,1
00052665,47,3,44,0,0,0,0,0,1
00052740,12,4,8,0,0,0,0,0,1
00053171,31,7,24,0,0,0,0,0,1
00053220,25,2,23,0,1,1,0,1,1
00053237,40,4,36,0,1,1,0,1,1
00053317,37,4,33,0,1,1,0,1,1
00053475,28,3,25,0,1,1,0,1,1
00053626,64,4,60,0,4,2,2,4,1
00053688,41,11,30,0,0,0,0,0,1
00053723,51,13,38,0,0,0,0,0,1
00053762,23,4,19,0,1,1,0,1,1
00053775,17,3,14,0,1,1,0,1,1
00053913,38,5,33,0,1,1,0,1,1
00054139,15,7,8,0,1,1,0,0,0
00054290,17,7,10,0,4,4,0,0,0
00054485,47,6,41,0,1,1,0,1,1
00054631,5,2,3,0,0,0,0,0,1
00054802,64,7,57,0,1,1,0,1,1
00054940,119,15,104,0,0,0,0,0,1
00055167,104,19,85,0,0,0,0,0,1
00055433,23,4,19,0,2,2,0,2,0
00055513,39,2,37,0,1,1,0,1,1
00055603,49,4,45,0,1,1,0,1,1
00055973,30,4,26,0,1,1,0,1,1
00056182,21,2,19,0,1,1,0,1,1
00056442,11,0,11,0,0,0,0,0,0
00056674,50,2,48,0,1,1,0,1,1
00057024,36,5,31,0,1,1,0,1,1
00057091,13,7,6,0,2,2,0,2,1
00057379,32,4,28,0,1,1,0,1,1
00057395,15,0,15,0,0,0,0,0,0
00057410,41,3,38,0,1,1,0,1,1
00057545,39,2,37,0,1,1,0,1,1
00057925,49,8,41,0,1,1,0,0,0
00057968,35,3,32,0,1,1,0,1,1
00058008,14,6,8,0,5,0,5,0,0
00058025,65,5,60,0,1,1,0,1,1
00058093,64,15,49,0,2,2,0,2,1
00058207,36,0,36,0,0,0,0,0,1
00058510,10,0,10,0,0,0,0,0,1
00058913,31,0,31,0,1,1,0,0,1
00058942,19,8,11,0,8,7,1,0,0
00058957,9,2,7,0,2,1,1,0,0
00059108,81,9,72,0,0,0,0,0,0
00059713,18,4,14,0,0,0,0,0,1
00060094,43,3,40,0,1,1,0,1,1
00060849,24,0,24,0,0,0,0,0,1
00060987,48,6,42,0,1,1,0,1,1
00061140,10,5,5,0,1,1,0,0,0
00061171,15,7,8,0,0,0,0,0,1
00061274,102,21,81,0,0,0,0,0,1
00061407,31,3,28,0,1,1,0,1,1
00061625,78,9,69,0,0,0,0,0,1
00061880,33,7,26,0,0,0,0,0,1
00062065,44,4,40,0,1,1,0,1,1
00062367,17,7,10,0,1,1,0,1,0
00062423,24,5,19,0,1,1,0,1,1
00062537,38,7,31,0,1,1,0,1,1
00062539,34,5,29,0,1,1,0,1,1
00062753,110,13,97,0,0,0,0,0,1
00063932,17,3,14,0,3,3,0,0,0
00064316,109,8,101,0,0,0,0,0,1
00064404,26,0,26,0,0,0,0,0,1
00064518,26,10,16,0,1,1,0,0,0
00064569,88,9,79,0,0,0,0,0,1
00064570,62,3,59,0,1,1,0,1,1
00064795,88,2,86,0,0,0,0,0,1
00064884,28,4,24,0,1,1,0,1,1
00065192,10,6,4,0,0,0,0,0,0
00065619,19,6,13,0,0,0,0,0,1
00065706,22,3,19,0,1,1,0,0,1
00065872,62,9,53,0,1,0,1,0,0
00065938,29,0,29,0,0,0,0,0,1
00066027,28,4,24,0,0,0,0,0,1
00066045,32,5,27,0,1,1,0,1,1
00066076,29,5,24,0,1,1,0,1,1
00066196,112,10,102,0,0,0,0,0,1
00066263,7,2,5,0,1,1,0,1,1
00066549,45,5,40,0,2,1,1,2,1
00066674,22,3,19,0,1,1,0,1,0
00067086,22,3,19,0,1,1,0,1,0
00067112,19,0,19,0,0,0,0,0,1
00067307,68,5,63,0,2,2,0,1,1
00067341,38,2,36,0,1,1,0,1,1
00067442,21,6,15,0,1,1,0,1,1
00067599,26,5,21,0,1,1,0,1,1
00067863,29,5,24,0,0,0,0,0,1
00068098,9,1,8,0,1,1,0,0,0
00068497,227,20,207,0,0,0,0,0,1
00068499,17,6,11,0,1,1,0,1,1
00068576,61,7,54,0,1,1,0,1,1
00069556,27,3,24,0,2,1,1,2,1
00069662,18,9,9,0,0,0,0,0,0
00069666,36,5,31,0,1,1,0,1,1
00069897,5,3,2,0,0,0,0,0,1
00070170,56,0,56,0,0,0,0,0,1
00070234,74,10,64,0,1,1,0,1,1
00070274,26,4,22,0,2,2,0,2,1
00070368,16,3,13,0,1,1,0,1,1
00070527,312,16,296,0,0,0,0,0,1
00070587,29,3,26,0,1,1,0,1,1
00071375,27,3,24,0,1,1,0,1,1
00071639,10,0,10,0,1,1,0,1,1
00071798,62,10,52,0,1,1,0,0,1
00072494,69,10,59,0,1,1,0,0,0
00073608,87,7,80,0,0,0,0,0,1
00073749,152,9,143,0,0,0,0,0,1
00074300,32,7,25,0,1,1,0,1,0
00074359,467,39,428,0,6,6,0,0,1
00074416,20,3,17,0,0,0,0,0,1
00074461,95,14,81,0,0,0,0,0,1
00075064,47,0,47,0,0,0,0,0,1
00075219,156,9,147,0,0,0,0,0,0
00075278,36,8,28,0,6,4,2,0,1
00075831,14,0,14,0,1,1,0,1,1
00075857,8,0,8,0,0,0,0,0,1
00076125,44,8,36,0,4,4,0,0,1
00076535,55,11,44,0,0,0,0,0,1
00076676,22,0,22,0,0,0,0,0,0
00076760,17,7,10,1,1,1,0,0,0
00077259,6,2,4,0,0,0,0,0,1
00077316,21,4,17,0,1,1,0,0,1
00077332,61,9,52,0,0,0,0,0,0
00077536,53,11,42,0,0,0,0,0,1
00077797,192,11,181,0,0,0,0,0,1
00077861,52,6,46,0,1,1,0,1,1
00077912,47,5,42,0,1,1,0,1,1
00077922,18,5,13,0,1,1,0,1,1
00078235,17,4,13,0,1,1,0,1,1
00078241,185,15,170,0,0,0,0,0,0
00078368,27,6,21,0,0,0,0,0,1
00078392,57,10,47,0,0,0,0,0,1
00078768,39,11,28,0,0,0,0,0,1
00078931,44,10,34,0,1,1,0,0,1
00078972,16,3,13,0,1,1,0,1,1
00079061,8,0,8,0,0,0,0,0,1
00079308,40,4,36,0,1,1,0,1,1
00079310,12,2,10,0,1,1,0,1,0
00079737,6,4,2,0,1,1,0,0,0
00079856,17,3,14,0,2,2,0,0,1
00080028,20,4,16,0,1,1,0,1,1
00080040,13,9,4,0,1,1,0,1,1
00080205,7,4,3,0,2,2,0,0,0
00080612,90,10,80,0,0,0,0,0,1
00081035,39,7,32,0,0,0,0,0,0
00081130,52,15,37,0,0,0,0,0,1
00081177,98,5,93,0,0,0,0,0,0
00081186,59,5,54,0,1,1,0,1,1
00081307,15,3,12,0,2,1,1,1,1
00081327,141,19,122,0,0,0,0,0,1
00081338,17,3,14,0,1,1,0,1,1
00081779,13,2,11,0,2,2,0,2,0
00082562,20,3,17,0,0,0,0,0,1
00082829,22,3,19,0,1,1,0,1,1
00082908,14,6,8,0,1,1,0,1,1
00083395,37,4,33,0,1,1,0,1,1
00083405,143,13,130,0,0,0,0,0,1
00083575,18,9,9,0,0,0,0,0,0
00083608,74,13,61,0,0,0,0,0,1
00083618,29,6,23,0,0,0,0,0,0
00083718,12,1,11,0,0,0,0,0,1
00083885,147,10,137,0,0,0,0,0,1
00084040,10,5,5,0,0,0,0,0,0
00084313,82,13,69,0,0,0,0,0,1
00084390,26,3,23,0,1,1,0,1,1
00084840,7,3,4,0,1,1,0,1,0
00084909,27,6,21,0,1,1,0,1,1
00084976,11,5,6,0,3,3,0,1,1
00085006,36,10,26,0,0,0,0,0,1
00085328,53,10,43,0,0,0,0,0,1
00085557,24,0,24,0,0,0,0,0,1
00085588,32,8,24,0,0,0,0,0,1
00086125,38,4,34,0,4,3,1,0,0
00086637,4,3,1,0,1,1,0,0,0
00086641,205,29,176,0,1,1,0,0,1
00086655,58,4,54,0,1,1,0,1,1
00087249,30,8,22,0,0,0,0,0,1
00087324,16,4,12,0,0,0,0,0,1
00087587,46,4,42,0,1,1,0,1,1
00087611,23,3,20,0,0,0,0,0,1
00087634,63,4,59,0,0,0,0,0,0
00087911,33,3,30,0,1,1,0,1,1
00087997,25,5,20,0,1,1,0,1,1
00088235,99,13,86,0,0,0,0,0,1
00088367,11,3,8,0,2,2,0,0,1
00088380,29,5,24,0,2,1,1,2,1
00088456,47,9,38,0,0,0,0,0,1
00088783,36,10,26,0,0,0,0,0,0
00089255,30,8,22,0,2,2,0,0,1
00089286,10,7,3,0,0,0,0,0,0
00089479,17,9,8,0,0,0,0,0,0
00089611,68,0,68,0,0,0,0,0,1
00089680,16,2,14,0,0,0,0,0,1
00089980,36,3,33,0,0,0,0,0,1
00090301,16,4,12,0,0,0,0,0,0
00090305,53,11,42,0,0,0,0,0,1
00091106,30,5,25,0,1,1,0,1,1
00091553,12,5,7,0,1,1,0,1,1
00091580,19,6,13,0,0,0,0,0,1
00091818,18,5,13,0,1,1,0,0,0
00091907,98,13,85,0,2,1,1,0,0
00092069,95,23,72,0,25,22,3,0,1
00092374,68,0,68,0,0,0,0,0,1
00092501,21,0,21,0,0,0,0,0,0
00092547,6,3,3,0,1,1,0,1,0
00093175,62,16,46,0,1,1,0,0,1
00093302,137,17,120,0,0,0,0,0,0
00093403,68,6,62,0,1,1,0,0,0
00093447,66,8,58,0,1,1,0,1,1
00093688,36,0,36,0,1,1,0,1,1
00094405,44,0,44,0,0,0,0,0,1
00094558,52,6,46,0,1,1,0,1,1
00094667,24,3,21,0,1,1,0,1,1
00095559,7,4,3,0,3,3,0,0,0
00095951,9,3,6,0,1,1,0,1,0
00096093,107,4,103,0,1,1,0,0,1
00096263,34,5,29,0,1,1,0,1,1
00096610,25,2,23,0,1,1,0,1,1
00096707,11,0,11,0,0,0,0,0,1
00096878,30,9,21,0,0,0,0,0,0
00097122,64,7,57,0,0,0,0,0,0
00097159,34,4,30,0,0,0,0,0,0
00097256,159,23,136,0,1,1,0,1,1
00098220,29,4,25,0,1,1,0,1,1
00098576,80,16,64,0,0,0,0,0,1
00098664,6,3,3,0,1,1,0,0,0
00098858,21,4,17,0,1,1,0,1,1
00099122,78,3,75,0,1,1,0,1,1
00099168,85,12,73,0,0,0,0,0,1
00099295,11,0,11,0,0,0,0,0,1
00099405,44,4,40,0,1,1,0,1,1
00099629,68,12,56,0,2,2,0,0,1
00099998,37,13,24,0,0,0,0,0,0
03020005,31,10,21,0,0,0,0,0,0
03020127,68,9,59,0,0,0,0,0,1
03020691,19,0,19,0,0,0,0,0,1
03020693,19,0,19,0,1,1,0,1,1
03020745,52,9,43,0,0,0,0,0,1
03020822,42,8,34,0,1,1,0,1,1
03021099,6,3,3,0,3,3,0,0,1
03021172,3,0,3,0,0,0,0,0,0
03021262,4,2,2,0,2,2,0,0,0
03021321,24,5,19,0,1,1,0,1,1
03021348,6,0,6,0,0,0,0,0,1
03021378,23,4,19,0,1,1,0,0,1
03021390,67,10,57,0,0,0,0,0,1
03021535,77,0,77,0,0,0,0,0,1
03021755,15,4,11,0,4,4,0,1,1
03021793,6,0,6,0,0,0,0,0,1
03021844,16,3,13,0,0,0,0,0,1
03021872,14,4,10,0,1,1,0,1,1
03021955,18,1,17,0,1,1,0,0,1
03022023,24,0,24,0,0,0,0,0,1
03022062,23,0,23,0,1,1,0,1,1
03022317,43,9,34,0,1,1,0,1,1
03022441,6,2,4,0,1,1,0,0,0
03022583,19,5,14,0,4,3,1,2,1
03022633,26,5,21,0,1,1,0,1,1
03022713,5,2,3,0,1,1,0,0,0
03022974,46,0,46,0,0,0,0,0,1
03023396,28,0,28,0,0,0,0,0,1
03023493,44,6,38,0,1,1,0,1,1
03023510,33,4,29,0,1,1,0,1,1
03023511,6,2,4,0,0,0,0,0,0
03023513,14,2,12,0,0,0,0,0,1
03023521,34,2,32,0,1,1,0,1,1
03023663,5,3,2,0,2,2,0,0,1
03023689,20,7,13,1,0,0,0,0,1
03024231,15,0,15,0,2,2,0,2,1
03024349,15,0,15,0,0,0,0,0,1
03024499,45,12,33,0,0,0,0,0,1
03024656,18,2,16,0,1,1,0,1,1
03024743,5,2,3,0,2,2,0,0,1
03024798,7,3,4,0,1,1,0,0,0
03024878,26,0,26,0,0,0,0,0,1
03024921,11,0,11,0,0,0,0,0,1
03024948,14,0,14,0,0,0,0,0,1
03025063,31,0,31,0,1,1,0,1,1
03025266,5,3,2,0,2,2,0,0,0
03025463,17,2,15,0,2,2,0,0,1
03025491,19,5,14,0,1,1,0,1,0
03025819,9,2,7,0,3,2,1,1,0
03025835,23,1,22,0,1,1,0,1,1
03026245,63,8,55,0,0,0,0,0,0
03026809,29,6,23,0,0,0,0,0,1
03026829,33,8,25,0,0,0,0,0,0
03026882,7,2,5,0,0,0,0,0,0
03027012,13,5,8,0,1,1,0,1,1
03027358,123,12,111,0,0,0,0,0,1
03027472,12,5,7,0,1,1,0,1,1
03027477,6,1,5,0,1,1,0,0,1
03027480,11,5,6,0,1,1,0,1,1
03027484,7,3,4,0,1,1,0,1,1
03027495,9,5,4,0,1,1,0,1,1
03027502,11,2,9,0,1,1,0,1,1
03027504,16,4,12,0,1,1,0,1,1
03027754,15,0,15,0,0,0,0,0,1
03027761,5,3,2,0,2,2,0,0,0
03028112,56,0,56,0,0,0,0,0,1
03028184,30,3,27,0,1,1,0,1,1
03028186,12,2,10,0,3,2,1,0,0
03028365,6,1,5,0,1,1,0,0,1
03028626,22,6,16,0,1,1,0,1,1
03028678,38,8,30,0,0,0,0,0,1
03028790,41,6,35,0,1,1,0,1,1
03028914,21,4,17,0,1,1,0,1,1
03029037,12,0,12,0,0,0,0,0,1
03029058,41,6,35,0,1,1,0,1,1
03029077,49,8,41,0,0,0,0,0,1
03029095,33,3,30,0,1,1,0,1,1
03029120,8,3,5,0,1,1,0,0,1
03029304,15,8,7,0,0,0,0,0,1
03029312,38,0,38,0,0,0,0,0,1
03029316,77,6,71,0,0,0,0,0,1
03029439,36,0,36,0,0,0,0,0,1
03029861,28,3,25,0,1,1,0,1,1
03029896,6,4,2,0,2,2,0,0,0
03029925,12,4,8,0,4,3,1,2,1
03029947,99,8,91,0,0,0,0,0,1
03030012,5,3,2,0,2,2,0,0,0
03030810,5,3,2,0,2,2,0,0,0
03031220,6,3,3,0,1,1,0,1,0
03031279,17,5,12,0,1,1,0,1,1
03031447,3,0,3,0,0,0,0,0,1
03031537,32,7,25,0,0,0,0,0,1
03031612,19,5,14,0,1,1,0,1,1
03031621,64,14,50,0,0,0,0,0,1
03031656,48,7,41,0,1,1,0,0,1
03032039,9,0,9,0,0,0,0,0,1
03032115,27,0,27,0,1,1,0,1,1
03032479,14,6,8,0,1,1,0,1,1
03032481,24,0,24,0,1,1,0,1,1
03032579,10,0,10,0,1,1,0,1,0
03032760,22,0,22,0,0,0,0,0,1
03032971,37,2,35,0,1,1,0,1,1
03033092,6,0,6,0,1,1,0,0,0
03033217,32,3,29,0,1,1,0,1,1
03033275,14,0,14,0,0,0,0,0,1
03033654,57,13,44,0,0,0,0,0,1
03034038,13,5,8,0,1,1,0,0,0
03034298,16,3,13,0,1,1,0,1,1
03034557,47,8,39,0,13,8,5,0,1
03035109,8,5,3,0,2,1,1,2,0
03035115,9,6,3,0,2,1,1,2,0
03035194,7,5,2,0,1,1,0,0,1
03035662,4,2,2,0,1,1,0,0,0
03035709,23,0,23,1,0,0,0,0,1
03035761,12,3,9,0,1,0,1,1,1
03036193,5,4,1,0,1,1,0,1,0
03036200,76,9,67,0,0,0,0,0,1
03036264,23,0,23,0,0,0,0,0,1
03036613,16,5,11,0,1,0,1,0,1
03036627,68,10,58,0,0,0,0,0,1
03036686,14,8,6,0,2,1,1,0,0
03036727,23,0,23,0,0,0,0,0,1
03036915,5,3,2,0,1,1,0,0,0
03036943,3,2,1,0,3,2,1,0,0
03037046,8,1,7,0,0,0,0,0,1
03037084,23,3,20,0,0,0,0,0,0
03037111,5,3,2,0,2,2,0,0,0
03037442,37,4,33,0,1,1,0,1,1
03037445,50,8,42,0,3,2,1,0,1
03037449,50,5,45,0,0,0,0,0,1
03037563,25,3,22,0,1,1,0,1,1
03037607,23,0,23,0,0,0,0,0,1
03037632,8,0,8,0,0,0,0,0,1
03037633,41,11,30,0,1,1,0,0,1
03037955,34,9,25,0,0,0,0,0,0
03038051,19,4,15,0,1,1,0,0,1
03038275,18,4,14,0,1,1,0,1,1
03038288,24,0,24,0,0,0,0,0,1
03038307,21,0,21,0,0,0,0,0,1
03038313,21,0,21,0,0,0,0,0,1
03038503,25,2,23,0,2,2,0,0,0
03038565,10,0,10,0,0,0,0,0,1
03038707,54,3,51,0,2,2,0,2,1
03038912,34,6,28,0,1,0,1,0,0
03039013,3,2,1,0,2,2,0,0,0
03039069,8,0,8,0,0,0,0,0,1
03039080,7,1,6,0,1,1,0,0,1
03039168,40,3,37,0,1,1,0,1,1
03039302,23,5,18,0,0,0,0,0,1
03039587,13,0,13,0,0,0,0,0,1
03039699,24,15,9,0,0,0,0,0,1
03039752,97,10,87,0,0,0,0,0,1
03040174,6,2,4,0,2,2,0,0,0
03040231,42,0,42,0,0,0,0,0,1
03040252,19,4,15,0,0,0,0,0,1
03040336,57,9,48,0,2,1,1,0,0
03040742,14,3,11,0,1,1,0,1,1
03040806,12,3,9,0,1,1,0,1,1
03040863,17,2,15,0,1,1,0,1,1
03041186,13,3,10,0,0,0,0,0,1
03041245,24,0,24,0,0,0,0,0,1
03041314,23,4,19,0,1,1,0,0,1
03041555,23,2,21,0,1,1,0,1,1
03042000,16,11,5,0,11,11,0,0,1
03042092,40,3,37,0,1,1,0,1,1
03042108,52,9,43,0,3,2,1,0,0
03042176,63,9,54,0,1,1,0,1,1
03042179,28,4,24,0,0,0,0,0,0
03042243,11,1,10,0,0,0,0,0,1
03042680,33,10,23,0,1,1,0,0,0
03043379,29,0,29,0,0,0,0,0,1
03043813,39,0,39,0,0,0,0,0,1
03043815,14,7,7,0,1,1,0,1,1
03043839,12,3,9,0,1,1,0,1,1
03043923,58,6,52,0,1,1,0,1,1
03044566,27,3,24,0,1,1,0,1,1
03044741,6,3,3,0,0,0,0,0,0
03045017,22,0,22,0,0,0,0,0,1
03045131,19,0,19,0,1,1,0,1,1
03045222,47,5,42,0,3,2,1,3,1
03045370,6,3,3,0,4,2,2,1,0
03045376,7,4,3,0,4,1,3,1,0
03045421,25,5,20,0,1,1,0,1,1
03045490,11,3,8,0,1,1,0,0,1
03045607,24,7,17,0,2,1,1,2,1
03045689,17,3,14,0,1,1,0,0,1
03045903,9,2,7,0,1,1,0,0,1
03045939,52,10,42,0,0,0,0,0,1
03046042,21,3,18,0,1,1,0,1,1
03046296,37,0,37,0,1,1,0,1,1
03046375,20,0,20,0,0,0,0,0,1
03046531,26,0,26,0,0,0,0,0,1
03046536,44,11,33,0,0,0,0,0,0
03046577,7,1,6,0,1,1,0,0,0
03046600,7,3,4,0,1,1,0,0,0
03046729,11,4,7,0,1,1,0,1,1
03047020,12,3,9,0,3,1,2,1,1
03047110,25,5,20,0,0,0,0,0,1
03047165,39,0,39,0,1,1,0,1,1
03047538,34,3,31,0,1,1,0,1,1
03047676,28,4,24,0,1,1,0,1,1
03047715,5,1,4,0,2,2,0,0,0
03047966,27,0,27,0,0,0,0,0,1
03048100,17,5,12,0,0,0,0,0,1
03048466,18,6,12,0,1,1,0,1,1
03048703,20,3,17,0,0,0,0,0,1
03048838,22,4,18,0,2,1,1,2,1
03048963,21,0,21,0,0,0,0,0,1
03049022,8,4,4,0,1,1,0,1,1
03049092,7,1,6,0,0,0,0,0,1
03049321,70,0,70,0,0,0,0,0,1
03049484,18,3,15,0,1,1,0,1,1
03049932,17,0,17,0,0,0,0,0,1
03049972,16,0,16,0,1,1,0,1,1
NC000670,5,3,2,0,1,1,0,0,0
NC000713,2,0,2,0,2,2,0,0,0
NC001355,2,2,0,0,2,2,0,2,0
NC001534,2,2,0,0,0,0,0,0,0
NC001550,2,2,0,0,2,2,0,2,0
NC001569,2,2,0,2,0,0,0,0,0
NF000159,20,0,20,0,0,0,0,0,1
NF000310,13,0,13,0,0,0,0,0,1
NF000342,1,0,1,0,0,0,0,0,1
NF000713,0,0,0,0,0,0,0,0,0
NF001053,8,0,8,0,0,0,0,0,1
NF002594,34,0,34,0,0,0,0,0,1
NF002795,0,0,0,0,0,0,0,0,0
NF002802,1,0,1,0,0,0,0,0,0
NF002856,0,0,0,0,0,0,0,0,0
NF002885,0,0,0,0,0,0,0,0,0
NF003168,0,0,0,0,0,0,0,0,0
NF003195,6,6,0,0,0,0,0,0,0
NF003198,12,0,12,0,0,0,0,0,0
NF003219,24,0,24,0,0,0,0,0,1
NF003233,12,0,12,0,0,0,0,0,0
NF003250,9,0,9,0,0,0,0,0,1
NF003316,10,8,2,0,0,0,0,0,1
NF003493,20,0,20,0,0,0,0,0,1
NF003501,5,5,0,0,0,0,0,0,1
NF003673,17,0,17,0,0,0,0,0,1
NF003719,0,0,0,0,0,0,0,0,1
NF004027,20,0,20,0,0,0,0,0,1
NF004236,7,7,0,0,0,0,0,0,1
NF004287,3,3,0,0,0,0,0,0,0
NI000083,56,6,50,0,2,2,0,0,0
NI000368,20,2,18,0,1,1,0,1,0
NI000438,20,9,11,0,5,3,2,0,0
NI000475,3,1,2,0,2,2,0,0,0
NI001170,13,2,11,0,1,1,0,1,1
NI001489,82,19,63,0,0,0,0,0,0
NI001664,8,3,5,0,1,1,0,1,0
NI002567,3,3,0,0,1,1,0,0,0
NI002634,28,18,10,0,0,0,0,0,0
NI002781,9,3,6,0,1,1,0,1,1
NI002964,12,8,4,0,0,0,0,0,0
NI003341,22,4,18,0,2,1,1,2,1
NI003344,77,12,65,0,3,2,1,0,0
NI003437,4,4,0,0,1,1,0,0,0
NI003516,17,0,17,0,0,0,0,0,1
NI003669,4,3,1,0,2,2,0,1,0
NI003842,4,4,0,0,0,0,0,0,0
NI003964,254,32,222,0,0,0,0,0,1
NI004230,26,4,22,0,1,1,0,1,1
NI004241,3,3,0,0,1,1,0,0,0
NI004557,42,3,39,0,0,0,0,0,1
NI004623,6,5,1,0,1,1,0,0,0
NI004645,48,22,26,0,0,0,0,0,0
NI004648,6,3,3,0,0,0,0,0,0
NI004772,14,3,11,0,1,1,0,1,0
NI004925,12,8,4,0,0,0,0,0,0
NI005011,15,6,9,0,1,1,0,0,0
NI005544,3,2,1,0,1,1,0,1,0
NI005568,57,15,42,0,0,0,0,0,1
NI005572,5,4,1,0,1,1,0,0,0
NI005822,19,6,13,0,2,2,0,0,1
NI005896,23,0,23,0,0,0,0,0,1
NI005926,8,4,4,0,1,1,0,0,0
NI006172,20,3,17,0,1,1,0,1,0
NI006295,10,2,8,0,2,2,0,0,0
NI006411,4,4,0,0,3,3,0,0,0
NI006755,4,2,2,0,1,1,0,0,0
NI006775,6,6,0,0,1,1,0,0,0
NI006905,11,8,3,0,8,7,1,0,0
NI007325,7,2,5,0,1,1,0,1,1
NI007345,18,2,16,0,1,1,0,1,1
NI007600,38,6,32,0,1,1,0,1,1
NI008020,16,3,13,0,1,1,0,0,1
NI008205,7,5,2,0,3,3,0,0,0
NI008319,4,3,1,0,1,1,0,0,0
NI008349,19,8,11,0,0,0,0,0,0
NI008636,6,3,3,0,1,1,0,0,0
NI009762,7,3,4,0,2,1,1,1,0
NI009857,3,3,0,0,0,0,0,0,0
NI009903,3,3,0,0,0,0,0,0,0
NI009982,17,3,14,0,1,1,0,1,0
NI010146,19,5,14,0,1,1,0,1,1
NI010217,6,3,3,0,1,1,0,0,0
NI010265,8,4,4,0,3,3,0,0,0
NI010312,3,3,0,0,2,2,0,0,0
NI010438,6,3,3,0,1,1,0,0,0
NI010775,11,3,8,0,0,0,0,0,0
NI010905,18,4,14,0,1,1,0,1,0
NI010974,14,3,11,0,3,1,2,0,0
NI011275,4,4,0,0,1,1,0,0,0
NI011284,18,3,15,0,1,1,0,0,0
NI011302,7,3,4,0,1,1,0,1,0
NI011519,8,4,4,0,1,1,0,0,0
NI011622,3,1,2,0,1,1,0,0,0
NI011683,15,7,8,0,0,0,0,0,0
NI011769,5,3,2,0,2,2,0,0,0
NI011844,8,2,6,0,1,1,0,1,1
NI011852,4,3,1,0,2,2,0,0,0
NI011877,3,0,3,0,0,0,0,0,0
NI012003,69,8,61,0,0,0,0,0,1
NI012350,5,4,1,0,2,2,0,0,0
NI012422,4,4,0,0,0,0,0,0,0
NI012530,5,3,2,0,2,2,0,0,0
NI013200,4,4,0,0,1,1,0,0,0
NI013211,3,3,0,0,1,1,0,0,0
NI013434,3,3,0,0,2,2,0,0,0
NI013436,9,2,7,0,3,2,1,0,0
NI013529,6,6,0,0,1,1,0,0,0
NI013874,7,3,4,0,2,2,0,0,0
NI013918,3,2,1,0,1,1,0,0,0
NI013930,10,3,7,0,2,1,1,1,0
NI014397,11,4,7,0,2,1,1,0,0
NI014690,2,2,0,0,1,1,0,0,0
NI014726,12,3,9,0,2,1,1,2,1
NI014871,20,6,14,0,2,2,0,2,1
NI014977,8,2,6,0,1,1,0,1,1
NI015067,12,2,10,0,0,0,0,0,0
NI015089,21,10,11,0,0,0,0,0,0
NI015136,3,3,0,0,2,2,0,0,0
NI015184,3,3,0,0,0,0,0,0,0
NI015241,3,3,0,0,0,0,0,0,0
NI015566,7,4,3,0,3,3,0,0,0
NI015608,10,2,8,0,1,1,0,0,0
NI016006,3,2,1,0,0,0,0,0,0
NI016109,20,0,20,0,2,1,1,2,1
NI016178,4,2,2,0,2,1,1,0,0
NI016183,3,3,0,0,2,2,0,0,0
NI016428,26,3,23,0,3,1,2,1,1
NI016596,7,5,2,0,1,1,0,0,0
NI016662,2,2,0,0,1,1,0,0,0
NI016846,3,3,0,0,2,2,0,0,0
NI016860,6,0,6,0,0,0,0,0,0
NI017621,11,1,10,0,1,1,0,0,0
NI017622,5,3,2,0,1,1,0,0,0
NI017667,3,2,1,0,0,0,0,0,0
NI017745,39,11,28,0,1,0,1,0,0
NI017785,33,10,23,0,0,0,0,0,0
NI017859,43,10,33,0,1,1,0,1,1
NI017957,6,4,2,0,0,0,0,0,0
NI018037,21,6,15,0,1,1,0,1,1
NI018051,5,5,0,0,1,1,0,0,0
NI018145,9,2,7,0,0,0,0,0,0
NI018177,13,1,12,0,0,0,0,0,0
NI018275,22,13,9,0,0,0,0,0,0
NI018370,22,4,18,0,1,1,0,1,1
NI018550,10,3,7,0,2,1,1,1,0
NI018557,42,13,29,0,0,0,0,0,0
NI018563,23,6,17,0,0,0,0,0,0
NI018768,15,8,7,0,0,0,0,0,0
NI018800,60,11,49,0,3,2,1,3,1
NI018819,5,4,1,0,0,0,0,0,0
NI018941,29,8,21,0,1,1,0,1,1
NI019253,47,10,37,0,0,0,0,0,1
NI019274,15,0,15,0,0,0,0,0,0
NI019369,8,0,8,0,0,0,0,0,1
NI019370,30,5,25,0,1,1,0,1,1
NI019383,12,0,12,0,0,0,0,0,1
NI019569,7,3,4,0,2,2,0,0,0
NI019632,4,2,2,0,1,1,0,0,0
NI019775,9,3,6,0,1,1,0,1,0
NI019795,14,8,6,0,1,1,0,1,0
NI019883,13,3,10,0,3,2,1,0,0
NI020058,15,10,5,0,1,1,0,0,0
NI020132,15,0,15,0,0,0,0,0,0
NI020147,14,3,11,0,0,0,0,0,0
NI020185,3,3,0,0,0,0,0,0,0
NI020442,3,3,0,0,2,2,0,0,0
NI020640,6,5,1,0,1,1,0,0,0
NI020714,4,4,0,0,3,3,0,0,0
NI020807,69,9,60,0,0,0,0,0,1
NI020880,16,7,9,0,0,0,0,0,0
NI021105,3,3,0,0,2,2,0,0,1
NI021188,3,3,0,0,2,2,0,0,0
NI021369,2,2,0,0,1,1,0,0,0
NI021387,71,13,58,0,0,0,0,0,0
NI021826,10,4,6,0,0,0,0,0,0
NI021834,14,7,7,0,0,0,0,0,0
NI021905,14,8,6,0,0,0,0,0,0
NI022018,4,1,3,0,1,1,0,0,0
NI022259,20,5,15,0,1,1,0,1,1
NI022410,69,17,52,0,0,0,0,0,0
NI022469,5,2,3,0,1,1,0,0,0
NI022486,7,6,1,0,0,0,0,0,1
NI022600,13,7,6,0,0,0,0,0,0
NI022724,4,4,0,0,1,1,0,0,0
NI022818,13,5,8,0,1,1,0,1,0
NI022828,45,12,33,0,0,0,0,0,0
NI022829,18,14,4,0,1,1,0,0,1
NI023021,24,3,21,0,0,0,0,0,0
NI023031,8,0,8,0,0,0,0,0,1
NI023114,11,4,7,0,1,1,0,1,0
NI023143,19,7,12,0,2,2,0,2,1
NI023388,8,0,8,0,0,0,0,0,1
NI023394,13,7,6,0,4,2,2,0,0
NI024133,10,5,5,0,2,1,1,2,0
NI024310,68,18,50,0,0,0,0,0,0
NI024448,12,3,9,0,1,1,0,1,1
NI024466,15,3,12,0,1,1,0,0,1
NI024478,26,4,22,0,1,1,0,1,1
NI024613,17,8,9,0,0,0,0,0,0
NI024616,3,1,2,0,1,1,0,0,0
NI024845,6,3,3,0,2,1,1,0,0
NI024871,16,3,13,0,0,0,0,0,0
NI024928,20,8,12,0,1,1,0,0,1
NI025152,14,5,9,0,0,0,0,0,0
NI025202,57,7,50,0,0,0,0,0,0
NI025285,32,6,26,0,1,1,0,0,1
NI025306,3,3,0,0,2,2,0,0,0
NI025350,12,2,10,0,1,1,0,1,1
NI025396,19,7,12,0,2,2,0,2,1
NI025411,3,3,0,0,1,1,0,0,0
NI025609,15,5,10,0,1,1,0,1,0
NI025672,7,5,2,0,1,1,0,1,0
NI025675,15,4,11,0,1,1,0,1,1
NI025869,32,6,26,0,1,1,0,0,0
NI025912,3,3,0,0,2,2,0,1,0
NI026022,4,1,3,0,1,1,0,0,1
NI026037,27,5,22,0,1,1,0,1,1
NI026041,20,6,14,0,1,1,0,1,1
NI026208,57,15,42,0,0,0,0,0,0
NI026419,9,6,3,0,3,3,0,0,0
NI026619,3,3,0,0,2,2,0,0,0
NI026947,33,8,25,0,1,1,0,1,1
NI026977,56,13,43,0,0,0,0,0,0
NI026985,10,2,8,0,1,1,0,1,0
NI027016,8,3,5,0,1,1,0,0,0
NI027092,35,9,26,0,0,0,0,0,0
NI027140,23,9,14,0,0,0,0,0,0
NI027158,4,0,4,0,0,0,0,0,0
NI027207,4,4,0,0,2,2,0,1,0
NI027285,17,8,9,0,1,1,0,0,0
NI027294,15,10,5,0,0,0,0,0,0
NI027338,48,13,35,0,0,0,0,0,1
NI027480,8,3,5,0,3,3,0,1,0
NI027904,20,9,11,0,8,8,0,0,0
NI027951,47,4,43,0,2,1,1,2,1
NI028078,49,9,40,0,0,0,0,0,1
NI028222,33,6,27,0,0,0,0,0,0
NI028244,24,8,16,0,0,0,0,0,0
NI028251,4,4,0,0,2,2,0,0,0
NI028295,18,6,12,0,0,0,0,0,0
NI028356,5,2,3,0,1,1,0,0,0
NI028721,6,3,3,0,1,1,0,0,1
NI028904,9,5,4,0,0,0,0,0,0
NI028925,20,10,10,0,1,1,0,0,0
NI028958,25,8,17,0,0,0,0,0,0
NI028979,12,0,12,0,0,0,0,0,0
NI029226,4,1,3,0,1,1,0,0,0
NI029266,6,6,0,0,1,1,0,0,0
NI029415,4,4,0,0,0,0,0,0,0
NI029511,8,3,5,0,1,1,0,0,1
NI029515,32,0,32,0,0,0,0,0,1
NI029602,6,5,1,0,3,1,2,1,0
NI029694,27,8,19,0,1,1,0,0,0
NI029721,3,2,1,0,3,1,2,0,0
NI029738,48,6,42,0,0,0,0,0,1
NI029801,43,5,38,0,1,1,0,1,1
NI029814,3,3,0,0,1,1,0,0,0
NI029832,4,3,1,0,1,1,0,0,0
NI029866,14,2,12,0,1,1,0,0,0
NI029898,23,10,13,0,1,1,0,0,0
NI029924,36,13,23,0,3,3,0,0,0
NI029990,9,0,9,0,0,0,0,0,1
04622047,67,11,56,0,1,1,0,1,1
04622065,25,3,22,1,0,0,0,0,1
04622154,33,7,26,0,1,1,0,0,1
04622244,23,2,21,0,1,1,0,1,1
04622794,13,0,13,0,0,0,0,0,1
04623186,22,6,16,0,1,1,0,1,1
04623216,10,0,10,0,0,0,0,0,1
04623333,33,12,21,0,0,0,0,0,1
04623609,5,2,3,0,1,1,0,0,0
04624177,16,7,9,0,1,1,0,0,1
04624333,9,2,7,0,1,1,0,0,1
04624382,9,0,9,0,0,0,0,0,1
04624572,5,3,2,0,2,1,1,0,0
04624938,18,1,17,0,0,0,0,0,1
04625041,8,0,8,0,0,0,0,0,1
04625200,16,7,9,0,2,2,0,2,1
04625218,7,4,3,0,2,2,0,1,1
04625220,7,0,7,0,0,0,0,0,1
04625343,7,0,7,0,0,0,0,0,1
04625347,14,2,12,0,1,1,0,0,1
04625467,28,13,15,0,1,1,0,0,0
04625470,6,3,3,0,2,2,0,0,0
04625566,27,5,22,0,1,1,0,1,1
04625810,32,12,20,0,0,0,0,0,0
04625947,5,3,2,0,2,2,0,0,0
04626078,38,8,30,0,1,1,0,1,1
04626358,24,8,16,0,0,0,0,0,1
04626526,15,3,12,0,1,1,0,1,1
04626614,7,0,7,0,0,0,0,0,1
04626618,14,3,11,0,2,1,1,2,1
04626711,27,9,18,0,0,0,0,0,1
04626829,9,3,6,0,1,1,0,1,1
04627003,8,3,5,0,2,2,0,0,0
04627023,17,2,15,0,1,1,0,1,1
04627028,8,5,3,0,2,2,0,0,1
04627042,4,1,3,0,1,1,0,0,1
04627055,29,5,24,0,2,2,0,2,1
04627065,45,0,45,0,0,0,0,0,1
04627104,11,3,8,0,1,1,0,1,1
04627114,6,4,2,0,1,1,0,1,1
04627117,9,6,3,0,1,1,0,0,1
04627247,9,3,6,0,3,3,0,1,1
04627290,21,2,19,0,1,1,0,0,1
04627531,5,3,2,0,2,2,0,0,0
04627868,5,3,2,0,3,2,1,0,0
04628036,6,3,3,0,1,1,0,0,0
04628121,5,2,3,0,2,2,0,0,1
04628365,23,7,16,0,1,1,0,0,0
04628479,6,2,4,0,0,0,0,0,1
04628609,6,4,2,0,2,2,0,0,1
04629111,10,3,7,0,2,1,1,1,1
04629334,5,2,3,0,1,1,0,1,1
04629662,8,2,6,0,1,1,0,0,1
04629766,4,2,2,0,1,1,0,0,1
04630239,12,4,8,0,1,1,0,1,1
04630259,7,0,7,0,0,0,0,0,1
04630268,6,1,5,0,1,1,0,0,0
04630306,5,1,4,0,1,1,0,0,0
04631083,25,4,21,0,1,1,0,1,1
04631395,29,2,27,0,0,0,0,0,1
04631782,16,5,11,0,1,1,0,0,0
04631786,4,1,3,0,1,1,0,0,0
04633215,21,4,17,0,2,2,0,2,1
04633362,5,3,2,0,2,2,0,0,0
04633593,17,2,15,0,0,0,0,0,1
04633666,23,1,22,0,1,1,0,1,1
04633897,10,0,10,0,0,0,0,0,1
04634174,11,2,9,0,1,1,0,1,1
04634187,5,4,1,0,3,3,0,0,1
04634670,5,0,5,0,1,1,0,0,1
04634845,5,0,5,0,0,0,0,0,1
04635176,19,8,11,0,0,0,0,0,0
04635724,23,4,19,0,1,1,0,1,1
04635775,5,3,2,0,2,2,0,0,0
04635839,7,0,7,0,0,0,0,0,1
04636079,7,3,4,0,1,1,0,0,0
04636303,18,3,15,0,2,2,0,0,1
04636534,6,0,6,0,0,0,0,0,1
04636670,7,2,5,0,1,1,0,0,1
04636674,3,2,1,0,1,1,0,0,0
04636726,100,16,84,0,0,0,0,0,1
04636766,5,2,3,0,1,1,0,0,0
04636772,10,0,10,0,0,0,0,0,1
04636789,24,4,20,0,1,1,0,1,1
04637060,7,0,7,0,0,0,0,0,1
04637187,27,8,19,0,0,0,0,0,1
04637252,55,9,46,0,0,0,0,0,1
04637832,6,2,4,0,1,1,0,0,1
04637861,5,3,2,0,1,1,0,0,0
04637992,13,0,13,0,0,0,0,0,1
04638269,10,4,6,0,1,1,0,0,1
04638555,5,1,4,0,2,1,1,0,0
04638621,23,5,18,0,0,0,0,0,1
04638778,4,1,3,0,1,1,0,0,0
04638841,21,7,14,0,1,1,0,1,1
04638872,4,0,4,0,0,0,0,0,1
04638882,11,4,7,0,1,1,0,1,1
04638953,6,1,5,0,1,1,0,0,0
04639026,18,3,15,0,1,1,0,1,1
04639157,50,11,39,0,1,1,0,0,1
04639175,16,3,13,0,1,1,0,1,1
04639273,18,5,13,0,0,0,0,0,0
04639435,5,2,3,0,1,1,0,0,0
04639449,10,3,7,0,2,1,1,0,1
04639527,5,2,3,0,2,2,0,0,0
04639742,9,5,4,0,2,2,0,0,0
04639835,4,2,2,0,1,1,0,0,0
04639884,5,3,2,0,2,2,0,0,0
04639953,5,3,2,0,2,2,0,0,0
04640142,22,3,19,0,1,1,0,1,1
04640255,18,3,15,0,1,1,0,1,1
04640347,5,3,2,0,1,1,0,0,0
04640580,5,3,2,0,1,1,0,0,0
04640698,15,3,12,0,7,1,6,1,1
04640774,5,0,5,0,0,0,0,0,1
04640898,7,0,7,0,0,0,0,0,1
04640920,9,4,5,0,1,1,0,1,0
04641002,4,0,4,0,1,1,0,0,1
04641079,47,9,38,0,0,0,0,0,1
04641500,5,3,2,0,2,2,0,0,0
04641646,9,3,6,0,0,0,0,0,0
04641863,13,3,10,0,2,2,0,0,1
04642027,22,6,16,0,1,1,0,1,1
04642468,4,2,2,0,2,2,0,0,0
04642515,12,3,9,0,3,3,0,2,1
04642829,5,2,3,0,0,0,0,0,0
04643420,7,4,3,0,5,3,2,0,1
04644642,31,7,24,0,2,1,1,0,1
04644947,7,0,7,0,0,0,0,0,1
04645611,32,7,25,0,0,0,0,0,0
04645778,5,3,2,0,2,1,1,0,0
04645889,3,0,3,0,0,0,0,0,1
04645893,6,0,6,0,0,0,0,0,1
04646385,13,2,11,0,1,1,0,1,1
04646727,26,9,17,0,0,0,0,0,1
04646838,5,0,5,0,0,0,0,0,1
04647426,3,3,0,0,1,1,0,1,0
04647644,10,4,6,0,1,1,0,1,1
04647863,5,2,3,0,1,1,0,0,0
04647961,19,2,17,0,1,1,0,1,1
04648598,2,2,0,0,1,1,0,0,0
04648744,15,0,15,0,1,1,0,1,1
04648835,7,2,5,0,0,0,0,0,1
04649018,4,0,4,0,1,1,0,0,1
04649105,4,0,4,0,0,0,0,0,0
04649110,14,2,12,0,1,1,0,1,1
04649291,29,7,22,0,1,1,0,1,1
04649316,17,4,13,0,2,1,1,2,1
04649379,4,2,2,0,0,0,0,0,0
04649644,3,0,3,0,2,2,0,0,1
04649696,24,3,21,0,1,1,0,1,1
04649718,6,1,5,0,1,1,0,0,0
04649873,39,9,30,0,0,0,0,0,1
04649890,14,3,11,0,2,2,0,0,1
04650227,8,0,8,0,0,0,0,0,1
04650303,4,0,4,0,0,0,0,0,1
04650605,17,0,17,0,0,0,0,0,1
04650649,6,2,4,0,1,1,0,0,0
04650923,7,0,7,0,0,0,0,0,0
04650964,25,0,25,0,0,0,0,0,1
04651171,4,2,2,0,2,2,0,0,0
04651226,5,2,3,0,1,1,0,0,1
04651415,4,2,2,0,2,2,0,0,1
04651440,5,3,2,0,1,1,0,0,0
04651604,6,3,3,0,2,2,0,0,0
04651788,7,2,5,0,1,1,0,0,0
04651889,6,4,2,0,1,1,0,0,1
04652348,17,4,13,1,0,0,0,0,1
04652655,4,0,4,0,1,1,0,0,0
04652686,5,4,1,0,1,1,0,1,1
04652699,4,4,0,0,1,1,0,0,0
04652869,6,3,3,0,1,1,0,0,1
04653165,5,3,2,0,1,1,0,1,1
04653899,14,3,11,0,0,0,0,0,1
04654143,8,2,6,0,2,2,0,0,1
04654163,14,3,11,0,3,1,2,1,1
04654191,5,2,3,0,2,2,0,0,0
04654230,8,3,5,0,2,2,0,0,1
04654238,5,3,2,0,2,2,0,0,0
04654893,14,3,11,0,2,2,0,0,1
04654997,9,4,5,0,3,3,0,0,0
04655022,12,0,12,0,0,0,0,0,1
04655330,4,2,2,0,1,1,0,0,0
04655558,7,1,6,0,3,1,2,1,1
04655663,3,2,1,0,1,1,0,0,0
04655675,59,12,47,0,1,1,0,1,1
04655829,5,0,5,0,2,2,0,0,1
04656087,5,3,2,0,2,2,0,0,0
04656254,6,0,6,0,0,0,0,0,1
04656997,6,3,3,0,1,1,0,1,0
04657358,7,0,7,0,0,0,0,0,0
04657401,53,10,43,0,0,0,0,0,0
04657537,6,2,4,0,1,1,0,0,1
04657999,33,0,33,0,0,0,0,0,1
04658096,14,4,10,0,3,2,1,3,1
04658152,6,0,6,0,0,0,0,0,1
04658389,18,5,13,0,2,2,0,2,1
04658622,10,2,8,0,2,0,2,0,0
04658709,5,3,2,0,1,1,0,0,0
04659062,15,4,11,0,1,1,0,1,1
04659164,17,8,9,0,6,4,2,0,0
04659199,51,12,39,0,2,1,1,0,1
04659333,6,4,2,0,1,1,0,0,0
04659351,43,12,31,0,2,2,0,0,1
04659433,20,6,14,0,1,1,0,1,1
04659485,9,3,6,0,2,2,0,0,0
04659539,10,2,8,0,1,1,0,0,1
04659619,5,3,2,0,2,2,0,0,0
04659667,6,4,2,0,2,2,0,0,0
04659849,37,5,32,0,2,1,1,2,1
04660052,5,3,2,0,2,2,0,0,1
04660403,32,4,28,0,0,0,0,0,1
04660437,5,3,2,0,1,1,0,0,0
04660482,19,3,16,0,0,0,0,0,0
04660816,8,1,7,0,2,1,1,1,1
04661058,4,3,1,0,3,2,1,2,0
04661178,6,2,4,0,2,2,0,0,1
04661236,6,3,3,0,2,2,0,0,1
04661508,5,0,5,0,0,0,0,0,1
04661568,5,2,3,0,2,1,1,0,0
04661696,18,3,15,0,1,1,0,1,1
04661707,18,2,16,0,0,0,0,0,1
04661973,7,2,5,0,1,1,0,0,0
04662007,81,11,70,0,1,1,0,1,1
04662086,4,2,2,0,2,2,0,0,0
04662088,5,3,2,0,0,0,0,0,0
04662202,10,3,7,0,2,2,0,0,0
04662350,39,7,32,0,0,0,0,0,0
04662524,8,3,5,0,4,2,2,2,0
04662603,5,1,4,0,1,1,0,0,1
04662622,4,2,2,0,1,1,0,0,0
04662773,8,0,8,0,2,1,1,2,1
04663015,25,5,20,0,0,0,0,0,1
04663146,11,2,9,0,1,1,0,0,0
04663164,6,4,2,0,2,2,0,0,0
04663388,5,0,5,0,0,0,0,0,1
04663503,11,4,7,0,0,0,0,0,1
04663698,30,2,28,0,1,1,0,1,1
04664124,9,7,2,0,6,6,0,0,0
04664347,6,4,2,0,1,1,0,0,0
04664532,15,0,15,0,0,0,0,0,1
04665150,6,2,4,0,2,2,0,0,0
04665665,23,6,17,0,1,1,0,0,1
04665900,4,2,2,0,1,1,0,0,0
04665945,14,0,14,0,1,1,0,1,1
04666020,5,2,3,0,2,2,0,0,0
04666108,5,3,2,0,2,2,0,0,0
04666109,8,2,6,0,2,1,1,0,0
04666277,51,10,41,0,0,0,0,0,0
04666342,8,0,8,0,0,0,0,0,0
04666351,11,4,7,0,3,1,2,1,1
04666440,6,3,3,0,2,2,0,0,1
04666511,4,2,2,0,1,1,0,0,0
04666609,8,2,6,0,2,2,0,1,1
04666630,8,2,6,0,3,1,2,0,0
04666777,6,2,4,0,1,1,0,0,1
04666867,35,7,28,0,0,0,0,0,1
04666890,4,2,2,0,2,2,0,0,0
04667291,25,0,25,0,0,0,0,0,1
04667322,33,9,24,0,1,1,0,1,1
04667335,5,3,2,0,2,2,0,0,0
04667639,5,3,2,0,2,2,0,0,1
04668183,7,3,4,0,1,1,0,0,1
04668278,52,14,38,0,0,0,0,0,1
04668297,28,10,18,0,1,1,0,0,0
04668315,5,2,3,0,2,1,1,0,0
04668416,5,3,2,0,2,2,0,0,0
04668430,5,3,2,0,2,2,0,0,1
04668708,7,5,2,0,0,0,0,0,1
04668792,4,2,2,0,2,2,0,0,0
04668820,5,3,2,0,2,2,0,0,0
04668881,12,0,12,0,3,1,2,1,1
04669231,5,3,2,0,2,2,0,0,0
04669263,2,0,2,0,0,0,0,0,0
04669363,2,2,0,0,1,1,0,0,0
04669525,27,6,21,0,1,1,0,1,1
04669575,7,4,3,0,0,0,0,0,0
04669592,13,0,13,0,0,0,0,0,1
04669596,20,5,15,0,1,1,0,1,1
04669681,5,3,2,0,2,2,0,0,0
04669736,4,2,2,0,1,1,0,0,1
04669845,5,0,5,0,1,1,0,0,0
04669879,13,4,9,0,1,1,0,0,1
04669957,6,2,4,0,2,2,0,0,0
03440258,24,4,20,0,0,0,0,0,1
03440292,28,8,20,0,1,1,0,1,1
03440398,5,3,2,0,2,2,0,0,1
03440857,9,0,9,0,1,1,0,1,1
03440985,22,0,22,0,0,0,0,0,1
03441143,26,0,26,0,0,0,0,0,1
03441449,7,0,7,0,0,0,0,0,1
03441880,23,0,23,0,0,0,0,0,1
03441913,7,2,5,0,0,0,0,0,1
03441917,5,2,3,0,1,1,0,0,1
03441969,32,0,32,0,1,1,0,1,1
03441997,8,2,6,0,2,2,0,1,0
03442086,54,14,40,0,0,0,0,0,1
03442228,17,2,15,0,1,1,0,1,1
03442623,23,6,17,0,0,0,0,0,0
03442643,48,6,42,0,10,6,4,0,0
03442831,26,0,26,0,0,0,0,0,1
03443003,7,2,5,0,1,1,0,0,0
03443026,49,9,40,0,0,0,0,0,1
03443242,11,1,10,0,1,1,0,0,1
03443413,22,5,17,0,1,1,0,1,1
03443510,9,4,5,0,1,1,0,0,0
03443533,18,5,13,0,3,1,2,2,1
03443737,18,5,13,0,0,0,0,0,1
03443823,153,23,130,0,0,0,0,0,1
03444246,70,13,57,0,1,1,0,1,1
03444526,17,0,17,0,0,0,0,0,1
03444601,7,2,5,0,1,1,0,0,0
03444656,10,5,5,0,0,0,0,0,1
03444694,26,4,22,0,1,1,0,0,1
03444723,5,2,3,0,1,1,0,1,1
03444931,16,3,13,0,1,1,0,1,1
03444992,15,0,15,0,0,0,0,0,1
03445124,23,0,23,0,0,0,0,0,1
03445152,7,0,7,0,0,0,0,0,1
03445324,12,0,12,0,0,0,0,0,1
03445424,8,0,8,0,0,0,0,0,1
03445693,32,2,30,0,0,0,0,0,1
03446080,14,2,12,0,2,1,1,2,1
03446139,21,0,21,0,0,0,0,0,1
03446298,50,14,36,0,0,0,0,0,1
03446307,57,12,45,0,0,0,0,0,1
03446326,5,3,2,0,1,1,0,0,1
03446625,55,5,50,0,0,0,0,0,1
03446671,15,0,15,0,2,2,0,0,1
03446714,43,3,40,0,1,1,0,1,1
03446734,10,4,6,0,4,3,1,0,1
03446785,18,0,18,0,0,0,0,0,1
03447028,16,2,14,0,1,1,0,1,1
03447220,4,2,2,0,0,0,0,0,1
03447631,53,11,42,0,0,0,0,0,1
03447836,41,3,38,0,2,2,0,2,1
03447944,6,3,3,0,1,1,0,0,0
03448196,11,0,11,0,5,5,0,1,1
03448379,29,2,27,0,1,1,0,1,1
03448606,5,2,3,0,0,0,0,0,1
03448612,11,2,9,0,1,1,0,1,1
03448894,46,5,41,0,3,0,3,0,1
03449249,6,0,6,0,0,0,0,0,1
03449469,29,5,24,0,0,0,0,0,1
03449519,25,3,22,0,1,1,0,0,1
03449630,33,4,29,0,2,1,1,2,1
03449709,8,0,8,0,1,1,0,1,1
03449749,20,5,15,0,4,1,3,1,1
03449879,4,0,4,0,0,0,0,0,0
03450086,29,3,26,0,1,1,0,1,1
03450138,38,4,34,0,1,1,0,1,1
03450248,10,4,6,0,1,1,0,0,0
03450273,27,6,21,0,1,1,0,1,1
03450432,12,3,9,0,1,1,0,1,1
03450509,4,0,4,0,0,0,0,0,1
03450521,15,0,15,0,2,2,0,2,1
03450615,16,3,13,0,1,1,0,1,1
03451049,14,3,11,0,0,0,0,0,1
03451078,7,2,5,0,1,1,0,0,0
03451782,21,3,18,0,1,1,0,1,1
03451803,5,3,2,0,1,1,0,0,0
03451823,6,2,4,0,1,1,0,0,0
03451902,24,9,15,0,1,1,0,0,1
03452016,12,5,7,0,1,1,0,0,0
03452169,31,4,27,0,1,1,0,1,1
03452384,8,0,8,0,0,0,0,0,1
03452545,8,2,6,0,2,2,0,0,0
03452684,33,5,28,0,0,0,0,0,1
03452745,6,0,6,0,0,0,0,0,1
03452747,8,2,6,0,0,0,0,0,1
03452911,4,1,3,0,2,2,0,0,0
03453149,33,5,28,0,0,0,0,0,1
03453165,36,0,36,0,0,0,0,0,1
03453392,9,0,9,0,0,0,0,0,1
03453764,15,2,13,0,1,1,0,1,1
03453821,6,3,3,0,1,1,0,0,0
03454039,6,4,2,0,1,1,0,0,1
03454245,5,1,4,0,1,1,0,0,0
03454355,9,2,7,0,1,1,0,0,1
03454396,27,4,23,1,0,0,0,0,1
03454611,23,3,20,0,2,1,1,2,1
03454778,16,2,14,0,1,1,0,1,1
03454910,12,4,8,0,1,1,0,0,0
03455027,51,8,43,0,0,0,0,0,0
03455247,5,3,2,0,2,2,0,0,1
03455523,15,2,13,0,0,0,0,0,1
03455563,23,0,23,0,0,0,0,0,1
03455805,11,3,8,0,2,2,0,0,0
03456240,21,4,17,0,0,0,0,0,0
03456813,7,0,7,0,0,0,0,0,1
03456891,60,10,50,0,1,1,0,1,1
03457337,17,2,15,0,1,1,0,1,1
03458308,11,2,9,0,0,0,0,0,1
03458347,41,0,41,0,0,0,0,0,1
03458520,76,6,70,0,0,0,0,0,1
03458790,6,2,4,0,1,1,0,1,1
03458895,34,9,25,0,0,0,0,0,1
03459039,22,0,22,0,0,0,0,0,1
03459102,35,3,32,0,1,1,0,1,1
03459157,21,0,21,0,0,0,0,0,1
03459183,5,3,2,0,2,2,0,0,1
03459300,42,3,39,0,2,1,1,1,1
03459334,23,3,20,0,1,1,0,1,1
03459497,5,2,3,0,1,1,0,0,0
03459914,19,6,13,0,0,0,0,0,1
03459919,9,2,7,0,2,2,0,0,0
03460068,7,0,7,0,2,2,0,0,1
03460296,48,11,37,0,0,0,0,0,1
03460360,5,3,2,0,2,2,0,0,1
03460711,8,0,8,0,1,1,0,0,1
03460716,42,8,34,0,0,0,0,0,0
03461075,36,4,32,0,4,2,2,0,1
03461171,5,2,3,0,0,0,0,0,0
03461277,43,3,40,0,2,1,1,2,1
03461748,24,0,24,0,0,0,0,0,1
03461992,42,3,39,0,1,1,0,1,1
03462121,18,4,14,0,1,1,0,1,1
03462165,7,2,5,0,1,1,0,0,0
03462290,23,0,23,0,0,0,0,0,1
03462378,16,6,10,0,1,1,0,0,1
03462483,13,4,9,0,1,1,0,1,1
03462585,21,1,20,0,1,1,0,1,1
03462640,43,0,43,0,0,0,0,0,1
03462654,24,4,20,0,1,1,0,1,1
03462673,21,2,19,0,1,1,0,1,1
03462707,16,4,12,2,2,2,0,0,1
03463149,8,0,8,0,0,0,0,0,1
03463428,6,3,3,0,2,2,0,1,0
03463729,15,0,15,0,0,0,0,0,1
03463736,12,6,6,0,2,2,0,0,1
03463752,32,8,24,0,0,0,0,0,1
03463891,26,5,21,0,1,1,0,1,1
03464019,16,2,14,0,1,1,0,1,0
03464252,16,0,16,0,0,0,0,0,1
03464543,8,6,2,0,1,1,0,0,0
03464979,36,3,33,0,1,1,0,1,1
03464985,25,0,25,0,0,0,0,0,1
03465066,28,14,14,0,0,0,0,0,0
03465914,41,6,35,0,0,0,0,0,1
03465935,6,2,4,0,1,1,0,0,1
03466115,33,0,33,0,1,1,0,1,1
03466135,16,2,14,0,1,1,0,1,1
03466186,24,0,24,0,0,0,0,0,1
03466466,7,2,5,0,1,1,0,0,1
03467001,8,3,5,0,1,1,0,0,0
03467019,15,0,15,0,0,0,0,0,1
03467035,62,13,49,0,0,0,0,0,1
03467194,16,2,14,0,0,0,0,0,1
03467317,19,0,19,0,0,0,0,0,1
03467358,17,0,17,0,0,0,0,0,1
03467622,42,5,37,0,1,1,0,1,1
03467631,17,7,10,0,1,1,0,1,1
03467679,6,3,3,0,5,5,0,0,1
03467925,37,3,34,0,1,1,0,1,1
03468251,5,1,4,0,1,1,0,0,0
03468565,8,2,6,0,1,1,0,1,0
03468645,16,3,13,0,1,1,0,1,1
03468774,28,0,28,0,0,0,0,0,1
03468934,42,2,40,0,3,2,1,0,0
03469005,6,4,2,0,1,1,0,1,0
03469072,6,0,6,0,0,0,0,0,1
03469107,14,4,10,0,0,0,0,0,1
03469264,42,7,35,0,0,0,0,0,1
03469531,40,7,33,0,4,2,2,4,1
03469632,5,1,4,0,1,1,0,0,1
03469812,28,4,24,0,1,1,0,1,1
03469982,30,14,16,0,0,0,0,0,0
03470048,21,4,17,0,1,1,0,1,1
03470200,28,0,28,0,0,0,0,0,1
03470398,54,12,42,0,0,0,0,0,1
03470406,12,2,10,0,1,1,0,0,0
03471082,28,0,28,0,0,0,0,0,1
03471116,17,5,12,0,1,1,0,1,1
03471289,25,0,25,0,1,1,0,1,1
03471298,29,5,24,0,2,1,1,2,1
03471368,5,2,3,0,1,1,0,0,1
03471477,14,3,11,0,3,2,1,1,1
03471563,27,2,25,0,0,0,0,0,1
03471591,17,2,15,0,1,1,0,1,0
03472296,17,2,15,0,1,1,0,1,1
03472492,6,1,5,0,1,1,0,0,1
03472501,45,10,35,0,0,0,0,0,1
03472585,12,0,12,0,0,0,0,0,0
03472633,20,3,17,0,0,0,0,0,1
03472684,16,4,12,0,5,4,1,0,0
03472749,13,0,13,0,0,0,0,0,1
03472911,32,2,30,0,0,0,0,0,1
03473033,13,0,13,0,0,0,0,0,1
03473114,96,17,79,0,2,1,1,0,1
03473127,46,9,37,0,0,0,0,0,1
03473133,4,2,2,0,1,1,0,0,1
03473136,4,2,2,0,1,1,0,0,1
03473344,11,0,11,0,0,0,0,0,1
03473349,23,0,23,0,0,0,0,0,1
03473546,13,0,13,0,1,1,0,0,1
03473614,23,7,16,0,0,0,0,0,1
03473879,38,10,28,0,0,0,0,0,1
03474045,23,5,18,0,1,1,0,0,1
03474307,10,1,9,0,3,1,2,2,1
03474371,12,3,9,0,2,1,1,2,1
03474391,15,3,12,0,4,1,3,1,1
03474543,8,5,3,0,2,2,0,0,1
03474585,25,3,22,0,0,0,0,0,0
03474881,47,2,45,0,1,1,0,1,1
03474959,22,5,17,1,0,0,0,0,1
03475085,25,6,19,0,0,0,0,0,0
03475202,71,22,49,0,0,0,0,0,1
03475556,17,9,8,0,0,0,0,0,1
03475619,8,4,4,0,1,1,0,0,1
03475726,10,2,8,0,1,1,0,1,1
03475737,34,4,30,0,1,1,0,1,1
03475763,33,7,26,0,0,0,0,0,1
03475999,9,4,5,0,3,3,0,0,1
11873433,1,1,0,0,2,2,0,0,0
11873574,4,4,0,0,0,0,0,0,0
11874406,2,1,1,0,0,0,0,0,0
11874473,2,2,0,0,2,2,0,0,0
11875297,3,3,0,0,3,3,0,0,0
11875316,1,1,0,0,1,1,0,0,0
11875489,1,1,0,0,1,1,0,0,0
11876007,1,1,0,0,1,1,0,0,0
11876047,1,1,0,0,1,1,0,0,0
11876489,1,1,0,0,1,1,0,0,0
11876603,2,1,1,0,2,1,1,0,0
11876723,2,2,0,0,2,2,0,0,0
11876908,3,3,0,0,0,0,0,0,0
11876997,2,2,0,0,1,1,0,1,1
11877319,1,1,0,0,1,1,0,0,0
11877419,1,1,0,0,1,1,0,0,0
11877789,2,2,0,0,2,2,0,0,0
11877968,2,2,0,0,1,1,0,0,0
11878065,2,2,0,0,1,1,0,0,0
11878245,2,2,0,0,2,2,0,0,0
11878401,1,1,0,0,1,1,0,0,0
11878474,1,1,0,0,1,1,0,0,0
11878947,2,2,0,0,1,1,0,0,0
11879213,1,1,0,0,1,1,0,0,0
11879275,2,2,0,0,2,2,0,0,0
11879697,2,2,0,0,1,1,0,0,0
11879894,2,2,0,0,2,2,0,0,0
11880813,1,1,0,0,1,1,0,0,0
11880950,1,1,0,0,1,1,0,0,0
11881536,1,1,0,0,1,1,0,0,0
11881626,3,3,0,0,1,1,0,1,1
11881874,1,1,0,0,1,1,0,0,0
11881885,1,1,0,0,1,1,0,0,0
11881928,1,1,0,0,2,2,0,0,0
11882165,5,5,0,0,0,0,0,0,0
11882213,4,4,0,0,1,1,0,1,0
11882339,1,1,0,0,1,1,0,0,0
11882749,2,2,0,0,1,1,0,0,0
11882800,4,3,1,0,1,0,1,0,1
11882806,2,2,0,0,1,1,0,0,0
11882977,3,3,0,0,2,2,0,0,0
11883564,1,1,0,0,1,1,0,0,0
11884241,2,2,0,0,2,2,0,0,1
11884557,2,2,0,0,2,2,0,0,0
11884569,1,1,0,0,1,1,0,0,0
11884664,1,1,0,0,1,1,0,0,0
11884813,2,2,0,0,1,1,0,0,0
11885143,1,1,0,0,1,1,0,0,0
11885233,1,1,0,0,1,1,0,0,0
11885411,2,2,0,0,2,2,0,0,0
11885448,2,2,0,0,1,1,0,0,0
11885461,4,3,1,0,1,1,0,1,1
11885614,1,1,0,0,1,1,0,0,0
11885693,1,1,0,0,1,1,0,0,0
11885778,2,2,0,0,1,1,0,0,0
11885780,1,1,0,0,1,1,0,0,0
11886094,1,1,0,0,2,2,0,0,0
11886306,1,1,0,0,1,1,0,0,0
11886443,2,2,0,0,1,1,0,0,1
11886607,2,2,0,0,1,1,0,0,0
11886822,2,2,0,0,1,1,0,0,0
11887251,1,1,0,0,1,1,0,0,0
11887327,1,1,0,0,1,1,0,0,0
11887734,1,1,0,0,1,1,0,0,0
11887911,2,2,0,0,2,2,0,0,0
11888175,2,2,0,0,2,2,0,0,0
11888270,1,1,0,0,1,1,0,0,0
11888728,2,2,0,0,1,1,0,0,0
11888751,2,2,0,0,2,2,0,0,0
11889513,2,2,0,0,2,2,0,0,0
11890320,1,1,0,0,1,1,0,0,0
11890484,2,2,0,0,2,2,0,0,0
11890559,2,2,0,0,2,2,0,0,0
11890847,1,1,0,0,0,0,0,0,0
11891526,2,2,0,0,2,2,0,0,0
11891530,1,1,0,0,1,1,0,0,0
11892024,2,2,0,0,2,2,0,0,0
11892794,3,3,0,0,1,1,0,1,1
11892881,1,1,0,0,1,1,0,0,0
11892917,2,2,0,0,2,2,0,0,0
11892945,1,1,0,0,1,1,0,0,0
11893077,1,1,0,0,1,1,0,0,0
11893184,10,10,0,0,0,0,0,0,1
11893274,3,3,0,0,1,1,0,1,1
11893331,1,1,0,0,2,2,0,0,0
11893510,3,3,0,0,1,1,0,0,0
11893575,1,1,0,0,1,1,0,0,0
11893669,1,1,0,0,1,1,0,0,0
11893687,1,1,0,0,1,1,0,0,0
11893692,1,1,0,0,0,0,0,0,0
11893961,4,4,0,0,4,4,0,0,0
11894042,1,1,0,0,1,1,0,0,0
11894395,1,1,0,0,1,1,0,1,0
11894551,4,4,0,0,1,0,1,0,0
11894829,1,1,0,0,1,1,0,0,0
11895420,1,1,0,0,1,1,0,0,0
11895836,1,1,0,0,1,1,0,0,0
11895992,1,1,0,0,1,1,0,0,0
11896305,1,1,0,0,1,1,0,0,0
11896709,4,4,0,0,1,1,0,1,1
11897050,1,1,0,0,1,1,0,0,0
11897133,1,1,0,0,1,1,0,0,0
11897222,1,1,0,0,1,1,0,0,0
11897456,2,2,0,0,2,2,0,0,0
11897626,1,1,0,0,1,1,0,0,0
11898149,1,1,0,0,1,1,0,0,0
11898214,5,5,0,0,1,1,0,1,0
11898236,1,1,0,0,1,1,0,0,0
11898506,2,2,0,0,1,1,0,0,0
11898947,1,1,0,0,1,1,0,0,0
11899008,2,2,0,0,1,1,0,1,1
11899462,2,2,0,0,1,1,0,1,0
11899525,3,3,0,0,1,1,0,1,0
11899576,3,3,0,0,1,1,0,0,1
11899651,2,2,0,0,1,1,0,0,0
11899901,1,1,0,0,1,1,0,0,0
11900249,2,2,0,0,2,2,0,0,0
11900352,1,1,0,0,1,1,0,0,0
11900627,3,3,0,0,3,3,0,0,0
11900630,1,1,0,0,1,1,0,0,0
11900755,1,1,0,0,1,1,0,0,1
11900810,4,4,0,0,0,0,0,0,0
11901022,2,2,0,0,1,1,0,0,0
11901252,4,4,0,0,1,1,0,1,1
11901983,1,1,0,0,1,1,0,0,0
11902089,1,1,0,0,1,1,0,0,0
11902452,1,1,0,0,1,1,0,0,0
11903186,1,1,0,0,1,1,0,0,0
11904076,1,1,0,0,1,1,0,0,0
11904526,2,2,0,0,1,1,0,1,1
11904794,2,2,0,0,1,1,0,0,0
11905007,1,1,0,0,2,2,0,0,0
11905227,1,1,0,0,1,1,0,0,0
11905262,1,1,0,0,1,1,0,0,1
11905815,1,1,0,0,1,1,0,0,1
11906218,1,1,0,0,1,1,0,0,0
11906635,2,2,0,0,2,2,0,0,0
11906660,5,5,0,0,1,1,0,1,1
11906955,2,2,0,0,1,1,0,0,0
11907200,1,1,0,0,1,1,0,0,0
11907260,1,1,0,0,1,1,0,0,0
11907561,3,3,0,0,2,2,0,0,1
11907627,3,3,0,2,1,1,0,1,0
11907670,1,1,0,0,0,0,0,0,0
11907710,7,4,3,0,1,0,1,0,0
11907715,1,1,0,0,1,1,0,0,0
11908020,3,3,0,0,1,1,0,1,1
11908035,1,1,0,0,1,1,0,0,0
11908090,2,2,0,0,1,1,0,1,0
11908190,1,1,0,0,1,1,0,0,0
11908512,1,1,0,0,1,1,0,0,0
11908625,3,3,0,0,0,0,0,0,0
11908848,1,1,0,0,1,1,0,0,0
11908864,2,2,0,0,1,1,0,1,1
11909351,1,1,0,0,1,1,0,0,0
11909503,1,1,0,0,1,1,0,0,0
11909570,2,2,0,0,3,3,0,0,1
11909604,2,2,0,0,2,2,0,0,0
11909700,1,1,0,0,1,1,0,1,0
11910048,4,4,0,0,1,1,0,1,0
11910179,1,1,0,0,0,0,0,0,0
11910941,1,1,0,0,1,1,0,0,0
11911008,1,1,0,0,1,1,0,0,0
11911050,1,1,0,0,1,1,0,0,0
11911085,5,5,0,0,0,0,0,0,0
11911538,1,1,0,0,1,1,0,0,0
11911686,1,1,0,0,1,1,0,0,0
11911732,1,1,0,0,1,1,0,0,0
11912093,3,3,0,0,2,2,0,0,0
11912262,1,1,0,0,1,1,0,0,0
11912342,1,1,0,0,1,1,0,0,0
11913037,5,5,0,0,1,1,0,1,1
11913253,2,2,0,0,2,2,0,0,0
11913388,2,1,1,0,1,1,0,0,0
11913511,1,1,0,0,1,1,0,0,0
11913924,1,1,0,0,3,3,0,0,0
11914114,1,1,0,0,1,1,0,0,0
11914256,3,3,0,0,2,2,0,0,0
11914417,2,2,0,0,1,1,0,1,1
11914569,2,2,0,0,2,2,0,0,0
11914608,1,1,0,0,1,1,0,0,0
11914737,1,1,0,0,1,1,0,0,0
11915803,2,2,0,0,1,1,0,0,0
11915942,1,1,0,0,1,1,0,0,1
11916576,1,1,0,0,1,1,0,0,0
11916930,1,1,0,0,1,1,0,0,0
11917131,1,1,0,0,1,1,0,0,0
11917249,1,1,0,0,1,1,0,0,0
11917387,1,1,0,0,1,1,0,0,0
11917751,1,1,0,0,1,1,0,0,0
11917814,1,1,0,0,1,1,0,0,0
11917871,1,1,0,0,1,1,0,0,0
11918501,1,1,0,0,1,1,0,0,0
11918616,9,9,0,0,0,0,0,0,0
11918618,4,4,0,0,2,2,0,0,0
11918826,1,1,0,0,1,1,0,0,0
11919092,1,1,0,0,1,1,0,0,0
11919284,2,2,0,0,2,2,0,0,0
11919301,1,1,0,0,1,1,0,0,0
11919387,2,2,0,0,1,1,0,0,0
11919393,2,2,0,0,1,1,0,0,0
11919782,2,2,0,0,2,2,0,0,0
11919834,2,2,0,0,2,2,0,0,0
11919933,3,3,0,0,2,2,0,0,0
11920082,1,1,0,0,1,1,0,0,0
11920094,2,2,0,0,2,2,0,0,0
11920177,2,2,0,0,1,1,0,0,0
11920254,2,2,0,0,1,1,0,0,0
11920307,1,1,0,0,1,1,0,0,0
11920364,1,1,0,0,1,1,0,0,0
11920459,2,2,0,0,1,1,0,0,0
11920469,2,2,0,0,1,1,0,1,0
11920533,2,2,0,0,2,2,0,0,0
11921023,5,5,0,0,0,0,0,0,0
11921272,5,5,0,0,0,0,0,0,0
11921833,1,1,0,0,1,1,0,0,0
11921997,2,2,0,0,2,2,0,1,1
11922941,1,1,0,0,1,1,0,0,1
11923312,1,1,0,0,1,1,0,0,1
11923639,2,2,0,0,1,1,0,1,1
11923906,1,1,0,0,1,1,0,0,0
11924217,4,4,0,0,1,1,0,1,1
11924308,1,1,0,0,1,1,0,0,0
11924374,4,4,0,0,1,1,0,1,1
11924531,2,2,0,0,2,2,0,0,0
11924712,2,2,0,0,1,1,0,0,1
11924877,1,1,0,0,1,1,0,0,0
11924991,4,4,0,0,1,1,0,1,0
11925343,1,1,0,0,1,1,0,0,0
11925722,2,2,0,0,2,2,0,0,0
11926364,2,2,0,0,1,1,0,1,0
11927680,1,1,0,0,1,1,0,0,0
11927930,9,9,0,0,0,0,0,0,0
09845638,12,5,7,0,1,1,0,1,1
09845682,9,6,3,0,0,0,0,0,0
09846123,2,2,0,0,2,2,0,0,0
09846187,12,5,7,0,1,1,0,1,1
09846290,4,3,1,0,1,1,0,1,0
09846381,1,1,0,0,1,1,0,0,0
09846485,1,0,1,0,0,0,0,0,0
09846649,3,3,0,0,3,3,0,0,1
09846864,12,5,7,0,1,1,0,1,1
09846907,12,5,7,0,1,1,0,1,1
09847134,1,0,1,0,1,1,0,0,0
09847671,1,0,1,0,0,0,0,0,1
09847687,1,0,1,0,0,0,0,0,1
09847689,2,0,2,0,1,1,0,1,1
09847725,1,0,1,0,0,0,0,0,1
09847728,4,3,1,0,2,2,0,1,0
09847831,1,1,0,0,1,1,0,0,0
09847882,1,0,1,0,0,0,0,0,1
09847928,7,3,4,0,1,1,0,1,1
09847931,1,0,1,0,0,0,0,0,1
09847966,10,8,2,0,0,0,0,0,1
09848076,1,0,1,0,0,0,0,0,1
09848313,2,2,0,0,2,2,0,0,0
09848874,8,6,2,0,2,1,1,0,1
09849052,1,1,0,0,1,1,0,0,0
09849070,1,0,1,0,0,0,0,0,0
09849138,6,4,2,0,1,1,0,0,0
09849851,1,0,1,0,1,1,0,0,0
09850338,1,0,1,0,0,0,0,0,0
09850651,2,1,1,0,4,4,0,0,0
09850793,4,2,2,0,1,1,0,0,0
09850953,2,2,0,0,3,3,0,1,0
09850985,2,2,0,0,3,3,0,1,0
09851058,3,1,2,0,1,1,0,0,0
09851128,32,17,15,0,0,0,0,0,0
09851194,2,2,0,0,1,1,0,0,0
09851295,4,4,0,0,2,1,1,1,0
09851329,8,1,7,0,5,1,4,0,0
09851453,3,3,0,0,2,2,0,0,0
09851568,2,2,0,0,3,3,0,1,0
09851770,3,3,0,0,2,2,0,0,0
09851783,1,1,0,0,1,1,0,0,0
09851868,3,2,1,0,2,2,0,0,0
09851869,2,2,0,0,3,3,0,1,0
09853049,1,1,0,0,1,1,0,0,0
09853277,2,2,0,0,1,1,0,0,1
09853324,1,1,0,0,1,1,0,0,0
09853493,6,5,1,0,0,0,0,0,1
09853507,10,5,5,0,1,1,0,1,1
09854399,1,1,0,0,1,1,0,0,0
09854423,2,2,0,0,1,1,0,0,0
09854557,1,1,0,0,1,1,0,0,0
09854594,3,2,1,0,1,1,0,0,0
09854625,3,1,2,0,1,1,0,0,1
09854664,2,2,0,0,1,1,0,0,0
09854713,7,6,1,0,0,0,0,0,1
09854962,5,4,1,0,3,3,0,0,1
09855035,1,1,0,0,1,1,0,0,0
09855264,6,4,2,0,1,1,0,1,1
09855491,2,1,1,0,1,1,0,0,0
09855612,1,1,0,0,2,1,1,0,1
09855833,3,0,3,0,2,2,0,0,1
09856029,2,2,0,0,2,2,0,0,0
09856210,2,1,1,0,1,1,0,0,0
09856467,3,0,3,0,0,0,0,0,1
09856736,5,1,4,0,2,1,1,0,0
09856861,2,2,0,0,2,1,1,0,1
09856967,4,1,3,0,2,1,1,0,0
09856999,1,0,1,0,1,1,0,0,0
09857189,7,4,3,0,1,1,0,0,0
09857700,4,1,3,0,2,1,1,0,0
09857787,2,2,0,0,1,1,0,1,1
09858395,1,0,1,0,1,1,0,0,0
09858455,1,1,0,0,1,1,0,0,0
09858584,2,2,0,0,1,1,0,0,0
09858862,2,0,2,0,1,1,0,0,0
09858936,10,4,6,0,0,0,0,0,1
09858973,2,2,0,0,1,1,0,0,0
09859304,5,4,1,0,1,1,0,1,0
09859350,4,2,2,0,1,1,0,1,1
09859720,2,2,0,0,1,1,0,0,0
09859829,3,0,3,0,1,1,0,0,1
09859903,3,2,1,0,3,2,1,0,0
09860104,2,2,0,0,1,1,0,0,0
09860229,7,6,1,0,0,0,0,0,1
09860721,1,1,0,0,1,1,0,0,0
09861088,1,1,0,0,1,1,0,0,0
09861344,1,1,0,0,1,1,0,0,0
09861358,4,3,1,0,1,1,0,0,0
09861371,10,9,1,0,0,0,0,0,1
09861463,3,3,0,0,3,3,0,0,0
09862011,4,4,0,0,3,3,0,0,1
09862186,4,2,2,0,0,0,0,0,0
09862483,5,3,2,0,0,0,0,0,0
09862700,2,2,0,0,1,1,0,0,0
09862818,2,0,2,0,0,0,0,0,0
09863038,2,2,0,0,2,2,0,0,0
09863072,1,1,0,0,1,1,0,0,0
09863407,1,0,1,0,0,0,0,0,0
09863493,2,0,2,0,2,2,0,0,1
09864002,2,0,2,0,2,2,0,0,0
09864008,4,2,2,0,1,1,0,0,0
09864104,1,1,0,0,0,0,0,0,0
09864688,2,2,0,0,2,2,0,0,0
09865416,1,1,0,0,1,1,0,0,0
09865447,1,1,0,0,1,1,0,0,0
09865699,1,1,0,0,1,1,0,0,0
09865829,1,1,0,0,1,1,0,0,0
09865915,3,1,2,0,2,1,1,0,1
09865943,1,1,0,0,1,1,0,0,0
09866052,5,5,0,0,0,0,0,0,0
09866216,6,4,2,0,0,0,0,0,1
09866870,2,1,1,0,2,1,1,0,0
09866882,3,3,0,0,2,2,0,0,0
09866887,2,2,0,0,2,2,0,0,0
09866940,1,1,0,0,1,1,0,0,0
09867216,2,0,2,0,2,2,0,0,0
09867757,15,8,7,0,0,0,0,0,0
09868213,3,3,0,0,1,1,0,0,1
09868223,2,2,0,0,2,2,0,0,0
09868242,1,0,1,0,1,1,0,0,0
09868525,3,2,1,0,1,1,0,0,0
09868794,2,0,2,0,0,0,0,0,0
09868882,2,0,2,0,1,1,0,0,1
09868955,4,3,1,0,1,1,0,1,1
09869080,1,1,0,0,1,1,0,0,0
09869231,1,1,0,0,1,1,0,0,0
09869609,1,1,0,0,1,1,0,0,0
09869765,1,1,0,0,1,1,0,0,0
09870144,5,3,2,0,3,3,0,0,0
09870235,2,0,2,0,1,1,0,0,0
09870269,1,0,1,0,1,1,0,0,0
09870300,1,1,0,0,1,1,0,0,0
09870421,7,5,2,0,5,0,5,0,0
09870612,6,5,1,0,1,1,0,0,1
09870693,2,2,0,0,1,1,0,0,0
09871129,6,5,1,0,5,5,0,1,1
09871186,3,2,1,0,0,0,0,0,0
09872177,4,4,0,0,2,2,0,0,1
09872198,2,1,1,0,1,1,0,0,0
09872462,5,4,1,0,3,3,0,0,0
09873208,2,1,1,0,1,1,0,0,1
09873507,5,4,1,0,0,0,0,0,0
09876178,2,2,0,0,2,2,0,0,0
09876624,4,2,2,0,3,2,1,0,0
09876827,8,4,4,0,0,0,0,0,0
09876864,1,1,0,0,1,1,0,0,0
09876958,6,3,3,0,3,2,1,0,1
09876972,3,1,2,0,1,1,0,0,0
09877152,2,2,0,0,0,0,0,0,1
09877160,10,5,5,0,2,1,1,2,1
09877161,8,7,1,0,3,0,3,0,1
09877348,5,1,4,0,1,1,0,0,1
09877419,2,1,1,0,1,1,0,0,0
09877460,2,0,2,0,1,1,0,0,0
09878824,1,0,1,0,0,0,0,0,1
09878983,3,3,0,0,1,1,0,1,1
09879023,10,2,8,0,1,1,0,1,1
09879145,1,1,0,0,2,2,0,0,0
09879228,2,2,0,0,2,2,0,0,1
09879535,1,1,0,0,1,1,0,0,0
09879616,1,1,0,0,1,1,0,0,0
09879865,2,2,0,0,1,1,0,0,0
09879951,3,3,0,0,2,2,0,0,0
09879961,1,1,0,0,1,1,0,0,0
09880327,2,2,0,0,2,2,0,0,0
09880388,4,3,1,0,0,0,0,0,1
09880813,1,0,1,0,0,0,0,0,0
09881060,4,1,3,0,1,1,0,0,0
09881148,10,7,3,0,2,0,2,2,1
09881410,6,5,1,0,2,2,0,1,0
09881414,1,1,0,0,1,1,0,0,0
09881449,6,0,6,0,0,0,0,0,0
09881530,2,0,2,0,1,1,0,0,0
09881572,2,1,1,0,2,1,1,0,1
09881601,1,1,0,0,1,1,0,0,0
09881802,6,3,3,0,1,1,0,1,1
09882024,1,1,0,0,1,1,0,0,0
09882181,3,3,0,0,2,2,0,0,0
09882434,1,0,1,0,0,0,0,0,0
09882713,2,2,0,0,2,2,0,0,0
09883164,6,3,3,0,1,1,0,1,1
09883816,3,3,0,0,2,2,0,0,1
09884652,2,2,0,0,1,1,0,0,0
09884950,2,2,0,0,2,2,0,2,0
09885023,1,0,1,0,0,0,0,0,1
09885426,1,1,0,0,1,1,0,0,0
09885679,5,5,0,0,3,3,0,0,1
09885734,10,2,8,0,0,0,0,0,0
09885771,6,3,3,0,1,1,0,1,1
09885800,6,3,3,0,1,1,0,1,1
09886235,2,0,2,0,2,2,0,0,0
09886471,1,1,0,0,1,1,0,0,0
09886733,2,2,0,0,2,2,0,0,0
09886880,3,0,3,0,2,1,1,0,0
09887042,7,4,3,0,1,1,0,0,1
09887076,1,1,0,0,1,1,0,0,0
09887093,6,4,2,0,1,1,0,0,1
09887193,2,2,0,0,2,2,0,0,0
09887429,7,4,3,0,1,1,0,1,1
09887438,2,0,2,0,2,1,1,0,0
09887504,2,2,0,0,2,2,0,0,0
09887974,2,0,2,0,0,0,0,0,0
09888137,2,1,1,0,2,1,1,0,0
09888534,2,1,1,0,2,1,1,0,0
09888674,1,0,1,0,1,1,0,0,0
09888802,1,0,1,0,0,0,0,0,0
09888919,2,2,0,0,1,1,0,0,0
09889149,3,3,0,0,1,1,0,1,1
09889172,1,1,0,0,1,1,0,0,0
09889253,2,2,0,0,3,3,0,1,0
09889303,2,1,1,0,2,2,0,0,0
09889615,11,5,6,0,0,0,0,0,1
09890152,4,4,0,0,2,2,0,0,1
09890164,3,3,0,0,1,1,0,1,0
09890242,3,0,3,0,0,0,0,0,1
09890295,2,0,2,0,1,1,0,0,1
09890743,2,0,2,0,0,0,0,0,0
09891297,3,3,0,0,0,0,0,0,0
09891433,3,0,3,0,0,0,0,0,0
09891707,4,3,1,0,1,1,0,1,1
09891841,2,1,1,0,2,1,1,1,0
09891970,1,1,0,0,1,1,0,0,0
09892044,10,4,6,0,4,1,3,1,1
09892433,3,3,0,0,3,1,2,0,0
09892752,3,3,0,0,1,1,0,0,1
09893006,4,3,1,0,1,1,0,1,1
09893225,2,1,1,0,1,1,0,0,1
09893316,3,2,1,0,1,1,0,0,0
09893905,6,5,1,0,0,0,0,0,1
09894357,1,1,0,0,1,1,0,0,0
09894386,3,2,1,0,2,2,0,0,0
09894408,1,1,0,0,1,1,0,0,0
09894489,8,6,2,0,0,0,0,0,1
09895244,1,1,0,0,1,1,0,0,0
09895276,15,8,7,0,0,0,0,0,1
09895381,3,3,0,0,1,1,0,1,1
09895415,3,3,0,0,2,2,0,0,1
09895681,2,2,0,0,2,2,0,0,0
09895708,1,1,0,0,1,1,0,0,0
09895981,1,1,0,0,1,1,0,0,0
09896059,3,3,0,0,1,1,0,0,0
09896401,1,1,0,0,1,1,0,0,0
09896585,2,0,2,0,0,0,0,0,1
09896675,4,0,4,0,0,0,0,0,1
09896693,1,1,0,0,1,1,0,0,0
09896804,7,0,7,0,1,1,0,1,0
09896888,2,2,0,0,2,2,0,0,0
09896957,9,2,7,0,1,1,0,1,1
09897183,2,2,0,0,1,1,0,0,0
09897495,2,2,0,0,1,1,0,0,0
09897497,5,3,2,0,1,1,0,0,1
09897698,5,4,1,0,1,1,0,0,1
09897827,1,0,1,0,0,0,0,0,0
09898241,3,3,0,0,2,2,0,0,1
09898371,1,0,1,0,1,1,0,0,0
09898430,3,2,1,0,1,1,0,1,1
09898448,2,1,1,0,1,1,0,0,0
09899015,6,5,1,0,1,1,0,1,0
09899182,3,0,3,0,2,2,0,0,0
09899246,4,3,1,0,3,3,0,0,0
09899449,1,1,0,0,1,1,0,0,0
09899598,3,3,0,0,1,1,0,0,0
09899754,3,3,0,0,1,1,0,0,0
09899801,3,2,1,0,1,1,0,0,1
09900482,21,13,8,0,0,0,0,0,0
09900701,4,3,1,0,1,1,0,1,0
09901425,12,5,7,0,1,1,0,1,1
09901695,4,0,4,0,0,0,0,0,1
09901862,7,0,7,0,0,0,0,0,0
09901920,1,0,1,0,0,0,0,0,0
09902119,4,2,2,0,3,1,2,1,1
09902509,2,1,1,0,1,1,0,0,0
09902596,2,2,0,0,2,2,0,0,0
09902789,2,2,0,0,2,2,0,0,0
09902896,1,0,1,0,1,1,0,0,0
09902985,5,3,2,0,2,2,0,0,0
09903246,10,4,6,0,2,1,1,2,1
09903289,12,10,2,0,1,1,0,1,1
09903556,2,2,0,0,1,1,0,0,1
09903582,3,2,1,0,3,2,1,0,0
09903987,4,1,3,0,2,2,0,2,1
09904074,1,0,1,0,0,0,0,0,0
09904356,5,3,2,0,1,1,0,1,1
09904391,1,1,0,0,1,1,0,0,0
09905286,2,2,0,0,1,1,0,0,0
09905526,23,16,7,0,0,0,0,0,0
09905572,4,3,1,0,1,1,0,0,0
09906240,5,3,2,0,1,1,0,1,1
09907037,6,2,4,0,4,2,2,0,1
09907324,2,2,0,0,2,2,0,0,0
09907475,6,2,4,0,1,1,0,1,1
09907549,2,2,0,0,1,1,0,0,0
09907636,14,6,8,0,0,0,0,0,0
09907794,2,2,0,0,2,2,0,0,1
09907831,11,5,6,0,0,0,0,0,1
09907841,5,4,1,0,1,1,0,1,1
09908112,3,2,1,0,1,1,0,0,0
09908347,1,1,0,0,1,1,0,0,0
09908405,8,4,4,0,1,1,0,1,1
09908421,1,0,1,0,1,1,0,0,0
09909064,9,4,5,0,1,1,0,1,1
09909145,3,3,0,0,0,0,0,0,0
09909164,1,1,0,0,1,1,0,0,0
09909551,2,1,1,0,2,2,0,0,0
09909789,5,3,2,0,0,0,0,0,0
09909845,1,1,0,0,1,1,0,0,0
09910190,4,3,1,0,1,1,0,1,1
09910449,3,3,0,0,2,2,0,0,0
09911764,22,13,9,0,10,9,1,0,1
09911905,11,9,2,0,0,0,0,0,0
09912095,2,2,0,0,2,2,0,0,1
09912238,2,2,0,0,1,1,0,0,0
09912966,2,2,0,0,1,1,0,0,0
09913107,2,2,0,0,1,1,0,1,1
09913341,4,4,0,0,1,1,0,1,1
09913468,9,4,5,0,2,1,1,2,0
09913508,4,2,2,0,3,1,2,1,1
09913581,3,1,2,0,2,2,0,0,1
09913716,3,1,2,0,1,1,0,1,1
09913745,3,1,2,0,1,1,0,1,1
09913962,3,3,0,0,1,1,0,0,1
09914015,14,9,5,0,1,1,0,1,1
09914306,6,5,1,0,1,1,0,1,1
09914320,2,2,0,0,1,1,0,0,0
09914639,2,2,0,0,2,2,0,0,0
09914720,3,1,2,0,1,1,0,0,0
09914960,10,2,8,0,1,1,0,1,1
09915261,2,2,0,0,1,1,0,0,1
09915444,1,1,0,0,1,1,0,0,0
09915602,1,1,0,0,1,1,0,0,0
09915747,5,5,0,0,0,0,0,0,0
09915820,17,7,10,0,0,0,0,0,1
09915844,6,4,2,0,1,1,0,1,0
09915957,12,10,2,0,0,0,0,0,0
09915985,1,1,0,0,1,1,0,0,1
09916008,11,7,4,0,1,0,1,0,0
09916660,8,4,4,0,2,1,1,2,1
09917742,2,2,0,0,2,2,0,0,0
09917811,4,4,0,0,1,1,0,1,1
09917815,1,0,1,0,1,1,0,0,0
09918048,3,2,1,0,4,1,3,0,1
09918136,2,0,2,0,2,2,0,0,0
09918139,2,2,0,0,1,1,0,1,0
09918162,2,2,0,0,2,2,0,0,0
09918170,14,4,10,0,3,1,2,2,1
09918883,13,6,7,0,2,2,0,2,1
09919382,9,0,9,0,0,0,0,0,1
09919488,4,2,2,0,1,1,0,0,0
11005018,1,0,1,0,1,1,0,0,0
11005109,4,4,0,0,1,1,0,0,0
11005332,4,2,2,0,2,1,1,2,0
11005376,5,4,1,0,1,1,0,0,0
11005562,3,3,0,0,1,1,0,0,0
11005795,4,4,0,0,3,3,0,0,1
11006175,2,2,0,0,1,1,0,1,0
11006383,1,1,0,0,1,1,0,0,0
11006461,11,8,3,0,0,0,0,0,0
11006671,3,3,0,0,1,1,0,1,1
11006782,2,2,0,0,2,2,0,0,0
11007041,3,3,0,0,1,1,0,1,1
11007108,3,3,0,0,1,1,0,1,1
11007272,1,1,0,0,0,0,0,0,0
11007306,3,3,0,0,1,1,0,1,1
11007335,1,1,0,0,1,1,0,0,0
11007423,2,2,0,0,2,2,0,0,0
11007494,3,3,0,0,1,1,0,1,1
11007599,1,1,0,0,1,1,0,0,1
11007620,2,0,2,0,2,2,0,0,0
11007958,6,4,2,0,0,0,0,0,1
11008275,1,0,1,0,1,1,0,0,0
11008319,2,2,0,0,2,2,0,0,0
11008911,2,2,0,0,0,0,0,0,0
11008981,2,2,0,0,1,1,0,0,0
11009444,1,1,0,0,1,1,0,0,0
11010111,1,0,1,0,1,1,0,0,0
11010311,1,1,0,0,1,1,0,0,1
11010802,1,1,0,0,1,1,0,1,0
11010859,2,2,0,0,1,1,0,1,1
11011053,4,3,1,0,0,0,0,0,0
11011777,2,2,0,0,2,2,0,0,0
11011790,1,1,0,0,4,2,2,0,0
11012141,3,3,0,0,1,1,0,1,1
11012626,1,0,1,0,1,1,0,0,0
11012955,2,2,0,0,2,2,0,0,0
11013432,1,1,0,0,1,1,0,0,0
11013814,3,3,0,0,0,0,0,0,1
11014302,1,1,0,0,1,1,0,0,0
11014482,2,1,1,0,2,1,1,0,0
11014501,4,2,2,0,0,0,0,0,1
11014579,5,1,4,0,3,2,1,0,0
11014695,4,2,2,0,1,1,0,1,1
11014772,4,2,2,0,1,1,0,1,1
11014823,4,2,2,0,1,1,0,1,1
11015094,3,3,0,0,1,1,0,1,1
11015166,1,1,0,0,1,1,0,1,0
11015652,7,7,0,0,0,0,0,0,1
11015684,1,0,1,0,1,0,1,0,1
11015985,2,1,1,0,2,1,1,0,1
11016070,1,1,0,0,1,1,0,0,0
11016071,3,2,1,0,2,1,1,0,1
11016104,1,0,1,0,1,0,1,0,1
11016135,2,2,0,0,1,1,0,0,0
11016910,1,0,1,0,1,0,1,0,1
11016929,2,0,2,0,1,1,0,0,1
11016981,4,2,2,0,2,1,1,1,0
11017245,1,1,0,0,1,1,0,0,0
11017261,1,1,0,0,1,1,0,0,0
11017431,4,3,1,0,0,0,0,0,1
11017512,1,1,0,0,0,0,0,0,0
11018006,1,0,1,0,1,0,1,0,1
11018052,1,1,0,0,1,1,0,0,1
11018059,2,1,1,0,1,0,1,0,1
11018091,3,2,1,0,2,2,0,0,0
11018150,3,2,1,0,2,1,1,0,1
11018286,10,3,7,0,5,1,4,1,0
11018381,4,3,1,0,2,1,1,0,0
11018518,2,2,0,0,2,2,0,0,0
11018831,2,0,2,0,2,1,1,0,1
11019043,2,2,0,0,1,1,0,0,0
11019095,2,2,0,0,2,2,0,0,0
11019548,2,2,0,0,2,2,0,0,1
11019748,2,2,0,0,2,2,0,0,1
11019874,5,4,1,0,2,2,0,2,0
11020071,2,2,0,0,2,2,0,0,0
11020192,1,0,1,0,1,0,1,0,1
11020220,1,1,0,0,1,1,0,0,0
11020263,2,2,0,0,1,1,0,0,0
11020272,2,1,1,0,2,1,1,0,1
11020285,3,2,1,0,2,1,1,0,1
11020394,2,0,2,0,2,2,0,0,0
11020556,2,2,0,0,2,2,0,0,0
11021074,1,1,0,0,0,0,0,0,0
11021079,1,1,0,0,1,1,0,0,0
11021372,1,1,0,0,1,1,0,0,1
11021508,1,1,0,0,1,1,0,0,0
11021640,1,1,0,0,1,1,0,0,0
11021681,2,0,2,0,2,2,0,0,0
11021808,4,2,2,0,2,1,1,2,1
11021824,1,0,1,0,1,1,0,0,0
11021937,1,1,0,0,1,1,0,0,1
11022023,4,2,2,0,1,1,0,1,1
11022378,2,2,0,0,1,1,0,0,0
11022442,6,6,0,0,0,0,0,0,0
11022497,1,0,1,0,1,0,1,0,1
11022577,1,0,1,0,1,0,1,0,1
11022622,9,8,1,0,2,1,1,1,1
11022633,2,1,1,0,2,1,1,0,1
11022662,3,1,2,0,2,1,1,0,0
11022672,1,1,0,0,1,1,0,0,1
11022680,6,3,3,0,4,3,1,0,0
11022804,6,6,0,0,1,1,0,1,1
11022931,3,0,3,0,2,1,1,0,1
11022932,1,1,0,0,1,1,0,0,0
11022960,3,0,3,0,2,1,1,0,1
11022961,3,0,3,0,2,1,1,0,1
11022965,4,0,4,0,2,1,1,0,1
11022974,3,0,3,0,2,1,1,0,1
11022979,3,0,3,0,2,1,1,0,1
11023005,3,0,3,0,2,1,1,0,1
11023045,3,0,3,0,2,1,1,0,1
11023053,3,0,3,0,2,1,1,0,1
11023066,2,2,0,0,1,1,0,1,1
11023078,3,0,3,0,2,1,1,0,1
11023212,1,1,0,0,1,1,0,0,1
11023271,3,0,3,0,1,0,1,0,1
11023284,2,2,0,0,2,2,0,0,1
11023433,3,3,0,0,2,2,0,0,1
11023483,1,0,1,0,1,0,1,0,1
11023496,3,3,0,0,2,2,0,0,1
11023744,1,1,0,0,1,1,0,0,1
11024280,5,5,0,0,1,1,0,1,1
11024938,3,3,0,0,1,1,0,0,1
11025314,1,1,0,0,1,1,0,0,0
11025566,2,2,0,0,2,2,0,0,1
11026099,1,1,0,0,1,1,0,0,0
11026320,2,0,2,0,0,0,0,0,0
11026720,1,1,0,0,0,0,0,0,0
11026838,3,1,2,0,3,1,2,0,0
11026959,1,1,0,0,1,1,0,0,0
11027292,2,2,0,0,0,0,0,0,0
11027805,3,3,0,0,2,2,0,0,1
11028477,2,2,0,0,2,2,0,0,1
11029242,4,3,1,0,1,1,0,1,1
11029289,3,3,0,0,1,1,0,0,0
11029583,4,4,0,0,1,1,0,1,1
11029681,2,1,1,0,2,2,0,0,0
11029917,1,1,0,0,1,1,0,0,1
11031034,1,1,0,0,1,1,0,0,1
11031098,2,2,0,0,1,1,0,0,0
11031314,4,4,0,0,1,0,1,1,1
11031415,2,2,0,0,0,0,0,0,0
11031462,2,2,0,0,1,1,0,1,0
11031632,2,2,0,0,1,1,0,1,1
11031938,3,3,0,0,1,1,0,0,0
11031953,2,2,0,0,1,1,0,0,0
11032241,4,4,0,0,0,0,0,0,1
11032250,3,3,0,0,2,1,1,1,1
11032540,1,1,0,0,1,1,0,1,1
11032807,4,4,0,0,2,2,0,0,1
11033059,1,1,0,0,0,0,0,0,0
11033398,1,1,0,0,1,1,0,0,0
11033542,1,1,0,0,1,1,0,0,0
11033553,3,3,0,0,1,1,0,1,0
11033570,6,3,3,0,0,0,0,0,0
11034521,2,1,1,0,2,1,1,0,0
11034644,1,1,0,0,1,1,0,0,0
11034901,25,14,11,0,3,2,1,0,0
11035236,1,0,1,0,1,1,0,0,0
11035484,3,3,0,0,0,0,0,0,0
11035713,3,3,0,0,2,1,1,0,0
11035867,2,2,0,0,1,1,0,0,0
11036363,1,1,0,0,2,2,0,0,1
11036719,1,1,0,0,1,1,0,0,0
11036835,2,2,0,0,0,0,0,0,0
11036873,2,2,0,0,1,1,0,0,0
11037043,2,0,2,0,3,1,2,0,0
11037164,3,3,0,0,1,1,0,0,0
11038146,1,0,1,0,1,1,0,0,0
11038264,2,2,0,0,2,2,0,0,0
11038648,1,0,1,0,1,1,0,0,0
11039057,3,1,2,0,3,2,1,0,0
11039067,2,2,0,0,1,1,0,1,1
11039623,3,1,2,0,2,1,1,1,0
11039643,3,0,3,0,2,1,1,1,0
11039881,3,3,0,0,2,2,0,1,1
11039982,1,1,0,0,1,1,0,0,0
11039991,3,2,1,0,2,2,0,0,0
11040110,7,1,6,0,2,1,1,0,1
11040201,2,1,1,0,2,1,1,0,0
11040555,2,2,0,0,2,2,0,0,0
11040911,3,2,1,0,1,1,0,0,0
11040946,1,1,0,0,1,1,0,0,0
11041768,2,1,1,0,2,1,1,0,0
11041828,2,0,2,0,1,1,0,0,0
11041836,1,1,0,0,1,1,0,0,0
11042127,1,1,0,0,1,1,0,0,0
11042249,1,0,1,0,1,1,0,0,0
11042742,4,4,0,0,0,0,0,0,1
11042771,3,1,2,0,3,1,2,0,0
11043332,2,2,0,0,1,1,0,0,0
11043379,2,2,0,0,2,2,0,0,0
11043750,1,0,1,0,1,1,0,0,0
11043829,1,0,1,0,1,1,0,0,0
11044214,2,2,0,0,1,1,0,0,1
11044907,2,2,0,0,0,0,0,0,0
11045315,20,20,0,0,0,0,0,0,1
11045472,2,2,0,0,1,1,0,0,0
11045477,5,5,0,0,1,1,0,1,0
11045515,1,0,1,0,1,1,0,0,0
11045660,1,1,0,0,1,1,0,0,0
11045877,4,4,0,0,2,1,1,2,0
11046073,1,1,0,0,1,1,0,0,0
11046093,2,2,0,0,1,1,0,0,0
11046175,4,3,1,0,2,1,1,0,0
11046281,3,2,1,0,0,0,0,0,0
11046383,1,1,0,0,1,1,0,0,0
11046391,1,1,0,0,1,1,0,0,0
11046731,1,1,0,0,1,1,0,0,0
11046736,1,1,0,0,1,1,0,0,0
11046745,2,2,0,0,1,1,0,0,1
11046817,2,1,1,0,2,1,1,0,0
11046970,2,2,0,0,0,0,0,0,0
11047807,2,2,0,0,2,2,0,0,1
11048056,1,1,0,0,0,0,0,0,0
11048069,1,0,1,0,1,1,0,0,0
11048146,1,1,0,0,1,1,0,0,0
11048406,1,1,0,0,1,1,0,0,0
11048536,1,0,1,0,1,1,0,0,0
11048761,2,0,2,0,0,0,0,0,0
11049046,1,1,0,0,1,1,0,0,0
11049054,2,1,1,0,2,1,1,0,0
11049227,1,1,0,0,1,1,0,0,0
11049467,2,1,1,0,2,1,1,0,0
11049472,3,0,3,0,1,1,0,1,1
11049621,6,0,6,0,2,1,1,1,1
11049854,5,3,2,0,2,1,1,2,0
11050120,2,2,0,0,1,1,0,0,0
11050515,2,2,0,0,0,0,0,0,0
11050994,2,2,0,0,0,0,0,0,0
11051300,2,2,0,0,2,2,0,0,1
11051397,2,2,0,0,1,1,0,0,0
11051529,2,1,1,0,2,1,1,2,0
11051625,1,0,1,0,0,0,0,0,0
11051693,2,2,0,0,2,2,0,0,0
11051756,1,1,0,0,1,1,0,0,0
11051805,1,1,0,0,1,1,0,0,0
11051874,4,2,2,0,3,1,2,0,0
11052011,2,2,0,0,2,2,0,0,0
11052156,3,3,0,0,2,2,0,0,1
11052358,2,2,0,0,2,2,0,0,0
11053102,1,1,0,0,1,1,0,0,0
11053647,1,0,1,0,1,1,0,0,0
11053895,1,1,0,0,2,2,0,0,1
11053922,1,1,0,0,1,1,0,1,1
11054226,1,0,1,0,1,1,0,0,0
11054422,2,2,0,0,2,2,0,0,1
11054427,5,5,0,0,2,2,0,2,0
11054821,1,1,0,0,1,1,0,0,0
11055173,1,1,0,0,1,1,0,0,1
11055604,1,1,0,0,1,1,0,0,0
11055647,1,1,0,0,1,1,0,1,0
11055757,1,1,0,0,2,2,0,0,1
11055829,1,1,0,0,1,1,0,1,1
11056021,3,3,0,0,1,1,0,1,0
11056197,6,5,1,0,3,1,2,2,1
11056202,6,5,1,0,2,0,2,1,1
11056489,1,1,0,0,1,1,0,0,0
11056928,2,2,0,0,1,1,0,0,0
11056958,3,3,0,0,1,1,0,1,0
11057135,2,2,0,0,2,2,0,0,0
11057163,3,3,0,0,1,1,0,1,0
11057261,2,2,0,0,2,2,0,0,0
11057323,1,1,0,0,1,1,0,0,0
11057634,2,0,2,0,1,1,0,0,0
11058296,3,3,0,0,1,1,0,1,1
11058377,1,1,0,0,1,1,0,0,0
11058962,1,0,1,0,1,1,0,0,0
11059699,1,0,1,0,1,1,0,0,0
11059958,2,1,1,0,1,1,0,0,1
11060386,5,4,1,0,1,1,0,0,1
11060577,3,3,0,0,2,2,0,0,0
11060766,5,4,1,0,0,0,0,0,0
11060807,2,2,0,0,1,1,0,0,0
11061284,12,12,0,0,0,0,0,0,0
11061372,2,0,2,0,2,2,0,0,1
11061940,1,1,0,0,1,1,0,0,0
11062028,3,3,0,0,2,2,0,0,1
11062176,1,1,0,0,1,1,0,0,1
11062399,3,3,0,0,2,2,0,0,0
11062411,1,1,0,0,1,1,0,0,0
11062575,8,7,1,0,0,0,0,0,1
11062707,2,2,0,0,1,1,0,1,1
11063112,2,0,2,0,1,1,0,1,1
11063525,2,0,2,0,1,1,0,1,1
11063549,2,2,0,0,2,2,0,0,0
11063946,3,3,0,0,3,3,0,0,0
11064027,1,0,1,0,1,1,0,0,0
11064223,2,2,0,0,1,1,0,0,1
11064532,1,1,0,0,1,1,0,0,0
11064883,5,3,2,0,3,3,0,1,1
11064904,2,2,0,0,1,1,0,1,1
11064966,2,2,0,0,1,1,0,0,1
11065002,3,3,0,0,1,1,0,1,0
11065011,2,2,0,0,1,1,0,1,1
11065436,2,2,0,0,1,1,0,1,0
11065853,2,2,0,0,1,1,0,0,0
11066059,4,4,0,0,1,1,0,0,0
11066260,1,1,0,0,1,1,0,0,0
11066476,8,5,3,0,1,1,0,1,1
11066590,1,1,0,0,0,0,0,0,0
11066677,1,1,0,0,1,1,0,1,0
11067387,3,3,0,0,2,2,0,0,0
11067427,2,2,0,0,2,2,0,0,0
11067511,2,2,0,0,1,1,0,1,0
11067815,1,1,0,0,1,1,0,0,0
11067894,2,2,0,0,1,1,0,1,0
11068305,1,1,0,0,1,1,0,0,0
11068812,3,3,0,0,2,2,0,0,0
11068888,1,1,0,0,1,1,0,0,0
11069046,2,2,0,0,1,1,0,1,0
11069399,2,2,0,0,1,1,0,0,0
11069475,1,0,1,0,0,0,0,0,0
11069703,7,5,2,0,2,1,1,2,1
11070273,1,1,0,0,1,1,0,0,0
11070483,1,1,0,0,1,1,0,0,0
11070616,3,3,0,0,2,2,0,0,0
11070903,2,2,0,0,2,2,0,0,0
11071124,9,7,2,0,0,0,0,0,1
11071138,1,1,0,0,1,1,0,0,0
11071160,2,0,2,0,1,1,0,0,0
11071360,5,5,0,0,2,2,0,0,1
11071913,9,8,1,0,3,1,2,2,1
11071942,1,1,0,0,2,2,0,2,0
11072001,2,2,0,0,2,2,0,0,0
11072294,2,2,0,0,1,1,0,0,0
11072325,1,1,0,0,1,1,0,0,0
11072352,1,1,0,0,1,1,0,0,0
11072825,2,0,2,0,2,2,0,0,0
11072963,2,2,0,0,2,2,0,0,0
11073371,1,1,0,0,1,1,0,0,0
11073408,1,1,0,0,1,1,0,0,1
11074077,3,3,0,0,4,1,3,1,1
11074120,3,2,1,0,1,1,0,0,0
11074236,2,2,0,0,1,1,0,0,0
11074544,2,2,0,0,1,1,0,0,0
11074635,1,1,0,0,2,2,0,0,0
11074781,1,1,0,0,1,1,0,0,1
11074947,1,1,0,0,1,1,0,0,0
11075186,3,3,0,0,3,3,0,0,0
11075399,1,1,0,0,1,1,0,0,0
11075810,2,2,0,0,2,2,0,0,0
11076174,1,1,0,0,1,1,0,0,0
11076503,8,4,4,0,1,0,1,1,0
11076571,1,0,1,0,1,1,0,0,0
11076810,1,1,0,0,1,1,0,0,0
11076899,1,0,1,0,1,1,0,0,0
11076996,1,1,0,0,1,1,0,0,0
11077193,1,0,1,0,1,1,0,0,0
11077417,4,3,1,0,1,1,0,1,1
11077592,3,3,0,0,1,1,0,1,1
11077652,4,4,0,1,0,0,0,0,1
11077817,4,4,0,1,1,1,0,1,1
11078035,1,1,0,0,1,1,0,0,0
11078363,1,1,0,0,1,1,0,0,0
11078490,12,9,3,0,1,1,0,0,0
11078756,1,1,0,0,1,1,0,0,0
11078780,3,3,0,0,1,1,0,0,0
11078789,2,1,1,0,1,1,0,1,0
11078824,2,0,2,0,1,1,0,0,0
11079179,2,2,0,0,1,1,0,1,1
11079387,2,2,0,0,1,1,0,1,1
11079961,1,0,1,0,1,1,0,0,0
08745038,3,2,1,0,1,1,0,1,1
08745102,1,0,1,0,0,0,0,0,1
08745854,5,3,2,0,1,0,1,0,1
08746143,2,2,0,0,2,2,0,0,0
08746305,1,0,1,0,0,0,0,0,1
08747234,2,2,0,0,1,1,0,0,1
08747368,2,0,2,0,1,1,0,0,0
08747388,5,2,3,0,3,1,2,1,0
08747430,12,5,7,0,2,2,0,1,1
08747445,1,0,1,0,0,0,0,0,1
08747640,1,1,0,0,1,1,0,0,0
08747649,8,2,6,2,1,1,0,0,1
08747974,2,1,1,0,0,0,0,0,0
08748094,1,0,1,0,3,1,2,0,0
08748171,3,3,0,0,1,1,0,1,1
08749024,13,6,7,0,7,7,0,6,1
08749087,6,2,4,0,1,1,0,1,1
08749155,3,0,3,0,0,0,0,0,1
08749205,3,0,3,0,0,0,0,0,1
08749401,1,1,0,0,1,1,0,0,0
08749783,10,8,2,0,2,2,0,2,1
08750431,3,2,1,0,2,2,0,0,1
08750835,2,2,0,0,1,1,0,0,0
08751028,4,1,3,0,2,1,1,0,1
08751126,7,4,3,0,1,1,0,1,1
08751197,8,4,4,0,2,2,0,0,1
08751307,11,7,4,0,1,1,0,1,1
08751342,1,1,0,0,1,1,0,0,0
08751420,2,2,0,0,2,2,0,0,0
08751604,12,8,4,0,0,0,0,0,1
08751723,3,2,1,0,2,2,0,0,0
08751883,1,0,1,0,0,0,0,0,0
08751940,13,8,5,0,0,0,0,0,0
08751999,2,0,2,0,1,1,0,0,1
08752111,1,0,1,0,1,1,0,0,0
08752221,2,2,0,0,1,1,0,0,0
08752239,1,0,1,0,1,1,0,0,0
08752514,1,0,1,0,0,0,0,0,1
08753120,4,4,0,0,4,4,0,0,0
08753310,10,5,5,0,2,1,1,1,1
08753813,9,8,1,0,0,0,0,0,1
08753943,5,2,3,0,1,1,0,1,1
08754046,3,1,2,0,1,1,0,0,0
08754100,2,2,0,0,2,2,0,0,0
08754673,2,2,0,0,2,2,0,0,0
08754690,3,1,2,0,1,1,0,0,0
08754809,2,0,2,0,0,0,0,0,1
08755004,1,0,1,0,0,0,0,0,0
08755057,3,3,0,0,1,1,0,0,0
08755461,15,12,3,0,0,0,0,0,1
08755562,4,2,2,0,1,1,0,1,0
08755654,10,2,8,0,1,1,0,1,0
08755874,12,3,9,0,4,1,3,2,1
08756310,2,2,0,0,1,1,0,1,0
08756451,14,7,7,0,1,1,0,0,1
08756491,3,3,0,0,1,1,0,0,0
08756681,8,5,3,1,0,0,0,0,1
08757539,3,2,1,0,0,0,0,0,0
08757910,3,2,1,0,0,0,0,0,1
08758074,1,1,0,0,2,2,0,0,1
08758133,2,1,1,0,0,0,0,0,0
08758203,8,4,4,0,1,1,0,1,1
08758457,1,1,0,0,1,1,0,0,0
08758862,1,0,1,0,0,0,0,0,0
08759335,5,4,1,0,0,0,0,0,1
08759489,3,1,2,0,1,1,0,0,1
08760096,2,0,2,0,0,0,0,0,0
08760202,3,0,3,0,1,1,0,1,0
08760381,12,4,8,0,2,2,0,0,1
08760407,12,4,8,0,2,2,0,0,1
08760413,12,4,8,0,2,2,0,0,1
08760424,8,3,5,0,2,2,0,0,1
08760430,12,4,8,0,2,2,0,0,1
08760435,12,4,8,0,2,2,0,0,1
08760439,12,4,8,0,2,2,0,0,1
08760442,12,4,8,0,2,2,0,0,1
08760444,12,4,8,0,2,2,0,0,1
08760447,12,4,8,0,2,2,0,0,1
08760450,12,4,8,0,2,2,0,0,1
08760458,8,3,5,0,2,2,0,0,1
08760550,12,4,8,0,2,2,0,0,1
08760682,2,1,1,0,1,1,0,0,0
08760713,6,3,3,0,1,1,0,1,1
08760754,12,4,8,0,2,2,0,0,1
08760919,9,4,5,0,2,1,1,0,0
08760995,22,11,11,0,0,0,0,0,0
08761611,1,1,0,0,1,1,0,0,1
08761867,1,1,0,0,1,1,0,0,0
08762191,1,0,1,0,1,1,0,0,0
08762235,12,5,7,0,1,1,0,1,1
08762270,7,5,2,0,0,0,0,0,0
08762645,4,4,0,0,0,0,0,0,0
08762799,1,1,0,0,1,1,0,0,0
08763145,1,1,0,0,1,1,0,0,0
08763473,2,1,1,0,1,1,0,0,1
08763800,6,4,2,0,1,1,0,1,1
08764177,6,3,3,0,0,0,0,0,0
08764543,2,0,2,0,0,0,0,0,0
08765639,8,3,5,0,1,1,0,1,0
08766038,2,2,0,0,2,2,0,0,0
08766105,2,1,1,0,1,1,0,0,0
08766399,5,1,4,0,1,1,0,0,0
08766514,1,1,0,0,1,1,0,0,0
08766679,4,4,0,0,4,4,0,0,1
08767437,3,0,3,0,0,0,0,0,1
08767545,1,1,0,0,1,1,0,0,0
08767649,2,2,0,0,2,2,0,0,1
08768109,1,1,0,0,1,1,0,0,1
08768897,3,3,0,0,3,3,0,0,1
08769953,4,1,3,0,1,1,0,1,1
08770246,2,2,0,0,2,2,0,0,0
08770532,1,1,0,0,1,1,0,0,1
08770560,1,1,0,0,1,1,0,0,0
08771442,2,1,1,0,2,1,1,0,0
08771651,6,1,5,0,1,1,0,0,0
08771656,2,0,2,0,1,1,0,0,0
08772146,1,0,1,0,1,1,0,0,0
08772426,1,1,0,0,1,1,0,0,0
08773606,2,2,0,0,1,1,0,0,1
08773728,2,2,0,0,1,1,0,0,0
08773966,3,1,2,0,1,1,0,0,0
08774028,8,4,4,0,1,1,0,1,1
08774049,8,3,5,0,2,1,1,2,1
08774603,3,2,1,0,1,1,0,0,0
08775381,1,0,1,0,0,0,0,0,0
08775493,6,0,6,0,0,0,0,0,0
08775516,8,0,8,0,1,1,0,1,1
08776174,5,1,4,0,1,0,1,0,0
08776217,4,1,3,0,2,1,1,0,0
08776473,5,1,4,0,2,0,2,0,0
08776488,3,0,3,0,2,2,0,0,1
08776554,1,1,0,0,1,1,0,0,0
08776647,2,1,1,0,2,1,1,0,0
08776650,7,6,1,0,1,1,0,1,1
08776872,7,6,1,0,1,1,0,1,1
08777063,6,1,5,0,1,1,0,0,0
08777080,2,1,1,0,2,1,1,0,1
08777150,3,0,3,0,0,0,0,0,0
08777304,3,0,3,1,1,1,0,1,1
08777464,2,0,2,0,0,0,0,0,1
08777615,4,1,3,0,1,1,0,0,1
08777675,2,1,1,0,1,1,0,0,1
08778032,8,3,5,0,0,0,0,0,1
08778357,1,1,0,0,1,1,0,0,0
08778370,6,4,2,0,1,1,0,1,1
08778385,2,2,0,0,2,2,0,0,0
08778744,3,1,2,0,2,2,0,1,1
08779767,5,1,4,0,0,0,0,0,1
08779988,2,0,2,0,1,1,0,0,0
08779997,2,0,2,0,0,0,0,0,0
08780041,6,3,3,0,3,1,2,1,1
08780103,1,1,0,0,1,1,0,0,0
08780268,1,1,0,0,1,1,0,0,0
08780396,14,5,9,0,2,2,0,2,1
08780839,4,4,0,0,1,1,0,1,1
08781042,2,2,0,0,2,2,0,0,1
08781119,5,4,1,0,1,1,0,0,1
08781408,2,0,2,0,0,0,0,0,0
08781416,2,0,2,0,0,0,0,0,0
08781463,3,3,0,0,1,1,0,0,0
08781493,9,4,5,0,1,1,0,1,1
08781766,1,1,0,0,2,2,0,0,0
08782054,1,1,0,0,1,1,0,0,1
08782309,5,2,3,0,1,1,0,1,1
08782411,6,5,1,0,2,2,0,0,1
08783035,1,1,0,0,1,1,0,0,0
08783135,1,1,0,0,1,1,0,0,0
08783372,4,3,1,0,1,1,0,1,1
08783377,4,3,1,0,1,1,0,1,1
08783393,8,5,3,0,1,0,1,1,1
08783512,4,4,0,0,0,0,0,0,1
08783696,5,3,2,0,0,0,0,0,1
08783784,4,3,1,0,5,5,0,2,1
08783948,1,0,1,0,0,0,0,0,0
08784092,2,1,1,0,1,1,0,0,1
08784612,4,2,2,0,0,0,0,0,1
08784754,6,6,0,0,0,0,0,0,0
08784920,4,0,4,0,0,0,0,0,1
08784951,14,2,12,0,2,1,1,2,1
08784972,12,2,10,0,1,1,0,1,1
08784994,3,3,0,0,0,0,0,0,0
08785021,1,1,0,0,1,1,0,0,0
08785081,8,3,5,0,2,2,0,0,1
08785094,3,3,0,0,1,1,0,0,0
08785231,8,3,5,0,3,2,1,3,0
08785667,2,2,0,0,1,1,0,0,0
08785707,5,3,2,0,2,2,0,2,0
08785884,2,0,2,0,0,0,0,0,0
08785924,2,2,0,0,2,2,0,0,0
08786035,1,0,1,0,0,0,0,0,0
08786038,4,3,1,0,0,0,0,0,0
08786161,2,2,0,0,0,0,0,0,1
08786309,1,0,1,0,0,0,0,0,0
08786486,2,0,2,0,1,1,0,0,0
08786827,5,0,5,0,4,4,0,1,1
08787039,6,0,6,0,0,0,0,0,1
08787044,9,0,9,0,0,0,0,0,1
08787158,2,0,2,0,0,0,0,0,0
08787650,21,12,9,0,4,3,1,0,1
08787981,2,0,2,0,0,0,0,0,0
08788258,2,2,0,0,2,2,0,0,0
08788270,6,5,1,0,2,2,0,2,1
08788334,2,2,0,0,1,1,0,0,0
08788413,3,2,1,0,1,1,0,0,0
08788692,1,1,0,0,1,1,0,0,1
08788890,1,1,0,0,1,1,0,0,0
08789119,1,1,0,0,1,1,0,0,0
08790163,4,4,0,0,1,1,0,0,0
08790237,6,1,5,0,2,2,0,0,0
08790592,2,2,0,0,1,1,0,0,0
08791002,7,2,5,0,0,0,0,0,0
08791283,4,3,1,0,0,0,0,0,0
08791511,2,2,0,0,1,1,0,0,0
08792247,4,4,0,0,1,1,0,0,0
08792330,2,0,2,0,0,0,0,0,0
08792563,2,0,2,0,0,0,0,0,0
08792796,2,2,0,0,1,1,0,0,0
08792836,4,3,1,0,1,1,0,0,0
08792892,12,7,5,0,0,0,0,0,1
08792975,1,1,0,0,2,2,0,0,0
08793585,14,7,7,0,0,0,0,0,0
08794297,11,0,11,0,0,0,0,0,1
08794327,2,0,2,0,0,0,0,0,1
08794401,5,3,2,0,0,0,0,0,0
08794547,14,9,5,0,1,1,0,1,1
08794621,10,3,7,0,1,1,0,1,1
08794679,10,3,7,0,1,1,0,1,1
08794782,2,2,0,0,1,1,0,0,0
08794878,3,2,1,0,2,2,0,0,1
08795098,4,3,1,0,1,1,0,0,0
08795330,1,1,0,0,1,1,0,0,0
08796050,12,9,3,0,7,6,1,0,0
08796272,4,2,2,0,3,1,2,3,0
08796510,1,0,1,0,1,1,0,0,0
08796538,1,0,1,0,0,0,0,0,0
08796675,17,3,14,0,0,0,0,0,1
08796680,6,2,4,0,2,1,1,0,0
08797383,3,0,3,0,0,0,0,0,1
08797750,4,3,1,0,1,1,0,0,0
08798207,1,1,0,0,1,1,0,0,0
08798326,1,1,0,0,1,1,0,0,0
08798598,2,2,0,0,1,1,0,0,0
08798779,3,3,0,0,1,1,0,0,1
08798787,2,0,2,0,1,1,0,0,1
08798931,19,6,13,0,0,0,0,0,0
08799189,3,0,3,0,0,0,0,0,1
08799644,3,3,0,0,2,2,0,0,0
08799775,4,3,1,0,2,2,0,0,1
08799943,10,3,7,0,1,0,1,0,0
08799986,2,2,0,0,2,2,0,0,0
04146081,25,7,18,0,0,0,0,0,1
04146274,21,2,19,0,1,1,0,1,1
04146315,7,3,4,0,3,2,1,0,0
04146375,64,12,52,0,0,0,0,0,1
04146486,15,4,11,0,3,3,0,0,1
04146495,55,6,49,0,1,1,0,0,0
04146759,31,8,23,0,1,1,0,1,1
04146817,3,0,3,0,2,2,0,0,1
04146820,42,8,34,0,2,2,0,2,1
04146912,6,3,3,0,1,1,0,1,1
04146956,12,0,12,0,0,0,0,0,1
04146962,18,4,14,0,0,0,0,0,1
04147055,4,3,1,0,2,2,0,0,1
04147148,13,6,7,0,1,1,0,1,1
04147176,32,0,32,0,0,0,0,0,1
04147269,10,4,6,0,1,1,0,1,1
04147291,73,12,61,0,1,1,0,0,1
04147460,17,2,15,0,0,0,0,0,1
04147652,6,0,6,0,2,2,0,1,1
04148035,34,3,31,0,1,1,0,1,1
04148072,16,11,5,0,0,0,0,0,1
04148314,12,2,10,0,0,0,0,0,1
04148809,14,1,13,0,0,0,0,0,1
04149124,24,0,24,0,1,1,0,1,1
04149156,22,0,22,0,0,0,0,0,1
04149198,7,3,4,0,2,2,0,0,1
04149551,28,0,28,0,0,0,0,0,1
04150431,14,4,10,0,0,0,0,0,1
04150563,28,5,23,0,1,1,0,1,1
04150687,9,4,5,0,0,0,0,0,0
04151104,4,2,2,0,1,1,0,0,0
04151545,28,10,18,0,0,0,0,0,1
04151798,12,4,8,0,0,0,0,0,1
04151801,12,4,8,0,0,0,0,0,1
04151986,5,2,3,0,2,1,1,0,0
04152092,12,4,8,0,0,0,0,0,1
04152342,15,4,11,0,2,2,0,2,1
04152469,15,2,13,0,1,1,0,0,1
04152545,37,9,28,0,1,1,0,1,1
04152555,8,3,5,0,1,1,0,0,0
04153147,7,3,4,0,0,0,0,0,0
04153457,44,9,35,0,2,2,0,2,1
04153516,6,4,2,0,3,3,0,0,1
04153531,5,1,4,0,1,1,0,0,0
04153673,16,5,11,0,2,2,0,0,1
04153950,12,0,12,0,0,0,0,0,1
04154032,19,0,19,0,0,0,0,0,1
04154230,7,3,4,0,2,2,0,0,1
04154268,5,2,3,0,1,1,0,0,1
04154465,16,4,12,0,1,1,0,0,0
04154489,12,4,8,0,0,0,0,0,1
04154490,5,0,5,0,0,0,0,0,0
04154556,34,4,30,0,1,1,0,1,1
04154716,29,3,26,0,1,1,0,1,1
04154818,64,11,53,0,0,0,0,0,1
04154855,27,3,24,0,1,1,0,1,1
04154859,9,2,7,0,1,1,0,0,0
04154910,20,3,17,0,1,1,0,1,1
04155191,12,3,9,0,0,0,0,0,1
04155231,7,0,7,0,0,0,0,0,1
04155293,6,1,5,0,1,1,0,0,1
04155620,20,2,18,0,1,1,0,1,1
04155640,27,9,18,0,1,1,0,1,0
04155741,8,0,8,0,0,0,0,0,1
04156293,17,4,13,0,2,2,0,0,1
04156685,22,0,22,0,0,0,0,0,1
04156882,9,5,4,0,1,1,0,0,0
04156947,7,2,5,0,1,1,0,0,1
04156974,4,2,2,0,1,1,0,0,0
04157441,40,0,40,0,0,0,0,0,1
04157534,5,1,4,0,1,1,0,0,0
04157743,10,4,6,0,1,1,0,0,1
04157791,10,0,10,0,0,0,0,0,0
04157857,5,2,3,0,2,2,0,0,0
04157901,59,12,47,0,0,0,0,0,1
04158138,10,6,4,0,1,1,0,1,1
04158202,8,3,5,0,1,1,0,0,1
04158424,16,0,16,0,0,0,0,0,1
04158633,5,0,5,0,0,0,0,0,1
04158725,21,2,19,0,0,0,0,0,0
04158766,7,4,3,0,0,0,0,0,1
04159063,6,0,6,0,1,1,0,1,0
04159210,58,1,57,0,1,1,0,1,1
04159256,27,1,26,0,1,1,0,0,1
04159416,8,0,8,0,0,0,0,0,1
04159477,22,3,19,0,0,0,0,0,1
04159524,13,7,6,0,1,1,0,1,1
04159695,32,5,27,0,1,1,0,1,1
04159928,9,6,3,0,1,1,0,0,0
04160026,19,4,15,0,1,1,0,1,0
04160081,17,0,17,0,0,0,0,0,1
04160312,9,4,5,0,0,0,0,0,0
04161083,15,2,13,0,1,1,0,1,1
04161085,5,3,2,0,2,2,0,0,0
04161207,13,2,11,0,3,1,2,1,0
04161258,25,4,21,0,1,1,0,0,1
04161448,38,3,35,0,1,1,0,1,1
04161473,14,0,14,0,0,0,0,0,1
04161843,15,1,14,0,1,1,0,1,1
04162189,13,3,10,0,2,2,0,0,0
04162365,13,4,9,0,6,6,0,0,1
04162556,5,3,2,0,2,2,0,0,1
04162931,13,4,9,0,0,0,0,0,0
04162951,22,5,17,0,1,0,1,0,0
04163050,4,2,2,0,3,2,1,0,0
04163066,12,4,8,0,0,0,0,0,1
04163221,7,0,7,0,0,0,0,0,1
04163500,11,4,7,0,1,1,0,1,1
04163511,5,2,3,0,1,1,0,0,0
04163608,5,3,2,0,2,2,0,0,1
04163660,8,3,5,0,1,1,0,0,1
04164156,31,0,31,0,1,1,0,1,1
04164203,25,0,25,0,0,0,0,0,1
04164521,6,1,5,0,3,1,2,2,1
04164949,24,5,19,0,0,0,0,0,1
04165038,13,4,9,0,1,1,0,1,1
04165061,5,2,3,0,1,1,0,0,0
04165266,12,2,10,0,2,1,1,0,1
04165498,41,14,27,0,0,0,0,0,1
04165609,14,2,12,0,0,0,0,0,1
04165632,11,0,11,0,0,0,0,0,1
04165701,20,0,20,0,0,0,0,0,1
04165748,16,0,16,0,0,0,0,0,1
04165850,25,0,25,0,0,0,0,0,1
04165891,10,2,8,0,0,0,0,0,1
04165955,12,3,9,0,1,1,0,0,1
04165956,17,0,17,0,0,0,0,0,1
04165977,23,0,23,0,1,1,0,1,1
04165985,23,0,23,0,1,1,0,1,1
04166713,11,5,6,0,1,1,0,0,1
04166889,36,2,34,0,2,1,1,2,1
04166900,18,3,15,0,2,2,0,2,1
04166910,30,3,27,0,1,1,0,1,1
04167038,30,3,27,0,1,1,0,1,1
04167062,18,3,15,0,2,1,1,2,1
04167080,39,3,36,0,1,1,0,1,1
04167219,15,4,11,0,1,1,0,0,1
04167535,20,3,17,1,1,1,0,1,1
04167779,9,4,5,0,1,1,0,1,1
04167834,4,2,2,0,2,2,0,0,0
04167862,13,6,7,0,1,1,0,0,1
04168289,16,10,6,0,0,0,0,0,1
04168291,26,4,22,0,1,1,0,1,1
04168299,5,3,2,0,1,1,0,0,0
04168347,26,7,19,0,0,0,0,0,1
04168664,12,3,9,0,1,1,0,1,0
04168774,5,2,3,0,2,1,1,0,1
04169630,5,0,5,0,0,0,0,0,1
04169762,11,4,7,0,1,1,0,1,1
04169768,4,2,2,0,1,1,0,0,1
04170018,17,5,12,0,4,4,0,1,1
04170072,28,3,25,0,3,2,1,3,1
04170092,109,24,85,0,11,6,5,6,1
04170222,7,3,4,0,2,1,1,1,1
04170241,45,7,38,0,0,0,0,0,0
04170309,7,3,4,0,1,1,0,0,0
04170382,13,3,10,0,1,1,0,0,0
04170517,20,0,20,0,0,0,0,0,1
04170519,16,6,10,0,1,1,0,1,1
04170863,7,2,5,0,1,1,0,1,1
04170896,5,1,4,0,1,1,0,0,0
04170924,18,3,15,0,1,1,0,1,1
04171005,5,3,2,0,2,2,0,0,0
04171035,23,0,23,0,0,0,0,0,1
04171242,5,0,5,0,0,0,0,0,1
04171540,27,6,21,0,1,1,0,1,1
04171639,6,3,3,0,1,1,0,0,1
04171724,24,7,17,0,1,1,0,1,0
04172071,5,2,3,0,2,2,0,0,0
04172544,7,1,6,0,1,1,0,0,1
04172701,19,4,15,0,2,1,1,1,1
04172770,58,7,51,0,2,2,0,2,1
04172914,23,6,17,0,0,0,0,0,1
04173340,33,4,29,0,0,0,0,0,1
04173424,6,0,6,0,0,0,0,0,1
04173547,17,0,17,0,0,0,0,0,1
04173555,28,0,28,0,0,0,0,0,1
04173560,15,2,13,0,1,1,0,0,1
04173634,41,3,38,0,4,2,2,0,1
04173713,12,2,10,0,1,1,0,1,1
04173789,20,0,20,0,2,2,0,1,1
04174389,26,12,14,0,1,1,0,1,1
04174396,5,0,5,0,0,0,0,0,0
04174830,52,7,45,0,3,2,1,0,1
04175141,14,5,9,0,0,0,0,0,1
04175154,4,2,2,0,1,1,0,0,0
04175157,4,0,4,0,0,0,0,0,1
04175374,6,3,3,0,0,0,0,0,1
04175417,16,10,6,0,0,0,0,0,1
04175538,14,3,11,0,1,1,0,1,1
04175628,10,3,7,0,1,1,0,1,1
04176039,7,5,2,0,2,2,0,0,0
04176176,44,0,44,0,0,0,0,0,1
04176248,14,0,14,0,0,0,0,0,1
04176334,7,2,5,0,1,1,0,0,1
04176430,4,1,3,0,1,1,0,0,1
04176480,4,1,3,0,2,2,0,0,0
04176679,10,2,8,0,1,1,0,1,0
04176887,31,4,27,0,1,1,0,1,1
04176994,29,7,22,0,0,0,0,0,0
04177005,4,1,3,0,1,1,0,0,0
04177089,12,3,9,0,2,2,0,2,1
04177464,10,5,5,0,1,1,0,1,1
04177521,10,1,9,0,1,1,0,0,1
04177534,7,4,3,0,1,1,0,0,1
04177616,6,2,4,0,2,2,0,0,1
04177697,12,4,8,0,1,1,0,1,1
04177900,33,7,26,0,1,1,0,0,1
04178083,6,0,6,0,0,0,0,0,1
04178176,10,3,7,0,2,2,0,0,0
04178221,8,0,8,0,0,0,0,0,0
04178255,10,3,7,0,1,1,0,1,1
04178371,26,3,23,0,0,0,0,0,1
04178390,9,0,9,0,0,0,0,0,1
04178503,30,11,19,0,0,0,0,0,1
04178674,15,4,11,0,1,1,0,1,1
04178758,9,3,6,0,1,1,0,0,1
04178808,36,8,28,0,0,0,0,0,0
04178931,6,4,2,0,1,1,0,0,0
CE000506,0,0,0,0,0,0,0,0,0
CE000531,0,0,0,0,0,0,0,0,0
CE000547,0,0,0,0,0,0,0,0,0
CE000549,0,0,0,0,0,0,0,0,0
CE000556,0,0,0,0,0,0,0,0,0
CE000584,0,0,0,0,0,0,0,0,0
CE000622,0,0,0,0,0,0,0,0,0
CE000665,0,0,0,0,0,0,0,0,0
CE000694,0,0,0,0,0,0,0,0,0
CE000701,0,0,0,0,0,0,0,0,0
CE000731,0,0,0,0,0,0,0,0,0
CE000744,0,0,0,0,0,0,0,0,0
CE000759,0,0,0,0,0,0,0,0,0
CE000760,0,0,0,0,0,0,0,0,0
CE000843,0,0,0,0,0,0,0,0,0
CE000846,0,0,0,0,0,0,0,0,0
CE000925,0,0,0,0,0,0,0,0,0
CE000988,0,0,0,0,0,0,0,0,0
CE001037,0,0,0,0,0,0,0,0,0
CE001091,0,0,0,0,0,0,0,0,0
CE001094,0,0,0,0,0,0,0,0,0
CE001123,0,0,0,0,0,0,0,0,0
CE001133,0,0,0,0,0,0,0,0,0
CE001151,0,0,0,0,0,0,0,0,0
CE001160,0,0,0,0,0,0,0,0,0
CE001177,0,0,0,0,0,0,0,0,0
CE001190,0,0,0,0,0,0,0,0,0
CE001244,0,0,0,0,0,0,0,0,0
CE001284,0,0,0,0,0,0,0,0,0
CE001289,0,0,0,0,0,0,0,0,0
CE001297,0,0,0,0,0,0,0,0,0
CE001308,0,0,0,0,0,0,0,0,0
CE001310,0,0,0,0,0,0,0,0,0
CE001315,0,0,0,0,0,0,0,0,0
CE001364,0,0,0,0,0,0,0,0,0
CE001390,0,0,0,0,0,0,0,0,0
CE001391,0,0,0,0,0,0,0,0,0
CE001400,0,0,0,0,0,0,0,0,0
CE001414,0,0,0,0,0,0,0,0,0
CE001419,0,0,0,0,0,0,0,0,0
CE001423,0,0,0,0,0,0,0,0,0
CE001445,0,0,0,0,0,0,0,0,0
CE001455,0,0,0,0,0,0,0,0,0
CE001516,0,0,0,0,0,0,0,0,0
CE001520,0,0,0,0,0,0,0,0,0
CE001538,0,0,0,0,0,0,0,0,0
CE001549,0,0,0,0,0,0,0,0,0
CE001561,0,0,0,0,0,0,0,0,0
CE001635,0,0,0,0,0,0,0,0,0
CE001640,0,0,0,0,0,0,0,0,0
CE001647,0,0,0,0,0,0,0,0,0
CE001660,0,0,0,0,0,0,0,0,0
CE001669,0,0,0,0,0,0,0,0,0
CE001696,0,0,0,0,0,0,0,0,0
CE001701,0,0,0,0,0,0,0,0,0
CE001756,0,0,0,0,0,0,0,0,0
CE001763,0,0,0,0,0,0,0,0,0
CE001781,0,0,0,0,0,0,0,0,0
CE001796,0,0,0,0,0,0,0,0,0
CE001857,0,0,0,0,0,0,0,0,0
CE001875,0,0,0,0,0,0,0,0,0
CE001877,0,0,0,0,0,0,0,0,0
CE001886,0,0,0,0,0,0,0,0,0
CE001904,0,0,0,0,0,0,0,0,0
CE001907,0,0,0,0,0,0,0,0,0
CE001910,0,0,0,0,0,0,0,0,0
CE002010,0,0,0,0,0,0,0,0,0
CE002052,0,0,0,0,0,0,0,0,0
CE002087,0,0,0,0,0,0,0,0,0
CE002108,0,0,0,0,0,0,0,0,0
CE002122,0,0,0,0,0,0,0,0,0
CE002128,0,0,0,0,0,0,0,0,0
CE002131,0,0,0,0,0,0,0,0,0
CE002177,0,0,0,0,0,0,0,0,0
CE002204,0,0,0,0,0,0,0,0,0
CE002231,0,0,0,0,0,0,0,0,0
CE002232,0,0,0,0,0,0,0,0,0
CE002242,0,0,0,0,0,0,0,0,0
CE002243,0,0,0,0,0,0,0,0,0
CE002250,0,0,0,0,0,0,0,0,0
CE002338,0,0,0,0,0,0,0,0,0
CE002343,0,0,0,0,0,0,0,0,0
CE002353,0,0,0,0,0,0,0,0,0
CE002368,0,0,0,0,0,0,0,0,0
CE002381,0,0,0,0,0,0,0,0,0
CE002395,0,0,0,0,0,0,0,0,0
CE002401,0,0,0,0,0,0,0,0,0
CE002414,0,0,0,0,0,0,0,0,0
CE002417,0,0,0,0,0,0,0,0,0
CE002426,0,0,0,0,0,0,0,0,0
CE002444,0,0,0,0,0,0,0,0,0
CE002464,0,0,0,0,0,0,0,0,0
CE002474,0,0,0,0,0,0,0,0,0
CE002483,0,0,0,0,0,0,0,0,0
CE002502,0,0,0,0,0,0,0,0,0
CE002516,0,0,0,0,0,0,0,0,0
CE002589,0,0,0,0,0,0,0,0,0
CE002643,0,0,0,0,0,0,0,0,0
CE002715,0,0,0,0,0,0,0,0,0
CE002726,0,0,0,0,0,0,0,0,0
CE002753,0,0,0,0,0,0,0,0,0
CE002783,0,0,0,0,0,0,0,0,0
CE002817,0,0,0,0,0,0,0,0,0
CE002828,0,0,0,0,0,0,0,0,0
CE002864,0,0,0,0,0,0,0,0,0
CE002924,0,0,0,0,0,0,0,0,0
CE002930,0,0,0,0,0,0,0,0,0
CE002943,0,0,0,0,0,0,0,0,0
CE002947,0,0,0,0,0,0,0,0,0
CE002949,0,0,0,0,0,0,0,0,0
CE002952,0,0,0,0,0,0,0,0,0
CE002976,0,0,0,0,0,0,0,0,0
CE003007,0,0,0,0,0,0,0,0,0
CE003010,0,0,0,0,0,0,0,0,0
CE003055,0,0,0,0,0,0,0,0,0
CE003086,0,0,0,0,0,0,0,0,0
CE003101,0,0,0,0,0,0,0,0,0
CE003236,0,0,0,0,0,0,0,0,0
CE003246,0,0,0,0,0,0,0,0,0
CE003269,0,0,0,0,0,0,0,0,0
CE003285,0,0,0,0,0,0,0,0,0
CE003289,0,0,0,0,0,0,0,0,0
CE003368,0,0,0,0,0,0,0,0,0
CE003396,0,0,0,0,0,0,0,0,0
CE003447,0,0,0,0,0,0,0,0,0
CE003463,0,0,0,0,0,0,0,0,0
CE003470,0,0,0,0,0,0,0,0,0
CE003478,0,0,0,0,0,0,0,0,0
CE003509,0,0,0,0,0,0,0,0,0
CE003543,0,0,0,0,0,0,0,0,0
CE003567,0,0,0,0,0,0,0,0,0
CE003613,0,0,0,0,0,0,0,0,0
CE003619,0,0,0,0,0,0,0,0,0
CE003622,0,0,0,0,0,0,0,0,0
CE003704,0,0,0,0,0,0,0,0,0
CE003766,0,0,0,0,0,0,0,0,0
CE003798,0,0,0,0,0,0,0,0,0
CE003809,0,0,0,0,0,0,0,0,0
CE003816,0,0,0,0,0,0,0,0,0
CE003830,0,0,0,0,0,0,0,0,0
CE003831,0,0,0,0,0,0,0,0,0
CE003880,0,0,0,0,0,0,0,0,0
CE003910,0,0,0,0,0,0,0,0,0
CE003923,0,0,0,0,0,0,0,0,0
CE003941,0,0,0,0,0,0,0,0,0
CE003944,0,0,0,0,0,0,0,0,0
CE003964,0,0,0,0,0,0,0,0,0
CE004022,0,0,0,0,0,0,0,0,0
CE004026,0,0,0,0,0,0,0,0,0
CE004063,0,0,0,0,0,0,0,0,0
CE004068,0,0,0,0,0,0,0,0,0
CE004076,0,0,0,0,0,0,0,0,0
CE004100,0,0,0,0,0,0,0,0,0
CE004111,0,0,0,0,0,0,0,0,0
CE004128,0,0,0,0,0,0,0,0,0
CE004158,0,0,0,0,0,0,0,0,0
CE004162,0,0,0,0,0,0,0,0,0
CE004173,0,0,0,0,0,0,0,0,0
CE004176,0,0,0,0,0,0,0,0,0
CE004257,0,0,0,0,0,0,0,0,0
CE004285,0,0,0,0,0,0,0,0,0
CE004306,0,0,0,0,0,0,0,0,0
CE004313,0,0,0,0,0,0,0,0,0
CE004335,0,0,0,0,0,0,0,0,0
CE004345,0,0,0,0,0,0,0,0,0
CE004393,0,0,0,0,0,0,0,0,0
CE004397,0,0,0,0,0,0,0,0,0
CE004421,0,0,0,0,0,0,0,0,0
CE004448,0,0,0,0,0,0,0,0,0
CE004480,0,0,0,0,0,0,0,0,0
CE004495,0,0,0,0,0,0,0,0,0
CE004501,0,0,0,0,0,0,0,0,0
CE004508,0,0,0,0,0,0,0,0,0
CE004562,0,0,0,0,0,0,0,0,0
CE004570,0,0,0,0,0,0,0,0,0
CE004571,0,0,0,0,0,0,0,0,0
CE004724,0,0,0,0,0,0,0,0,0
CE004730,0,0,0,0,0,0,0,0,0
CE004731,0,0,0,0,0,0,0,0,0
CE004772,0,0,0,0,0,0,0,0,0
CE004815,0,0,0,0,0,0,0,0,0
CE004841,0,0,0,0,0,0,0,0,0
CE004845,0,0,0,0,0,0,0,0,0
CE004849,0,0,0,0,0,0,0,0,0
CE004857,0,0,0,0,0,0,0,0,0
CE004943,0,0,0,0,0,0,0,0,0
CE004951,0,0,0,0,0,0,0,0,0
CE004958,0,0,0,0,0,0,0,0,0
CE004960,0,0,0,0,0,0,0,0,0
CE004995,0,0,0,0,0,0,0,0,0
CE005008,0,0,0,0,0,0,0,0,0
CE005206,0,0,0,0,0,0,0,0,0
CE005232,0,0,0,0,0,0,0,0,0
CE005264,0,0,0,0,0,0,0,0,0
CE005268,0,0,0,0,0,0,0,0,0
CE005306,0,0,0,0,0,0,0,0,0
CE005321,0,0,0,0,0,0,0,0,0
CE005336,0,0,0,0,0,0,0,0,0
CE005400,0,0,0,0,0,0,0,0,0
CE005458,0,0,0,0,0,0,0,0,0
CE005493,0,0,0,0,0,0,0,0,0
CE005502,0,0,0,0,0,0,0,0,0
CE005509,0,0,0,0,0,0,0,0,0
CE005538,0,0,0,0,0,0,0,0,0
CE005546,0,0,0,0,0,0,0,0,0
CE005573,0,0,0,0,0,0,0,0,0
CE005595,0,0,0,0,0,0,0,0,0
CE005657,0,0,0,0,0,0,0,0,0
CE005659,0,0,0,0,0,0,0,0,0
CE005662,0,0,0,0,0,0,0,0,0
CE005705,0,0,0,0,0,0,0,0,0
CE005745,0,0,0,0,0,0,0,0,0
CE005798,0,0,0,0,0,0,0,0,0
CE005800,0,0,0,0,0,0,0,0,0
CE005826,0,0,0,0,0,0,0,0,0
CE005836,0,0,0,0,0,0,0,0,0
CE005878,0,0,0,0,0,0,0,0,0
CE005972,0,0,0,0,0,0,0,0,0
CE006002,0,0,0,0,0,0,0,0,0
CE006020,0,0,0,0,0,0,0,0,0
CE006029,0,0,0,0,0,0,0,0,0
CE006055,0,0,0,0,0,0,0,0,0
CE006070,0,0,0,0,0,0,0,0,0
CE006101,0,0,0,0,0,0,0,0,0
CE006139,0,0,0,0,0,0,0,0,0
CE006326,0,0,0,0,0,0,0,0,0
CE006502,0,0,0,0,0,0,0,0,0
CE006512,0,0,0,0,0,0,0,0,0
CE006525,0,0,0,0,0,0,0,0,0
CE006544,0,0,0,0,0,0,0,0,0
CE006570,0,0,0,0,0,0,0,0,0
CE006587,0,0,0,0,0,0,0,0,0
CE006605,0,0,0,0,0,0,0,0,0
CE006689,0,0,0,0,0,0,0,0,0
CE006706,0,0,0,0,0,0,0,0,0
CE006761,0,0,0,0,0,0,0,0,0
CE006771,0,0,0,0,0,0,0,0,0
CE006780,0,0,0,0,0,0,0,0,0
CE006789,0,0,0,0,0,0,0,0,0
CE006807,0,0,0,0,0,0,0,0,0
CE006900,0,0,0,0,0,0,0,0,0
CE006929,0,0,0,0,0,0,0,0,0
CE006975,0,0,0,0,0,0,0,0,0
11160387,4,3,1,0,1,1,0,1,1
11160422,9,5,4,0,1,0,1,0,1
11160424,9,8,1,0,0,0,0,0,1
11160458,2,1,1,0,2,1,1,0,0
11160596,3,0,3,0,3,3,0,0,0
11160635,1,1,0,0,1,1,0,0,0
11160919,2,2,0,0,1,1,0,0,0
11161391,6,5,1,0,2,1,1,1,1
11161745,3,3,0,0,3,3,0,1,0
11162056,5,4,1,0,1,1,0,1,1
11162534,3,3,0,0,1,1,0,1,1
11162982,1,1,0,0,1,1,0,0,0
11162998,3,1,2,0,3,1,2,0,0
11163735,1,1,0,0,1,1,0,0,0
11163900,4,3,1,0,1,1,0,1,1
11163951,3,3,0,0,1,1,0,0,1
11164295,1,1,0,0,1,1,0,0,0
11164488,3,3,0,0,2,2,0,0,0
11164553,1,1,0,0,1,1,0,0,0
11164641,1,1,0,0,1,1,0,0,0
11164704,1,1,0,0,1,1,0,0,0
11164818,2,2,0,0,1,1,0,0,0
11164881,7,4,3,0,1,1,0,0,1
11165036,1,1,0,0,2,2,0,0,0
11165164,3,2,1,0,2,2,0,0,0
11165196,4,4,0,0,1,1,0,0,1
11165556,2,2,0,0,2,2,0,0,0
11165866,2,2,0,0,1,1,0,1,0
11165870,2,2,0,0,2,2,0,0,0
11166205,3,2,1,0,1,1,0,0,1
11166222,3,1,2,0,3,1,2,0,0
11166252,1,0,1,0,1,1,0,0,0
11166515,1,1,0,0,1,1,0,0,0
11166553,4,4,0,0,1,1,0,0,1
11166845,3,3,0,0,3,3,0,0,1
11166862,4,4,0,0,0,0,0,0,0
11166982,1,1,0,0,1,1,0,0,0
11167059,2,2,0,0,1,1,0,0,1
11167106,1,1,0,0,1,1,0,0,0
11167133,3,2,1,0,1,1,0,1,1
11167443,1,1,0,0,1,1,0,0,0
11167499,1,1,0,0,1,1,0,0,0
11167543,1,0,1,0,1,1,0,0,0
11167550,2,2,0,0,1,1,0,0,1
11168014,2,2,0,0,1,1,0,0,1
11168029,4,3,1,0,1,1,0,0,1
11168113,2,1,1,0,1,1,0,0,0
11168663,3,3,0,0,1,1,0,0,0
11168704,2,2,0,0,1,1,0,0,0
11169168,1,1,0,0,1,1,0,0,0
11169314,3,3,0,0,3,3,0,0,0
11169442,1,1,0,0,1,1,0,0,0
11169647,5,3,2,0,0,0,0,0,1
11169719,5,4,1,0,0,0,0,0,0
11169964,4,4,0,0,2,2,0,2,0
11170226,1,1,0,0,1,1,0,0,0
11170404,5,4,1,0,0,0,0,0,0
11170857,3,3,0,0,3,3,0,0,0
11171346,2,2,0,0,1,1,0,0,0
11171683,1,1,0,0,1,1,0,0,0
11171773,3,3,0,0,2,2,0,0,0
11172195,1,1,0,0,1,1,0,0,0
11172468,3,3,0,0,0,0,0,0,0
11172973,2,1,1,0,2,1,1,1,0
11173245,1,1,0,0,1,1,0,0,0
11173764,2,2,0,0,2,2,0,0,0
11174260,1,1,0,0,1,1,0,0,0
11174483,1,1,0,0,1,1,0,0,0
11174701,3,2,1,0,3,2,1,0,0
11174840,4,0,4,0,0,0,0,0,0
11175111,1,1,0,0,1,1,0,0,1
11175313,1,1,0,0,1,1,0,0,0
11175649,1,1,0,0,1,1,0,0,0
11175785,3,3,0,0,1,1,0,0,0
11175894,4,4,0,0,2,2,0,0,1
11177039,1,1,0,0,1,1,0,1,0
11177287,3,0,3,0,1,1,0,1,1
11177993,2,2,0,0,1,1,0,1,1
11178029,3,3,0,0,1,1,0,1,1
11178114,5,5,0,0,1,1,0,1,1
11178900,2,2,0,0,1,1,0,0,0
11179792,2,2,0,0,1,1,0,1,1
11180376,3,3,0,0,2,2,0,0,0
11180874,4,2,2,0,1,1,0,0,0
11180992,2,1,1,0,2,2,0,0,0
11181008,9,6,3,0,2,0,2,0,1
11181287,1,1,0,0,1,1,0,0,0
11182290,2,2,0,0,1,1,0,0,1
11182372,2,2,0,0,0,0,0,0,0
11183273,6,5,1,0,1,1,0,1,1
11183439,2,2,0,0,2,2,0,0,0
11183930,1,1,0,0,1,1,0,0,0
11184368,1,1,0,0,1,1,0,0,0
11184413,6,5,1,0,1,1,0,1,1
11184417,6,5,1,0,1,1,0,1,1
11184435,6,5,1,0,1,1,0,1,1
11184461,2,2,0,0,2,2,0,0,0
11184483,5,5,0,0,1,1,0,1,1
11184535,1,1,0,0,1,1,0,0,0
11184723,1,1,0,0,0,0,0,0,0
11185370,1,1,0,0,0,0,0,0,0
11185611,3,2,1,0,1,1,0,0,0
11185807,2,2,0,0,1,1,0,1,1
11186178,2,0,2,0,2,1,1,0,0
11186513,2,2,0,0,2,2,0,0,0
11186554,1,1,0,0,1,1,0,0,0
11187005,1,0,1,0,1,1,0,0,0
11187233,1,1,0,0,1,1,0,0,0
11187278,2,2,0,0,1,1,0,0,1
11187662,1,1,0,0,1,1,0,0,0
11187832,1,1,0,0,1,1,0,0,0
11187894,1,1,0,0,0,0,0,0,0
11187948,4,4,0,0,2,2,0,0,0
11188434,1,1,0,0,1,1,0,1,1
11188861,2,2,0,0,2,2,0,0,0
11188892,5,1,4,0,1,1,0,1,1
11189136,1,1,0,0,1,1,0,0,0
11189175,3,2,1,0,1,1,0,0,1
11189566,1,1,0,0,1,1,0,0,0
11189592,7,7,0,0,3,2,1,2,1
11189726,4,4,0,0,2,2,0,0,0
11189771,2,1,1,0,0,0,0,0,0
11190167,2,2,0,0,2,1,1,2,0
11190518,1,1,0,0,1,1,0,0,0
11190713,8,6,2,0,1,1,0,1,1
11190894,1,1,0,0,1,1,0,0,0
11190898,3,3,0,0,1,1,0,1,1
11191048,3,3,0,0,1,1,0,1,1
11191064,1,1,0,0,0,0,0,0,0
11191320,2,2,0,0,1,1,0,0,0
11191426,1,0,1,0,1,1,0,0,0
11191479,3,2,1,0,1,1,0,0,0
11191743,1,1,0,0,1,1,0,0,0
11191763,1,1,0,0,1,1,0,0,0
11192358,2,1,1,0,2,1,1,0,0
11192371,2,2,0,0,1,1,0,0,0
11192518,2,1,1,0,0,0,0,0,0
11192739,4,2,2,0,0,0,0,0,0
11192821,2,2,0,0,1,1,0,0,0
11193051,1,1,0,0,1,1,0,0,0
11193155,1,1,0,0,1,1,0,0,0
11193802,2,2,0,0,2,2,0,0,0
11193849,5,3,2,0,1,1,0,1,0
11194060,6,4,2,0,1,1,0,1,1
11194085,1,1,0,0,1,1,0,0,0
11194332,2,2,0,0,1,1,0,0,0
11194343,2,1,1,0,2,1,1,0,0
11194947,1,1,0,0,1,1,0,0,0
11195314,1,1,0,0,1,1,0,0,0
11195344,11,7,4,0,3,2,1,3,1
11195480,14,9,5,0,0,0,0,0,1
11195716,1,1,0,0,1,1,0,0,0
11195841,1,1,0,0,1,1,0,0,0
11196637,3,3,0,0,1,1,0,1,0
11196986,3,3,0,0,0,0,0,0,0
11197046,1,0,1,0,1,1,0,0,0
11197538,1,0,1,0,1,1,0,0,0
11198083,1,1,0,0,2,2,0,0,0
11198321,12,9,3,0,0,0,0,0,0
11198347,1,1,0,0,1,1,0,1,0
11198443,1,1,0,0,1,1,0,1,0
11198776,1,1,0,0,1,1,0,0,0
11198986,3,3,0,0,2,1,1,1,1
11199161,2,2,0,0,1,1,0,1,1
11199380,6,5,1,0,2,2,0,0,1
11199569,1,1,0,0,1,1,0,0,0
11200123,2,2,0,0,2,2,0,0,1
11201096,2,2,0,0,1,1,0,0,0
11201294,4,4,0,0,1,1,0,1,1
11201349,1,1,0,0,1,1,0,0,0
11201724,3,3,0,0,1,1,0,0,0
11201809,4,3,1,0,1,1,0,1,0
11201954,2,1,1,0,5,2,3,0,1
11201960,1,1,0,0,1,1,0,0,1
11201997,2,2,0,0,2,2,0,0,0
11202058,1,0,1,0,1,1,0,0,0
11202693,2,2,0,0,1,1,0,0,0
11202885,1,1,0,0,2,2,0,0,0
11203010,1,1,0,0,1,1,0,0,0
11203022,1,1,0,0,1,1,0,0,0
11203102,1,1,0,0,0,0,0,0,0
11203120,1,1,0,0,2,2,0,0,1
11203286,1,1,0,0,1,1,0,0,0
11203311,2,2,0,0,2,2,0,0,0
11203358,2,2,0,0,1,1,0,0,0
11203550,1,1,0,0,1,1,0,0,0
11203731,6,6,0,0,3,3,0,0,1
11203841,2,2,0,0,0,0,0,0,0
11204398,2,2,0,0,1,1,0,0,0
11204546,1,0,1,0,1,1,0,0,0
11204595,2,2,0,0,1,1,0,0,0
11204902,1,1,0,0,1,1,0,0,0
11205152,1,1,0,0,1,1,0,0,0
11205194,10,7,3,0,2,1,1,1,0
11206288,2,1,1,0,2,1,1,0,0
11206431,1,1,0,0,1,1,0,0,0
11206650,2,2,0,0,2,2,0,0,0
11206758,2,2,0,0,2,2,0,0,0
11206821,2,2,0,0,2,2,0,0,0
11206864,1,1,0,0,1,1,0,1,0
11206943,1,1,0,0,1,1,0,1,0
11207917,1,1,0,0,1,1,0,0,0
11208123,4,4,0,0,4,4,0,0,1
11208145,1,1,0,0,1,1,0,0,0
11208458,1,1,0,0,1,1,0,0,0
11208477,2,2,0,0,2,2,0,0,0
11208576,1,1,0,0,1,1,0,0,0
11209228,1,1,0,0,1,1,0,0,1
11209338,1,1,0,0,1,1,0,0,0
11209468,1,0,1,0,1,0,1,0,0
11210259,3,2,1,0,1,1,0,1,1
11210809,1,1,0,0,1,1,0,0,0
11210965,4,3,1,0,1,1,0,1,1
11211110,4,4,0,0,0,0,0,0,0
11211413,1,1,0,0,1,1,0,0,0
11211415,2,2,0,0,1,1,0,1,1
11211908,3,2,1,0,1,1,0,1,1
11211928,1,1,0,0,1,1,0,0,0
11211984,2,2,0,0,1,1,0,1,0
11212323,3,2,1,0,1,1,0,0,0
11212342,1,1,0,0,1,1,0,0,0
11212480,1,1,0,0,0,0,0,0,0
11213137,1,1,0,0,1,1,0,0,0
11213293,2,2,0,0,1,1,0,1,1
11213302,2,2,0,0,1,1,0,1,1
11213470,2,2,0,0,1,1,0,0,0
11213635,1,1,0,0,1,1,0,0,0
11213717,1,1,0,0,1,1,0,0,0
11213802,2,2,0,0,1,1,0,0,0
11213953,1,1,0,0,0,0,0,0,0
11214907,6,3,3,0,0,0,0,0,1
11214959,3,3,0,0,2,2,0,0,0
11214991,1,1,0,0,1,1,0,0,0
11215011,2,2,0,0,1,1,0,0,0
11215079,2,2,0,0,0,0,0,0,0
11215252,3,2,1,0,1,1,0,0,0
11215773,1,1,0,0,1,1,0,1,0
11215937,2,2,0,0,2,2,0,0,0
11216313,2,2,0,0,2,2,0,0,0
11216506,2,1,1,0,2,1,1,0,0
11216541,3,3,0,0,1,1,0,1,0
11216591,2,2,0,0,1,1,0,1,1
11216592,1,1,0,0,1,1,0,0,0
11216757,1,1,0,0,1,1,0,0,0
11216927,2,1,1,0,1,1,0,0,1
11217037,1,1,0,0,1,1,0,0,0
11217057,2,2,0,0,2,2,0,0,0
11217059,2,1,1,0,1,1,0,0,0
11217069,4,3,1,0,0,0,0,0,0
11217952,4,4,0,0,1,1,0,1,1
11218776,2,1,1,0,1,1,0,1,0
11219183,4,2,2,0,2,1,1,1,0
11219479,1,1,0,0,1,1,0,0,0
11219507,2,2,0,0,2,2,0,0,0
11219675,2,2,0,0,2,2,0,0,0
11219722,1,1,0,0,1,1,0,1,0
11219955,2,2,0,0,1,1,0,0,0
11220291,1,1,0,0,1,1,0,0,0
11220819,1,1,0,0,1,1,0,0,1
11220948,1,1,0,0,1,1,0,0,0
11221116,2,2,0,0,1,1,0,1,1
11221171,2,2,0,0,1,1,0,1,1
11221450,1,0,1,0,1,1,0,0,0
11221555,2,2,0,0,2,2,0,0,1
11221678,1,1,0,0,0,0,0,0,0
11221733,1,1,0,0,1,1,0,0,0
11222030,7,7,0,0,1,1,0,1,1
11222062,2,1,1,0,2,1,1,0,1
11222599,1,1,0,0,1,1,0,0,0
11222746,2,2,0,0,1,1,0,0,0
11222843,1,1,0,0,2,2,0,0,0
11222919,7,5,2,0,0,0,0,0,0
11222974,3,3,0,0,1,1,0,1,1
11223449,1,1,0,0,1,1,0,0,0
11223487,2,2,0,0,2,2,0,0,0
11223539,2,2,0,0,2,2,0,0,0
11223883,2,1,1,0,2,1,1,0,0
11223927,1,1,0,0,1,1,0,0,0
11224608,1,1,0,0,1,1,0,0,0
11224632,1,1,0,0,1,1,0,0,0
11225561,1,1,0,0,1,1,0,0,0
11225998,2,2,0,0,2,2,0,0,0
11226230,1,1,0,0,1,1,0,0,1
11226714,2,2,0,0,1,1,0,0,0
11226891,2,2,0,0,1,1,0,0,0
11227467,2,2,0,0,1,1,0,0,0
11227639,1,1,0,0,1,0,1,1,0
11227998,1,1,0,0,2,2,0,0,0
11228533,12,10,2,0,0,0,0,0,0
11228591,1,1,0,0,1,1,0,0,0
11228823,1,1,0,0,1,1,0,0,0
11229064,1,1,0,0,1,1,0,0,0
11229517,2,1,1,0,1,1,0,0,0
11229725,1,1,0,0,1,1,0,0,0
11229735,2,1,1,0,2,2,0,0,0
11229820,1,1,0,0,1,1,0,0,0
11230089,2,2,0,0,1,1,0,1,0
11230112,1,1,0,0,1,1,0,0,1
11230126,3,3,0,0,2,2,0,0,0
11230444,1,1,0,0,1,1,0,0,0
11230641,12,6,6,0,3,1,2,3,1
11230974,3,2,1,0,2,1,1,2,1
11231418,1,1,0,0,0,0,0,0,0
11231515,2,1,1,0,2,0,2,1,1
11231740,2,2,0,0,1,1,0,0,0
11232154,1,1,0,0,1,1,0,0,0
11232231,1,1,0,0,2,1,1,1,0
11232257,1,1,0,0,0,0,0,0,0
11232424,1,1,0,0,1,1,0,0,0
11232558,1,1,0,0,1,1,0,0,0
11232727,1,1,0,0,2,2,0,0,0
11232971,3,3,0,0,2,2,0,0,1
11233181,2,2,0,0,1,1,0,0,0
11233671,1,1,0,0,2,2,0,0,0
11234740,1,1,0,0,1,1,0,1,0
11234758,7,7,0,0,2,1,1,0,1
11234881,2,1,1,0,1,1,0,0,0
11235128,2,2,0,0,2,2,0,0,0
11235984,2,2,0,0,0,0,0,0,0
11236741,3,3,0,0,1,1,0,0,1
11236775,1,1,0,0,1,1,0,0,0
11236777,1,1,0,0,1,1,0,0,0
11237083,2,2,0,0,1,1,0,1,0
11237439,1,1,0,0,1,1,0,0,0
11237926,1,1,0,0,0,0,0,0,0
11238088,3,3,0,0,1,1,0,0,0
11238340,2,2,0,0,1,1,0,0,0
11238595,1,0,1,0,1,1,0,0,0
11238848,3,2,1,0,1,1,0,1,0
11240273,1,1,0,0,1,1,0,0,0
11240414,2,2,0,0,2,2,0,0,0
11241023,2,2,0,0,1,1,0,0,1
11241130,3,1,2,0,1,0,1,1,0
11241160,1,1,0,0,1,1,0,0,0
11241484,1,1,0,0,0,0,0,0,0
11241509,2,1,1,0,2,1,1,0,0
11241773,1,1,0,0,1,1,0,0,0
11242380,2,2,0,0,2,2,0,0,0
11242759,2,2,0,0,2,2,0,0,1
11242789,4,4,0,1,0,0,0,0,1
11243100,1,0,1,0,1,1,0,0,0
11243327,5,2,3,0,0,0,0,0,0
11243343,1,1,0,0,1,1,0,0,0
11243462,2,2,0,0,2,2,0,2,1
11243869,3,2,1,0,2,1,1,0,1
11243945,2,2,0,0,1,1,0,0,0
11244478,1,1,0,0,1,1,0,0,0
11244627,2,1,1,0,2,1,1,0,0
11244912,4,4,0,1,1,1,0,1,1
11245399,3,3,0,0,2,2,0,0,0
11245443,2,1,1,0,2,1,1,0,0
11245750,1,1,0,0,1,1,0,0,0
11245770,1,1,0,0,1,1,0,0,0
11245917,3,3,0,0,1,1,0,1,1
11245921,1,1,0,0,0,0,0,0,0
11246221,5,5,0,0,0,0,0,0,1
11246251,3,1,2,0,2,1,1,0,0
11246273,1,0,1,0,1,1,0,0,0
11246440,1,1,0,0,1,1,0,0,0
11246555,2,2,0,0,2,2,0,0,0
11247113,1,0,1,0,0,0,0,0,0
11247191,1,1,0,0,1,1,0,0,0
11247315,1,1,0,0,1,1,0,0,0
11247566,3,3,0,0,2,2,0,0,1
11247684,1,1,0,0,1,1,0,0,0
11247814,2,2,0,0,1,1,0,0,0
11247872,2,2,0,0,2,2,0,0,0
11247993,1,1,0,0,1,1,0,0,0
11248061,4,4,0,0,3,3,0,0,1
11248148,9,9,0,0,2,1,1,2,1
11248155,3,3,0,0,3,3,0,0,0
11248364,3,1,2,0,3,1,2,0,0
11248440,3,3,0,0,0,0,0,0,0
11248664,2,1,1,0,2,1,1,0,0
11248720,1,0,1,0,1,0,1,0,0
11248847,2,2,0,0,2,2,0,0,0
11249076,2,1,1,0,2,1,1,0,0
11249170,2,2,0,0,1,1,0,0,0
11249357,2,2,0,0,2,2,0,0,0
11249384,1,1,0,0,1,1,0,0,0
11249419,1,1,0,0,1,1,0,0,0
11249871,2,2,0,0,0,0,0,0,0
05025004,5,3,2,0,2,2,0,0,0
05025197,21,5,16,0,0,0,0,0,0
05025213,29,9,20,0,0,0,0,0,1
05025229,20,5,15,0,2,1,1,0,1
05025230,40,6,34,0,1,1,0,1,1
05025382,3,2,1,0,0,0,0,0,1
05025661,9,5,4,0,0,0,0,0,0
05025903,8,2,6,0,1,1,0,0,1
05025973,8,3,5,0,2,1,1,1,1
05026270,5,0,5,0,1,1,0,0,1
05026274,4,0,4,0,0,0,0,0,1
05026457,4,0,4,0,0,0,0,0,0
05026617,26,9,17,0,1,1,0,0,1
05027024,21,3,18,0,1,1,0,1,1
05027148,9,2,7,0,2,2,0,0,1
05027233,7,3,4,0,1,1,0,1,0
05027926,10,0,10,0,1,1,0,0,1
05028085,5,0,5,0,0,0,0,0,1
05028474,10,0,10,0,0,0,0,0,1
05029083,14,5,9,0,1,1,0,1,1
05029101,0,0,0,0,0,0,0,0,1
05029136,6,0,6,0,0,0,0,0,1
05029423,4,3,1,0,1,1,0,0,1
05029658,10,0,10,0,0,0,0,0,1
05029792,6,1,5,0,1,1,0,0,0
05030273,14,0,14,0,0,0,0,0,1
05030316,35,7,28,0,0,0,0,0,1
05030455,28,3,25,0,1,1,0,1,1
05030536,10,4,6,0,1,1,0,0,1
05030692,18,0,18,0,1,1,0,1,1
05030951,4,2,2,0,1,1,0,0,0
05031599,7,0,7,0,1,1,0,1,1
05031892,7,1,6,0,2,1,1,0,1
05032437,3,3,0,0,2,2,0,0,0
05032629,7,5,2,0,2,2,0,0,1
05032682,5,3,2,0,1,1,0,1,0
05032699,4,0,4,0,1,1,0,0,1
05032803,19,7,12,0,1,1,0,1,1
05032842,3,2,1,0,1,1,0,0,0
05032867,13,0,13,0,0,0,0,0,1
05032899,6,2,4,0,1,1,0,0,1
05032923,14,0,14,0,1,1,0,1,1
05032989,35,6,29,0,1,1,0,1,1
05033021,20,2,18,1,0,0,0,0,1
05033022,7,0,7,0,0,0,0,0,1
05033023,12,0,12,0,0,0,0,0,1
05033392,7,4,3,0,3,3,0,0,1
05033642,20,0,20,0,0,0,0,0,1
05033672,7,0,7,0,0,0,0,0,1
05033812,7,0,7,0,0,0,0,0,1
05033870,7,0,7,0,0,0,0,0,1
05033936,3,1,2,0,0,0,0,0,1
05034164,13,5,8,0,0,0,0,0,0
05034393,7,2,5,0,1,1,0,0,0
05034472,5,0,5,0,0,0,0,0,1
05034484,4,2,2,0,1,1,0,0,1
05034597,4,2,2,0,1,1,0,0,1
05034782,6,0,6,0,0,0,0,0,1
05035321,5,2,3,0,1,1,0,0,0
05035529,4,3,1,0,1,1,0,0,0
05035814,6,0,6,0,0,0,0,0,1
05035921,27,2,25,0,1,1,0,1,1
05036018,8,2,6,0,0,0,0,0,1
05036022,5,0,5,0,0,0,0,0,1
05036136,4,1,3,0,1,1,0,0,1
05036461,4,3,1,0,1,1,0,0,1
05037430,5,0,5,0,0,0,0,0,1
05037448,13,3,10,0,2,2,0,2,1
05037771,8,4,4,0,1,1,0,0,1
05037898,7,2,5,0,1,1,0,0,1
05037963,4,2,2,0,0,0,0,0,1
05037998,15,4,11,0,1,1,0,1,1
05038041,26,6,20,1,2,1,1,2,1
05038217,7,2,5,0,1,1,0,1,1
05038294,34,7,27,0,0,0,0,0,1
05038715,10,4,6,0,1,1,0,1,1
05038829,6,3,3,0,3,2,1,1,1
05038852,9,0,9,0,1,1,0,1,1
05039130,5,0,5,0,0,0,0,0,1
05039242,7,2,5,0,2,2,0,0,0
05039301,13,3,10,0,2,2,0,0,0
05039377,21,0,21,0,0,0,0,0,1
05039439,2,0,2,0,0,0,0,0,1
05039554,68,14,54,0,1,1,0,1,1
05040021,9,2,7,0,1,1,0,1,1
05040593,24,3,21,0,1,1,0,1,1
05040684,7,3,4,0,2,1,1,1,1
05040738,12,3,9,0,1,1,0,1,1
05040937,7,0,7,0,1,1,0,1,1
05040966,3,3,0,0,2,2,0,0,1
05041223,5,2,3,0,1,1,0,0,1
05041461,6,1,5,0,1,1,0,0,0
05042196,5,3,2,0,2,2,0,0,0
05042279,20,11,9,0,1,1,0,0,1
05042852,3,2,1,0,2,1,1,2,1
05042894,22,3,19,0,0,0,0,0,1
05042905,24,2,22,0,1,1,0,1,1
05042921,25,7,18,0,0,0,0,0,1
05042973,7,4,3,0,1,1,0,0,0
05043032,10,1,9,0,2,1,1,1,0
05043181,19,9,10,0,0,0,0,0,0
05043262,6,1,5,0,1,1,0,0,1
05043538,30,3,27,0,1,1,0,1,1
05043999,8,2,6,0,1,1,0,0,1
05044020,21,3,18,0,2,2,0,0,1
05044348,27,3,24,0,1,1,0,1,1
05044510,41,3,38,0,1,1,0,1,1
05044630,17,5,12,0,1,1,0,1,1
05044991,7,0,7,0,0,0,0,0,1
05045000,36,4,32,0,1,1,0,1,1
05045325,15,3,12,0,0,0,0,0,1
05045523,22,2,20,0,0,0,0,0,1
05045817,8,4,4,0,1,1,0,1,0
05045897,4,2,2,0,0,0,0,0,0
05046406,38,0,38,0,2,1,1,2,1
05047055,21,4,17,0,1,1,0,1,1
05047732,6,4,2,0,1,1,0,0,1
05047771,30,8,22,0,3,3,0,3,1
05047975,8,3,5,0,1,1,0,1,0
05048092,11,4,7,0,2,1,1,1,1
05048236,7,5,2,0,4,4,0,2,1
05048319,17,4,13,0,0,0,0,0,1
05048465,10,3,7,0,1,1,0,1,1
05048704,4,2,2,0,2,2,0,0,0
05048795,18,4,14,0,1,1,0,1,1
05048856,22,0,22,0,0,0,0,0,1
05048969,7,2,5,0,0,0,0,0,1
05049472,5,1,4,0,0,0,0,0,1
05049806,10,0,10,0,0,0,0,0,1
05050108,29,0,29,0,0,0,0,0,0
05050564,6,3,3,0,3,2,1,0,1
05050608,27,4,23,0,1,1,0,0,1
05050619,34,5,29,0,1,1,0,0,1
05050652,15,0,15,0,0,0,0,0,1
05050949,4,3,1,0,1,1,0,0,0
05051166,24,9,15,0,7,0,7,0,0
05051572,8,0,8,0,0,0,0,0,0
05051709,8,2,6,0,1,1,0,0,0
05052052,22,7,15,0,0,0,0,0,1
05052416,4,2,2,0,1,1,0,0,1
05052432,5,4,1,0,3,3,0,0,1
05052661,20,5,15,0,1,1,0,1,1
05052670,6,2,4,0,2,2,0,0,1
05052743,5,3,2,0,2,2,0,0,1
05053906,17,5,12,0,0,0,0,0,0
05053960,20,6,14,0,0,0,0,0,1
05054122,2,2,0,0,1,1,0,0,0
05054312,10,6,4,0,1,1,0,1,1
05054429,6,1,5,0,3,3,0,0,1
05054503,37,3,34,0,1,1,0,1,1
05054729,5,0,5,0,1,1,0,0,0
05054947,10,4,6,0,1,1,0,0,1
05055092,32,2,30,0,1,1,0,1,1
05055105,18,3,15,0,2,2,0,2,1
05055283,3,0,3,1,0,0,0,0,1
05055296,4,0,4,1,0,0,0,0,1
05055300,4,0,4,1,0,0,0,0,1
05055304,4,0,4,1,0,0,0,0,1
05055305,8,4,4,0,1,1,0,0,0
05055308,6,3,3,1,7,7,0,0,1
05055311,4,0,4,1,0,0,0,0,1
05055346,29,11,18,0,0,0,0,0,1
05055553,4,3,1,0,1,1,0,0,0
05055575,2,0,2,0,0,0,0,0,1
05055612,7,3,4,0,1,1,0,1,1
05055861,15,7,8,0,1,1,0,1,0
05055997,10,5,5,0,1,1,0,1,1
05056342,4,0,4,0,0,0,0,0,1
05056437,20,3,17,0,1,1,0,1,1
05056439,16,2,14,0,1,1,0,1,1
05056489,15,5,10,0,0,0,0,0,1
05056788,12,12,0,0,0,0,0,0,0
05056899,5,1,4,0,1,1,0,1,0
05057064,5,3,2,0,1,1,0,1,1
05057663,17,3,14,0,0,0,0,0,1
05057797,7,3,4,0,1,1,0,0,1
05057831,3,0,3,0,0,0,0,0,1
05057946,9,2,7,0,2,1,1,0,0
05058157,8,0,8,0,0,0,0,0,1
05058510,6,0,6,0,0,0,0,0,1
05058982,6,0,6,0,0,0,0,0,0
05059093,9,0,9,0,0,0,0,0,1
05059338,6,1,5,0,1,1,0,0,0
05059363,16,0,16,0,0,0,0,0,1
05059407,24,9,15,0,0,0,0,0,1
05059427,32,0,32,0,1,1,0,1,1
05059496,5,1,4,0,1,1,0,0,0
05059704,4,3,1,0,2,2,0,0,1
05059934,5,1,4,0,1,1,0,0,1
05060401,5,0,5,0,0,0,0,0,0
05060656,18,0,18,0,0,0,0,0,1
05060698,84,16,68,0,0,0,0,0,1
05060852,6,2,4,0,3,1,2,0,1
05060866,82,16,66,0,0,0,0,0,1
05061171,5,0,5,0,0,0,0,0,1
05061242,4,2,2,0,2,2,0,0,0
05061484,5,1,4,0,1,1,0,0,0
05061856,22,8,14,0,1,1,0,0,0
05062775,9,2,7,0,0,0,0,0,0
05063379,12,0,12,0,0,0,0,0,1
05063435,7,0,7,0,0,0,0,0,1
05063444,9,4,5,1,0,0,0,0,1
05063463,32,9,23,0,0,0,0,0,1
05063700,12,2,10,0,1,1,0,0,1
05063751,43,0,43,0,0,0,0,0,1
05064147,11,3,8,0,1,1,0,1,1
05064329,4,2,2,0,0,0,0,0,1
05064507,7,2,5,0,3,3,0,0,1
05065196,4,0,4,0,0,0,0,0,1
05065382,4,2,2,0,2,2,0,0,0
05065800,10,0,10,0,0,0,0,0,1
05065801,6,2,4,0,1,1,0,0,1
05065834,8,0,8,0,0,0,0,0,1
05065909,4,0,4,0,0,0,0,0,1
05066067,9,3,6,0,0,0,0,0,0
05066192,30,3,27,0,1,1,0,1,1
05066216,5,0,5,0,1,1,0,0,1
05066242,6,0,6,0,0,0,0,0,1
05066406,37,11,26,0,1,1,0,1,0
05066506,24,2,22,0,1,1,0,1,1
05066560,8,1,7,0,1,1,0,0,1
05067221,8,2,6,0,2,2,0,0,0
05067291,35,7,28,0,0,0,0,0,1
05067328,6,4,2,0,2,2,0,0,0
05067702,17,8,9,0,3,3,0,0,1
05067721,6,4,2,0,1,1,0,1,0
05067923,5,4,1,0,0,0,0,0,0
05068031,21,3,18,0,0,0,0,0,0
05068503,16,3,13,0,1,1,0,1,1
05068535,20,9,11,0,0,0,0,0,0
05069107,18,3,15,0,1,1,0,1,1
05069189,4,2,2,0,1,1,0,0,1
05069221,5,3,2,0,1,1,0,0,0
05069440,2,1,1,0,1,1,0,0,0
05069781,20,0,20,0,0,0,0,0,1
05069800,4,2,2,0,1,1,0,0,1
05069933,12,4,8,0,0,0,0,0,1
01177243,7,3,4,0,0,0,0,0,0
01177275,14,3,11,0,1,1,0,1,0
01177474,21,4,17,0,0,0,0,0,0
01177488,21,0,21,0,0,0,0,0,1
01177507,26,0,26,0,0,0,0,0,1
01177822,54,4,50,0,1,1,0,1,1
01178020,17,6,11,0,0,0,0,0,1
01178566,13,2,11,0,1,1,0,1,1
01178687,19,6,13,0,0,0,0,0,1
01178762,26,3,23,0,1,1,0,1,0
01179780,15,7,8,0,1,1,0,0,0
01179918,65,12,53,0,0,0,0,0,1
01179975,64,5,59,0,0,0,0,0,1
01179980,74,11,63,0,1,1,0,1,1
01180275,20,0,20,0,0,0,0,0,1
01180361,50,0,50,0,0,0,0,0,1
01180365,17,0,17,0,0,0,0,0,1
01180515,31,9,22,0,0,0,0,0,1
01180662,0,0,0,0,0,0,0,0,0
01180733,5,2,3,0,1,1,0,0,1
01180969,20,6,14,0,1,1,0,1,1
01181327,10,3,7,0,2,1,1,0,1
01181769,24,4,20,0,0,0,0,0,0
01182229,1,1,0,0,0,0,0,0,0
01182437,142,26,116,0,0,0,0,0,1
01182469,41,5,36,0,1,1,0,1,1
01182630,116,3,113,0,1,1,0,1,1
01182631,73,3,70,0,1,1,0,1,1
01182633,75,4,71,0,1,1,0,1,1
01182734,268,8,260,0,0,0,0,0,1
01182908,33,4,29,0,1,1,0,0,1
01183133,16,8,8,0,6,5,1,0,1
01183291,18,4,14,0,1,1,0,1,1
01183428,8,1,7,0,1,1,0,0,1
01183941,16,4,12,0,1,1,0,1,1
01184163,0,0,0,0,0,0,0,0,0
01184323,34,7,27,0,1,1,0,1,1
01184594,44,16,28,0,0,0,0,0,1
01184634,12,3,9,0,1,1,0,1,1
01184724,5,4,1,0,1,1,0,0,0
01184903,38,3,35,0,1,1,0,1,1
01184988,26,2,24,0,2,2,0,0,1
01185027,10,4,6,0,0,0,0,0,1
01185512,14,7,7,0,1,1,0,1,1
01185797,10,2,8,0,2,2,0,0,0
01185932,25,3,22,0,1,1,0,1,1
01186095,10,2,8,0,1,1,0,0,1
01186314,18,2,16,0,1,1,0,0,1
01186681,41,5,36,0,1,1,0,1,1
01186950,5,4,1,0,1,1,0,0,0
01187031,13,3,10,0,1,1,0,1,1
01187434,16,3,13,0,1,1,0,1,1
01187592,10,3,7,0,2,2,0,0,0
01188070,38,5,33,0,1,1,0,1,1
01188119,16,3,13,0,0,0,0,0,0
01188209,70,15,55,0,0,0,0,0,1
01188270,6,2,4,0,1,1,0,0,1
01188467,15,0,15,0,0,0,0,0,1
01188468,37,7,30,0,1,1,0,1,1
01188567,57,12,45,0,1,1,0,1,1
01188772,39,6,33,0,0,0,0,0,1
01189037,5,2,3,0,1,1,0,0,0
01189187,9,0,9,0,0,0,0,0,1
01189776,242,13,229,0,0,0,0,0,1
01190087,65,9,56,0,0,0,0,0,1
01190207,3,0,3,0,0,0,0,0,1
01190450,6,6,0,0,2,2,0,0,0
01190503,19,0,19,0,1,1,0,1,1
01190608,34,14,20,0,0,0,0,0,1
01190843,24,0,24,0,0,0,0,0,1
01191154,23,2,21,0,1,1,0,1,1
01191504,31,10,21,0,1,1,0,1,1
01191882,25,3,22,0,1,1,0,1,1
01191929,12,0,12,0,0,0,0,0,1
01192186,8,2,6,0,1,1,0,0,0
01192287,33,0,33,0,0,0,0,0,1
01192575,14,3,11,0,1,1,0,1,1
01192577,8,0,8,0,0,0,0,0,0
01192857,42,0,42,0,0,0,0,0,1
01192863,14,2,12,0,0,0,0,0,0
01194084,28,7,21,0,2,1,1,2,1
01194206,40,12,28,0,0,0,0,0,1
01194355,39,6,33,0,3,2,1,1,1
01194903,17,1,16,0,0,0,0,0,1
01195498,93,7,86,0,0,0,0,0,0
01195527,7,3,4,0,1,1,0,0,0
01195637,30,4,26,0,0,0,0,0,0
01195799,37,9,28,0,0,0,0,0,0
01195905,42,2,40,0,0,0,0,0,1
01195988,24,0,24,0,1,1,0,1,1
01196043,100,11,89,0,0,0,0,0,1
01196676,23,3,20,0,2,2,0,2,1
01196703,25,4,21,0,3,2,1,1,1
01197291,6,0,6,0,1,1,0,0,1
01197546,22,3,19,0,1,1,0,1,1
01197743,96,9,87,0,1,1,0,1,1
01198312,20,0,20,0,0,0,0,0,1
01198814,6,2,4,0,2,1,1,1,1
01198998,35,0,35,0,0,0,0,0,1
01199112,21,0,21,0,1,1,0,1,1
01199263,4,0,4,0,0,0,0,0,1
01199364,11,3,8,0,2,2,0,2,1
01199402,139,32,107,0,0,0,0,0,1
01199458,11,0,11,0,1,1,0,1,1
01199576,8,1,7,0,1,1,0,0,0
01199594,6,5,1,0,1,1,0,0,0
01199738,6,3,3,0,2,2,0,0,0
01200032,27,10,17,0,0,0,0,0,1
01200092,8,3,5,0,4,3,1,1,0
01200318,239,33,206,0,0,0,0,0,1
01201092,20,3,17,0,1,1,0,1,1
01202058,46,4,42,0,0,0,0,0,1
01202632,26,0,26,0,1,1,0,1,1
01203072,13,0,13,0,0,0,0,0,1
01203132,33,0,33,0,0,0,0,0,1
01203199,0,0,0,0,0,0,0,0,0
01203292,35,4,31,0,2,0,2,0,1
01203357,12,3,9,0,1,1,0,1,0
01203466,33,4,29,0,1,1,0,1,1
01203607,4,1,3,0,1,1,0,0,0
01203696,86,11,75,0,1,1,0,1,1
01204181,12,0,12,0,0,0,0,0,1
01204384,15,5,10,0,0,0,0,0,0
01204694,112,10,102,0,0,0,0,0,1
01204831,20,5,15,0,1,1,0,1,1
01204868,0,0,0,0,0,0,0,0,1
01205298,89,16,73,0,0,0,0,0,1
01205342,5,5,0,0,1,1,0,0,0
01205488,88,30,58,0,0,0,0,0,1
01205515,20,4,16,0,1,1,0,1,1
01205530,15,3,12,0,1,1,0,1,1
01205542,21,5,16,0,1,1,0,1,1
01205888,19,1,18,0,0,0,0,0,1
01205988,17,0,17,0,0,0,0,0,1
01206191,20,5,15,0,1,1,0,1,1
01206244,14,4,10,0,1,1,0,1,1
01206978,37,5,32,0,2,0,2,2,1
01207001,12,3,9,0,1,1,0,0,0
01207237,27,0,27,0,0,0,0,0,1
01207787,63,12,51,0,0,0,0,0,1
01207921,61,5,56,0,1,1,0,0,0
01208081,9,2,7,0,2,2,0,0,1
01208137,26,6,20,0,1,1,0,1,1
01208439,7,3,4,0,2,2,0,0,0
01208671,12,6,6,0,2,2,0,0,1
01208697,10,3,7,0,1,1,0,1,1
01208973,13,4,9,0,1,1,0,1,0
01209272,5,2,3,0,1,1,0,0,0
01209831,80,15,65,0,0,0,0,0,1
01210050,77,15,62,0,0,0,0,0,1
01210373,10,3,7,0,1,1,0,1,1
01211078,3,3,0,0,1,1,0,1,0
01211648,43,3,40,0,1,1,0,1,1
01211979,100,14,86,0,0,0,0,0,1
01212455,14,8,6,0,6,0,6,0,1
01212462,25,0,25,0,0,0,0,0,1
01213043,30,3,27,0,1,1,0,1,1
01213106,42,2,40,0,1,1,0,1,1
01213157,23,2,21,0,1,1,0,1,1
01213819,93,30,63,0,0,0,0,0,1
01213991,27,4,23,0,0,0,0,0,1
01214315,72,5,67,0,2,1,1,2,1
01214348,22,0,22,0,0,0,0,0,1
01214640,30,4,26,0,3,1,2,3,1
01214674,29,7,22,0,1,1,0,1,1
01215133,32,8,24,0,1,1,0,0,0
01215502,5,2,3,0,1,1,0,0,0
01215741,279,19,260,0,0,0,0,0,1
01215906,54,0,54,0,0,0,0,0,1
01215927,25,4,21,0,1,1,0,1,1
01216132,30,3,27,0,1,1,0,1,1
01216593,11,4,7,0,2,2,0,0,1
01216701,117,14,103,0,0,0,0,0,0
01216730,26,6,20,0,46,41,5,0,1
01217006,93,10,83,0,0,0,0,0,1
01217230,9,5,4,0,1,1,0,1,0
01217250,5,3,2,0,2,2,0,0,0
01217758,0,0,0,0,0,0,0,0,0
01217770,207,10,197,0,1,1,0,0,1
01218060,9,0,9,0,0,0,0,0,0
01218235,19,4,15,0,0,0,0,0,0
01218466,22,4,18,0,1,1,0,1,1
01218639,70,10,60,0,0,0,0,0,0
01218707,12,3,9,0,1,1,0,0,1
01219145,21,10,11,0,0,0,0,0,0
01219330,137,46,91,0,0,0,0,0,0
01219838,38,8,30,0,11,8,3,0,1
01219906,10,3,7,0,2,2,0,0,1
01220044,5,3,2,0,0,0,0,0,0
01220218,6,4,2,0,2,2,0,0,1
01220262,3,2,1,0,1,1,0,0,0
01220282,10,2,8,0,0,0,0,0,0
01220696,16,7,9,0,0,0,0,0,1
01220754,36,0,36,0,0,0,0,0,1
01220993,17,6,11,0,2,2,0,0,1
01221141,18,0,18,0,2,1,1,2,1
01221384,11,4,7,0,1,1,0,1,1
01221601,4,3,1,0,1,1,0,0,0
01221764,18,0,18,0,0,0,0,0,1
01221968,54,14,40,0,0,0,0,0,1
01222246,21,6,15,0,1,1,0,1,1
01222607,285,3,282,0,1,1,0,1,1
01222723,3,1,2,0,1,1,0,0,0
01223040,6,5,1,0,2,2,0,0,0
01223374,30,3,27,0,1,1,0,1,1
01223702,21,0,21,0,1,1,0,1,1
01223977,34,1,33,0,2,2,0,1,1
01224029,52,3,49,0,0,0,0,0,1
01224434,38,3,35,0,1,1,0,1,1
01224573,51,7,44,0,0,0,0,0,1
01224751,57,8,49,0,0,0,0,0,1
01225251,28,5,23,0,0,0,0,0,1
01225294,4,4,0,0,3,1,2,0,0
01225656,17,3,14,0,0,0,0,0,0
01225802,69,12,57,0,0,0,0,0,1
01226001,37,3,34,0,1,1,0,1,1
01226062,10,1,9,0,1,1,0,1,1
01226220,6,5,1,0,1,1,0,1,1
01226384,11,4,7,0,1,1,0,1,1
01226597,7,3,4,0,1,1,0,0,0
01226660,30,13,17,0,0,0,0,0,1
01226903,27,10,17,0,0,0,0,0,1
01227130,63,5,58,0,9,7,2,0,1
01227343,11,2,9,0,1,1,0,1,1
01227443,17,0,17,0,0,0,0,0,1
01227497,23,5,18,0,2,1,1,2,1
01227580,17,5,12,0,0,0,0,0,1
01227639,3,1,2,0,2,1,1,0,0
01227868,122,10,112,0,0,0,0,0,1
01227931,89,10,79,0,0,0,0,0,1
01227970,132,14,118,0,0,0,0,0,1
09669076,2,0,2,0,1,1,0,0,1
09669232,3,3,0,0,2,2,0,0,1
09669361,3,3,0,0,1,1,0,0,1
09669898,3,2,1,0,2,2,0,0,0
09670462,1,1,0,0,2,2,0,0,0
09670593,1,1,0,0,1,1,0,0,0
09670601,2,2,0,0,2,2,0,0,0
09670729,1,0,1,0,1,1,0,0,1
09670952,2,2,0,0,2,2,0,0,1
09671025,4,2,2,0,2,2,0,0,1
09671085,1,0,1,0,1,1,0,0,0
09671246,2,1,1,0,1,1,0,0,0
09671577,2,2,0,0,2,2,0,0,1
09671661,5,2,3,0,2,1,1,2,1
09672106,1,1,0,0,2,2,0,0,0
09673129,2,0,2,0,1,1,0,0,1
09673420,2,1,1,0,1,1,0,0,0
09673444,2,1,1,0,3,1,2,3,1
09674203,8,6,2,0,1,1,0,0,1
09674288,6,0,6,0,1,1,0,1,0
09674560,2,2,0,0,2,2,0,0,0
09674788,5,0,5,0,1,1,0,1,1
09675351,1,1,0,0,1,1,0,0,0
09675729,1,1,0,0,1,1,0,0,1
09676169,2,2,0,0,1,1,0,0,0
09676327,2,2,0,0,1,1,0,0,0
09676897,2,2,0,0,2,2,0,0,0
09677242,4,2,2,0,4,1,3,2,0
09677263,9,3,6,0,1,1,0,1,0
09677266,9,3,6,0,1,1,0,1,0
09677471,2,1,1,0,1,1,0,0,0
09677488,3,3,0,0,1,1,0,0,0
09677641,1,1,0,0,1,1,0,0,1
09677774,2,0,2,0,1,1,0,1,1
09677803,2,0,2,0,1,1,0,1,1
09678048,11,8,3,0,1,1,0,1,1
09678063,2,1,1,0,1,1,0,0,0
09678748,1,1,0,0,1,1,0,0,0
09679101,2,0,2,0,2,2,0,0,1
09679238,2,0,2,0,2,2,0,0,0
09679536,28,16,12,0,0,0,0,0,0
09679603,15,5,10,0,1,1,0,1,1
09679683,17,10,7,0,3,3,0,0,0
09679852,4,3,1,0,3,3,0,0,1
09679873,2,1,1,0,1,1,0,0,0
09679938,1,1,0,0,1,1,0,0,0
09679978,4,4,0,0,2,2,0,0,1
09680067,2,2,0,0,2,2,0,0,0
09680241,23,11,12,0,3,3,0,0,1
09680666,2,2,0,0,1,1,0,0,1
09680755,7,4,3,0,6,4,2,0,0
09680786,1,1,0,0,1,1,0,0,1
09680944,1,1,0,0,1,1,0,0,0
09681986,3,0,3,0,0,0,0,0,1
09682174,2,2,0,0,2,2,0,0,0
09682590,5,3,2,0,0,0,0,0,1
09682694,2,0,2,0,1,1,0,0,0
09683214,3,3,0,0,1,1,0,0,1
09685038,3,2,1,0,4,2,2,2,0
09685043,1,1,0,0,1,1,0,0,0
09685446,1,1,0,0,1,1,0,0,1
09685712,15,7,8,0,0,0,0,0,1
09685744,5,5,0,0,0,0,0,0,0
09685825,2,2,0,0,2,2,0,0,0
09686460,2,1,1,0,1,1,0,0,1
09686983,12,7,5,0,1,1,0,1,1
09687073,2,1,1,0,1,1,0,0,0
09687299,1,1,0,0,1,1,0,0,1
09687523,1,0,1,0,1,1,0,0,0
09687912,1,0,1,0,1,1,0,0,0
09687973,10,3,7,0,5,3,2,4,1
09688383,2,1,1,0,2,1,1,0,0
09688433,12,8,4,0,1,1,0,1,1
09688889,2,2,0,0,2,2,0,0,0
09689043,2,2,0,0,1,1,0,0,0
09689339,2,1,1,0,1,1,0,0,0
09689426,1,1,0,0,2,2,0,0,0
09689457,1,1,0,0,1,1,0,0,0
09689954,5,5,0,0,1,1,0,0,1
09690289,1,1,0,0,2,2,0,0,1
09691165,1,1,0,0,1,1,0,0,0
09691176,1,1,0,0,1,1,0,0,0
09691367,2,2,0,0,2,2,0,0,0
09691407,1,1,0,0,1,1,0,0,0
09691605,3,3,0,0,4,4,0,0,0
09691901,2,2,0,0,2,2,0,0,1
09692162,4,3,1,2,2,1,1,1,0
09692692,1,1,0,0,1,1,0,0,0
09692832,6,6,0,0,1,1,0,1,1
09693016,5,5,0,0,1,1,0,1,1
09693096,3,3,0,0,3,3,0,0,0
09693422,2,0,2,0,1,1,0,0,0
09693599,2,2,0,0,1,1,0,0,1
09693704,1,0,1,0,1,1,0,0,0
09694076,1,1,0,0,1,1,0,0,0
09694313,8,4,4,0,3,0,3,0,0
09694599,2,0,2,0,1,1,0,0,0
09695254,2,2,0,0,2,2,0,0,0
09695308,1,1,0,0,2,2,0,0,0
09695328,1,1,0,0,1,1,0,0,0
09695529,5,3,2,0,4,1,3,1,0
09695808,3,3,0,0,2,2,0,0,1
09696010,1,1,0,0,2,2,0,0,0
09696088,7,6,1,0,1,1,0,1,1
09696134,2,1,1,0,2,1,1,0,0
09696402,1,0,1,0,0,0,0,0,0
09696424,4,4,0,0,1,1,0,0,0
09696941,2,2,0,0,1,1,0,0,1
09697109,3,3,0,0,1,1,0,0,0
09697140,1,1,0,0,1,1,0,0,0
09697210,2,2,0,0,2,2,0,0,0
09697560,3,2,1,0,3,2,1,0,0
09697639,6,2,4,0,0,0,0,0,1
09697680,1,1,0,0,1,1,0,0,0
09697686,6,1,5,0,2,1,1,1,0
09697721,1,0,1,0,0,0,0,0,0
09697878,2,1,1,0,1,1,0,0,1
09697931,3,3,0,0,2,2,0,0,1
09698746,3,2,1,0,1,1,0,0,0
09698813,1,1,0,0,1,1,0,0,0
09699092,1,1,0,0,1,1,0,0,0
09699284,1,1,0,0,1,1,0,0,0
09699305,2,2,0,0,2,2,0,0,1
09699351,2,0,2,0,2,2,0,0,1
09699638,1,0,1,0,1,1,0,0,0
09699745,1,0,1,0,1,1,0,0,0
09699769,1,1,0,0,1,1,0,0,0
09699798,2,1,1,0,1,1,0,0,1
09699910,1,1,0,0,1,1,0,0,0
09700818,11,8,3,0,1,1,0,1,1
09701436,7,7,0,0,1,1,0,0,1
09701535,3,3,0,0,2,2,0,0,1
09701564,3,3,0,0,1,1,0,1,1
09701705,4,0,4,0,1,1,0,1,1
09701735,2,2,0,0,1,1,0,0,0
09701744,3,3,0,0,0,0,0,0,1
09701755,8,4,4,0,1,1,0,1,1
09701762,3,3,0,0,1,1,0,1,1
09701801,4,2,2,0,2,2,0,0,0
09701919,5,5,0,0,1,1,0,0,1
09702225,1,1,0,0,1,1,0,0,0
09702356,2,2,0,0,1,1,0,0,0
09702825,3,3,0,0,2,2,0,0,0
09702951,2,0,2,0,1,1,0,1,1
09702968,5,4,1,0,1,1,0,0,1
09703010,5,4,1,0,1,1,0,0,1
09703032,16,0,16,0,0,0,0,0,1
09703094,2,2,0,0,1,1,0,0,0
09703721,1,1,0,0,1,1,0,0,1
09703739,1,0,1,0,1,1,0,0,0
09703836,3,1,2,0,2,1,1,0,0
09704038,2,2,0,0,2,1,1,0,0
09704065,9,7,2,0,0,0,0,0,0
09704399,1,1,0,0,1,1,0,0,0
09704814,3,3,0,0,1,1,0,1,1
09705105,2,2,0,0,2,2,0,0,1
09705222,3,2,1,0,1,1,0,0,0
09705718,1,1,0,0,1,1,0,0,0
09705732,14,9,5,0,4,0,4,0,1
09705977,1,1,0,0,1,1,0,0,0
09706105,1,1,0,0,2,2,0,0,1
09706126,8,5,3,0,2,2,0,2,1
09706188,9,7,2,0,2,1,1,1,1
09706676,3,2,1,0,1,1,0,1,1
09706814,3,2,1,0,2,1,1,1,0
09707060,2,2,0,0,2,2,0,1,1
09707378,4,3,1,0,1,1,0,0,0
09707429,3,2,1,0,1,1,0,0,0
09707733,1,1,0,0,1,1,0,0,0
09707793,7,1,6,0,3,1,2,1,0
09707857,1,0,1,0,0,0,0,0,1
09707952,3,2,1,0,1,1,0,1,0
09708029,4,4,0,0,4,4,0,0,0
09708232,1,1,0,0,1,1,0,0,0
09708255,2,2,0,0,2,2,0,0,1
09708294,3,2,1,0,1,1,0,0,0
09708463,2,2,0,0,1,1,0,0,0
09708476,7,1,6,0,5,1,4,0,0
09708477,1,1,0,0,1,1,0,0,0
09709076,2,0,2,0,1,1,0,0,1
09709547,4,2,2,0,2,2,0,0,1
09709574,5,1,4,0,4,1,3,3,1
09709586,4,2,2,0,3,1,2,1,1
09709766,2,0,2,0,1,1,0,0,0
09710193,2,2,0,0,4,2,2,0,0
09710229,2,0,2,0,3,3,0,3,1
09711650,1,1,0,0,1,1,0,0,0
09712024,5,0,5,0,2,1,1,0,0
09712078,10,1,9,0,7,1,6,0,0
09712308,2,0,2,0,2,2,0,2,1
09712377,2,0,2,0,2,2,0,2,1
09712416,2,0,2,0,2,2,0,2,1
09712418,2,0,2,0,2,2,0,2,1
09712678,1,1,0,0,1,1,0,0,0
09712774,4,4,0,0,2,2,0,0,0
09712843,3,1,2,0,1,1,0,0,0
09712966,1,1,0,0,2,2,0,0,0
09713256,5,3,2,0,0,0,0,0,1
09713315,7,3,4,0,2,1,1,2,1
09713332,7,3,4,0,1,1,0,1,1
09713596,2,2,0,0,1,1,0,0,0
09713645,6,5,1,0,2,2,0,2,1
09713669,5,4,1,0,0,0,0,0,1
09713942,2,2,0,0,2,2,0,0,1
09714476,5,1,4,0,1,1,0,0,1
09714620,3,2,1,0,1,1,0,0,1
09714893,7,3,4,0,0,0,0,0,1
09714995,2,2,0,0,1,1,0,0,1
09715522,1,1,0,0,1,1,0,0,0
09715658,2,1,1,0,1,1,0,0,0
09715685,1,1,0,0,1,1,0,0,0
09716006,2,1,1,0,1,1,0,0,0
09716034,2,2,0,0,4,2,2,0,0
09716107,1,0,1,0,1,1,0,0,1
09716586,1,1,0,0,1,1,0,0,0
09716994,2,0,2,0,0,0,0,0,0
09717001,2,2,0,0,2,2,0,0,0
09717350,24,18,6,0,0,0,0,0,1
09717512,2,2,0,0,1,1,0,0,1
09717534,1,1,0,0,1,1,0,0,0
09717896,2,2,0,0,2,2,0,0,0
09717920,5,3,2,0,1,1,0,0,0
09717961,2,2,0,0,1,1,0,0,0
09718065,1,1,0,0,1,1,0,0,0
09718117,1,1,0,0,1,1,0,0,0
09719108,3,3,0,0,1,1,0,0,0
07257358,2,2,0,0,1,1,0,0,0
07257485,6,0,6,0,0,0,0,0,0
07257611,3,3,0,0,1,1,0,0,0
07257632,6,4,2,0,3,3,0,0,1
07258019,7,3,4,0,3,3,0,1,1
07258023,6,3,3,0,2,2,0,0,1
07258055,2,0,2,0,0,0,0,0,0
07258456,13,3,10,0,1,1,0,1,1
07258478,11,3,8,1,1,1,0,1,1
07258491,25,9,16,0,1,1,0,1,1
07258641,8,0,8,1,0,0,0,0,1
07259039,11,0,11,0,1,1,0,1,1
07259164,22,9,13,0,0,0,0,0,1
07259214,2,1,1,0,1,1,0,0,0
07259342,1,0,1,0,0,0,0,0,1
07259728,2,2,0,0,1,1,0,0,0
07260364,2,0,2,0,0,0,0,0,0
07260548,5,3,2,0,4,2,2,0,1
07260608,8,4,4,0,4,4,0,0,1
07260809,7,3,4,0,0,0,0,0,1
07260848,1,1,0,0,1,1,0,0,0
07260985,3,0,3,0,2,2,0,0,1
07261369,2,2,0,0,2,2,0,0,0
07261372,3,2,1,0,1,1,0,0,0
07261541,5,2,3,0,2,1,1,0,0
07261627,4,1,3,0,1,1,0,0,0
07261857,16,3,13,0,1,1,0,1,1
07261971,49,7,42,0,2,1,1,0,0
07262121,3,3,0,0,2,2,0,0,1
07262855,2,1,1,0,1,1,0,0,0
07262918,4,3,1,0,0,0,0,0,1
07263129,2,0,2,0,0,0,0,0,1
07263305,2,1,1,0,1,1,0,0,1
07263835,6,4,2,0,1,1,0,0,0
07263921,8,3,5,0,0,0,0,0,1
07264214,4,3,1,0,3,3,0,0,1
07264350,3,2,1,0,1,1,0,0,0
07264417,3,2,1,0,1,1,0,0,0
07264501,2,2,0,0,2,2,0,0,0
07264555,23,7,16,0,1,1,0,1,1
07264678,28,9,19,0,0,0,0,0,1
07264967,3,2,1,0,1,1,0,1,0
07265368,11,0,11,0,0,0,0,0,1
07265492,9,3,6,0,0,0,0,0,0
07265982,9,3,6,0,1,1,0,1,0
07266006,17,4,13,0,1,1,0,1,1
07266173,3,2,1,0,1,1,0,1,1
07266312,6,0,6,0,0,0,0,0,1
07266574,11,5,6,0,1,1,0,1,1
07267256,10,6,4,0,1,1,0,1,1
07267552,4,3,1,0,2,2,0,0,1
07267638,5,4,1,0,3,1,2,1,0
07267677,1,1,0,0,1,1,0,0,0
07267880,14,8,6,0,0,0,0,0,1
07268106,2,2,0,0,1,1,0,1,0
07268357,4,2,2,0,3,2,1,0,1
07268511,2,2,0,0,1,1,0,0,0
07268655,11,0,11,0,0,0,0,0,1
07268671,12,6,6,0,0,0,0,0,1
07269708,9,0,9,0,0,0,0,0,1
07269802,2,2,0,0,2,2,0,0,0
07270233,2,2,0,0,2,2,0,0,0
07270302,14,4,10,0,0,0,0,0,1
07270745,7,4,3,0,0,0,0,0,0
07270922,3,0,3,0,1,1,0,0,0
07271189,3,3,0,0,2,2,0,0,0
07271198,5,1,4,0,1,1,0,0,1
07271403,1,0,1,0,0,0,0,0,0
07271494,2,2,0,0,1,1,0,0,0
07271657,5,3,2,0,2,2,0,0,1
07272433,3,0,3,0,0,0,0,0,1
07272526,3,2,1,0,2,2,0,0,0
07272530,7,2,5,0,1,1,0,1,1
07272568,10,1,9,0,1,1,0,1,1
07273055,2,2,0,0,2,2,0,0,0
07273184,2,2,0,0,1,1,0,0,0
07273356,10,1,9,0,1,1,0,1,1
07273434,3,0,3,0,2,2,0,0,1
07273493,2,2,0,0,2,2,0,0,0
07273762,10,3,7,0,1,1,0,1,1
07273848,2,1,1,0,2,1,1,1,0
07273934,3,1,2,0,1,1,0,0,0
07274100,6,5,1,0,0,0,0,0,0
07274183,7,0,7,0,0,0,0,0,0
07274449,3,2,1,0,2,2,0,0,1
07274923,2,2,0,0,1,1,0,0,1
07275057,3,0,3,0,0,0,0,0,1
07275626,14,0,14,0,0,0,0,0,0
07275804,3,1,2,0,1,1,0,0,0
07275898,1,1,0,0,2,2,0,0,1
07276185,3,2,1,0,1,1,0,0,0
07276415,6,3,3,0,2,2,0,0,0
07276853,4,0,4,0,0,0,0,0,1
07276977,29,10,19,0,0,0,0,0,1
07277239,5,0,5,0,0,0,0,0,1
07277371,14,7,7,0,1,1,0,1,0
07277460,18,3,15,0,0,0,0,0,1
07277512,3,0,3,0,0,0,0,0,1
07277635,16,6,10,0,3,2,1,3,0
07277904,7,2,5,0,1,1,0,1,1
07278074,4,0,4,0,0,0,0,0,1
07278168,4,4,0,0,2,2,0,0,0
07278496,14,8,6,0,0,0,0,0,1
07278654,3,0,3,0,0,0,0,0,1
07278844,6,4,2,0,10,10,0,1,1
07278867,7,4,3,0,11,10,1,1,1
07279005,14,0,14,0,0,0,0,0,1
07279103,6,2,4,0,3,1,2,1,0
07279760,5,3,2,0,0,0,0,0,1
07279856,9,4,5,0,1,1,0,0,1
07279867,1,1,0,0,1,1,0,0,0
07279868,12,0,12,0,0,0,0,0,1
07280079,5,5,0,0,1,1,0,0,1
07280473,4,3,1,0,2,2,0,0,0
07280538,16,7,9,0,0,0,0,0,1
07281493,2,0,2,0,1,1,0,0,1
07281796,13,6,7,0,0,0,0,0,0
07282298,4,4,0,0,2,2,0,0,1
07282452,7,3,4,0,0,0,0,0,1
07282497,8,4,4,0,1,1,0,0,1
07282856,7,3,4,0,1,1,0,0,1
07282890,2,2,0,0,2,2,0,0,1
07283266,5,4,1,0,1,1,0,1,0
07283380,2,2,0,0,3,3,0,0,1
07283608,1,1,0,0,1,1,0,0,1
07283790,5,2,3,0,1,1,0,1,0
07283824,19,6,13,0,0,0,0,0,0
07283993,6,3,3,0,4,1,3,1,0
07284043,15,5,10,0,1,1,0,1,1
07284055,15,5,10,0,1,1,0,1,1
07284542,6,3,3,0,1,1,0,1,1
07284602,15,6,9,0,0,0,0,0,1
07284813,1,1,0,0,1,1,0,0,1
07285002,3,0,3,0,0,0,0,0,1
07285230,7,3,4,0,1,1,0,0,1
07285438,7,3,4,0,2,2,0,2,1
07285660,6,1,5,0,3,2,1,0,1
07285667,16,0,16,0,0,0,0,0,1
07285880,3,2,1,0,1,1,0,0,0
07285884,2,1,1,0,1,1,0,0,0
07285930,2,0,2,0,0,0,0,0,1
07286116,7,4,3,0,1,1,0,0,0
07286359,10,3,7,0,0,0,0,0,0
07286399,29,13,16,0,0,0,0,0,1
07286540,13,6,7,0,0,0,0,0,1
07287246,5,2,3,0,1,1,0,1,0
07287389,3,1,2,0,1,1,0,0,0
07287625,6,0,6,0,0,0,0,0,1
07287992,2,0,2,0,2,2,0,0,1
07288006,1,1,0,0,1,1,0,0,0
07288186,13,8,5,0,1,1,0,0,0
07288320,9,0,9,0,0,0,0,0,1
07288364,1,0,1,0,0,0,0,0,1
07288563,3,2,1,0,2,2,0,0,0
07289145,5,2,3,0,2,1,1,0,0
07289756,3,1,2,0,1,1,0,0,0
07290223,1,1,0,0,1,1,0,0,1
07290404,18,9,9,0,1,1,0,1,0
07290425,11,4,7,0,1,1,0,1,1
07290590,19,13,6,0,3,3,0,3,1
07290767,1,1,0,0,1,1,0,0,0
07290895,15,5,10,0,1,1,0,1,1
07290959,5,2,3,0,2,1,1,0,1
07291340,3,3,0,0,1,1,0,0,1
07291380,3,2,1,0,1,1,0,0,1
07291412,3,3,0,0,1,1,0,0,0
07291844,3,2,1,0,2,2,0,0,1
07292336,6,0,6,0,0,0,0,0,1
07292504,3,3,0,0,2,2,0,0,0
07292623,3,1,2,0,1,1,0,0,0
07292824,6,2,4,0,0,0,0,0,0
07292924,22,10,12,0,0,0,0,0,1
07293296,7,0,7,0,0,0,0,0,1
07293421,18,5,13,0,1,1,0,1,1
07293521,22,7,15,0,0,0,0,0,0
07293809,7,1,6,0,3,3,0,0,1
07293852,11,0,11,0,0,0,0,0,1
07294359,12,4,8,0,2,2,0,2,1
07294491,1,1,0,0,0,0,0,0,0
07294894,6,3,3,0,3,3,0,1,1
07295103,5,0,5,0,2,2,0,0,1
07295133,2,0,2,0,0,0,0,0,0
07295260,3,3,0,0,3,3,0,0,1
07295659,22,7,15,0,0,0,0,0,1
07295955,3,0,3,0,2,2,0,0,1
07297092,5,3,2,0,2,2,0,0,0
07297257,8,0,8,0,0,0,0,0,1
07297453,10,3,7,0,1,1,0,1,0
07297600,1,0,1,0,0,0,0,0,0
07297716,2,0,2,0,0,0,0,0,1
07297726,7,0,7,0,0,0,0,0,1
07298038,2,2,0,0,2,1,1,1,0
07298687,9,3,6,0,0,0,0,0,1
07298912,38,11,27,0,10,10,0,0,1
07299463,1,1,0,0,1,1,0,0,0
07299535,6,6,0,0,1,1,0,0,0
07300010,6,4,2,0,1,1,0,1,1
07300225,11,5,6,0,0,0,0,0,1
07300523,2,2,0,0,1,1,0,0,0
07300882,6,4,2,0,1,1,0,1,1
07301390,4,0,4,0,3,3,0,3,0
07301446,4,0,4,0,1,1,0,1,0
07301585,36,14,22,0,0,0,0,0,1
07301961,20,8,12,0,3,2,1,3,1
07302036,23,12,11,0,1,1,0,0,1
07302079,7,3,4,0,1,1,0,0,1
07302286,3,0,3,0,0,0,0,0,0
07302465,2,0,2,0,1,1,0,0,0
07302622,16,0,16,0,0,0,0,0,1
07303248,1,1,0,0,1,1,0,0,0
07303529,7,2,5,0,0,0,0,0,1
07303630,3,0,3,0,0,0,0,0,1
07303852,2,2,0,0,2,2,0,0,1
07304347,23,6,17,0,0,0,0,0,0
07304443,30,8,22,0,0,0,0,0,0
07304900,5,1,4,0,1,1,0,0,1
07305054,2,2,0,0,1,1,0,0,0
07305858,5,5,0,0,2,2,0,0,1
07305923,14,3,11,0,2,1,1,2,1
07306069,2,2,0,0,2,2,0,0,0
07306139,3,2,1,0,4,1,3,3,1
07306177,1,1,0,0,2,2,0,0,0
07306419,18,12,6,0,1,1,0,1,1
07306622,3,1,2,0,1,1,0,0,0
07306666,7,5,2,0,1,1,0,0,1
07307162,8,0,8,0,0,0,0,0,1
07307333,10,4,6,0,1,1,0,1,0
07307344,31,23,8,0,1,1,0,1,1
07307624,3,3,0,0,4,4,0,0,0
07307680,8,0,8,0,1,1,0,1,1
07307697,6,0,6,0,0,0,0,0,1
07307720,21,5,16,0,1,1,0,1,1
07308389,2,0,2,0,1,1,0,0,0
07308516,8,6,2,0,0,0,0,0,0
07308754,2,0,2,0,0,0,0,0,0
07308907,10,0,10,0,0,0,0,0,1
07308990,4,2,2,0,1,1,0,0,1
07309063,3,3,0,0,2,2,0,0,0
07309185,4,3,1,0,2,2,0,0,1
07309241,3,0,3,0,0,0,0,0,1
07309466,5,0,5,0,0,0,0,0,1
07309893,9,2,7,0,4,2,2,0,0
07310220,11,5,6,0,0,0,0,0,1
07310535,4,2,2,0,2,2,0,0,1
07310848,37,9,28,0,0,0,0,0,0
07311456,13,3,10,0,1,1,0,1,1
07311571,4,0,4,0,4,4,0,0,0
07311824,1,1,0,0,1,1,0,0,0
07312033,3,2,1,0,2,2,0,0,1
07312521,3,1,2,0,1,1,0,0,1
07312896,30,10,20,0,0,0,0,0,1
07312923,7,4,3,0,0,0,0,0,1
07313137,6,2,4,0,2,2,0,1,1
07313190,2,1,1,0,1,1,0,0,0
07313191,18,6,12,0,3,2,1,0,1
07313319,4,1,3,0,2,1,1,0,1
07314422,1,1,0,0,2,2,0,0,0
07314533,5,4,1,0,4,0,4,0,1
07314717,3,3,0,0,1,1,0,0,0
07314865,32,13,19,0,0,0,0,0,1
07314988,4,3,1,0,3,3,0,0,0
07315327,3,2,1,0,1,1,0,0,0
07315594,2,0,2,0,0,0,0,0,1
07315853,2,2,0,0,2,2,0,0,0
07315957,1,1,0,0,1,1,0,0,0
07316055,13,5,8,0,1,1,0,1,1
07316069,11,5,6,0,1,1,0,1,1
07316447,11,3,8,0,3,3,0,0,1
07316783,6,5,1,0,0,0,0,0,1
07316895,5,4,1,0,3,3,0,1,1
07317020,1,0,1,0,1,1,0,0,0
07317370,29,12,17,0,0,0,0,0,1
07317393,3,3,0,0,1,1,0,1,0
07317395,3,3,0,0,2,2,0,0,0
07317434,7,5,2,0,1,1,0,0,0
07317556,1,1,0,0,2,2,0,0,0
07317718,3,3,0,0,2,2,0,0,0
07317720,15,2,13,0,1,1,0,1,1
07317751,6,2,4,0,1,1,0,0,1
07317966,2,1,1,0,1,1,0,0,0
07318210,2,2,0,0,1,1,0,0,0
07318376,3,0,3,0,0,0,0,0,1
07319183,3,3,0,0,2,2,0,0,1
07319304,2,1,1,0,2,2,0,0,0
07319468,2,1,1,0,1,1,0,0,1
07319927,6,0,6,0,0,0,0,0,0
07320048,2,0,2,0,0,0,0,0,1
07320056,6,5,1,0,1,1,0,1,1
07320081,9,0,9,0,0,0,0,0,1
07320238,4,2,2,0,1,1,0,0,1
07320693,2,2,0,0,1,1,0,0,1
07320947,21,7,14,0,1,1,0,1,1
07321418,3,3,0,0,2,2,0,0,0
07321421,5,1,4,0,1,1,0,0,1
07321486,9,5,4,0,3,3,0,0,1
07321709,2,0,2,0,1,1,0,0,0
07321750,6,0,6,0,1,1,0,0,1
07321768,5,2,3,0,1,1,0,1,1
07321827,29,13,16,0,0,0,0,0,0
07321916,7,0,7,0,0,0,0,0,1
07321980,9,3,6,0,2,1,1,1,1
07322073,5,1,4,0,0,0,0,0,0
07322169,4,0,4,0,2,2,0,0,0
07322342,2,1,1,0,0,0,0,0,1
07322406,2,1,1,0,2,2,0,0,0
07322569,4,0,4,0,0,0,0,0,1
07322626,3,2,1,0,1,1,0,0,0
07322858,7,3,4,0,0,0,0,0,0
07322950,13,4,9,0,1,1,0,1,1
07323899,3,3,0,0,2,2,0,0,0
07324065,1,1,0,0,1,1,0,0,0
07324406,2,2,0,0,2,2,0,0,0
07324761,11,7,4,0,2,2,0,2,1
07325038,3,2,1,0,1,1,0,0,1
07325051,2,2,0,0,1,1,0,0,0
07325147,17,9,8,0,3,0,3,0,1
07325584,5,2,3,0,0,0,0,0,1
07326078,7,0,7,0,2,2,0,2,1
07327105,19,8,11,0,0,0,0,0,1
07327371,9,4,5,0,1,1,0,1,1
07327556,5,3,2,0,1,1,0,1,1
07327597,16,8,8,0,1,1,0,1,1
07327783,15,7,8,0,4,2,2,0,0
07327954,3,2,1,0,2,2,0,0,0
07328588,23,14,9,0,0,0,0,0,1
07328730,7,4,3,0,2,1,1,2,1
07329125,20,2,18,0,3,1,2,3,1
07329164,8,3,5,0,4,3,1,0,0
07329205,2,0,2,0,1,1,0,0,0
07329496,2,1,1,0,2,2,0,0,0
07329677,2,0,2,0,1,1,0,0,0
07329930,11,5,6,0,1,1,0,1,1
07330058,44,14,30,0,0,0,0,0,0
07330087,6,3,3,0,1,1,0,1,1
07330290,11,4,7,0,0,0,0,0,1
07331490,1,1,0,0,2,2,0,0,0
07331526,11,2,9,0,0,0,0,0,0
07331869,12,6,6,0,3,2,1,3,1
07331936,7,2,5,1,0,0,0,0,1
07331961,13,4,9,0,1,1,0,1,0
07331966,7,2,5,1,0,0,0,0,1
07332395,9,2,7,0,2,1,1,2,1
07333089,17,9,8,0,3,3,0,0,0
07333127,3,0,3,0,0,0,0,0,0
07334026,10,6,4,0,2,1,1,2,0
07334069,3,2,1,0,1,1,0,0,0
07334784,2,1,1,0,1,1,0,0,0
07335019,6,3,3,0,2,1,1,0,0
07335106,1,1,0,0,1,1,0,0,1
07335368,2,0,2,0,2,2,0,0,0
07335662,1,1,0,0,1,1,0,0,0
07336115,8,2,6,0,1,1,0,1,1
07336254,15,0,15,0,0,0,0,0,0
07336373,4,2,2,0,3,1,2,1,1
07336521,1,0,1,0,0,0,0,0,1
07336748,6,0,6,0,0,0,0,0,1
07337006,4,3,1,0,1,1,0,0,0
07337220,10,4,6,0,0,0,0,0,1
07337291,8,5,3,0,1,1,0,1,0
07337824,3,3,0,0,2,2,0,1,1
07338027,1,1,0,0,1,1,0,0,1
07338180,1,0,1,0,1,1,0,0,0
07338658,7,3,4,0,1,1,0,0,0
07338685,4,4,0,0,2,2,0,0,1
07338749,4,0,4,0,0,0,0,0,1
07339088,3,0,3,0,1,0,1,0,0
07339491,5,0,5,0,0,0,0,0,1
07339929,1,1,0,0,1,1,0,0,0
04926092,12,7,5,0,1,1,0,0,1
04926093,15,9,6,0,1,1,0,1,1
04926144,4,2,2,0,1,1,0,0,1
04926346,3,1,2,0,2,2,0,0,0
04926427,4,2,2,0,1,1,0,0,0
04926931,17,4,13,0,1,1,0,1,1
04927383,15,0,15,0,0,0,0,0,1
04927467,10,3,7,0,1,1,0,1,1
04927584,5,0,5,0,0,0,0,0,1
04927593,7,4,3,0,1,1,0,0,0
04928171,8,1,7,0,2,2,0,0,1
04928252,6,4,2,0,2,2,0,0,1
04928571,25,11,14,0,2,1,1,0,0
04928733,34,9,25,0,0,0,0,0,0
04929194,6,2,4,0,1,1,0,0,0
04929486,29,3,26,0,1,1,0,1,1
04929860,58,0,58,0,2,2,0,2,1
04929976,6,2,4,0,1,1,0,0,1
04929982,9,3,6,0,2,2,0,1,1
04930050,11,0,11,1,0,0,0,0,1
04930071,5,2,3,0,1,1,0,0,1
04930107,4,2,2,0,1,1,0,0,1
04930275,7,2,5,0,1,1,0,0,0
04930298,8,2,6,0,1,1,0,0,1
04930349,4,4,0,0,1,1,0,0,1
04930461,26,7,19,0,0,0,0,0,1
04930511,11,3,8,0,1,1,0,1,1
04930714,14,1,13,0,1,1,0,1,1
04930895,5,2,3,0,1,1,0,0,0
04930926,30,14,16,0,0,0,0,0,1
04931030,9,5,4,0,1,1,0,1,1
04931031,75,18,57,0,0,0,0,0,1
04931164,12,0,12,0,0,0,0,0,1
04931348,15,0,15,0,0,0,0,0,1
04931627,5,4,1,0,3,3,0,0,0
04931679,22,15,7,0,2,2,0,1,1
04931683,3,1,2,0,1,1,0,0,0
04931823,5,3,2,0,2,2,0,0,0
04932271,17,3,14,0,1,1,0,1,1
04932349,7,0,7,0,0,0,0,0,1
04932509,2,1,1,0,1,1,0,0,0
04932863,6,1,5,0,1,1,0,1,1
04933096,7,1,6,0,1,1,0,0,1
04933185,9,0,9,0,1,1,0,1,1
04933369,10,2,8,0,2,1,1,1,1
04933371,7,1,6,0,1,1,0,1,1
04933534,5,0,5,0,0,0,0,0,1
04933580,4,0,4,0,1,1,0,0,1
04933827,8,0,8,0,0,0,0,0,1
04934120,3,2,1,0,1,1,0,0,0
04934182,6,0,6,0,0,0,0,0,1
04934243,17,2,15,0,0,0,0,0,1
04934809,8,0,8,0,1,1,0,1,1
04934814,45,0,45,0,0,0,0,0,1
04934863,12,5,7,0,3,3,0,0,0
04934899,13,8,5,0,6,5,1,0,1
04935127,13,0,13,0,0,0,0,0,1
04935471,18,0,18,0,0,0,0,0,1
04935658,27,3,24,0,1,1,0,1,1
04935737,4,2,2,0,1,1,0,0,0
04935972,5,0,5,0,0,0,0,0,1
04936146,11,5,6,0,1,1,0,1,1
04936153,11,5,6,0,1,1,0,1,1
04936260,7,2,5,0,2,2,0,2,1
04936643,11,5,6,0,1,1,0,1,1
04936660,11,0,11,0,0,0,0,0,1
04936736,10,4,6,0,0,0,0,0,1
04936788,5,2,3,0,1,1,0,0,0
04937256,27,7,20,0,0,0,0,0,0
04937472,5,2,3,0,0,0,0,0,1
04937639,9,6,3,0,2,2,0,0,1
04937661,16,3,13,0,1,1,0,1,1
04937693,5,3,2,0,2,2,0,0,0
04937754,7,0,7,0,0,0,0,0,1
04937844,4,1,3,0,1,1,0,0,1
04937900,5,0,5,0,1,1,0,0,0
04938028,5,1,4,0,1,1,0,0,0
04938224,11,5,6,0,1,1,0,1,1
04938303,18,6,12,0,2,1,1,2,1
04938403,60,0,60,0,1,1,0,0,1
04938664,6,0,6,0,0,0,0,0,0
04938801,9,3,6,0,1,1,0,1,1
04938963,13,8,5,0,6,5,1,0,1
04938971,13,8,5,0,6,5,1,0,1
04939147,13,5,8,0,2,2,0,0,1
04939285,12,3,9,0,1,1,0,1,1
04939322,6,3,3,0,1,1,0,1,0
04939524,5,3,2,0,2,2,0,0,0
04940075,5,0,5,0,1,1,0,1,1
04940419,5,0,5,0,0,0,0,0,1
04941112,14,5,9,0,5,4,1,0,1
04941337,5,1,4,0,2,2,0,0,1
04941364,6,0,6,0,0,0,0,0,0
04941616,15,5,10,0,0,0,0,0,1
04941979,10,3,7,0,1,1,0,1,1
04942001,10,3,7,0,2,1,1,2,1
04942090,18,6,12,0,0,0,0,0,1
04942536,9,3,6,0,1,1,0,1,1
04942956,8,3,5,0,1,1,0,0,0
04943245,13,4,9,0,1,1,0,1,1
04943684,12,5,7,0,1,1,0,0,1
04943917,3,0,3,0,1,1,0,1,1
04944046,9,4,5,0,2,2,0,0,1
04944059,7,4,3,0,1,1,0,0,1
04944097,4,2,2,0,1,1,0,0,0
04944176,21,8,13,0,0,0,0,0,0
04944329,7,2,5,0,1,1,0,0,1
04944331,8,3,5,0,2,2,0,0,1
04944337,9,0,9,0,0,0,0,0,1
04944344,24,3,21,0,0,0,0,0,0
04944546,19,2,17,0,0,0,0,0,1
04944833,6,0,6,0,0,0,0,0,0
04944887,4,0,4,0,2,2,0,0,1
04946051,17,5,12,0,1,1,0,1,1
04946121,14,3,11,0,0,0,0,0,0
04946137,6,3,3,0,2,2,0,0,1
04946791,6,0,6,0,2,2,0,0,1
04946965,9,2,7,0,0,0,0,0,1
04947076,4,1,3,0,0,0,0,0,0
04947328,11,7,4,0,2,1,1,1,1
04947618,9,4,5,0,1,1,0,1,1
04947884,9,2,7,0,0,0,0,0,1
04947999,12,0,12,0,0,0,0,0,1
04948078,28,8,20,0,0,0,0,0,1
04948126,9,3,6,0,1,1,0,1,0
04948353,5,3,2,0,2,2,0,0,0
04948493,5,3,2,0,2,2,0,0,1
04948518,6,1,5,0,1,1,0,0,1
04948542,12,1,11,0,1,1,0,0,1
04948632,18,4,14,0,2,1,1,1,1
04948846,85,12,73,0,1,1,0,1,1
04949032,15,2,13,0,1,1,0,1,1
04949219,3,3,0,0,1,1,0,0,0
04949259,20,5,15,0,2,2,0,2,0
04949874,8,0,8,0,0,0,0,0,1
04950173,12,1,11,0,1,1,0,0,1
04950282,5,1,4,0,1,1,0,0,1
04950376,10,0,10,0,0,0,0,0,1
04950453,12,2,10,0,2,2,0,2,1
04950454,12,2,10,0,1,1,0,1,1
04950734,7,4,3,0,1,1,0,0,1
04951177,6,4,2,0,3,3,0,0,0
04951257,0,0,0,0,0,0,0,0,1
04951291,4,2,2,0,2,2,0,0,0
04951344,5,3,2,0,2,1,1,0,0
04951490,14,3,11,0,1,1,0,1,0
04951507,13,0,13,0,0,0,0,0,1
04951578,7,2,5,0,2,2,0,0,1
04952162,5,3,2,0,2,2,0,0,0
04952211,8,2,6,0,1,1,0,1,1
04952236,12,3,9,0,0,0,0,0,1
04952239,8,2,6,0,0,0,0,0,1
04952586,15,4,11,0,0,0,0,0,1
04952611,4,0,4,0,1,1,0,0,1
04952613,4,0,4,0,0,0,0,0,0
04952640,6,0,6,0,0,0,0,0,1
04952858,7,0,7,0,1,1,0,0,1
04953529,6,2,4,0,1,1,0,1,0
04953960,25,0,25,0,0,0,0,0,1
04954170,14,2,12,0,1,1,0,1,1
04954436,10,4,6,0,1,1,0,1,1
04954520,4,3,1,0,1,1,0,0,0
04954996,6,0,6,0,0,0,0,0,1
04955172,30,7,23,0,0,0,0,0,0
04955177,8,0,8,0,1,1,0,1,1
04955221,12,2,10,0,1,1,0,1,1
04955227,7,3,4,0,2,2,0,0,1
04955302,18,4,14,0,1,1,0,1,1
04955356,26,3,23,0,1,1,0,1,1
04955546,4,1,3,0,1,1,0,0,0
04955944,9,6,3,0,3,1,2,1,0
04956170,24,0,24,0,1,1,0,1,1
04956435,15,3,12,0,1,1,0,1,1
04956725,4,3,1,0,2,2,0,0,0
04956739,4,3,1,0,2,2,0,0,0
04957103,5,0,5,0,1,1,0,0,0
04957131,33,7,26,0,1,1,0,1,1
04957159,9,4,5,0,1,1,0,1,1
04957252,5,3,2,0,1,1,0,1,1
04957706,41,10,31,0,0,0,0,0,1
04957966,19,9,10,0,0,0,0,0,0
04958152,22,4,18,0,1,1,0,1,1
04958289,15,4,11,0,1,1,0,1,1
04958401,13,3,10,0,0,0,0,0,1
04958555,5,0,5,0,1,1,0,0,0
04958710,4,0,4,0,0,0,0,0,0
04958897,6,2,4,0,2,2,0,0,0
04959016,10,0,10,0,0,0,0,0,1
04959031,9,3,6,0,1,1,0,1,1
04959175,5,0,5,0,1,1,0,0,1
04959308,5,3,2,0,1,1,0,0,1
04959332,5,0,5,0,0,0,0,0,1
04959394,20,5,15,0,1,1,0,1,1
04959428,26,5,21,0,2,2,0,2,1
04959445,38,7,31,0,0,0,0,0,1
04959825,9,4,5,0,0,0,0,0,0
04959893,7,3,4,0,1,1,0,1,1
04960054,19,5,14,0,7,5,2,0,1
04960644,4,2,2,0,1,1,0,0,0
04960934,6,1,5,0,1,1,0,0,0
04961043,16,4,12,0,1,1,0,1,0
04961135,5,0,5,0,0,0,0,0,0
04961302,152,3,149,0,1,1,0,1,1
04961513,7,0,7,0,1,1,0,1,0
04961564,5,3,2,0,3,3,0,0,1
04961635,35,5,30,0,1,1,0,1,1
04961944,5,3,2,0,2,2,0,0,0
04961988,12,3,9,0,5,2,3,0,1
04962066,16,0,16,0,1,1,0,1,1
04962402,8,4,4,0,2,2,0,0,1
04963348,7,4,3,0,3,2,1,0,1
04963377,23,2,21,0,1,1,0,1,1
04963469,18,8,10,0,0,0,0,0,1
04963890,8,0,8,0,0,0,0,0,1
04964111,4,1,3,0,1,1,0,0,1
04964424,30,10,20,0,0,0,0,0,1
04964441,9,2,7,0,1,1,0,1,1
04964578,6,5,1,0,0,0,0,0,0
04965297,8,4,4,0,3,3,0,1,1
04965511,6,2,4,0,1,1,0,1,0
04965680,13,0,13,0,0,0,0,0,1
04966087,22,5,17,0,1,1,0,1,1
04966206,22,0,22,0,0,0,0,0,1
04966253,5,3,2,0,2,1,1,0,0
04966845,12,5,7,0,1,1,0,0,1
04967001,41,11,30,0,0,0,0,0,1
04967104,50,0,50,0,0,0,0,0,1
04967242,16,3,13,0,1,1,0,1,1
04967898,5,2,3,0,1,1,0,0,1
04968045,17,3,14,0,1,1,0,1,1
04968528,9,1,8,0,2,2,0,0,1
04968613,7,3,4,0,1,1,0,0,0
04968889,17,5,12,0,1,1,0,1,1
04969045,5,1,4,0,0,0,0,0,1
04969061,4,0,4,0,0,0,0,0,1
04969335,6,0,6,0,0,0,0,0,1
04969696,8,2,6,0,0,0,0,0,1
04970134,6,4,2,0,2,2,0,0,0
04970419,11,2,9,0,1,1,0,1,1
04970968,15,8,7,0,1,1,0,1,1
04971210,10,2,8,0,1,1,0,1,1
04971228,5,3,2,0,0,0,0,0,0
04971387,9,0,9,0,0,0,0,0,1
04971425,12,0,12,0,0,0,0,0,1
04971742,2,0,2,0,1,1,0,0,1
04971831,8,0,8,0,1,1,0,0,1
04972036,7,0,7,0,1,1,0,1,1
04972168,14,0,14,0,0,0,0,0,1
04972305,3,0,3,0,0,0,0,0,1
04972342,5,2,3,0,1,1,0,0,1
04972971,9,2,7,0,1,1,0,0,0
04973117,13,6,7,0,2,1,1,2,1
04973132,26,3,23,0,1,1,0,1,1
04973215,5,3,2,0,2,2,0,0,0
04973500,12,4,8,0,1,1,0,1,1
04974437,9,3,6,0,1,1,0,0,0
04974517,8,0,8,0,0,0,0,0,1
04974554,43,15,28,0,1,1,0,0,1
04974663,5,0,5,0,0,0,0,0,1
04974787,8,2,6,0,0,0,0,0,1
04974917,11,8,3,0,0,0,0,0,0
04975261,5,0,5,0,0,0,0,0,1
04975428,12,8,4,0,2,1,1,1,1
04975638,6,4,2,0,1,1,0,1,0
SC550084,3,2,1,0,1,1,0,1,1
SC550109,2,0,2,0,2,1,1,0,0
SC550153,2,2,0,0,2,2,0,0,0
SC550320,6,2,4,0,2,1,1,1,1
SC550322,2,2,0,0,2,2,0,0,1
SC550453,1,1,0,0,0,0,0,0,0
SC550717,1,0,1,0,1,1,0,0,0
SC550819,1,1,0,0,1,1,0,0,0
SC550844,3,0,3,0,0,0,0,0,0
SC550995,2,2,0,0,2,2,0,0,0
SC551197,4,4,0,0,3,3,0,1,1
SC551210,1,1,0,0,1,1,0,0,0
SC551217,1,0,1,0,1,1,0,0,1
SC551300,2,2,0,0,2,2,0,0,1
SC551313,12,12,0,0,0,0,0,0,0
SC551380,2,0,2,0,1,1,0,1,1
SC551405,6,4,2,0,1,1,0,1,1
SC551423,1,1,0,0,2,2,0,0,0
SC551436,2,0,2,0,1,1,0,0,1
SC551716,6,4,2,0,0,0,0,0,0
SC551758,1,1,0,0,1,1,0,0,0
SC552039,12,6,6,0,0,0,0,0,0
SC552067,1,0,1,0,1,1,0,0,0
SC552179,2,0,2,0,1,1,0,1,1
SC552369,5,4,1,0,3,2,1,0,1
SC552878,5,1,4,0,2,1,1,1,0
SC552930,1,1,0,0,0,0,0,0,0
SC552934,1,1,0,0,1,1,0,0,0
SC552975,1,1,0,0,1,1,0,0,0
SC553114,3,0,3,0,2,2,0,0,0
SC553564,1,1,0,0,1,1,0,0,0
SC553567,1,0,1,0,1,1,0,0,0
SC553670,1,0,1,0,1,1,0,0,0
SC553714,1,1,0,0,1,1,0,0,0
SC553922,3,0,3,0,0,0,0,0,0
SC553945,3,3,0,0,3,1,2,3,0
SC554125,2,0,2,0,2,2,0,0,0
SC554195,5,4,1,0,1,1,0,0,1
SC554464,1,1,0,0,1,1,0,0,0
SC554531,1,0,1,0,1,1,0,0,0
SC554745,2,1,1,0,2,1,1,0,0
SC554942,1,1,0,0,1,1,0,0,0
SC555117,4,3,1,0,1,1,0,1,0
SC555367,1,1,0,0,1,1,0,0,0
SC555404,2,2,0,0,1,1,0,0,0
SC555463,1,1,0,0,0,0,0,0,0
SC555518,3,2,1,0,1,1,0,0,0
SC555528,2,0,2,0,1,0,1,0,0
SC555572,1,1,0,0,1,1,0,0,1
SC555814,1,1,0,0,1,1,0,0,0
SC555892,3,2,1,0,3,1,2,0,0
SC555963,2,1,1,0,3,3,0,0,0
SC556016,2,0,2,0,0,0,0,0,0
SC556380,1,1,0,0,1,1,0,0,0
SC556550,2,2,0,0,0,0,0,0,0
SC556689,2,0,2,0,1,1,0,0,0
SC556730,1,1,0,0,1,1,0,0,0
SC556775,2,0,2,0,0,0,0,0,0
SC556882,4,4,0,0,0,0,0,0,0
SC557125,2,1,1,0,2,1,1,0,0
SC557178,4,4,0,0,3,3,0,1,1
SC557268,2,2,0,0,2,2,0,0,0
SC557284,1,1,0,0,1,1,0,0,0
SC557296,4,0,4,0,0,0,0,0,0
SC557502,3,1,2,0,2,1,1,2,1
SC557512,2,2,0,0,1,1,0,0,0
SC557592,1,0,1,0,1,1,0,0,0
SC557595,12,9,3,0,0,0,0,0,0
SC557947,1,1,0,0,2,1,1,0,0
SC557949,2,0,2,0,0,0,0,0,0
SC557976,2,2,0,0,2,2,0,0,0
SC558046,2,2,0,0,1,1,0,0,1
SC558096,1,1,0,0,1,1,0,0,0
SC558227,1,1,0,0,1,1,0,0,0
SC558249,2,2,0,0,2,2,0,0,0
SC558789,1,1,0,0,2,2,0,0,0
SC558935,1,1,0,0,0,0,0,0,0
SC559021,7,6,1,0,0,0,0,0,1
SC559028,1,1,0,0,1,1,0,0,0
SC559139,5,3,2,0,3,1,2,0,0
SC559219,2,2,0,0,2,2,0,0,0
SC559403,2,2,0,0,2,2,0,0,0
SC559641,5,4,1,0,3,2,1,0,0
SC559759,2,1,1,0,2,1,1,0,0
SC559781,1,1,0,0,1,1,0,0,0
SC559811,3,0,3,0,2,2,0,0,1
SC559916,1,1,0,0,1,1,0,0,0
SC559962,1,1,0,0,1,1,0,0,0
SC559971,2,2,0,0,2,2,0,0,0
SC560117,3,3,0,0,2,2,0,0,0
SC560597,1,1,0,0,1,1,0,0,0
SC560623,2,2,0,0,2,2,0,0,0
SC560843,2,2,0,0,1,1,0,0,0
SC561107,1,1,0,0,1,1,0,0,0
SC561189,3,3,0,0,3,3,0,1,0
SC561243,1,0,1,0,1,1,0,0,0
SC561301,1,1,0,0,1,1,0,0,0
SC561544,2,0,2,0,0,0,0,0,0
SC561642,3,3,0,0,1,1,0,0,0
SC561683,2,2,0,0,2,2,0,0,0
SC561968,1,1,0,0,1,1,0,0,0
SC562023,1,1,0,0,1,1,0,0,1
SC562575,1,1,0,0,1,1,0,0,0
SC562586,1,1,0,0,1,1,0,0,0
SC562669,2,2,0,0,2,2,0,0,0
SC562799,3,3,0,0,3,3,0,0,0
SC562874,2,2,0,0,1,1,0,0,1
SC563149,3,2,1,0,2,1,1,2,0
SC563185,1,1,0,0,1,1,0,0,0
SC563213,1,1,0,0,1,1,0,0,0
SC563277,2,2,0,0,1,1,0,0,0
SC563463,9,6,3,0,0,0,0,0,0
SC563473,2,2,0,0,2,2,0,0,0
SC563520,1,1,0,0,1,1,0,0,0
SC563617,1,0,1,0,1,1,0,0,0
SC563835,2,2,0,0,1,1,0,0,0
SC563849,2,0,2,0,0,0,0,0,0
SC564171,1,1,0,0,1,1,0,0,0
SC564218,2,1,1,0,2,2,0,0,0
SC564243,2,0,2,0,1,1,0,0,0
SC564743,2,2,0,0,1,1,0,0,1
SC564854,2,2,0,0,1,1,0,0,0
SC564941,1,1,0,0,1,1,0,0,0
SC564966,1,1,0,0,1,1,0,0,0
SC565078,1,1,0,0,1,1,0,0,0
SC565106,18,12,6,0,4,1,3,0,0
SC565115,2,2,0,0,1,1,0,0,0
SC565290,1,0,1,0,1,1,0,0,0
SC565389,1,1,0,0,1,1,0,0,0
SC565506,8,6,2,0,0,0,0,0,0
SC565590,1,1,0,0,1,1,0,0,0
SC565638,3,3,0,0,3,3,0,0,0
SC565646,2,2,0,0,2,2,0,0,0
SC565726,1,1,0,0,1,1,0,0,0
SC565817,2,2,0,0,1,1,0,0,1
SC565835,2,2,0,0,0,0,0,0,0
SC565942,1,1,0,0,1,1,0,0,0
SC565986,3,3,0,0,2,2,0,0,0
SC566103,3,3,0,0,4,4,0,0,0
SC566294,1,1,0,0,1,1,0,0,0
SC566911,2,2,0,0,2,2,0,0,0
SC567005,11,8,3,0,0,0,0,0,0
SC567110,1,1,0,0,1,1,0,0,0
SC567303,1,0,1,0,1,1,0,0,0
SC567334,4,4,0,0,2,2,0,0,0
SC567454,1,1,0,0,1,1,0,0,0
SC567890,1,0,1,0,1,0,1,0,0
SC568158,2,0,2,0,1,1,0,1,1
SC568165,2,0,2,0,1,1,0,1,1
SC568260,4,4,0,0,1,1,0,1,1
SC568355,1,0,1,0,1,1,0,0,0
SC568362,2,2,0,0,2,2,0,0,0
SC568388,1,1,0,0,1,1,0,0,0
SC568408,7,3,4,0,0,0,0,0,0
SC568584,1,0,1,0,1,1,0,0,0
SC568933,3,3,0,0,2,2,0,0,0
SC569009,1,1,0,0,1,1,0,0,0
SC569029,2,2,0,0,1,1,0,0,0
SC569205,2,2,0,0,3,3,0,0,0
SC569209,2,2,0,0,1,1,0,0,0
SC569251,1,0,1,0,0,0,0,0,0
SC569258,1,0,1,0,1,1,0,0,0
SC569463,2,2,0,0,2,2,0,2,1
SC569701,2,2,0,0,1,1,0,1,0
SC569776,2,2,0,0,2,2,0,0,0
SC570160,3,3,0,0,1,1,0,1,1
SC570172,3,3,0,0,2,2,0,2,0
SC570269,2,2,0,0,2,2,0,0,0
SC570937,1,1,0,0,1,1,0,0,0
SC571086,3,3,0,0,1,1,0,0,1
SC571609,2,2,0,0,1,1,0,0,0
SC571709,3,3,0,0,4,4,0,1,1
SC571730,2,2,0,0,2,2,0,0,0
SC571773,2,2,0,0,2,2,0,0,0
SC571776,4,4,0,0,0,0,0,0,0
SC572046,2,2,0,0,1,1,0,0,0
SC572068,2,0,2,0,1,1,0,0,0
SC572202,3,3,0,0,4,4,0,0,0
SC572424,1,1,0,0,1,1,0,0,0
SC572507,4,4,0,0,0,0,0,0,1
SC572840,2,2,0,0,1,1,0,0,0
SC572868,2,2,0,0,2,1,1,2,0
SC572927,1,1,0,0,1,1,0,0,0
SC573238,5,5,0,0,0,0,0,0,0
SC573388,5,4,1,0,1,0,1,0,1
SC573492,5,5,0,0,0,0,0,0,0
SC573901,1,1,0,0,1,1,0,0,0
SC573949,1,1,0,0,1,1,0,0,0
SC574003,1,1,0,0,1,1,0,0,0
SC574010,1,1,0,0,1,1,0,0,0
SC574020,1,1,0,0,1,1,0,0,0
SC574401,3,1,2,0,2,1,1,0,0
SC574726,1,0,1,0,1,1,0,0,0
SC574870,1,1,0,0,1,1,0,0,0
SC575001,1,1,0,0,2,2,0,0,0
SC575089,1,1,0,0,1,1,0,0,0
SC575141,1,1,0,0,1,1,0,0,0
SC575207,3,3,0,0,1,1,0,1,1
SC575254,2,2,0,0,0,0,0,0,0
SC575445,1,0,1,0,1,1,0,0,0
SC575648,3,2,1,0,1,1,0,0,0
SC575787,4,4,0,0,0,0,0,0,0
SC575930,2,2,0,0,1,1,0,0,0
SC576111,2,2,0,0,2,2,0,0,1
SC576184,1,1,0,0,1,1,0,1,1
SC576213,1,1,0,0,1,1,0,0,0
SC576272,9,9,0,0,1,1,0,1,1
SC576450,2,2,0,0,2,2,0,0,0
SC576509,4,4,0,0,1,1,0,0,0
SC576654,2,2,0,0,2,2,0,0,0
SC576707,4,1,3,0,2,1,1,1,0
SC577073,1,1,0,0,1,1,0,0,0
SC577168,1,0,1,0,1,1,0,0,0
SC577236,2,2,0,0,1,1,0,0,0
SC577485,1,1,0,0,1,1,0,0,0
SC577558,1,1,0,0,1,1,0,0,0
SC577598,1,1,0,0,1,1,0,0,0
SC577640,4,4,0,0,1,1,0,1,1
SC577717,3,2,1,0,3,2,1,0,0
SC577962,1,1,0,0,1,1,0,0,1
SC578062,1,0,1,0,1,1,0,0,0
SC578105,1,1,0,0,1,1,0,0,0
SC578124,2,2,0,0,2,2,0,0,0
SC578145,1,1,0,0,1,1,0,0,0
SC578367,2,1,1,0,2,1,1,0,0
SC578553,2,2,0,0,1,1,0,0,1
SC578778,3,2,1,0,5,4,1,1,1
SC578898,9,7,2,0,0,0,0,0,0
SC578942,7,5,2,0,2,2,0,0,0
SC579175,2,2,0,0,2,2,0,0,0
SC579194,1,1,0,0,1,1,0,0,0
SC579213,3,2,1,0,2,1,1,0,1
SC579238,1,1,0,0,0,0,0,0,0
SC579293,4,4,0,0,0,0,0,0,0
SC579338,2,2,0,0,1,1,0,0,0
SC579379,1,1,0,0,1,1,0,0,0
SC579419,3,3,0,0,3,3,0,0,0
SC579591,2,0,2,0,0,0,0,0,0
SC579689,1,1,0,0,1,1,0,0,0
SC579830,1,0,1,0,1,1,0,0,0
SC579855,3,2,1,0,1,1,0,0,0
SC579925,1,0,1,0,1,1,0,0,0
SC580219,1,1,0,0,1,1,0,0,0
SC580297,5,5,0,0,3,1,2,1,1
SC580344,2,2,0,0,2,2,0,0,0
SC580510,11,10,1,0,0,0,0,0,0
SC580834,4,3,1,0,2,1,1,0,0
SC580959,2,2,0,0,2,2,0,0,0
SC581008,2,2,0,0,3,3,0,1,0
SC581044,7,7,0,0,0,0,0,0,1
SC581134,2,2,0,0,2,2,0,0,0
SC581205,2,1,1,0,2,1,1,0,0
SC581263,1,1,0,0,1,1,0,0,0
SC581271,1,1,0,0,1,1,0,0,0
SC581402,1,1,0,0,1,1,0,0,0
SC581439,1,0,1,0,1,1,0,0,0
SC581539,4,2,2,0,3,1,2,0,0
SC581634,2,2,0,0,2,2,0,0,0
SC581845,5,4,1,0,2,2,0,0,1
SC582043,2,2,0,0,2,2,0,0,0
SC582091,2,2,0,0,0,0,0,0,0
SC582181,1,1,0,0,1,1,0,0,1
SC582254,1,1,0,0,1,1,0,0,0
SC582342,1,1,0,0,1,1,0,0,0
SC582530,1,1,0,0,1,1,0,0,0
SC582544,1,1,0,0,1,1,0,0,0
SC582737,3,2,1,0,1,1,0,0,0
SC582936,4,4,0,0,1,1,0,1,0
SC583058,1,1,0,0,1,1,0,0,0
SC583273,1,1,0,0,1,1,0,0,0
SC583547,2,2,0,0,0,0,0,0,0
SC583812,2,2,0,0,1,1,0,1,1
SC583939,6,3,3,0,2,2,0,0,1
SC584128,2,2,0,0,1,1,0,0,0
SC584313,1,1,0,0,1,1,0,0,0
SC584497,1,1,0,0,1,1,0,1,0
SC584722,2,2,0,0,1,1,0,0,0
SC584821,4,3,1,0,0,0,0,0,0
SC584924,1,1,0,0,1,1,0,0,0
SC585011,4,4,0,0,0,0,0,0,1
SC585030,1,1,0,0,1,1,0,0,1
SC585106,1,1,0,0,1,1,0,0,0
SC585166,1,0,1,0,1,1,0,0,1
SC585219,1,1,0,0,1,1,0,0,0
SC585408,1,1,0,0,1,1,0,0,0
SC585455,9,6,3,0,0,0,0,0,1
SC585764,1,0,1,0,1,1,0,0,0
SC585951,1,1,0,0,1,1,0,0,0
SC585968,1,1,0,0,1,1,0,0,0
SC585981,1,1,0,0,0,0,0,0,0
SC586069,2,2,0,0,2,1,1,1,1
SC586197,4,3,1,0,1,1,0,0,1
SC586337,1,1,0,0,1,1,0,0,0
SC586351,1,1,0,0,1,1,0,0,1
SC586413,1,1,0,0,1,1,0,0,0
SC586435,1,1,0,0,1,1,0,0,0
SC586843,1,1,0,0,1,1,0,0,0
SC586899,2,1,1,0,2,1,1,0,0
SC587170,1,1,0,0,1,1,0,0,0
SC587203,1,1,0,0,0,0,0,0,0
SC587245,3,3,0,0,2,2,0,0,0
SC587254,2,1,1,0,0,0,0,0,0
SC587576,2,2,0,0,2,2,0,0,0
SC587577,1,1,0,0,1,1,0,0,0
SC588000,1,1,0,0,1,1,0,0,0
SC588006,1,1,0,0,1,1,0,0,0
SC588163,1,1,0,0,0,0,0,0,0
SC588444,1,0,1,0,1,1,0,0,0
SC588522,1,1,0,0,1,1,0,0,0
SC588875,3,3,0,0,1,1,0,1,1
09466013,13,0,13,0,1,1,0,1,0
09466078,2,2,0,0,1,1,0,1,0
09466094,2,2,0,0,1,1,0,0,0
09466352,1,0,1,0,1,1,0,0,0
09466387,2,1,1,0,1,1,0,0,0
09466420,1,1,0,0,1,1,0,0,0
09466423,4,2,2,0,1,1,0,0,0
09466430,4,3,1,0,2,2,0,0,1
09466774,1,1,0,0,1,1,0,0,0
09467234,3,3,0,0,3,3,0,0,0
09467241,9,2,7,0,1,1,0,1,1
09467348,7,2,5,0,3,1,2,2,1
09467440,3,3,0,0,1,1,0,0,0
09467592,1,1,0,0,1,1,0,0,0
09467869,4,2,2,0,1,1,0,0,1
09468390,1,1,0,0,1,1,0,0,0
09468829,1,0,1,0,1,1,0,0,0
09469009,5,0,5,0,2,2,0,2,1
09469091,2,2,0,0,2,2,0,0,0
09469336,2,1,1,0,1,1,0,0,1
09469356,3,2,1,0,1,1,0,0,1
09469380,5,3,2,0,1,1,0,1,1
09470135,1,0,1,0,0,0,0,0,0
09470167,2,2,0,0,0,0,0,0,0
09470192,2,2,0,0,2,2,0,0,0
09470229,16,9,7,0,0,0,0,0,0
09470658,2,0,2,0,0,0,0,0,1
09470858,1,0,1,0,0,0,0,0,1
09471328,2,2,0,0,2,2,0,0,0
09471458,2,2,0,0,1,1,0,0,0
09471465,2,2,0,0,2,2,0,0,0
09471468,7,7,0,0,2,2,0,2,1
09471712,3,3,0,0,5,2,3,2,0
09472272,5,5,0,0,5,5,0,0,0
09472387,10,7,3,0,0,0,0,0,0
09472432,1,1,0,0,1,1,0,0,0
09472918,3,3,0,0,1,1,0,1,1
09473005,6,4,2,0,0,0,0,0,0
09473045,1,0,1,0,0,0,0,0,0
09473207,1,1,0,0,1,1,0,0,0
09473370,2,1,1,0,2,2,0,0,0
09473828,1,1,0,0,1,1,0,0,0
09474000,4,3,1,0,0,0,0,0,1
09474199,5,5,0,0,5,5,0,0,0
09474326,1,1,0,0,1,1,0,0,0
09474500,12,8,4,0,0,0,0,0,0
09474525,1,0,1,0,0,0,0,0,0
09474581,2,2,0,0,2,2,0,0,0
09474833,5,0,5,0,3,1,2,1,1
09475195,5,2,3,1,3,3,0,1,0
09475226,1,0,1,0,1,1,0,0,0
09475227,5,2,3,1,3,3,0,1,0
09475304,5,2,3,1,3,3,0,1,0
09476105,6,3,3,0,3,3,0,0,0
09476185,1,1,0,0,1,1,0,0,0
09476216,7,7,0,0,1,1,0,1,0
09476227,4,4,0,0,1,1,0,0,0
09476534,1,1,0,0,1,1,0,0,1
09476932,3,0,3,0,1,1,0,0,0
09477037,2,2,0,0,2,2,0,0,0
09477131,2,2,0,0,1,1,0,0,0
09477214,3,3,0,0,2,2,0,0,1
09477534,1,1,0,0,1,1,0,0,0
09477566,1,1,0,0,1,1,0,0,0
09478011,10,1,9,0,1,1,0,1,1
09479246,2,2,0,0,2,2,0,0,0
09479417,4,3,1,0,2,1,1,0,1
09479587,3,2,1,0,1,1,0,0,1
09479677,2,0,2,0,1,1,0,0,0
09479845,2,1,1,0,2,2,0,1,0
09480128,2,2,0,0,1,1,0,0,0
09480152,1,1,0,0,1,1,0,0,0
09480481,1,1,0,0,2,2,0,1,0
09480591,1,1,0,0,1,1,0,0,0
09480685,1,1,0,0,1,1,0,0,0
09481073,6,3,3,0,0,0,0,0,1
09481079,7,7,0,0,0,0,0,0,1
09481161,12,10,2,0,2,1,1,2,1
09481183,4,3,1,0,2,1,1,0,1
09481496,4,4,0,0,0,0,0,0,1
09481995,1,1,0,0,1,1,0,0,0
09482034,5,4,1,0,1,1,0,0,1
09482038,5,4,1,0,1,1,0,0,1
09482179,5,3,2,0,1,1,0,0,1
09482185,3,2,1,0,2,2,0,0,0
09482527,9,1,8,1,6,1,5,1,0
09482602,13,6,7,0,0,0,0,0,0
09482612,3,0,3,0,0,0,0,0,0
09482613,12,3,9,0,0,0,0,0,0
09482614,11,3,8,0,0,0,0,0,0
09482850,1,0,1,0,1,1,0,0,0
09482853,1,0,1,0,1,1,0,0,0
09482963,1,0,1,0,1,1,0,1,1
09483037,2,2,0,0,2,2,0,0,0
09483355,11,3,8,0,3,1,2,2,1
09483394,7,6,1,0,2,2,0,2,1
09483670,4,0,4,0,0,0,0,0,1
09483901,2,2,0,0,2,2,0,0,0
09484045,11,3,8,0,1,1,0,1,1
09484181,1,1,0,0,2,2,0,0,0
09484205,5,2,3,0,2,2,0,1,1
09484335,2,2,0,0,1,1,0,0,0
09484410,1,0,1,0,1,1,0,0,0
09484541,2,2,0,0,2,2,0,0,1
09484662,9,3,6,0,2,2,0,2,1
09484685,2,0,2,0,6,6,0,0,1
09485198,2,2,0,0,2,2,0,0,0
09485316,2,0,2,0,0,0,0,0,1
09485336,5,5,0,0,6,6,0,1,1
09485353,5,5,0,0,6,6,0,1,1
09485355,5,5,0,0,6,6,0,1,1
09485382,5,5,0,0,5,5,0,0,1
09485417,5,5,0,0,6,6,0,1,1
09485471,5,5,0,0,6,6,0,1,1
09485504,5,3,2,0,2,1,1,1,0
09485534,2,2,0,0,1,1,0,0,1
09485548,12,3,9,0,2,1,1,2,1
09485570,5,5,0,0,6,6,0,1,1
09485713,1,1,0,0,1,1,0,0,0
09485724,1,0,1,0,1,1,0,0,0
09486257,7,5,2,0,0,0,0,0,1
09486529,1,1,0,0,1,1,0,0,0
09487057,2,2,0,0,2,2,0,0,0
09487128,1,1,0,0,1,1,0,0,0
09487514,3,2,1,0,1,1,0,0,0
09487576,1,0,1,0,1,1,0,0,0
09488023,2,0,2,0,1,1,0,0,0
09488286,3,3,0,0,1,1,0,0,0
09488604,2,2,0,0,1,1,0,0,0
09488674,6,5,1,0,1,1,0,0,1
09488767,1,0,1,0,1,1,0,0,0
09489112,3,2,1,0,1,1,0,0,0
09489226,1,1,0,0,1,1,0,0,0
09489250,21,10,11,0,1,1,0,1,1
09489319,1,1,0,0,1,1,0,0,0
09489464,3,2,1,0,2,2,0,0,1
09489483,3,2,1,0,2,2,0,0,1
09489501,7,4,3,0,2,2,0,0,1
09490008,14,8,6,0,1,1,0,0,0
09490093,24,14,10,0,0,0,0,0,1
09490152,2,2,0,0,2,2,0,0,1
09490202,6,0,6,0,0,0,0,0,0
09490384,3,3,0,0,1,1,0,1,0
09490466,5,5,0,0,0,0,0,0,0
09490492,3,3,0,0,1,1,0,0,0
09491138,1,1,0,0,1,1,0,0,1
09491802,4,4,0,0,1,1,0,0,0
09492018,3,2,1,0,0,0,0,0,0
09492858,1,1,0,0,1,1,0,0,0
09494070,5,5,0,0,2,2,0,0,0
09494087,3,3,0,0,3,3,0,0,0
09494122,1,0,1,0,0,0,0,0,0
09494501,2,0,2,0,1,1,0,0,0
09495957,10,2,8,0,1,1,0,1,1
09496037,1,1,0,0,1,1,0,0,0
09496161,8,4,4,0,1,1,0,1,0
09496410,1,1,0,0,1,1,0,0,0
09496896,1,1,0,0,1,1,0,0,0
09497375,2,2,0,0,1,1,0,0,1
09497401,2,0,2,0,2,2,0,0,0
09497462,6,0,6,0,0,0,0,0,1
09497585,2,0,2,0,1,1,0,0,0
09497768,1,1,0,0,1,1,0,0,0
09497844,6,4,2,0,2,2,0,2,1
09498067,5,4,1,0,1,1,0,0,0
09498085,4,0,4,0,1,1,0,0,1
09498248,4,2,2,0,3,1,2,0,0
09498298,6,2,4,0,3,2,1,0,1
09498606,2,2,0,0,3,3,0,0,0
09498764,4,1,3,0,3,1,2,0,0
09498809,4,4,0,0,1,1,0,1,0
09499110,2,2,0,0,1,1,0,0,0
09499238,1,1,0,0,1,1,0,0,0
09499346,3,3,0,0,1,1,0,0,1
09499822,2,1,1,0,2,2,0,0,0
09499889,7,7,0,0,0,0,0,0,0
09499893,3,3,0,0,0,0,0,0,1
09500088,5,5,0,0,1,1,0,1,1
09500119,2,0,2,0,0,0,0,0,0
09500166,1,1,0,0,1,1,0,0,1
09500227,1,1,0,0,1,1,0,0,1
09501001,11,8,3,0,0,0,0,0,1
09501207,2,2,0,0,2,1,1,0,1
09501645,2,1,1,0,1,1,0,1,1
09501957,2,1,1,0,1,1,0,0,1
09502123,7,5,2,0,2,2,0,1,0
09502148,2,1,1,0,1,1,0,0,1
09502198,1,1,0,0,1,1,0,0,0
09502287,1,1,0,0,1,1,0,0,0
09502381,2,0,2,0,0,0,0,0,1
09502488,1,1,0,0,1,1,0,0,1
09502630,2,1,1,0,1,1,0,1,1
09502632,2,1,1,0,1,1,0,1,1
09503030,2,2,0,0,2,2,0,0,0
09503401,1,1,0,0,1,1,0,0,1
09503951,1,0,1,0,1,1,0,0,0
09504038,2,2,0,0,2,2,0,0,0
09504137,1,0,1,0,1,1,0,0,0
09504181,1,1,0,0,1,1,0,0,0
09504299,2,0,2,0,0,0,0,0,0
09504599,2,1,1,0,1,1,0,0,0
09504725,6,5,1,0,2,2,0,0,1
09504820,3,3,0,0,3,3,0,0,0
09504988,4,2,2,0,3,2,1,0,1
09505001,8,2,6,0,0,0,0,0,1
09505316,2,2,0,0,2,2,0,0,0
09505971,9,4,5,0,0,0,0,0,0
09506071,1,1,0,0,1,1,0,0,0
09506360,2,2,0,0,1,1,0,0,1
09506377,1,0,1,0,0,0,0,0,1
09506419,1,1,0,0,1,1,0,0,0
09506634,2,1,1,0,1,1,0,0,0
09506737,5,1,4,0,2,1,1,1,0
09506836,1,1,0,0,1,1,0,0,1
09507585,1,1,0,0,1,1,0,0,0
09507978,1,1,0,0,1,1,0,0,0
09508302,2,2,0,0,1,1,0,0,0
09508398,4,0,4,0,0,0,0,0,1
09508524,1,1,0,0,1,1,0,0,0
09509261,2,2,0,0,1,1,0,0,1
09509304,2,1,1,0,2,1,1,0,0
09509693,1,0,1,0,0,0,0,0,1
09509798,12,4,8,0,1,0,1,1,0
09509968,1,0,1,0,0,0,0,0,1
09510092,1,1,0,0,2,2,0,0,0
09510332,4,2,2,0,3,3,0,0,0
09510349,7,6,1,0,1,0,1,1,1
09510997,2,1,1,0,1,1,0,0,1
09511012,10,6,4,0,0,0,0,0,1
09511797,4,4,0,0,0,0,0,0,1
09511992,2,0,2,0,1,1,0,1,1
09512134,2,1,1,0,1,1,0,0,0
09512178,4,4,0,0,0,0,0,0,1
09512266,2,2,0,0,1,1,0,0,1
09512290,1,1,0,0,1,1,0,0,1
09512474,5,5,0,0,1,1,0,0,1
09512681,4,2,2,0,1,1,0,0,1
09512690,2,2,0,0,1,1,0,0,0
09512722,8,5,3,0,6,4,2,1,0
09512728,8,5,3,0,6,4,2,1,0
09512806,3,2,1,0,2,1,1,1,0
09512809,2,2,0,0,1,1,0,0,0
09512874,1,1,0,0,1,1,0,0,0
09513128,1,1,0,0,1,1,0,0,0
09513426,2,1,1,0,2,1,1,0,0
09513536,1,1,0,0,0,0,0,0,0
09513757,1,1,0,0,1,1,0,0,0
06443842,10,0,10,0,0,0,0,0,1
06443857,5,2,3,0,1,1,0,0,1
06443858,7,0,7,0,0,0,0,0,1
06444010,19,4,15,0,2,2,0,2,1
06444021,4,1,3,0,1,1,0,0,0
06444051,19,0,19,0,0,0,0,0,1
06444254,12,2,10,0,3,1,2,1,1
06444705,10,2,8,0,1,1,0,1,1
06444781,7,3,4,0,1,0,1,1,1
06445029,10,0,10,0,0,0,0,0,1
06445100,5,0,5,0,0,0,0,0,1
06445109,5,0,5,0,0,0,0,0,1
06445263,5,3,2,0,1,1,0,1,0
06445355,6,0,6,0,0,0,0,0,1
06445377,3,0,3,0,3,2,1,0,1
06445419,6,3,3,0,2,2,0,0,1
06445722,6,3,3,0,2,1,1,0,1
06445757,2,0,2,0,1,1,0,0,0
06445864,10,1,9,0,0,0,0,0,0
06445873,3,1,2,0,1,1,0,0,1
06445879,17,3,14,0,1,1,0,1,1
06446039,20,4,16,0,1,1,0,0,1
06446137,4,2,2,0,1,1,0,0,1
06446154,6,0,6,0,0,0,0,0,1
06446302,5,0,5,0,0,0,0,0,1
06446321,8,1,7,0,1,1,0,0,1
06446484,17,4,13,0,1,1,0,0,1
06447213,5,0,5,0,0,0,0,0,1
06447453,2,0,2,0,0,0,0,0,1
06447607,4,2,2,0,1,1,0,0,1
06447731,11,5,6,0,1,1,0,0,1
06448014,2,2,0,0,1,1,0,0,0
06448025,13,4,9,0,8,4,4,0,0
06448060,6,3,3,0,1,1,0,1,1
06448063,5,3,2,0,1,1,0,0,1
06448126,18,7,11,0,0,0,0,0,1
06448178,6,3,3,0,1,1,0,1,1
06448183,6,3,3,0,1,1,0,1,1
06448500,7,2,5,0,0,0,0,0,1
06448592,5,0,5,0,1,1,0,0,1
06448593,13,7,6,0,1,1,0,1,1
06448607,10,0,10,0,1,1,0,1,1
06448909,14,5,9,0,1,1,0,1,1
06449040,20,3,17,0,2,1,1,2,1
06449218,8,2,6,0,1,1,0,0,1
06449335,4,2,2,0,1,1,0,0,0
06449390,4,0,4,0,2,2,0,0,0
06449456,11,0,11,0,0,0,0,0,1
06449477,3,3,0,0,2,2,0,0,0
06449686,6,0,6,0,1,0,1,0,1
06449787,6,0,6,0,0,0,0,0,1
06449928,5,3,2,0,1,1,0,0,1
06449944,5,3,2,0,1,1,0,0,1
06449994,5,2,3,0,0,0,0,0,1
06450118,6,3,3,0,2,2,0,2,1
06450121,6,3,3,0,2,2,0,2,1
06450348,5,3,2,0,1,1,0,0,0
06450355,3,0,3,0,0,0,0,0,1
06450452,3,3,0,0,2,2,0,0,0
06450467,5,3,2,0,1,1,0,0,1
06450483,5,1,4,0,1,1,0,0,0
06451019,23,5,18,0,2,1,1,2,1
06451156,5,1,4,0,1,1,0,0,0
06451211,20,2,18,0,1,1,0,1,1
06451233,4,2,2,0,1,1,0,0,1
06451271,22,3,19,0,2,1,1,2,1
06451374,4,2,2,0,1,1,0,0,1
06451441,6,4,2,0,1,1,0,0,1
06451455,16,6,10,0,0,0,0,0,1
06451478,4,2,2,0,1,1,0,0,0
06451603,11,2,9,0,0,0,0,0,1
06451650,2,2,0,0,1,1,0,0,0
06451677,9,6,3,0,1,1,0,0,1
06451745,6,4,2,0,1,1,0,0,1
06451756,13,3,10,0,1,1,0,1,1
06451817,5,2,3,0,3,3,0,0,1
06451905,5,0,5,0,0,0,0,0,1
06452409,12,7,5,0,0,0,0,0,0
06452503,5,0,5,0,2,2,0,0,0
06452509,12,0,12,0,0,0,0,0,0
06452540,24,9,15,0,4,3,1,0,1
06452630,4,2,2,0,1,1,0,0,1
06452779,5,2,3,0,2,2,0,0,1
06452959,4,0,4,0,0,0,0,0,1
06452985,6,2,4,0,0,0,0,0,1
06452998,3,0,3,0,0,0,0,0,1
06453018,2,0,2,0,0,0,0,0,0
06453072,4,1,3,0,1,1,0,0,1
06453231,5,2,3,0,0,0,0,0,1
06453257,6,2,4,0,2,2,0,1,1
06453324,5,0,5,0,0,0,0,0,1
06453357,4,0,4,0,0,0,0,0,1
06453457,3,0,3,0,0,0,0,0,1
06453482,2,0,2,0,0,0,0,0,1
06453489,2,0,2,0,0,0,0,0,1
06453504,2,2,0,0,0,0,0,0,1
06453593,12,1,11,0,4,2,2,1,1
06453830,12,7,5,0,2,2,0,2,1
06453891,6,0,6,0,0,0,0,0,1
06454089,4,2,2,0,1,1,0,0,1
06454105,5,3,2,0,2,2,0,0,1
06454122,5,0,5,0,2,2,0,0,1
06454146,5,3,2,0,1,1,0,1,1
06454176,7,2,5,0,2,2,0,0,1
06454378,29,8,21,0,0,0,0,0,1
06454471,14,0,14,0,0,0,0,0,1
06454965,7,4,3,0,1,1,0,0,1
06455305,8,3,5,0,1,1,0,1,1
06455407,3,0,3,0,1,1,0,0,0
06455439,10,0,10,0,0,0,0,0,1
06455581,4,3,1,0,1,1,0,1,1
06455671,2,1,1,0,1,1,0,0,0
06455788,19,4,15,0,2,2,0,2,1
06455911,4,2,2,0,2,2,0,0,1
06455947,6,2,4,0,1,1,0,0,1
06456135,5,3,2,0,2,2,0,0,1
06456185,20,0,20,0,0,0,0,0,1
06456323,6,0,6,0,0,0,0,0,1
06456344,6,4,2,0,2,2,0,0,1
06456441,26,0,26,0,0,0,0,0,1
06456522,3,2,1,0,2,2,0,0,0
06456590,15,4,11,0,2,2,0,2,1
06456709,4,2,2,0,1,1,0,0,0
06456722,9,0,9,0,0,0,0,0,1
06456726,5,1,4,0,0,0,0,0,1
06456901,5,3,2,0,0,0,0,0,0
06456993,3,0,3,0,0,0,0,0,0
06457246,5,3,2,0,2,2,0,0,1
06457257,5,2,3,0,1,1,0,0,1
06457400,5,2,3,0,2,2,0,0,1
06457435,18,3,15,0,1,1,0,1,1
06457553,17,3,14,0,0,0,0,0,1
06457657,4,4,0,0,1,1,0,1,1
06457721,10,6,4,0,3,1,2,1,0
06457794,5,3,2,0,3,3,0,0,1
06457807,9,5,4,0,3,3,0,0,1
06457830,3,0,3,0,0,0,0,0,1
06457834,5,3,2,0,2,2,0,0,1
06458029,10,3,7,0,1,1,0,1,1
06458336,14,5,9,0,1,1,0,1,1
06458377,4,0,4,0,1,1,0,0,1
06458380,4,0,4,0,0,0,0,0,1
06458503,15,5,10,0,1,1,0,1,1
06458504,9,2,7,0,0,0,0,0,0
06458538,9,0,9,0,0,0,0,0,1
06458580,11,3,8,0,0,0,0,0,1
06458814,39,10,29,0,0,0,0,0,1
06458828,20,5,15,0,1,1,0,1,1
06458829,52,9,43,0,9,0,9,0,1
06458982,14,3,11,0,1,1,0,1,1
06459120,8,3,5,0,1,1,0,1,1
06459369,6,0,6,0,0,0,0,0,1
06459546,11,2,9,0,1,1,0,1,1
06459854,15,3,12,0,1,1,0,1,1
06459856,12,1,11,0,3,1,2,1,1
06459857,8,1,7,0,1,1,0,1,1
06459864,9,3,6,0,1,1,0,1,1
06461032,6,0,6,0,1,1,0,0,1
06461048,5,0,5,0,0,0,0,0,1
06461049,6,3,3,0,3,2,1,0,1
06461164,4,3,1,0,3,3,0,0,0
06461911,4,0,4,0,0,0,0,0,1
06462043,10,5,5,0,0,0,0,0,1
06462220,34,12,22,0,0,0,0,0,1
06462519,2,2,0,0,2,2,0,0,0
06462541,8,0,8,0,0,0,0,0,1
06462674,16,4,12,0,1,1,0,0,1
06462846,7,0,7,0,1,1,0,1,1
06462849,7,0,7,0,1,1,0,1,1
06462850,7,4,3,0,1,1,0,1,1
06462852,7,0,7,0,1,1,0,1,1
06462853,7,0,7,0,1,1,0,1,1
06462854,7,0,7,0,1,1,0,1,1
06462855,7,0,7,0,1,1,0,1,1
06462856,7,0,7,0,1,1,0,1,1
06463031,8,4,4,0,1,1,0,1,1
06463493,7,0,7,0,1,1,0,1,1
06463761,7,0,7,0,1,1,0,0,1
06463812,24,10,14,0,0,0,0,0,1
06464092,12,0,12,0,0,0,0,0,1
06464207,5,2,3,0,2,2,0,0,1
06464338,11,3,8,0,1,1,0,1,1
06464539,6,1,5,0,2,1,1,0,0
06464603,13,7,6,0,1,1,0,0,0
06464687,17,2,15,0,0,0,0,0,1
06464749,42,14,28,0,0,0,0,0,1
06464783,7,4,3,0,1,1,0,0,0
06464825,3,0,3,0,2,2,0,0,0
06464867,4,0,4,0,0,0,0,0,1
06464940,3,1,2,0,2,1,1,0,0
06464988,7,2,5,0,6,4,2,0,1
06465032,4,0,4,0,0,0,0,0,1
06465063,19,9,10,0,1,1,0,0,0
06465313,5,3,2,0,1,1,0,0,1
06465317,44,17,27,0,0,0,0,0,1
06465358,4,2,2,0,4,4,0,0,1
06465371,4,2,2,0,2,2,0,0,1
06465395,10,0,10,0,0,0,0,0,1
06465660,8,4,4,0,4,3,1,0,1
06465806,5,1,4,0,1,1,0,1,1
06465865,6,3,3,0,1,1,0,0,1
06466042,8,2,6,0,1,1,0,1,1
06466077,2,1,1,0,1,1,0,0,1
06466083,6,1,5,0,2,1,1,0,1
06466092,2,2,0,0,2,2,0,0,1
06466105,3,3,0,0,2,2,0,0,0
06466234,2,0,2,0,1,1,0,0,0
06466371,9,2,7,0,2,1,1,0,1
06466422,10,7,3,0,0,0,0,0,1
06466537,7,3,4,0,2,2,0,0,1
06466623,4,1,3,0,1,1,0,0,1
06466811,16,6,10,0,0,0,0,0,1
06466973,8,4,4,0,1,1,0,0,0
06466974,36,13,23,0,0,0,0,0,1
06466983,17,7,10,0,0,0,0,0,1
06467108,4,0,4,0,2,2,0,0,1
06467425,5,0,5,0,0,0,0,0,1
06467453,7,0,7,0,0,0,0,0,1
06468064,6,4,2,0,1,1,0,1,1
06468073,6,4,2,0,1,1,0,1,1
06468199,4,0,4,0,0,0,0,0,0
06468205,7,0,7,0,0,0,0,0,1
06468598,5,2,3,0,2,2,0,0,1
06468610,6,1,5,0,1,1,0,1,1
06468832,5,2,3,0,1,1,0,0,0
06469055,6,2,4,0,1,1,0,1,1
06469141,18,7,11,0,0,0,0,0,0
06469186,7,3,4,0,0,0,0,0,1
06469210,4,0,4,0,0,0,0,0,1
06469549,26,5,21,0,1,1,0,1,1
06469607,9,2,7,0,1,1,0,0,1
06469905,2,2,0,0,1,1,0,0,1
06469948,24,12,12,0,1,1,0,1,1
06470047,4,1,3,0,1,1,0,0,1
06470133,26,4,22,0,2,1,1,2,1
06470277,20,0,20,0,1,1,0,0,1
06470363,4,0,4,0,0,0,0,0,1
06470364,5,0,5,0,0,0,0,0,1
06470369,5,3,2,0,1,1,0,0,1
06470388,6,2,4,0,1,1,0,0,1
06470644,5,2,3,0,1,1,0,0,1
06470668,5,2,3,0,1,1,0,0,1
06470721,3,0,3,0,0,0,0,0,0
06471157,5,2,3,0,1,1,0,0,1
06471164,3,3,0,0,2,2,0,0,0
06471233,15,6,9,0,1,1,0,1,1
06471276,15,6,9,0,2,2,0,2,1
06471532,6,3,3,0,1,1,0,1,1
06471620,9,3,6,0,3,3,0,0,1
06471634,2,1,1,0,1,1,0,0,0
06471659,15,6,9,0,1,1,0,1,1
06471775,8,5,3,0,1,1,0,1,0
06471826,4,0,4,0,0,0,0,0,1
06472273,6,2,4,0,2,1,1,0,1
06472294,3,1,2,0,1,1,0,1,1
06472473,2,1,1,0,1,1,0,0,0
06472571,13,2,11,0,0,0,0,0,1
06472886,12,0,12,0,1,1,0,1,1
06472916,7,3,4,0,1,1,0,0,1
02964231,12,4,8,0,2,1,1,1,1
02964304,17,0,17,0,1,1,0,1,1
02964309,66,9,57,0,0,0,0,0,1
02964479,5,1,4,0,2,1,1,0,0
02964844,22,5,17,0,1,1,0,1,1
02964988,7,3,4,0,1,1,0,0,0
02965021,11,3,8,0,0,0,0,0,1
02965040,8,4,4,0,3,3,0,0,1
02965424,12,0,12,0,1,1,0,1,1
02965671,26,0,26,0,0,0,0,0,1
02965748,28,6,22,0,0,0,0,0,1
02965770,20,9,11,0,1,1,0,0,1
02966051,33,3,30,0,1,1,0,1,1
02966054,63,6,57,0,1,1,0,1,1
02966113,30,3,27,0,1,1,0,1,1
02966357,6,4,2,0,3,3,0,0,1
02966505,69,0,69,0,0,0,0,0,1
02966506,30,7,23,0,1,1,0,1,1
02966566,4,3,1,0,1,1,0,0,1
02966619,5,0,5,0,0,0,0,0,1
02966638,5,3,2,0,0,0,0,0,0
02966640,5,3,2,0,0,0,0,0,0
02966828,19,4,15,0,1,1,0,1,1
02966934,12,3,9,0,1,1,0,1,1
02966938,15,4,11,0,3,3,0,0,1
02966946,33,4,29,0,1,1,0,1,1
02967121,77,12,65,0,0,0,0,0,0
02967199,47,7,40,0,0,0,0,0,1
02967251,15,0,15,0,0,0,0,0,1
02967577,34,6,28,1,5,4,1,0,1
02967620,42,8,34,0,0,0,0,0,0
02967826,7,3,4,0,2,2,0,0,1
02967847,16,0,16,0,0,0,0,0,1
02967967,5,3,2,0,1,1,0,1,0
02968125,20,0,20,0,0,0,0,0,1
02968147,7,0,7,0,0,0,0,0,1
02968180,4,0,4,0,0,0,0,0,1
02968233,9,4,5,0,1,1,0,0,1
02968645,16,2,14,0,1,1,0,1,1
02968916,19,4,15,0,1,1,0,1,1
02969165,64,12,52,0,0,0,0,0,1
02969209,4,2,2,0,2,2,0,0,1
02969302,25,0,25,0,0,0,0,0,1
02969307,61,6,55,0,0,0,0,0,1
02969411,31,4,27,0,1,1,0,1,1
02969614,14,0,14,0,0,0,0,0,1
02969695,24,0,24,0,1,1,0,1,1
02969703,15,4,11,0,4,3,1,0,0
02969806,18,3,15,0,1,1,0,0,1
02969849,4,3,1,0,1,1,0,0,0
02969915,25,0,25,0,0,0,0,0,1
02970035,16,7,9,0,1,1,0,1,1
02970119,20,3,17,0,0,0,0,0,1
02970218,23,3,20,0,1,1,0,1,0
02970219,25,5,20,0,1,1,0,1,1
02970229,8,1,7,0,1,1,0,1,1
02970319,57,12,45,0,1,1,0,1,1
02970326,21,5,16,0,1,1,0,1,1
02970583,80,7,73,0,1,1,0,1,1
02970596,20,0,20,0,0,0,0,0,1
02970609,49,5,44,0,1,1,0,1,1
02971049,10,4,6,0,3,3,0,0,1
02971086,32,0,32,0,0,0,0,0,1
02971095,20,0,20,0,1,1,0,1,1
02971428,11,0,11,0,0,0,0,0,1
02971930,67,11,56,0,0,0,0,0,1
02971956,9,2,7,0,1,1,0,1,0
02972023,13,3,10,0,5,4,1,0,1
02972059,37,6,31,0,1,1,0,1,1
02972150,18,5,13,0,1,1,0,0,1
02972203,17,4,13,0,1,1,0,0,1
02972251,9,1,8,0,1,1,0,0,1
02972325,42,8,34,0,0,0,0,0,1
02972338,31,6,25,0,1,1,0,1,1
02972451,12,7,5,0,3,1,2,1,0
02972452,13,8,5,0,3,1,2,1,0
02973057,36,0,36,0,1,1,0,1,1
02973115,37,3,34,0,1,1,0,1,1
02973200,36,8,28,0,0,0,0,0,1
02973246,20,1,19,0,1,1,0,0,1
02973349,13,2,11,0,1,1,0,0,1
02973351,8,3,5,0,1,1,0,0,1
02973571,10,3,7,0,2,0,2,2,1
02973699,8,3,5,0,3,1,2,1,1
02973782,15,3,12,0,2,2,0,2,1
02973871,19,3,16,0,4,4,0,0,1
02973913,11,3,8,0,1,1,0,0,0
02974080,19,3,16,0,2,2,0,0,1
02974333,36,6,30,0,1,1,0,1,1
02974366,25,0,25,0,0,0,0,0,1
02974488,16,2,14,0,1,1,0,1,1
02974489,29,3,26,0,1,1,0,1,1
02974600,102,16,86,0,0,0,0,0,1
02974995,15,0,15,0,0,0,0,0,1
02975261,32,7,25,0,0,0,0,0,0
02975404,49,7,42,0,0,0,0,0,1
02975774,7,2,5,0,1,1,0,0,0
02975900,5,3,2,0,2,2,0,0,0
02975954,12,6,6,0,2,2,0,0,0
02975955,4,2,2,0,2,2,0,0,0
02976291,12,3,9,0,1,1,0,1,1
02976398,13,3,10,0,1,1,0,1,1
02976594,7,2,5,0,1,1,0,0,0
02976597,23,2,21,0,1,1,0,1,1
02976598,12,1,11,0,1,1,0,0,1
02976601,24,0,24,0,0,0,0,0,1
02976748,36,9,27,0,1,1,0,0,1
02976853,8,0,8,0,0,0,0,0,1
02976921,7,3,4,0,3,1,2,1,1
02977138,28,0,28,0,0,0,0,0,1
02977551,18,2,16,0,1,1,0,1,1
02977555,9,3,6,0,2,2,0,0,0
02977580,17,0,17,0,0,0,0,0,1
02977634,6,2,4,0,1,1,0,0,0
02977910,17,4,13,0,1,1,0,1,1
02977936,20,4,16,0,1,1,0,1,1
02978176,4,0,4,0,0,0,0,0,0
02978412,42,1,41,0,1,1,0,1,1
02978518,34,0,34,0,0,0,0,0,1
02978531,17,6,11,0,0,0,0,0,1
02978712,9,5,4,0,4,1,3,1,0
02978718,8,5,3,0,4,2,2,1,0
02979061,18,3,15,0,1,1,0,1,1
02979420,8,2,6,0,1,1,0,1,1
02979430,8,2,6,0,1,1,0,1,1
02979433,8,2,6,0,1,1,0,1,1
02979487,30,9,21,0,0,0,0,0,1
02979676,7,3,4,0,1,1,0,0,1
02979794,39,3,36,0,1,1,0,1,1
02979872,31,3,28,0,1,1,0,1,1
02980110,8,0,8,0,0,0,0,0,1
02980254,8,5,3,0,3,3,0,0,1
02980415,9,2,7,0,2,2,0,0,1
02980523,13,0,13,0,0,0,0,0,1
02980636,23,8,15,0,0,0,0,0,1
02980806,30,5,25,0,0,0,0,0,1
02981031,43,6,37,0,0,0,0,0,1
02981163,9,4,5,0,1,1,0,0,0
02981492,15,4,11,0,2,1,1,0,1
02981683,12,5,7,0,0,0,0,0,0
02981756,7,0,7,0,0,0,0,0,1
02981969,9,0,9,0,0,0,0,0,1
02982088,33,0,33,0,0,0,0,0,1
02982105,24,3,21,0,2,2,0,0,1
02982116,25,2,23,0,1,1,0,1,1
02982167,4,2,2,0,2,2,0,0,1
02982187,9,0,9,0,0,0,0,0,1
02982279,40,11,29,0,1,1,0,0,1
02982397,24,0,24,0,0,0,0,0,1
02982760,38,3,35,0,0,0,0,0,1
02982879,29,3,26,0,1,1,0,1,1
02982917,19,2,17,0,1,1,0,1,1
02982925,19,2,17,0,1,1,0,1,1
02982999,14,1,13,0,2,2,0,1,1
02983159,4,0,4,0,0,0,0,0,1
02983449,4,0,4,0,1,1,0,0,0
02983847,35,10,25,0,0,0,0,0,1
02983919,32,4,28,0,2,2,0,2,0
02984094,27,3,24,0,1,1,0,1,1
02984127,12,2,10,0,1,1,0,0,1
02984320,47,5,42,0,0,0,0,0,1
02984371,20,0,20,0,0,0,0,0,1
02984546,15,0,15,0,1,1,0,1,1
02984635,9,2,7,0,1,1,0,0,1
02984663,5,3,2,0,2,2,0,0,1
02984735,14,4,10,0,0,0,0,0,1
02984805,29,5,24,0,1,1,0,1,1
02984838,65,0,65,0,0,0,0,0,1
02984862,48,0,48,0,0,0,0,0,1
02984930,8,2,6,0,1,1,0,0,0
02984993,22,0,22,0,1,1,0,0,1
02985018,21,3,18,0,1,1,0,1,1
02985026,19,0,19,0,1,1,0,1,1
02985051,0,0,0,0,0,0,0,0,1
02985190,28,4,24,0,1,1,0,1,1
02985309,4,0,4,0,0,0,0,0,0
02985396,21,3,18,0,0,0,0,0,1
02985554,7,0,7,0,1,1,0,0,1
02985572,4,0,4,0,1,1,0,0,1
02985577,23,6,17,0,0,0,0,0,1
02985988,7,3,4,0,2,2,0,0,1
02986356,9,2,7,0,1,1,0,1,1
02986360,8,2,6,0,1,1,0,1,1
02986417,54,14,40,0,0,0,0,0,0
02986437,25,0,25,0,0,0,0,0,1
02986446,4,2,2,0,2,2,0,0,1
02986447,9,2,7,0,1,1,0,0,1
02986454,16,5,11,0,1,1,0,0,1
02986668,11,8,3,0,2,2,0,0,0
02987163,31,3,28,0,1,1,0,0,1
02988263,10,2,8,0,2,2,0,0,1
02988344,4,2,2,0,1,1,0,0,1
02988424,8,2,6,0,1,1,0,0,1
02988520,37,4,33,0,1,1,0,1,1
02988561,15,0,15,0,0,0,0,0,1
02988901,26,4,22,0,1,1,0,1,1
02989194,7,2,5,0,0,0,0,0,0
02989429,5,2,3,0,1,1,0,0,1
02989519,18,4,14,0,0,0,0,0,1
02989577,31,0,31,0,1,1,0,1,0
02989830,19,0,19,0,1,1,0,1,1
02989838,84,6,78,0,1,1,0,1,1
02989969,18,4,14,0,2,1,1,2,1
02990119,13,0,13,0,0,0,0,0,1
02990155,71,0,71,0,0,0,0,0,1
02990191,12,0,12,0,0,0,0,0,1
02990194,6,2,4,0,1,1,0,1,1
02990329,26,0,26,0,0,0,0,0,1
02990425,58,14,44,0,1,1,0,0,0
02990649,33,13,20,0,0,0,0,0,0
02990783,120,21,99,0,0,0,0,0,0
02990785,17,4,13,0,1,1,0,1,1
02990953,21,0,21,0,0,0,0,0,0
02991397,31,8,23,0,0,0,0,0,1
02991429,12,6,6,0,1,1,0,1,1
02991471,5,2,3,0,1,1,0,0,1
02991672,34,9,25,0,0,0,0,0,1
02991857,14,3,11,0,2,2,0,0,0
02991943,9,4,5,0,1,1,0,0,1
02992152,5,2,3,0,1,1,0,0,1
02992159,5,1,4,0,1,1,0,0,1
02992162,5,3,2,0,2,2,0,0,1
02992408,17,0,17,0,0,0,0,0,1
02992429,19,10,9,0,0,0,0,0,1
02992437,36,11,25,0,0,0,0,0,1
02992457,28,5,23,0,0,0,0,0,0
02992607,21,4,17,0,0,0,0,0,1
02992862,16,0,16,0,0,0,0,0,1
02992904,12,3,9,0,0,0,0,0,1
02993077,5,0,5,0,0,0,0,0,1
02993186,30,2,28,0,1,1,0,1,1
02993243,17,0,17,0,1,1,0,1,1
02993376,32,0,32,0,0,0,0,0,1
02993591,11,0,11,0,0,0,0,0,0
02993626,5,0,5,0,0,0,0,0,1
02993634,5,3,2,0,2,2,0,0,1
02993638,5,3,2,0,1,1,0,1,1
02993822,24,7,17,0,0,0,0,0,0
02993850,7,2,5,0,1,1,0,0,1
02993948,18,0,18,0,0,0,0,0,1
02994061,26,3,23,0,1,1,0,1,1
02994482,8,3,5,0,2,2,0,0,0
07086104,13,4,9,2,4,2,2,1,0
07086238,2,1,1,0,1,1,0,1,0
07086392,5,2,3,0,2,2,0,0,1
07086844,1,1,0,0,2,2,0,0,0
07086916,25,4,21,0,2,1,1,1,1
07087239,7,0,7,0,0,0,0,0,1
07087275,2,0,2,0,0,0,0,0,1
07087276,7,2,5,1,0,0,0,0,1
07087384,13,5,8,0,0,0,0,0,0
07087528,10,5,5,0,0,0,0,0,1
07087896,4,0,4,0,0,0,0,0,0
07087960,3,2,1,0,0,0,0,0,1
07088009,58,20,38,0,0,0,0,0,1
07088263,4,1,3,0,1,1,0,1,1
07088386,12,4,8,0,1,1,0,1,0
07088419,12,4,8,0,1,1,0,1,0
07088434,12,4,8,0,1,1,0,1,0
07089066,6,3,3,0,2,2,0,0,0
07089864,1,0,1,0,0,0,0,0,1
07090066,12,0,12,0,0,0,0,0,1
07090099,8,0,8,0,0,0,0,0,1
07090269,4,4,0,0,3,3,0,0,1
07090319,3,3,0,0,2,2,0,0,1
07090414,5,0,5,0,1,1,0,1,1
07090476,2,2,0,0,1,1,0,0,0
07090521,9,4,5,0,1,1,0,1,1
07091156,4,0,4,0,0,0,0,0,0
07091448,1,1,0,0,1,1,0,0,1
07091551,5,1,4,0,3,1,2,0,1
07091597,5,3,2,0,3,1,2,0,0
07091979,7,0,7,0,0,0,0,0,1
07092125,15,12,3,0,1,1,0,1,1
07092487,1,1,0,0,1,1,0,0,0
07092922,2,0,2,0,0,0,0,0,0
07092985,11,0,11,0,0,0,0,0,1
07093069,11,0,11,0,2,2,0,0,1
07093115,11,2,9,0,1,1,0,1,1
07093506,4,0,4,0,0,0,0,0,0
07093532,3,0,3,0,0,0,0,0,0
07093625,3,0,3,0,0,0,0,0,0
07094135,5,4,1,0,3,3,0,0,1
07094272,2,0,2,0,1,1,0,0,0
07094851,9,5,4,0,1,1,0,1,1
07094870,5,0,5,0,0,0,0,0,1
07094874,9,2,7,0,3,1,2,3,0
07095168,17,3,14,0,1,1,0,1,1
07095334,3,0,3,0,1,1,0,0,1
07095350,1,1,0,0,1,1,0,0,1
07095843,2,2,0,0,2,2,0,0,0
07095940,4,2,2,0,3,1,2,1,0
07096105,21,10,11,0,1,1,0,1,1
07096665,6,2,4,0,1,1,0,0,1
07096798,1,0,1,0,0,0,0,0,1
07097099,14,0,14,0,0,0,0,0,1
07097107,17,9,8,0,0,0,0,0,0
07097320,1,1,0,0,1,1,0,0,1
07097615,5,2,3,0,1,1,0,0,0
07097752,6,2,4,1,1,1,0,1,0
07098550,8,1,7,0,1,1,0,1,0
07098566,15,6,9,0,1,1,0,1,1
07098618,28,14,14,0,0,0,0,0,1
07098814,4,1,3,0,1,1,0,0,0
07098916,14,6,8,0,0,0,0,0,1
07099095,2,0,2,0,0,0,0,0,1
07099445,3,3,0,0,1,1,0,0,0
07099552,2,1,1,0,1,1,0,0,0
07099666,27,8,19,0,8,4,4,0,0
07099805,14,2,12,0,0,0,0,0,0
07100268,5,2,3,0,2,2,0,0,0
07100852,1,1,0,0,2,2,0,0,0
07101375,7,0,7,0,0,0,0,0,1
07101530,23,8,15,0,6,6,0,0,1
07101581,8,5,3,0,1,1,0,1,1
07101748,4,0,4,0,0,0,0,0,0
07101760,1,1,0,0,1,1,0,0,0
07101777,3,1,2,0,2,2,0,0,0
07102432,4,2,2,0,1,1,0,1,1
07102619,2,2,0,0,2,2,0,2,0
07102717,34,11,23,0,1,1,0,1,1
07102893,2,2,0,0,2,2,0,0,0
07102943,13,4,9,1,0,0,0,0,1
07103770,22,8,14,0,6,6,0,0,1
07104028,4,3,1,0,1,1,0,0,0
07104037,2,2,0,0,2,2,0,0,0
07104418,2,1,1,0,1,1,0,0,0
07104632,3,3,0,0,1,1,0,0,1
07105051,14,6,8,0,1,1,0,1,1
07105124,3,0,3,0,0,0,0,0,0
07105209,2,2,0,0,1,1,0,0,0
07105241,2,1,1,0,1,1,0,0,0
07105283,3,0,3,0,0,0,0,0,0
07105905,28,9,19,0,0,0,0,0,1
07106021,4,1,3,0,2,2,0,0,0
07106438,10,6,4,0,0,0,0,0,0
07106453,4,0,4,0,0,0,0,0,1
07106472,18,2,16,0,2,1,1,2,1
07106492,5,2,3,0,4,2,2,0,1
07106615,12,6,6,0,0,0,0,0,1
07106728,13,6,7,0,1,1,0,0,0
07107538,1,1,0,0,1,1,0,0,1
07107689,6,2,4,0,1,1,0,0,1
07107825,2,2,0,0,2,2,0,0,0
07107908,1,0,1,0,0,0,0,0,1
07108176,14,0,14,0,1,1,0,1,0
07108297,12,3,9,0,1,1,0,1,1
07108454,3,0,3,0,0,0,0,0,1
07108603,4,1,3,0,1,1,0,0,1
07108723,9,4,5,0,1,1,0,1,1
07108769,6,3,3,0,0,0,0,0,0
07108847,4,3,1,0,3,3,0,0,1
07109145,11,0,11,0,0,0,0,0,1
07109265,2,2,0,0,1,1,0,1,0
07109432,3,1,2,0,1,1,0,0,0
07109537,5,2,3,0,2,2,0,0,1
07109753,6,1,5,0,1,1,0,1,1
07109849,14,3,11,0,2,1,1,2,1
07110214,19,5,14,0,0,0,0,0,1
07110269,2,2,0,0,3,3,0,0,0
07110396,4,3,1,0,1,1,0,0,0
07110700,21,5,16,0,1,1,0,1,1
07111000,21,4,17,0,1,1,0,1,1
07111249,11,2,9,0,1,1,0,1,1
07111287,7,2,5,0,1,1,0,1,1
07111345,18,9,9,0,1,1,0,1,1
07111348,18,9,9,0,1,1,0,1,1
07111438,19,9,10,0,2,2,0,2,1
07111650,15,7,8,0,1,1,0,1,1
07111690,13,2,11,0,1,1,0,1,1
07111842,1,0,1,0,0,0,0,0,1
07111916,2,2,0,0,2,2,0,0,0
07111969,14,4,10,0,2,2,0,2,1
07112004,11,5,6,0,1,1,0,0,1
07112008,23,4,19,0,0,0,0,0,1
07112055,10,3,7,0,1,1,0,1,0
07112628,11,4,7,0,0,0,0,0,1
07112821,10,4,6,0,2,1,1,2,1
07113915,4,2,2,0,1,1,0,0,1
07114143,5,0,5,0,0,0,0,0,1
07114234,7,0,7,0,0,0,0,0,1
07114333,2,0,2,0,0,0,0,0,1
07114334,2,0,2,0,0,0,0,0,1
07114668,62,14,48,0,0,0,0,0,0
07114909,6,2,4,0,1,1,0,0,1
07114911,6,3,3,0,0,0,0,0,1
07114978,14,7,7,0,0,0,0,0,0
07115358,16,8,8,0,1,1,0,1,1
07115370,9,4,5,0,1,1,0,0,0
07115583,9,2,7,0,1,1,0,1,0
07115640,14,0,14,0,0,0,0,0,1
07115774,3,1,2,0,1,1,0,1,1
07116211,3,0,3,0,0,0,0,0,1
07116655,5,0,5,0,0,0,0,0,1
07116858,4,0,4,0,2,2,0,0,0
07116900,2,1,1,0,1,1,0,0,0
07117770,7,7,0,0,0,0,0,0,0
07117817,5,2,3,0,1,1,0,0,1
07117832,7,2,5,0,0,0,0,0,1
07117937,5,1,4,0,1,1,0,0,1
07117959,6,2,4,0,1,1,0,0,1
07117969,7,4,3,0,1,1,0,1,0
07118170,17,14,3,0,1,0,1,0,1
07118278,1,1,0,0,1,1,0,0,0
07118282,2,0,2,0,1,1,0,0,1
07118464,2,2,0,0,2,2,0,0,0
07118642,7,3,4,0,3,1,2,1,1
07118679,7,3,4,0,0,0,0,0,1
07118962,7,3,4,0,0,0,0,0,1
07118968,24,6,18,0,0,0,0,0,0
07119201,4,3,1,0,2,2,0,0,0
07119436,3,3,0,0,1,1,0,1,0
07119657,1,0,1,0,0,0,0,0,1
07119841,2,1,1,0,2,2,0,0,0
07120232,4,3,1,0,2,2,0,0,0
07120277,2,2,0,0,2,2,0,0,1
07120423,2,0,2,0,1,1,0,0,1
07120907,19,8,11,0,0,0,0,0,1
07121047,21,3,18,0,2,2,0,2,1
07121735,8,3,5,0,1,1,0,1,0
07121942,6,0,6,0,1,1,0,1,1
07121945,3,0,3,0,1,1,0,0,1
07122611,3,0,3,0,0,0,0,0,0
07122681,7,3,4,0,1,1,0,0,1
07123227,22,11,11,0,0,0,0,0,1
07123427,3,0,3,0,0,0,0,0,1
07123448,7,5,2,0,1,1,0,0,1
07124620,3,2,1,0,1,1,0,0,0
07124628,5,5,0,0,2,2,0,0,0
07124696,7,2,5,0,3,1,2,1,1
07124725,4,2,2,0,1,1,0,0,1
07125033,8,3,5,0,1,1,0,1,1
07125097,2,0,2,0,2,2,0,0,1
07125666,9,4,5,0,2,1,1,2,1
07125774,2,2,0,0,2,2,0,0,0
07125912,8,3,5,0,2,2,0,0,1
07126090,1,1,0,0,1,1,0,0,0
07126716,9,4,5,0,3,3,0,0,1
07126808,4,0,4,0,0,0,0,0,0
07126959,2,1,1,0,1,1,0,0,0
07126995,5,4,1,0,1,1,0,0,0
07127109,4,1,3,0,2,2,0,0,0
07127130,8,4,4,0,0,0,0,0,1
07127152,2,2,0,0,1,1,0,0,0
07127256,3,0,3,0,0,0,0,0,1
07127320,5,4,1,0,2,0,2,0,1
07127388,2,2,0,0,1,1,0,0,1
07127413,36,19,17,0,0,0,0,0,1
07127476,18,9,9,0,0,0,0,0,1
07128051,8,0,8,0,0,0,0,0,1
07128317,24,3,21,0,2,2,0,2,1
07128441,5,5,0,0,2,2,0,0,1
07128523,10,6,4,0,0,0,0,0,1
07129286,2,2,0,0,1,1,0,0,0
07130127,12,6,6,0,1,1,0,0,1
07130145,27,10,17,0,0,0,0,0,0
07130487,2,2,0,0,1,1,0,0,1
07130538,3,2,1,0,1,1,0,0,0
07130547,3,0,3,0,0,0,0,0,1
07130571,8,6,2,0,1,1,0,0,1
07130820,1,1,0,0,1,1,0,0,0
02887005,8,2,6,0,2,1,1,1,1
02887007,16,6,10,0,1,1,0,0,1
02887054,5,3,2,0,2,2,0,0,0
02887058,20,2,18,0,1,1,0,1,1
02887390,18,0,18,0,0,0,0,0,1
02887410,14,4,10,0,0,0,0,0,1
02887678,23,0,23,0,0,0,0,0,1
02887767,6,3,3,0,1,1,0,0,0
02888048,11,3,8,0,1,1,0,1,1
02888133,23,3,20,0,1,1,0,1,1
02888907,38,3,35,0,2,1,1,2,1
02888946,36,5,31,0,1,1,0,1,1
02888960,44,12,32,0,0,0,0,0,1
02889052,5,0,5,0,0,0,0,0,1
02889070,7,2,5,0,1,1,0,1,1
02889192,7,3,4,0,1,1,0,0,1
02889486,41,7,34,0,1,1,0,1,1
02889757,65,17,48,0,0,0,0,0,1
02889962,8,0,8,0,0,0,0,0,0
02890011,12,3,9,0,1,1,0,1,1
02890014,14,3,11,0,1,1,0,1,1
02890160,4,1,3,0,0,0,0,0,0
02890236,30,0,30,0,1,1,0,1,1
02890792,13,6,7,0,0,0,0,0,0
02890849,21,5,16,0,1,1,0,1,1
02891043,45,4,41,0,1,1,0,1,1
02891064,41,6,35,0,0,0,0,0,1
02891128,4,2,2,0,1,1,0,0,1
02891307,24,7,17,0,0,0,0,0,1
02891387,26,4,22,0,1,1,0,1,1
02891762,30,5,25,0,0,0,0,0,1
02891987,21,0,21,0,1,1,0,1,1
02892257,36,3,33,0,0,0,0,0,1
02892469,19,0,19,0,0,0,0,0,1
02892836,36,7,29,0,0,0,0,0,1
02892850,9,3,6,0,0,0,0,0,1
02892852,19,0,19,0,0,0,0,0,1
02892853,12,0,12,0,0,0,0,0,1
02892856,11,3,8,0,2,2,0,0,1
02892872,21,5,16,0,0,0,0,0,1
02893060,38,4,34,0,2,2,0,2,1
02893076,9,3,6,0,1,1,0,0,0
02893177,18,5,13,0,1,1,0,1,1
02893365,29,5,24,0,0,0,0,0,1
02894291,24,11,13,0,1,1,0,1,0
02894382,13,0,13,0,0,0,0,0,1
02894622,4,2,2,0,0,0,0,0,1
02894677,9,0,9,0,0,0,0,0,0
02894738,9,3,6,0,1,1,0,1,1
02894742,15,1,14,0,0,0,0,0,1
02895015,32,4,28,0,1,1,0,1,1
02895103,88,2,86,0,1,1,0,1,1
02895196,27,3,24,0,1,1,0,1,1
02895722,37,5,32,0,1,1,0,1,1
02895736,28,0,28,0,0,0,0,0,1
02895790,47,13,34,0,0,0,0,0,1
02895938,10,4,6,0,1,1,0,1,1
02896250,20,4,16,0,2,2,0,2,1
02896252,7,1,6,0,2,2,0,0,1
02896353,6,2,4,0,2,2,0,1,0
02896390,19,7,12,0,2,2,0,2,1
02896508,23,2,21,0,0,0,0,0,1
02896552,20,3,17,0,1,1,0,1,1
02896700,51,7,44,0,0,0,0,0,1
02896730,22,4,18,0,1,1,0,0,0
02896762,196,10,186,0,0,0,0,0,1
02896868,15,3,12,0,4,1,3,0,1
02897056,28,0,28,0,0,0,0,0,1
02897253,18,4,14,0,1,1,0,1,1
02897384,9,2,7,0,1,1,0,0,0
02897789,64,2,62,0,0,0,0,0,0
02897801,8,4,4,0,1,1,0,0,0
02898090,7,3,4,0,2,2,0,0,1
02898299,9,2,7,0,1,1,0,0,1
02898911,18,0,18,0,0,0,0,0,1
02899038,23,0,23,0,1,1,0,1,1
02899078,11,0,11,0,1,1,0,0,1
02899116,24,2,22,0,1,1,0,1,1
02899235,7,5,2,0,4,3,1,0,1
02899314,55,9,46,0,2,1,1,2,1
02899596,8,0,8,0,0,0,0,0,0
02899608,8,0,8,0,0,0,0,0,0
02899713,31,2,29,0,1,1,0,0,1
02899741,11,0,11,0,3,3,0,1,1
02899870,13,3,10,0,0,0,0,0,1
02900082,31,3,28,0,1,1,0,1,1
02900132,16,3,13,0,1,1,0,0,1
02900137,16,3,13,0,1,1,0,0,1
02900270,28,6,22,0,0,0,0,0,1
02900368,63,8,55,0,1,0,1,0,0
02900446,41,6,35,0,1,1,0,1,1
02900588,4,2,2,0,1,1,0,0,1
02900722,13,3,10,0,1,1,0,1,1
02901034,26,0,26,0,0,0,0,0,1
02901085,79,11,68,0,0,0,0,0,1
02901114,8,1,7,0,1,1,0,0,0
02901124,25,0,25,0,0,0,0,0,1
02901263,17,2,15,0,1,1,0,1,1
02901437,49,5,44,0,1,1,0,1,1
02901456,71,11,60,0,1,1,0,1,1
02901508,68,3,65,0,0,0,0,0,1
02901787,25,3,22,0,2,2,0,2,1
02901790,17,0,17,0,0,0,0,0,1
02902074,36,5,31,0,1,1,0,1,1
02902165,25,3,22,0,1,1,0,1,1
02902170,20,3,17,0,1,1,0,1,1
02902219,18,3,15,0,1,1,0,1,1
02902264,15,3,12,0,1,1,0,1,1
02902302,19,3,16,0,1,1,0,1,1
02902323,16,0,16,0,0,0,0,0,1
02902416,74,4,70,0,1,1,0,1,1
02902472,42,6,36,0,0,0,0,0,1
02902686,36,7,29,0,1,1,0,1,1
02902926,31,5,26,0,1,1,0,1,1
02902958,9,2,7,0,2,2,0,1,1
02903349,18,3,15,0,1,1,0,1,1
02903386,50,13,37,0,0,0,0,0,1
02903443,26,1,25,0,1,1,0,1,1
02903444,17,0,17,0,0,0,0,0,1
02903725,6,4,2,0,1,1,0,1,1
02903749,57,4,53,0,13,7,6,0,0
02903798,5,3,2,0,1,1,0,0,0
02903983,11,3,8,0,1,1,0,0,1
02904044,7,3,4,0,1,1,0,0,1
02904270,18,5,13,0,0,0,0,0,1
02904282,46,5,41,0,2,1,1,2,1
02904326,13,3,10,0,2,2,0,0,1
02904358,22,5,17,0,1,1,0,1,1
02904446,75,10,65,0,0,0,0,0,1
02904478,5,2,3,0,1,1,0,0,0
02904587,91,12,79,0,1,1,0,1,1
02904784,4,3,1,0,2,2,0,0,0
02904831,20,3,17,0,1,1,0,1,1
02904897,29,0,29,0,0,0,0,0,1
02904942,28,5,23,0,2,2,0,2,1
02905273,9,0,9,0,1,1,0,1,1
02905667,15,1,14,0,4,2,2,1,1
02905726,3,2,1,0,1,1,0,0,1
02905740,7,3,4,0,2,1,1,1,0
02905798,6,3,3,0,1,1,0,0,1
02905840,17,0,17,0,0,0,0,0,1
02905925,31,1,30,0,1,1,0,1,1
02905946,13,2,11,0,4,1,3,3,0
02906084,52,6,46,0,1,1,0,1,1
02906109,16,0,16,0,0,0,0,0,1
02906362,50,15,35,0,1,1,0,0,1
02906416,8,3,5,0,2,2,0,0,0
02906527,30,0,30,0,1,1,0,1,1
02906585,27,4,23,0,3,3,0,0,0
02906593,26,7,19,0,1,1,0,1,1
02906681,17,0,17,0,0,0,0,0,1
02906838,48,10,38,0,0,0,0,0,0
02906847,34,0,34,0,0,0,0,0,1
02906848,48,2,46,0,1,1,0,1,1
02906868,28,2,26,0,1,1,0,1,1
02906880,29,3,26,0,1,1,0,1,1
02906991,39,5,34,0,1,1,0,1,1
02906994,35,4,31,0,1,1,0,1,1
02907116,43,12,31,0,1,1,0,1,1
02907167,11,0,11,0,0,0,0,0,1
02907172,82,8,74,0,0,0,0,0,1
02907296,27,3,24,0,0,0,0,0,1
02907403,4,0,4,0,0,0,0,0,0
02907433,14,2,12,0,0,0,0,0,1
02907465,15,3,12,0,1,1,0,1,1
02907543,20,6,14,0,1,1,0,1,1
02907610,36,3,33,0,1,1,0,1,1
02907769,45,0,45,0,1,0,1,0,1
02907797,3,0,3,0,0,0,0,0,1
02907987,14,0,14,0,0,0,0,0,1
02908000,16,3,13,0,1,1,0,1,1
02908082,19,0,19,0,0,0,0,0,1
02908089,16,3,13,0,2,1,1,2,1
02908113,29,1,28,0,1,1,0,1,1
02908142,31,3,28,0,1,1,0,1,1
02908145,12,3,9,0,2,2,0,0,1
02908163,11,2,9,0,1,1,0,0,1
02908288,33,0,33,0,0,0,0,0,1
02908378,36,9,27,0,0,0,0,0,1
02908397,4,0,4,0,0,0,0,0,1
02908452,21,3,18,0,4,1,3,1,1
02908834,26,0,26,0,0,0,0,0,1
02909098,69,13,56,0,0,0,0,0,1
02909192,26,4,22,0,3,3,0,0,1
02909297,15,9,6,0,2,2,0,0,1
02909623,32,7,25,0,0,0,0,0,1
02909638,15,6,9,0,1,1,0,1,0
02909939,37,8,29,0,0,0,0,0,1
02910074,15,2,13,0,2,1,1,1,1
02910116,20,4,16,0,1,1,0,1,1
02910157,12,2,10,0,2,1,1,1,1
02910347,11,2,9,0,1,1,0,1,1
02910752,35,3,32,0,1,1,0,1,1
02910783,18,4,14,0,2,2,0,1,1
02911106,42,5,37,0,7,4,3,0,1
02911143,25,0,25,0,0,0,0,0,1
02911175,22,1,21,0,1,1,0,0,0
02911222,40,10,30,0,0,0,0,0,1
02911350,24,2,22,0,0,0,0,0,1
02911387,7,2,5,0,2,2,0,1,1
02911399,6,0,6,0,1,1,0,0,1
02911543,13,3,10,0,1,1,0,1,1
02911668,31,0,31,0,1,1,0,1,1
02911753,35,5,30,1,0,0,0,0,1
02912114,14,2,12,0,1,1,0,1,1
02912283,5,1,4,0,1,1,0,0,1
02912338,51,2,49,0,1,1,0,1,1
02912437,23,0,23,0,0,0,0,0,1
02912491,8,2,6,0,1,1,0,0,0
02912564,58,14,44,0,0,0,0,0,1
02912638,54,7,47,0,1,1,0,1,1
02912649,8,2,6,0,1,1,0,1,1
02912655,46,5,41,0,0,0,0,0,1
02912767,16,7,9,0,1,1,0,0,1
02912853,71,12,59,0,0,0,0,0,1
02913178,24,0,24,0,0,0,0,0,1
02913191,19,4,15,0,1,1,0,1,1
02913219,18,0,18,0,0,0,0,0,1
02913221,31,7,24,0,0,0,0,0,1
02913278,37,10,27,0,0,0,0,0,1
02913280,30,7,23,0,0,0,0,0,1
02913375,78,15,63,0,0,0,0,0,1
02913554,20,5,15,0,1,1,0,1,1
02913564,13,5,8,0,1,1,0,1,1
02913720,23,2,21,0,1,1,0,1,1
02913827,4,0,4,0,1,1,0,0,1
02914228,18,5,13,0,1,1,0,1,1
02914272,33,0,33,0,0,0,0,0,0
02914327,104,18,86,0,0,0,0,0,1
02914384,89,8,81,0,0,0,0,0,1
02914398,7,3,4,0,2,2,0,0,1
02914479,8,0,8,0,0,0,0,0,1
02914518,2,2,0,0,0,0,0,0,1
02914566,12,3,9,0,3,3,0,0,1
02914750,13,0,13,0,0,0,0,0,1
02914954,27,3,24,0,1,1,0,1,1
02915215,4,2,2,0,1,1,0,0,0
02915273,16,3,13,0,1,1,0,1,1
02915326,10,3,7,0,1,1,0,1,1
02915444,32,2,30,0,1,1,0,1,1
02915554,25,0,25,0,0,0,0,0,1
02915614,29,9,20,0,3,1,2,1,0
02915651,30,11,19,0,1,1,0,1,1
02915907,21,0,21,0,0,0,0,0,1
02916037,36,9,27,0,1,1,0,0,1
02916257,16,4,12,0,0,0,0,0,1
02916314,36,5,31,0,0,0,0,0,1
02916623,7,2,5,0,1,1,0,0,1
02916652,8,2,6,0,2,2,0,0,1
02916683,11,3,8,0,3,3,0,0,0
02917048,59,3,56,0,0,0,0,0,1
02917073,10,2,8,0,2,2,0,1,1
02917294,31,0,31,0,0,0,0,0,1
02917448,16,3,13,0,1,1,0,0,1
02917450,16,3,13,0,1,1,0,0,1
02917479,10,2,8,0,1,1,0,0,1
02917670,14,0,14,0,0,0,0,0,1
02917845,21,2,19,0,0,0,0,0,1
02917861,6,0,6,0,0,0,0,0,1
02918124,37,2,35,0,1,1,0,1,1
02918478,17,3,14,0,2,1,1,0,0
02918492,41,10,31,0,0,0,0,0,1
02918503,13,3,10,0,0,0,0,0,1
02918533,15,0,15,0,0,0,0,0,1
02918727,22,4,18,0,1,1,0,1,1
02918910,14,3,11,0,3,1,2,0,1
02918913,28,3,25,0,1,1,0,1,1
02919246,9,3,6,0,2,2,0,0,0
02919331,24,4,20,0,1,1,0,1,1
02919367,23,4,19,0,1,1,0,1,1
02919781,94,12,82,0,0,0,0,0,1
02920061,37,4,33,0,1,1,0,1,1
02920080,9,3,6,0,1,1,0,0,1
02920164,35,0,35,0,0,0,0,0,1
02920185,7,2,5,0,1,1,0,1,0
02920235,23,0,23,0,0,0,0,0,1
02920335,27,4,23,0,0,0,0,0,1
02920387,30,11,19,0,1,1,0,1,1
02920588,16,3,13,0,1,1,0,1,1
02920711,10,2,8,0,1,1,0,1,0
02920857,19,0,19,0,0,0,0,0,1
02921010,13,4,9,0,0,0,0,0,1
02921143,88,9,79,0,0,0,0,0,1
02921166,5,3,2,0,2,2,0,0,1
02921223,9,2,7,0,2,2,0,0,1
02921263,8,3,5,0,2,2,0,0,1
02921283,22,6,16,0,2,2,0,2,1
02921348,4,3,1,0,2,2,0,0,1
02921414,16,4,12,0,0,0,0,0,1
02921462,49,6,43,0,1,1,0,1,1
02921536,12,0,12,0,1,1,0,1,1
02921607,44,5,39,0,1,1,0,1,1
02921708,5,2,3,0,1,1,0,0,1
02921838,24,4,20,0,1,1,0,1,1
02921854,6,3,3,0,1,1,0,0,1
02921889,11,4,7,0,1,0,1,0,1
02921944,0,0,0,0,0,0,0,0,1
02922108,29,6,23,0,1,1,0,0,1
02922162,34,8,26,0,0,0,0,0,1
02922734,37,5,32,0,1,1,0,1,1
02923018,17,4,13,0,2,2,0,1,1
02923119,17,0,17,0,0,0,0,0,1
02923252,42,6,36,0,1,1,0,1,1
02923255,24,3,21,0,0,0,0,0,1
02923491,15,4,11,0,1,1,0,1,1
02923638,30,6,24,0,1,1,0,0,0
02923647,80,8,72,0,0,0,0,0,1
02923819,7,4,3,0,1,1,0,0,1
02924138,32,1,31,0,1,1,0,1,1
02924157,22,4,18,0,1,1,0,1,1
02924181,11,3,8,0,1,1,0,0,1
02924197,31,0,31,0,1,1,0,1,1
02924211,17,0,17,0,0,0,0,0,1
02924357,42,0,42,1,0,0,0,0,1
02924450,23,5,18,0,1,1,0,1,1
02924472,42,0,42,0,0,0,0,0,1
02924589,10,3,7,0,2,2,0,0,1
02924590,7,3,4,0,2,1,1,0,1
02924707,46,4,42,0,1,1,0,1,1
02924742,28,1,27,0,3,1,2,0,1
02924874,15,3,12,0,1,1,0,1,1
02925286,25,8,17,0,0,0,0,0,1
02925314,16,3,13,0,1,1,0,0,1
02925398,0,0,0,0,0,0,0,0,1
02925485,4,2,2,0,1,1,0,0,1
02925647,23,1,22,0,1,1,0,1,1
02925717,14,1,13,0,3,3,0,2,1
02926194,12,5,7,0,1,1,0,1,1
02926265,8,2,6,0,1,1,0,1,1
02926596,22,4,18,0,0,0,0,0,1
02926656,13,3,10,0,3,1,2,1,0
02926939,18,4,14,0,1,1,0,0,1
02927049,43,5,38,0,1,1,0,1,1
02927112,13,0,13,0,0,0,0,0,1
02927198,14,0,14,0,0,0,0,0,1
02927367,5,3,2,0,2,2,0,0,1
02927397,5,3,2,0,1,1,0,0,1
02927406,4,0,4,0,0,0,0,0,1
02927514,7,0,7,0,1,1,0,1,0
02927565,12,2,10,0,3,2,1,0,1
02927688,68,9,59,0,0,0,0,0,1
02927713,18,4,14,0,0,0,0,0,1
02927965,28,4,24,0,1,1,0,1,1
02928108,5,3,2,0,0,0,0,0,1
02928488,23,2,21,0,1,1,0,1,1
02928598,19,0,19,0,0,0,0,0,1
02928606,9,6,3,0,0,0,0,0,1
02928662,14,5,9,0,1,1,0,1,1
02928687,75,18,57,0,2,1,1,0,1
02928730,10,1,9,0,1,1,0,0,1
02928738,38,8,30,0,0,0,0,0,1
02928759,17,3,14,0,1,1,0,1,0
02928814,0,0,0,0,0,0,0,0,1
02928961,44,6,38,0,0,0,0,0,1
02929077,20,5,15,0,0,0,0,0,1
02929098,27,2,25,0,1,1,0,1,1
02929119,33,6,27,0,0,0,0,0,1
02929253,35,7,28,0,0,0,0,0,1
02929255,16,0,16,0,1,1,0,1,1
02929363,28,3,25,0,1,1,0,1,1
02929641,10,2,8,0,2,1,1,0,1
02929731,13,0,13,0,0,0,0,0,1
02929801,39,4,35,0,1,0,1,1,1
02929880,20,4,16,0,1,1,0,0,1
02929932,8,4,4,0,1,1,0,0,1
07416023,5,0,5,0,0,0,0,0,1
07416230,2,1,1,0,2,1,1,0,0
07416378,11,6,5,0,0,0,0,0,0
07416617,6,3,3,0,1,1,0,1,1
07416643,12,7,5,0,1,1,0,0,0
07416785,2,2,0,0,1,1,0,1,0
07416869,6,3,3,0,5,3,2,0,0
07416901,13,0,13,0,0,0,0,0,1
07416939,3,1,2,0,1,1,0,0,0
07417138,2,2,0,0,2,2,0,0,1
07417300,9,0,9,0,0,0,0,0,1
07417640,1,1,0,0,1,1,0,1,1
07418270,2,1,1,0,1,1,0,0,0
07418397,4,2,2,0,1,1,0,0,1
07418449,3,0,3,0,0,0,0,0,0
07418585,14,0,14,0,1,1,0,0,0
07418645,2,2,0,0,1,1,0,0,1
07419683,4,1,3,0,1,1,0,0,0
07419778,2,2,0,0,2,2,0,0,0
07419788,15,8,7,0,1,1,0,0,1
07420161,4,0,4,0,0,0,0,0,1
07420265,1,1,0,0,1,1,0,0,0
07420347,2,2,0,0,2,2,0,0,0
07420638,3,2,1,0,2,2,0,1,0
07420983,3,2,1,0,2,2,0,0,0
07421232,14,0,14,0,0,0,0,0,1
07421271,5,0,5,0,1,1,0,1,1
07421295,14,4,10,0,0,0,0,0,0
07421548,6,5,1,0,2,2,0,2,1
07422059,7,0,7,0,0,0,0,0,1
07422194,5,2,3,0,1,1,0,1,1
07422199,1,1,0,0,1,1,0,0,0
07422241,6,4,2,0,0,0,0,0,1
07422282,6,0,6,0,1,1,0,1,1
07422319,17,8,9,0,10,3,7,1,0
07422567,2,1,1,0,1,1,0,0,0
07422588,9,3,6,0,1,1,0,1,1
07422922,1,0,1,0,0,0,0,0,1
07422976,2,0,2,0,1,1,0,0,1
07423163,5,0,5,0,0,0,0,0,1
07423404,4,1,3,0,1,1,0,0,1
07423627,3,1,2,0,2,1,1,0,0
07424174,9,4,5,0,0,0,0,0,0
07424514,1,1,0,0,1,1,0,0,0
07424708,1,0,1,0,1,1,0,0,0
07425184,3,1,2,0,1,1,0,0,1
07425371,9,0,9,0,0,0,0,0,1
07425374,28,14,14,0,0,0,0,0,0
07425445,5,5,0,0,0,0,0,0,0
07425487,13,5,8,0,1,1,0,0,1
07425578,16,5,11,0,4,2,2,4,1
07425891,20,11,9,0,0,0,0,0,0
07425897,34,15,19,0,0,0,0,0,1
07426486,3,3,0,0,0,0,0,0,0
07426741,3,2,1,0,1,1,0,0,1
07427026,8,2,6,0,1,1,0,1,1
07427059,3,1,2,0,1,1,0,0,0
07427292,3,3,0,0,3,3,0,0,0
07427401,9,3,6,0,1,1,0,1,1
07427941,2,2,0,0,2,2,0,0,0
07428253,2,0,2,0,1,1,0,0,1
07428335,10,4,6,0,1,1,0,1,1
07428531,10,0,10,0,1,1,0,1,0
07428554,2,1,1,0,1,1,0,0,1
07428615,8,6,2,0,0,0,0,0,1
07428895,1,1,0,0,1,1,0,0,0
07428954,2,0,2,0,0,0,0,0,0
07429586,3,2,1,0,1,1,0,0,1
07429919,28,10,18,0,0,0,0,0,0
07430058,2,0,2,0,0,0,0,0,1
07430135,2,2,0,0,2,2,0,0,1
07430281,4,2,2,0,0,0,0,0,0
07430317,26,14,12,0,0,0,0,0,0
07430472,2,2,0,0,2,2,0,0,1
07430535,4,2,2,0,1,1,0,0,0
07430619,2,2,0,0,2,2,0,1,0
07430686,7,4,3,1,3,1,2,3,1
07431220,11,4,7,0,5,0,5,0,0
07431392,2,2,0,0,1,1,0,0,0
07431494,17,0,17,0,2,1,1,2,1
07431607,8,4,4,0,2,1,1,1,0
07433236,4,4,0,0,0,0,0,0,1
07433244,7,1,6,0,2,2,0,1,0
07433423,5,0,5,0,1,1,0,0,1
07434201,3,2,1,0,0,0,0,0,0
07434350,20,5,15,0,0,0,0,0,1
07434415,3,3,0,0,2,2,0,0,0
07434476,2,2,0,0,2,2,0,0,1
07434518,5,4,1,0,0,0,0,0,0
07434551,3,3,0,0,1,1,0,0,0
07434617,1,1,0,0,1,1,0,0,0
07435186,5,2,3,0,1,1,0,1,1
07435210,5,2,3,0,1,1,0,1,1
07435459,2,2,0,0,1,1,0,0,0
07435521,17,6,11,0,2,2,0,2,1
07435572,2,0,2,0,0,0,0,0,1
07435646,5,4,1,0,1,1,0,0,0
07435706,11,2,9,0,1,1,0,1,1
07435839,13,0,13,0,0,0,0,0,1
07435953,3,0,3,0,0,0,0,0,0
07435991,5,0,5,0,3,3,0,0,1
07436054,1,0,1,0,0,0,0,0,0
07436169,4,2,2,0,1,1,0,1,1
07436350,9,6,3,0,0,0,0,0,1
07436448,1,0,1,0,1,1,0,0,0
07437287,2,1,1,0,1,1,0,0,1
07438619,2,0,2,0,0,0,0,0,1
07438666,1,1,0,0,1,1,0,0,0
07439393,2,2,0,0,1,1,0,0,1
07439594,1,0,1,0,0,0,0,0,1
07440313,1,1,0,0,1,1,0,0,0
07440386,3,0,3,0,0,0,0,0,0
07440858,1,1,0,0,1,1,0,1,0
07441654,4,2,2,0,1,1,0,0,1
07442383,4,3,1,0,2,1,1,0,0
07442643,3,0,3,0,1,1,0,0,1
07442751,1,1,0,0,1,1,0,0,0
07442803,13,3,10,0,5,2,3,0,1
07442885,4,0,4,0,1,1,0,1,1
07443123,9,2,7,0,1,1,0,1,1
07443251,3,3,0,0,2,2,0,0,1
07443267,3,0,3,0,0,0,0,0,1
07443536,2,2,0,0,1,1,0,1,0
07443660,6,5,1,0,0,0,0,0,1
07443987,3,0,3,0,0,0,0,0,1
07444179,9,6,3,0,7,5,2,0,1
07444180,6,0,6,0,1,1,0,1,1
07444269,13,7,6,0,0,0,0,0,1
07444586,4,2,2,0,1,1,0,0,1
07444737,26,4,22,0,1,1,0,1,1
07444776,7,0,7,0,0,0,0,0,1
07444825,3,3,0,0,1,1,0,0,0
07445493,39,15,24,0,3,0,3,0,0
07445684,5,1,4,0,4,4,0,0,1
07445735,6,1,5,0,4,4,0,0,1
07446111,3,2,1,0,1,1,0,0,0
07446228,2,0,2,0,0,0,0,0,0
07446749,15,7,8,0,0,0,0,0,1
07446775,1,1,0,0,1,1,0,0,0
07447077,4,0,4,0,0,0,0,0,1
07447124,5,3,2,0,3,2,1,0,1
07447160,3,0,3,0,0,0,0,0,0
07447290,4,2,2,0,2,2,0,0,0
07447392,2,1,1,0,1,1,0,0,1
07447468,2,0,2,0,0,0,0,0,1
07447497,33,17,16,0,0,0,0,0,1
07448220,3,2,1,0,1,1,0,0,1
07448315,5,1,4,0,0,0,0,0,1
07448468,4,0,4,0,1,1,0,0,0
07448647,8,2,6,0,1,1,0,1,1
07448668,5,0,5,0,0,0,0,0,1
07448778,2,1,1,0,1,1,0,0,1
07449136,33,13,20,0,0,0,0,0,1
07449255,9,4,5,0,1,1,0,1,1
07450353,3,0,3,0,0,0,0,0,1
07450373,6,0,6,0,0,0,0,0,1
07450392,13,5,8,0,0,0,0,0,1
07451013,2,0,2,0,2,2,0,0,0
07451077,2,0,2,0,1,1,0,0,1
07451571,41,13,28,0,0,0,0,0,1
07451590,5,0,5,0,1,1,0,0,0
07452726,1,1,0,0,2,1,1,0,0
07452787,10,3,7,0,0,0,0,0,1
07452872,6,2,4,0,1,1,0,1,1
07452976,11,5,6,0,0,0,0,0,0
07453039,17,7,10,0,1,1,0,1,1
07453126,4,3,1,0,1,1,0,0,1
07453228,6,4,2,0,3,3,0,0,1
07453308,4,2,2,0,1,1,0,1,1
07453779,2,2,0,0,2,2,0,0,0
07454107,4,2,2,0,1,1,0,0,1
07454147,7,0,7,0,0,0,0,0,1
07454321,3,2,1,0,1,1,0,0,1
07454604,1,0,1,0,0,0,0,0,1
07454631,4,3,1,0,1,1,0,0,1
07454767,1,1,0,0,1,1,0,0,0
07454852,7,0,7,0,0,0,0,0,1
07455283,3,3,0,0,2,2,0,0,1
07455304,4,0,4,0,0,0,0,0,1
07455452,35,13,22,0,0,0,0,0,0
07455521,1,1,0,0,1,1,0,0,0
07455608,5,0,5,0,2,2,0,0,1
07456027,2,2,0,0,1,1,0,0,0
07456048,1,1,0,0,1,1,0,0,0
07456185,14,5,9,0,0,0,0,0,0
07456226,3,2,1,0,1,1,0,0,1
07456273,2,1,1,0,1,1,0,0,0
07456396,7,3,4,0,2,1,1,2,1
07457183,1,0,1,0,0,0,0,0,0
07457716,2,2,0,0,1,1,0,0,1
07457867,26,11,15,0,0,0,0,0,0
07457884,2,1,1,0,1,1,0,0,1
07458046,2,0,2,0,0,0,0,0,0
07458217,9,6,3,0,1,1,0,0,1
07458285,5,1,4,0,1,1,0,1,1
07458529,33,7,26,0,0,0,0,0,1
07458638,3,0,3,0,0,0,0,0,1
07458758,3,0,3,0,0,0,0,0,1
07458925,4,3,1,0,1,1,0,0,1
07459325,2,0,2,0,0,0,0,0,0
07459500,1,0,1,0,0,0,0,0,1
07459742,28,10,18,0,4,3,1,0,0
07459811,2,0,2,0,0,0,0,0,0
07460062,1,0,1,0,1,1,0,0,1
07460237,3,0,3,0,0,0,0,0,1
07460395,1,0,1,0,1,1,0,0,0
07460411,1,1,0,0,1,1,0,0,0
07460508,3,3,0,0,0,0,0,0,1
07460865,4,1,3,0,1,1,0,0,1
07460907,17,5,12,0,0,0,0,0,1
07461122,5,3,2,0,1,1,0,1,0
07461147,61,52,9,0,2,2,0,1,0
07461173,43,20,23,0,0,0,0,0,1
07461381,24,10,14,0,0,0,0,0,0
07461969,1,1,0,0,1,1,0,0,0
07461988,37,10,27,0,0,0,0,0,0
07462734,15,6,9,0,1,1,0,1,1
07462747,10,3,7,0,1,1,0,1,0
07463028,14,7,7,0,2,1,1,1,0
07463067,16,0,16,0,0,0,0,0,1
07463088,3,2,1,0,3,3,0,0,1
07463419,6,0,6,0,0,0,0,0,1
07463779,8,5,3,0,4,4,0,0,1
07463927,8,7,1,0,2,2,0,2,0
07463976,7,3,4,0,1,1,0,1,1
07463998,14,1,13,0,1,1,0,1,0
07464020,3,2,1,0,1,1,0,0,0
07464111,1,1,0,0,1,1,0,0,0
07464420,2,2,0,0,2,2,0,0,0
07464593,2,2,0,0,2,2,0,0,0
07465215,8,0,8,0,0,0,0,0,1
07465295,1,1,0,0,1,1,0,0,0
07465428,1,1,0,0,1,1,0,0,0
07465435,12,4,8,0,2,2,0,2,1
07465520,39,13,26,0,4,3,1,0,0
07465711,6,3,3,0,1,1,0,1,1
07466232,3,2,1,0,1,1,0,0,0
07466519,13,0,13,0,0,0,0,0,1
07466695,3,0,3,0,0,0,0,0,1
07466696,1,0,1,0,0,0,0,0,0
07467283,1,0,1,0,0,0,0,0,1
07467780,4,0,4,0,0,0,0,0,1
07467849,3,2,1,0,2,2,0,0,1
07467935,6,5,1,0,0,0,0,0,1
07468205,6,0,6,0,0,0,0,0,1
07468501,5,0,5,0,0,0,0,0,1
07468546,11,6,5,0,2,2,0,0,1
07468558,10,0,10,0,2,2,0,0,1
07468571,9,4,5,0,2,2,0,0,1
07468582,11,5,6,0,1,1,0,0,1
07468597,9,4,5,0,2,2,0,0,1
07469226,1,1,0,0,1,1,0,0,0
07469330,38,21,17,0,1,1,0,1,1
07469370,3,0,3,0,2,2,0,0,1
07469385,4,1,3,0,1,1,0,0,1
07469437,7,3,4,0,2,2,0,1,0
07469528,10,7,3,0,0,0,0,0,1
07469616,3,0,3,0,1,1,0,0,0
07470231,2,0,2,0,0,0,0,0,1
07470381,4,3,1,0,1,1,0,0,1
07470419,4,2,2,0,2,2,0,0,1
07470610,2,1,1,0,1,1,0,0,0
07470768,3,0,3,0,0,0,0,0,1
07470849,4,0,4,0,2,2,0,0,1
07471505,6,0,6,0,0,0,0,0,0
07471693,4,4,0,0,3,3,0,0,1
07471734,30,12,18,0,3,2,1,0,1
07471754,8,2,6,1,0,0,0,0,1
07472112,1,1,0,0,2,1,1,0,0
07472116,2,1,1,0,1,1,0,0,0
07472125,1,1,0,0,1,1,0,0,0
07472200,24,11,13,0,0,0,0,0,1
07472348,11,2,9,0,1,1,0,1,1
07472682,3,2,1,0,2,1,1,2,1
07472799,32,8,24,0,0,0,0,0,1
07472920,4,2,2,0,1,1,0,0,0
07472997,14,3,11,0,1,1,0,1,1
07473044,15,0,15,0,1,1,0,0,1
07473069,6,0,6,0,1,1,0,1,0
07473073,11,6,5,0,1,1,0,1,1
07473097,3,1,2,0,1,1,0,0,0
07473177,11,0,11,0,1,1,0,1,1
07473223,6,0,6,0,2,1,1,2,0
07473326,3,0,3,0,0,0,0,0,1
07473409,2,1,1,0,1,1,0,1,0
07473477,3,0,3,0,0,0,0,0,1
07473958,1,0,1,0,0,0,0,0,1
07474041,2,2,0,0,2,2,0,0,0
07474404,7,5,2,0,1,1,0,1,1
07474406,10,2,8,0,3,1,2,3,0
07474461,2,2,0,0,1,1,0,0,0
07474948,12,8,4,0,0,0,0,0,1
07475104,10,7,3,2,3,1,2,1,0
07475194,15,5,10,0,1,1,0,1,1
07475888,3,0,3,0,2,2,0,0,1
07476339,2,1,1,0,4,3,1,0,0
07476413,11,4,7,0,0,0,0,0,1
07476462,41,3,38,0,1,1,0,1,1
07476998,2,1,1,0,2,1,1,0,0
07477111,3,3,0,0,2,2,0,0,0
07477164,1,1,0,0,1,1,0,0,0
07477668,13,6,7,0,0,0,0,0,1
07477770,17,4,13,0,2,2,0,2,1
07477777,7,1,6,0,1,0,1,1,1
07477778,8,0,8,0,0,0,0,0,0
07477841,16,0,16,0,0,0,0,0,1
07478141,2,1,1,0,1,1,0,0,0
07478372,1,1,0,0,1,1,0,0,0
07478393,1,1,0,0,1,1,0,0,0
07478562,3,2,1,0,2,2,0,0,0
07479562,17,9,8,0,1,0,1,0,0
07479572,5,1,4,0,1,1,0,0,0
07479733,19,4,15,0,1,0,1,0,0
07479803,11,3,8,0,1,1,0,0,0
07479835,3,2,1,0,1,1,0,0,0
07479972,14,12,2,0,1,1,0,0,1
07480153,3,0,3,0,0,0,0,0,1
07480565,4,2,2,0,1,1,0,0,1
07480622,2,2,0,0,1,1,0,0,0
07481069,12,2,10,0,0,0,0,0,0
07481177,2,2,0,0,2,2,0,0,1
07481195,7,2,5,0,1,1,0,0,1
07481482,3,2,1,0,1,1,0,0,0
07481485,3,3,0,0,2,2,0,0,0
07482186,1,1,0,0,1,1,0,0,0
07482264,3,0,3,0,0,0,0,0,1
07482355,2,0,2,0,0,0,0,0,0
07482448,2,2,0,0,1,1,0,0,1
07482461,8,3,5,0,2,2,0,1,1
07482548,6,2,4,0,1,1,0,0,1
07482925,4,0,4,0,0,0,0,0,1
07483192,1,1,0,0,1,1,0,0,0
07483287,4,0,4,0,1,1,0,1,0
07483503,2,2,0,0,2,2,0,0,1
07483659,6,1,5,0,1,1,0,0,1
07483722,7,3,4,0,2,2,0,1,1
07483787,1,0,1,0,0,0,0,0,1
07484170,3,2,1,0,2,2,0,1,0
07484197,1,1,0,0,1,1,0,0,0
07484310,10,4,6,0,2,1,1,1,0
07484439,5,3,2,0,2,1,1,1,1
07484440,5,3,2,0,2,1,1,1,1
07484443,5,3,2,0,2,1,1,1,1
07484541,5,3,2,0,2,1,1,1,1
07484546,5,3,2,0,2,1,1,1,1
07484553,5,3,2,0,2,1,1,1,1
07484575,5,3,2,0,2,1,1,1,1
07484805,5,3,2,0,2,1,1,1,1
07484831,5,3,2,0,2,1,1,1,1
07484836,5,3,2,0,2,1,1,1,1
07484865,9,6,3,0,1,1,0,1,1
07484884,2,2,0,0,1,1,0,0,1
07484940,5,3,2,0,2,1,1,1,1
07484977,5,3,2,0,2,1,1,1,1
07484982,5,3,2,0,2,1,1,1,1
07485242,8,4,4,0,0,0,0,0,1
07485257,2,2,0,0,1,1,0,0,0
07485466,40,18,22,0,1,1,0,0,0
07485525,14,2,12,0,1,1,0,1,1
07485723,5,3,2,0,2,1,1,1,1
07485729,5,3,2,0,2,1,1,1,1
07485739,5,3,2,0,2,1,1,1,1
07485783,5,3,2,0,2,1,1,1,1
07486088,1,1,0,0,1,1,0,0,0
07486412,4,1,3,0,2,1,1,0,0
07486676,3,2,1,0,2,2,0,0,0
07486782,2,2,0,0,2,2,0,0,0
07487231,12,0,12,0,0,0,0,0,1
07487384,5,2,3,0,0,0,0,0,1
07487488,8,1,7,0,2,1,1,1,1
07488061,6,5,1,0,1,1,0,0,0
07488392,1,0,1,0,0,0,0,0,0
07488689,2,1,1,0,2,1,1,1,1
07488695,2,2,0,0,1,1,0,0,1
07488792,2,1,1,0,2,2,0,0,1
07488898,15,5,10,0,0,0,0,0,1
07488901,14,5,9,0,1,1,0,1,1
07489014,3,3,0,0,2,2,0,0,0
07489109,5,3,2,0,1,1,0,0,0
07489217,4,0,4,0,0,0,0,0,0
07489336,2,0,2,0,0,0,0,0,1
07489639,1,1,0,0,1,1,0,0,0
08195101,1,1,0,0,1,1,0,0,0
08195102,2,2,0,0,1,1,0,0,0
08195215,5,2,3,0,2,2,0,0,1
08195416,2,1,1,0,1,1,0,0,0
08195533,6,5,1,0,2,2,0,0,1
08195835,4,2,2,0,1,1,0,0,0
08196283,4,3,1,0,1,1,0,1,1
08196295,7,4,3,0,1,1,0,1,1
08196503,2,2,0,0,1,1,0,0,0
08196566,24,0,24,0,0,0,0,0,1
08196621,5,4,1,0,0,0,0,0,0
08196643,1,1,0,0,1,1,0,0,0
08196681,10,0,10,0,0,0,0,0,1
08196739,1,1,0,0,1,1,0,0,0
08196830,6,2,4,0,1,1,0,1,1
08197047,1,0,1,0,0,0,0,0,0
08197273,2,2,0,0,2,2,0,0,0
08197400,4,1,3,0,2,1,1,0,1
08197670,4,0,4,0,0,0,0,0,1
08197840,1,1,0,0,2,2,0,0,0
08197966,25,6,19,0,1,1,0,1,1
08198110,3,0,3,0,0,0,0,0,1
08198119,2,1,1,0,0,0,0,0,0
08198132,1,0,1,0,0,0,0,0,0
08198157,3,0,3,0,0,0,0,0,1
08198220,3,0,3,0,0,0,0,0,1
08198452,3,2,1,0,2,1,1,1,0
08198531,1,0,1,0,0,0,0,0,1
08198858,7,0,7,0,0,0,0,0,0
08198928,5,3,2,0,1,1,0,0,1
08198980,24,9,15,0,0,0,0,0,0
08199743,5,5,0,0,0,0,0,0,0
08200090,3,0,3,0,0,0,0,0,1
08200370,1,0,1,0,0,0,0,0,0
08200466,3,0,3,0,0,0,0,0,1
08200600,2,2,0,0,1,1,0,0,0
08200665,9,3,6,0,1,1,0,0,0
08201235,1,1,0,0,1,1,0,0,0
08201426,2,1,1,0,1,1,0,0,0
08201487,6,4,2,0,1,1,0,1,0
08202145,2,0,2,0,1,0,1,0,0
08202222,2,2,0,0,1,1,0,0,1
08202231,1,0,1,0,0,0,0,0,1
08202482,2,2,0,0,2,2,0,0,0
08202792,4,3,1,0,1,1,0,0,0
08202835,2,2,0,0,2,2,0,0,1
08203080,17,6,11,0,6,3,3,2,1
08203264,10,5,5,0,1,1,0,1,1
08203526,5,3,2,0,3,3,0,0,0
08203605,1,1,0,0,1,1,0,0,0
08204034,2,0,2,0,1,1,0,0,1
08204180,1,0,1,0,0,0,0,0,1
08204212,2,0,2,0,1,1,0,0,0
08204619,2,0,2,0,0,0,0,0,1
08205021,35,16,19,0,0,0,0,0,1
08205091,3,1,2,0,1,1,0,0,0
08205409,2,0,2,0,0,0,0,0,0
08205463,7,1,6,0,1,1,0,1,1
08205954,3,0,3,0,0,0,0,0,0
08206502,21,13,8,0,0,0,0,0,1
08207150,5,1,4,0,4,1,3,4,1
08208097,2,1,1,0,1,1,0,0,0
08208245,4,4,0,0,1,1,0,1,0
08208682,5,3,2,0,1,1,0,0,0
08208956,1,0,1,0,0,0,0,0,0
08209427,2,0,2,0,0,0,0,0,1
08209619,3,2,1,0,1,1,0,0,0
08209734,2,0,2,0,0,0,0,0,0
08209968,2,0,2,0,2,2,0,0,0
08210217,15,12,3,0,0,0,0,0,1
08211018,1,0,1,0,0,0,0,0,1
08211563,2,2,0,0,1,1,0,0,0
08211970,3,2,1,0,1,1,0,0,0
08211971,3,3,0,0,0,0,0,0,1
08212123,2,0,2,0,0,0,0,0,1
08212217,3,3,0,0,1,1,0,0,1
08212242,1,0,1,0,1,1,0,0,1
08212566,3,0,3,0,0,0,0,0,1
08213053,9,7,2,0,2,0,2,0,1
08213686,1,1,0,0,1,1,0,0,0
08213847,9,5,4,0,0,0,0,0,1
08213929,1,0,1,0,0,0,0,0,0
08213964,9,0,9,0,0,0,0,0,1
08214201,1,1,0,0,1,1,0,0,0
08214746,2,0,2,0,0,0,0,0,1
08214819,2,2,0,0,1,1,0,0,1
08214904,2,0,2,0,0,0,0,0,1
08215242,6,3,3,0,1,1,0,1,1
08215328,1,1,0,0,1,1,0,0,0
08215397,9,3,6,0,6,2,4,0,1
08215875,1,1,0,0,1,1,0,0,0
08216069,2,2,0,0,2,2,0,0,1
08216900,1,0,1,0,0,0,0,0,0
08217363,3,3,0,0,1,1,0,0,0
08217485,2,2,0,0,1,1,0,0,0
08217842,1,1,0,0,1,1,0,0,1
08218136,2,0,2,0,0,0,0,0,1
08218874,2,0,2,0,0,0,0,0,0
08218875,1,0,1,0,0,0,0,0,0
08219394,2,2,0,0,1,1,0,0,0
08219440,4,0,4,0,1,1,0,1,1
08219624,3,0,3,0,0,0,0,0,1
08220339,3,3,0,0,2,2,0,0,0
08220509,9,3,6,0,0,0,0,0,0
08220515,1,0,1,0,0,0,0,0,0
08220719,5,1,4,0,1,1,0,1,1
08220978,10,6,4,0,2,2,0,0,0
08221088,21,9,12,0,5,0,5,2,1
08221183,6,4,2,0,0,0,0,0,0
08221734,2,2,0,0,2,2,0,0,0
08222606,7,0,7,0,2,1,1,2,1
08222685,4,3,1,0,1,1,0,0,0
08222734,2,0,2,0,1,1,0,0,0
08223049,8,2,6,0,1,1,0,1,1
08223187,14,4,10,0,0,0,0,0,1
08224216,26,16,10,0,5,4,1,1,0
08224404,7,4,3,0,2,1,1,2,1
08224477,9,0,9,0,1,1,0,1,1
08224514,8,1,7,0,2,1,1,2,1
08224605,9,0,9,0,1,1,0,0,1
08224627,14,8,6,0,0,0,0,0,0
08224707,2,0,2,0,0,0,0,0,0
08224902,18,12,6,0,0,0,0,0,0
08224945,2,0,2,0,1,1,0,0,0
08225217,2,1,1,0,1,1,0,0,1
08225256,3,2,1,0,1,1,0,0,0
08225388,1,0,1,0,0,0,0,0,1
08225496,1,0,1,0,0,0,0,0,1
08225670,3,2,1,0,1,1,0,0,1
08225701,2,0,2,0,0,0,0,0,1
08225705,2,1,1,0,1,1,0,0,1
08225803,2,0,2,0,0,0,0,0,1
08226777,9,5,4,0,1,1,0,0,0
08226852,13,2,11,0,1,1,0,1,1
08226854,3,3,0,0,2,2,0,0,0
08226902,13,2,11,0,1,1,0,1,1
08227300,5,3,2,0,1,1,0,0,1
08228251,3,3,0,0,3,3,0,0,1
08228319,3,3,0,0,3,3,0,0,0
08228630,2,2,0,0,1,1,0,1,0
08229577,1,1,0,0,1,1,0,0,0
08230210,1,1,0,0,1,1,0,0,1
08230252,3,1,2,0,2,1,1,0,0
08230280,6,1,5,0,2,1,1,0,0
08230468,2,1,1,0,3,3,0,0,0
08230492,2,2,0,0,2,2,0,0,0
08230534,4,2,2,0,1,1,0,1,0
08230538,10,4,6,0,1,1,0,1,1
08230738,1,1,0,0,1,1,0,0,0
08230916,22,11,11,0,0,0,0,0,0
08231157,1,1,0,0,1,1,0,0,0
08231296,3,2,1,0,4,1,3,1,0
08231682,1,1,0,0,1,1,0,0,0
08231780,3,2,1,0,3,2,1,0,0
08232110,7,3,4,1,3,1,2,1,0
08232211,2,0,2,0,1,1,0,0,0
08232261,2,0,2,0,1,1,0,0,1
08232582,1,1,0,0,1,1,0,0,1
08232930,2,1,1,0,1,1,0,1,0
08233312,1,1,0,0,1,1,0,0,1
08233438,7,3,4,0,0,0,0,0,0
08233496,8,8,0,0,0,0,0,0,0
08233744,2,1,1,0,0,0,0,0,0
08233813,11,6,5,0,0,0,0,0,0
08233891,8,4,4,0,1,1,0,0,1
08234049,1,1,0,0,1,1,0,0,0
08234330,1,1,0,0,1,1,0,0,0
08234474,3,0,3,0,2,2,0,0,1
08234554,3,0,3,0,0,0,0,0,1
08234573,1,0,1,0,0,0,0,0,1
08235263,3,3,0,0,2,2,0,0,1
08235493,13,5,8,0,1,1,0,1,1
08235495,13,5,8,0,1,1,0,1,1
08235892,24,15,9,0,0,0,0,0,1
08236188,2,2,0,0,2,2,0,0,0
08236423,7,3,4,0,0,0,0,0,1
08237164,6,5,1,0,1,1,0,1,1
08237374,4,0,4,0,0,0,0,0,1
08238527,1,1,0,0,1,1,0,0,0
08238750,2,2,0,0,1,1,0,0,0
08239370,4,2,2,0,1,1,0,0,1
08239535,4,2,2,0,1,1,0,0,0
08239538,1,1,0,0,1,1,0,0,1
08239750,16,5,11,0,1,1,0,1,1
08239989,6,3,3,0,1,0,1,0,1
08239991,1,0,1,0,0,0,0,0,0
08240548,2,0,2,0,0,0,0,0,1
08240550,7,0,7,0,1,1,0,1,1
08240583,2,2,0,0,1,1,0,0,0
08240609,8,3,5,0,3,3,0,1,1
08240940,3,3,0,0,1,1,0,0,0
08240960,6,0,6,0,0,0,0,0,0
08241158,12,6,6,0,1,1,0,1,1
08241286,1,0,1,0,1,1,0,0,0
08241623,5,4,1,0,0,0,0,0,1
08241880,10,3,7,0,0,0,0,0,1
08242625,7,5,2,0,1,1,0,1,0
08243309,2,2,0,0,2,2,0,0,0
08243480,2,0,2,0,0,0,0,0,0
08243718,21,11,10,0,0,0,0,0,1
08244211,5,5,0,0,0,0,0,0,0
08244338,6,4,2,0,3,2,1,1,1
08244585,63,38,25,0,0,0,0,0,0
08245156,4,1,3,0,1,1,0,0,0
08245482,3,3,0,0,3,3,0,0,1
08245597,1,1,0,0,1,1,0,0,0
08245822,4,0,4,0,0,0,0,0,1
08246407,25,12,13,0,0,0,0,0,1
08246544,1,1,0,0,1,1,0,0,0
08246817,1,1,0,0,1,1,0,0,0
08246908,2,2,0,0,1,1,0,0,0
08247225,1,1,0,0,1,1,0,0,0
08247243,3,1,2,0,0,0,0,0,1
08247247,3,0,3,0,0,0,0,0,1
08247269,2,2,0,0,1,1,0,0,0
08247283,2,2,0,0,2,2,0,0,0
08248102,1,1,0,0,1,1,0,0,0
08248158,1,1,0,0,0,0,0,0,1
08248484,4,0,4,0,3,3,0,0,1
08248561,2,2,0,0,1,1,0,0,1
08248581,5,0,5,0,0,0,0,0,1
08248932,1,1,0,0,1,1,0,0,0
08249117,2,2,0,0,2,2,0,0,0
08249160,6,2,4,0,2,2,0,0,1
08249167,10,2,8,0,3,2,1,3,1
08249172,8,3,5,1,1,1,0,1,1
08249211,2,1,1,0,2,1,1,0,0
08249262,2,1,1,0,1,1,0,0,0
08249914,12,0,12,0,1,1,0,1,1
08249948,12,0,12,1,1,1,0,1,1
08250134,5,0,5,0,2,2,0,0,1
08250305,7,5,2,0,1,1,0,0,1
08250377,3,2,1,0,2,1,1,0,0
08250658,2,0,2,0,0,0,0,0,1
08250810,3,0,3,0,0,0,0,0,1
08250837,4,0,4,0,0,0,0,0,0
08251061,3,0,3,0,0,0,0,0,1
08251122,1,1,0,0,1,1,0,0,0
08251326,4,4,0,0,5,5,0,1,1
08251500,2,1,1,0,1,1,0,0,0
08251960,2,2,0,0,1,1,0,0,0
08252536,2,0,2,0,0,0,0,0,0
08252639,26,10,16,0,0,0,0,0,1
08252651,8,0,8,0,0,0,0,0,1
08253207,3,0,3,0,1,1,0,0,0
08253238,2,0,2,0,0,0,0,0,1
08253452,7,4,3,0,4,1,3,2,0
08253576,4,0,4,0,2,2,0,0,1
08253617,1,1,0,0,1,1,0,0,0
08254177,2,0,2,0,0,0,0,0,1
08254235,6,2,4,0,1,1,0,1,1
08254642,7,5,2,0,2,2,0,2,1
08254664,1,1,0,0,1,1,0,0,0
08254863,11,4,7,0,1,1,0,1,1
08254903,13,5,8,0,0,0,0,0,0
08254982,9,1,8,0,2,1,1,0,0
08255003,1,1,0,0,1,1,0,0,0
08255024,1,0,1,0,0,0,0,0,1
08255056,2,0,2,0,0,0,0,0,0
08255588,6,3,3,0,1,1,0,1,1
08255664,5,4,1,0,3,3,0,0,0
08255706,3,1,2,0,1,1,0,0,0
08256142,5,4,1,0,1,1,0,1,1
08256148,6,5,1,0,1,1,0,1,1
08256300,3,0,3,0,0,0,0,0,0
08256340,6,3,3,0,0,0,0,0,0
08256463,4,3,1,0,1,1,0,0,1
08256622,5,0,5,0,0,0,0,0,1
08256800,8,0,8,0,0,0,0,0,1
08257195,2,2,0,0,2,2,0,0,0
08257392,31,15,16,0,0,0,0,0,1
08257461,21,3,18,0,0,0,0,0,1
08257472,6,3,3,0,0,0,0,0,0
08257511,5,0,5,0,0,0,0,0,1
08257539,5,3,2,0,3,2,1,0,0
08257570,3,1,2,0,1,1,0,0,1
08257650,3,0,3,0,0,0,0,0,1
08257661,3,3,0,0,2,2,0,0,0
08257814,16,11,5,0,1,1,0,1,1
08257883,29,13,16,0,0,0,0,0,1
08257942,13,2,11,0,1,1,0,1,1
08258030,4,4,0,0,0,0,0,0,0
08258198,6,4,2,0,2,1,1,1,1
08258425,2,0,2,0,0,0,0,0,0
08258475,1,0,1,0,1,1,0,0,0
08258855,2,1,1,0,2,2,0,0,0
08259027,17,6,11,0,2,0,2,0,1
08259045,10,4,6,0,0,0,0,0,0
08259069,25,12,13,0,5,3,2,0,0
08259197,10,6,4,0,1,1,0,1,1
08259233,2,2,0,0,1,1,0,0,0
08259411,37,15,22,0,0,0,0,0,0
08259606,6,3,3,0,1,1,0,1,1
08259654,23,11,12,0,0,0,0,0,0
08259714,7,3,4,0,1,1,0,1,1
08259742,6,3,3,0,1,1,0,1,1
08259814,5,5,0,1,0,0,0,0,1
08259842,1,0,1,0,1,1,0,0,1
08260073,1,0,1,0,1,1,0,0,1
08260217,5,0,5,0,0,0,0,0,1
08260710,9,6,3,0,1,1,0,1,1
08260754,2,2,0,0,1,1,0,0,0
08260807,6,4,2,0,1,1,0,1,1
08260933,6,4,2,0,1,1,0,1,1
08260934,1,1,0,0,1,1,0,0,1
08261036,13,6,7,0,1,1,0,0,1
08263027,3,0,3,0,0,0,0,0,1
08263118,4,4,0,0,0,0,0,0,1
08263187,6,3,3,0,1,1,0,1,1
08263484,1,1,0,0,1,1,0,0,0
08263487,9,3,6,0,1,1,0,1,0
08264728,6,1,5,0,1,1,0,1,1
08264790,2,0,2,0,0,0,0,0,1
08264962,2,1,1,0,1,1,0,0,0
08265030,5,4,1,0,1,1,0,0,0
08265047,5,4,1,0,1,1,0,0,0
08265961,3,2,1,0,0,0,0,0,0
08265992,2,0,2,0,1,1,0,0,0
08266005,9,5,4,0,0,0,0,0,0
08266903,2,2,0,0,2,2,0,0,0
08267419,1,0,1,0,0,0,0,0,1
08267508,3,2,1,0,1,1,0,0,0
08267580,1,1,0,0,1,1,0,0,0
08267613,2,2,0,0,1,1,0,0,0
08267703,30,5,25,0,1,1,0,0,1
08267756,4,0,4,0,0,0,0,0,1
08268240,1,1,0,0,1,1,0,0,0
08268504,1,0,1,0,0,0,0,0,0
08268532,1,1,0,0,1,1,0,0,0
08268543,2,2,0,0,1,1,0,0,0
08268723,1,1,0,0,1,1,0,0,0
08268976,10,3,7,0,1,1,0,1,1
08269121,2,2,0,0,1,1,0,0,1
08269213,3,0,3,0,0,0,0,0,0
08269385,3,3,0,0,1,1,0,1,0
08269458,2,2,0,0,2,2,0,0,0
08269806,1,1,0,0,1,1,0,0,0
08269852,3,3,0,0,2,1,1,2,1
08269983,7,2,5,0,2,2,0,0,0
SC102875,24,2,22,0,1,1,0,1,1
SC102881,31,5,26,0,0,0,0,0,1
SC102894,6,1,5,0,1,1,0,0,0
SC102957,56,3,53,0,2,1,1,2,1
SC102981,16,4,12,0,3,3,0,0,1
SC103046,95,16,79,0,0,0,0,0,1
SC103082,39,6,33,0,0,0,0,0,1
SC103091,41,0,41,0,0,0,0,0,1
SC103256,53,3,50,0,1,1,0,1,1
SC103343,6,0,6,1,0,0,0,0,1
SC103423,64,10,54,0,1,1,0,1,0
SC103739,27,2,25,0,1,1,0,1,1
SC103778,9,3,6,0,0,0,0,0,0
SC103809,19,5,14,1,1,1,0,0,1
SC103840,77,14,63,0,1,1,0,1,1
SC103899,51,11,40,0,0,0,0,0,1
SC103904,77,11,66,0,1,1,0,0,1
SC103912,10,3,7,0,1,1,0,1,1
SC103915,39,6,33,0,0,0,0,0,1
SC103964,2,1,1,0,0,0,0,0,1
SC104030,17,0,17,0,0,0,0,0,1
SC104415,19,0,19,0,0,0,0,0,1
SC104485,20,3,17,0,1,1,0,1,1
SC104896,46,5,41,0,1,1,0,1,1
SC105027,8,3,5,0,1,1,0,1,1
SC105035,21,3,18,0,1,1,0,1,0
SC105212,9,3,6,0,2,2,0,0,1
SC105250,3,0,3,0,2,2,0,0,1
SC105400,75,13,62,0,1,0,1,0,1
SC105413,6,2,4,0,1,1,0,0,0
SC105775,5,0,5,1,1,1,0,0,1
SC105783,11,3,8,0,1,1,0,0,1
SC106137,10,3,7,1,2,2,0,0,0
SC106247,61,8,53,0,1,1,0,1,1
SC106299,19,0,19,0,0,0,0,0,1
SC106331,59,12,47,0,1,1,0,1,1
SC106415,13,4,9,0,1,1,0,1,1
SC106505,34,0,34,0,1,1,0,1,1
SC106514,17,6,11,0,1,1,0,1,0
SC106533,2,1,1,0,1,1,0,0,0
SC106562,10,6,4,0,2,2,0,0,1
SC106669,86,6,80,0,3,1,2,1,1
SC106763,64,10,54,0,0,0,0,0,0
SC106766,5,5,0,0,2,2,0,1,1
SC106857,4,3,1,0,2,2,0,0,1
SC107480,51,10,41,0,0,0,0,0,1
SC107645,5,5,0,0,1,1,0,1,1
SC107701,5,1,4,0,1,1,0,0,0
SC107812,29,0,29,0,0,0,0,0,1
SC107896,36,4,32,0,1,1,0,1,1
SC107926,12,0,12,0,1,1,0,1,0
SC108095,33,0,33,0,2,2,0,1,1
SC108130,9,4,5,0,2,2,0,0,0
SC108165,25,4,21,0,1,1,0,1,1
SC108166,51,0,51,0,2,2,0,2,1
SC108270,14,0,14,0,0,0,0,0,1
SC108323,10,2,8,0,2,2,0,0,1
SC108371,17,3,14,0,2,2,0,0,1
SC108440,3,0,3,0,0,0,0,0,0
SC108476,4,0,4,0,0,0,0,0,1
SC108500,20,3,17,0,1,1,0,1,1
SC108581,6,4,2,1,2,2,0,0,0
SC108600,8,2,6,1,2,2,0,0,1
SC108613,17,0,17,0,0,0,0,0,1
SC108682,23,5,18,0,0,0,0,0,1
SC108694,60,5,55,0,1,1,0,0,0
SC108857,45,11,34,0,5,4,1,0,1
SC108909,57,7,50,0,2,2,0,2,1
SC108926,29,8,21,0,0,0,0,0,1
SC108972,9,3,6,0,1,1,0,1,1
SC109050,35,0,35,0,0,0,0,0,1
SC109131,21,10,11,0,5,1,4,1,1
SC109137,11,3,8,1,1,1,0,1,0
SC109146,29,9,20,0,0,0,0,0,0
SC109198,18,5,13,1,2,1,1,2,1
SC109367,10,2,8,0,1,1,0,1,0
SC109565,41,4,37,0,1,1,0,1,1
SC109608,43,2,41,0,1,1,0,1,1
SC109824,13,3,10,0,1,1,0,1,1
SC109825,12,3,9,0,1,1,0,1,1
SC109852,34,5,29,0,0,0,0,0,1
SC109880,24,3,21,0,2,2,0,0,1
SC109923,35,0,35,0,0,0,0,0,1
SC109933,37,0,37,0,0,0,0,0,1
SC109935,45,4,41,0,1,1,0,1,1
SC109937,35,0,35,0,0,0,0,0,1
SC109966,92,13,79,0,0,0,0,0,1
SC110120,5,5,0,0,1,1,0,0,1
SC110129,8,0,8,0,0,0,0,0,1
SC110185,54,0,54,0,0,0,0,0,1
SC110186,66,10,56,0,0,0,0,0,1
SC110313,3,1,2,0,2,1,1,0,0
SC110356,63,9,54,0,0,0,0,0,1
SC110419,19,1,18,0,1,1,0,1,1
SC110489,25,3,22,0,1,1,0,1,0
SC110621,82,10,72,0,1,1,0,0,1
SC110638,7,1,6,0,1,1,0,0,1
SC110813,13,0,13,0,0,0,0,0,1
SC110933,39,0,39,0,0,0,0,0,1
SC111210,6,3,3,0,1,1,0,0,1
SC111258,41,9,32,0,0,0,0,0,0
SC111399,21,0,21,0,1,1,0,1,1
SC111556,34,4,30,0,1,1,0,1,0
SC111606,26,3,23,0,2,1,1,2,1
SC111806,16,2,14,0,1,1,0,1,0
SC112013,33,0,33,0,0,0,0,0,1
SC112078,16,0,16,0,0,0,0,0,1
SC112372,12,3,9,0,1,1,0,1,1
SC112396,13,5,8,0,3,2,1,0,1
SC112755,57,6,51,0,0,0,0,0,1
SC112838,50,13,37,0,0,0,0,0,1
SC112872,30,4,26,0,1,1,0,1,1
SC113057,109,3,106,0,1,1,0,1,1
SC113186,9,2,7,0,1,1,0,0,1
SC113202,24,4,20,0,1,1,0,1,0
SC113203,21,0,21,0,0,0,0,0,1
SC113211,18,7,11,0,1,1,0,1,1
SC113224,46,6,40,0,1,1,0,1,1
SC113505,48,6,42,0,1,1,0,1,1
SC113579,9,2,7,0,1,1,0,1,1
SC113642,22,5,17,0,0,0,0,0,1
SC113775,44,4,40,0,1,1,0,1,1
SC113882,16,5,11,2,1,1,0,1,1
SC114029,36,2,34,0,1,1,0,1,1
SC114098,19,2,17,0,2,2,0,0,1
SC114154,21,4,17,0,2,2,0,0,1
SC114606,87,0,87,0,0,0,0,0,1
SC115061,91,10,81,0,0,0,0,0,1
SC115195,11,3,8,0,3,3,0,1,1
SC115235,30,2,28,0,2,1,1,2,1
SC115516,9,0,9,0,0,0,0,0,1
SC115530,78,53,25,0,5,4,1,5,1
SC115534,15,4,11,0,2,2,0,2,1
SC115535,6,0,6,0,0,0,0,0,1
SC115537,14,0,14,0,0,0,0,0,1
SC115638,31,8,23,0,1,1,0,1,1
SC115744,3,2,1,0,1,1,0,1,0
SC115800,4,2,2,0,1,1,0,0,1
SC116297,13,2,11,1,1,1,0,0,0
SC116351,28,12,16,0,1,1,0,1,1
SC116379,7,4,3,1,3,3,0,0,1
SC116584,18,3,15,0,1,1,0,1,1
SC116630,30,3,27,0,1,1,0,1,1
SC116845,10,0,10,0,0,0,0,0,0
SC116920,2,2,0,0,0,0,0,0,0
SC117118,53,0,53,0,0,0,0,0,1
SC117119,52,11,41,0,0,0,0,0,1
SC117120,51,4,47,0,1,1,0,1,1
SC117121,52,2,50,0,1,1,0,1,1
SC117165,5,3,2,0,2,2,0,0,1
SC117262,17,3,14,0,1,1,0,0,1
SC117747,13,4,9,0,3,3,0,0,1
SC117992,18,5,13,0,1,1,0,1,1
SC118134,64,3,61,0,1,1,0,1,1
SC118451,12,0,12,0,0,0,0,0,1
SC118550,48,8,40,0,0,0,0,0,0
SC118747,25,3,22,0,1,1,0,1,1
SC118794,17,3,14,0,1,1,0,1,1
SC118811,46,4,42,0,1,1,0,1,1
SC118877,10,3,7,0,1,1,0,0,1
SC118995,40,0,40,0,1,1,0,0,0
SC119227,55,3,52,0,0,0,0,0,1
SC119306,6,0,6,0,0,0,0,0,1
SC119419,9,2,7,0,2,2,0,0,1
SC119496,28,2,26,0,1,1,0,1,1
SC119497,32,4,28,0,1,1,0,1,1
SC119505,64,4,60,0,0,0,0,0,1
SC119978,10,3,7,0,2,1,1,0,1
SC120503,14,2,12,0,4,2,2,1,1
SC120550,56,5,51,0,1,1,0,1,1
SC120769,23,2,21,0,0,0,0,0,1
SC121009,29,3,26,0,0,0,0,0,1
SC121126,47,3,44,0,2,1,1,2,1
SC121137,68,0,68,0,0,0,0,0,1
SC121212,7,3,4,0,3,3,0,0,0
SC121275,4,2,2,0,1,1,0,0,1
SC121310,3,0,3,0,1,1,0,0,1
SC121349,38,0,38,0,0,0,0,0,1
SC121376,43,7,36,0,2,1,1,1,1
SC121508,21,3,18,0,0,0,0,0,1
SC121528,24,4,20,0,1,1,0,1,1
SC121558,10,2,8,0,0,0,0,0,1
SC121576,23,3,20,0,0,0,0,0,1
SC121722,16,2,14,0,1,1,0,1,1
SC121731,21,2,19,0,3,3,0,1,1
SC121740,5,2,3,0,1,1,0,0,1
SC121791,46,20,26,0,1,1,0,1,1
SC121849,26,3,23,0,1,1,0,1,1
SC122029,22,5,17,2,1,1,0,1,1
SC122044,45,6,39,1,2,2,0,2,1
SC122265,0,0,0,0,0,0,0,0,1
SC122369,59,6,53,0,0,0,0,0,1
SC122398,35,2,33,0,1,1,0,1,1
SC122565,10,2,8,0,1,1,0,0,1
SC122681,3,3,0,0,2,2,0,0,0
SC122762,73,9,64,0,0,0,0,0,1
SC122818,25,4,21,1,2,1,1,2,1
SC122842,21,6,15,0,1,1,0,1,1
SC122863,12,3,9,0,1,1,0,0,1
SC122964,39,2,37,0,1,1,0,0,0
SC123114,12,0,12,0,0,0,0,0,1
SC123144,19,4,15,0,0,0,0,0,1
SC123409,74,3,71,0,1,0,1,1,1
SC123638,8,2,6,0,1,1,0,0,1
SC123684,22,5,17,0,1,1,0,1,1
SC123842,17,0,17,0,2,2,0,0,1
SC123870,15,7,8,0,1,1,0,1,1
SC123956,6,0,6,1,0,0,0,0,1
SC124058,8,0,8,0,1,1,0,0,1
SC124090,53,12,41,0,0,0,0,0,1
SC124096,22,6,16,0,2,2,0,2,1
SC124097,16,2,14,0,1,1,0,1,0
SC124209,47,22,25,0,1,1,0,1,1
SC124478,44,9,35,0,0,0,0,0,1
SC124577,38,7,31,0,0,0,0,0,1
SC124620,62,3,59,0,1,1,0,1,1
SC124648,8,3,5,0,1,1,0,0,1
SC124667,27,6,21,0,1,1,0,0,1
SC124668,12,6,6,0,1,1,0,0,1
SC124670,30,0,30,0,0,0,0,0,1
SC124677,13,4,9,0,1,1,0,1,1
SC124771,17,4,13,0,1,1,0,1,1
SC124799,33,8,25,0,0,0,0,0,0
SC124884,40,1,39,0,1,1,0,1,1
SC124924,25,2,23,0,0,0,0,0,1
SC125046,52,2,50,0,0,0,0,0,1
SC125068,7,3,4,0,1,1,0,0,1
SC125204,31,3,28,0,1,1,0,1,1
SC125232,68,3,65,0,1,1,0,1,1
SC125363,10,4,6,0,1,1,0,0,1
SC125368,123,18,105,0,1,1,0,0,1
SC125430,18,3,15,0,1,1,0,1,1
SC125547,55,3,52,0,1,0,1,1,1
SC125616,5,3,2,0,2,2,0,0,1
SC125694,25,0,25,0,0,0,0,0,1
SC125708,21,3,18,0,1,1,0,1,1
SC125722,27,0,27,0,0,0,0,0,1
SC125726,8,2,6,1,0,0,0,0,1
SC125732,16,3,13,0,3,2,1,0,1
SC125792,46,3,43,0,1,1,0,1,0
SC126051,15,1,14,0,1,1,0,0,1
SC126056,23,3,20,0,1,1,0,1,1
SC126239,45,8,37,0,0,0,0,0,0
SC126249,67,3,64,0,1,1,0,1,1
SC126384,33,0,33,0,0,0,0,0,1
SC126396,18,2,16,0,1,1,0,1,1
SC126524,23,6,17,0,0,0,0,0,1
SC126718,15,5,10,1,2,2,0,1,1
SC126791,8,3,5,0,1,1,0,0,1
SC126838,41,8,33,0,0,0,0,0,0
SC126868,43,0,43,0,0,0,0,0,1
SC126870,14,3,11,0,1,1,0,1,1
SC126957,24,2,22,0,1,1,0,1,1
SC127012,62,8,54,0,1,1,0,1,1
SC127023,10,0,10,0,2,2,0,2,1
SC127043,46,2,44,0,2,2,0,2,1
SC127089,18,3,15,0,1,1,0,0,1
SC127664,18,3,15,0,1,1,0,1,1
SC127669,19,2,17,0,1,1,0,1,0
SC127793,39,7,32,0,0,0,0,0,0
SC127818,53,2,51,0,1,1,0,1,1
SC127819,53,2,51,0,1,1,0,1,1
SC127950,48,5,43,0,0,0,0,0,1
SC128179,21,8,13,0,1,1,0,0,1
SC128215,14,4,10,0,1,1,0,1,1
SC128221,23,2,21,0,0,0,0,0,1
SC128255,48,13,35,0,5,4,1,0,1
SC128290,6,2,4,0,1,1,0,0,1
SC128293,12,4,8,0,1,1,0,1,1
SC128297,6,2,4,0,2,2,0,0,1
SC128300,23,0,23,0,0,0,0,0,1
SC128301,31,3,28,0,1,1,0,0,1
SC128373,43,6,37,0,1,1,0,0,1
SC128566,43,3,40,0,1,1,0,1,1
SC128588,5,2,3,0,0,0,0,0,1
SC128650,21,1,20,0,2,1,1,1,1
SC128867,41,8,33,0,3,3,0,0,1
SC128982,36,12,24,0,0,0,0,0,0
SC129094,40,3,37,0,1,1,0,1,1
SC129141,11,0,11,1,0,0,0,0,1
SC129215,39,0,39,0,0,0,0,0,1
SC129222,33,5,28,0,0,0,0,0,1
SC129254,12,0,12,0,0,0,0,0,1
SC129323,50,11,39,0,1,1,0,1,1
SC129333,42,4,38,1,1,1,0,1,1
SC129611,22,3,19,0,1,1,0,1,1
SC129648,16,4,12,0,1,1,0,1,1
SC129716,18,2,16,0,1,1,0,1,1
SC129754,11,0,11,0,0,0,0,0,1
SC129773,8,1,7,0,2,2,0,0,0
SC129785,32,6,26,0,0,0,0,0,1
SC129787,25,3,22,0,1,1,0,1,1
SC129946,76,9,67,0,0,0,0,0,0
SC130056,20,2,18,0,1,1,0,1,1
SC130066,66,11,55,0,1,0,1,0,1
SC130067,43,10,33,0,0,0,0,0,0
SC130142,17,0,17,0,1,1,0,1,0
SC130146,22,1,21,0,1,1,0,1,0
SC130208,7,0,7,0,0,0,0,0,1
SC130489,7,0,7,0,0,0,0,0,1
SC130490,62,3,59,0,1,1,0,1,1
SC130532,5,2,3,0,1,1,0,0,1
SC130576,2,2,0,0,0,0,0,0,1
SC130590,12,0,12,0,1,1,0,1,0
SC130620,53,7,46,0,1,1,0,1,0
SC130688,28,0,28,0,0,0,0,0,1
SC130793,64,3,61,0,1,1,0,1,1
SC130813,16,4,12,0,0,0,0,0,1
SC130830,61,3,58,0,1,1,0,1,1
SC130854,7,1,6,0,1,1,0,0,1
SC130871,24,6,18,0,1,1,0,1,1
SC130930,97,4,93,0,5,0,5,0,0
SC130997,58,10,48,0,0,0,0,0,1
SC131044,38,9,29,1,1,1,0,1,1
SC131161,32,6,26,0,0,0,0,0,1
SC131185,27,5,22,0,7,5,2,0,0
SC131271,38,8,30,0,0,0,0,0,0
SC131377,34,2,32,0,1,1,0,1,1
SC131583,8,2,6,0,1,1,0,0,1
SC131584,8,2,6,0,1,1,0,1,1
SC131587,26,3,23,0,1,1,0,1,1
SC131741,15,3,12,0,1,1,0,1,1
SC131754,43,4,39,0,1,1,0,1,1
SC132061,97,13,84,0,1,1,0,1,1
SC132162,35,5,30,0,1,1,0,1,1
SC132306,80,11,69,0,0,0,0,0,0
SC132366,123,10,113,0,0,0,0,0,1
SC132543,29,8,21,1,0,0,0,0,1
SC132607,15,3,12,0,1,1,0,0,1
SC132609,23,4,19,0,1,1,0,1,1
SC132610,14,0,14,0,0,0,0,0,1
SC132750,27,0,27,0,0,0,0,0,1
SC132874,8,3,5,0,2,2,0,0,0
SC132908,14,0,14,0,1,1,0,1,1
SC132919,19,4,15,0,1,1,0,1,1
SC132927,9,1,8,0,2,1,1,0,1
SC132928,15,5,10,0,4,3,1,0,0
SC132929,15,5,10,0,4,3,1,0,0
SC132979,35,5,30,0,8,5,3,0,1
05605025,10,5,5,0,1,1,0,1,1
05605162,3,0,3,0,1,1,0,0,1
05605411,10,0,10,0,0,0,0,0,1
05605478,10,0,10,0,0,0,0,0,1
05605481,10,0,10,0,0,0,0,0,1
05605928,9,1,8,0,1,1,0,1,1
05606795,5,0,5,0,1,1,0,1,1
05606840,4,0,4,0,0,0,0,0,0
05607007,26,7,19,0,1,1,0,1,1
05607050,6,0,6,0,0,0,0,0,0
05607094,13,3,10,0,1,1,0,1,0
05607268,4,0,4,0,0,0,0,0,1
05607276,25,3,22,1,1,1,0,1,0
05607391,11,4,7,0,1,1,0,0,1
05607415,5,3,2,0,1,1,0,0,1
05607426,4,3,1,0,1,1,0,0,0
05607463,27,7,20,1,0,0,0,0,1
05607631,5,2,3,0,1,1,0,0,1
05607632,6,0,6,0,0,0,0,0,1
05607794,4,3,1,0,2,2,0,0,0
05607850,7,2,5,0,2,2,0,0,0
05607878,23,10,13,0,0,0,0,0,1
05608175,9,1,8,0,2,1,1,2,1
05608690,21,4,17,0,5,3,2,0,0
05608858,5,0,5,0,0,0,0,0,1
05608868,11,4,7,0,0,0,0,0,1
05609248,12,5,7,0,3,1,2,0,1
05609455,14,4,10,0,1,1,0,0,1
05609598,7,3,4,0,1,1,0,0,1
05609677,9,0,9,0,0,0,0,0,1
05609781,19,4,15,0,1,1,0,1,1
05609877,5,1,4,0,2,1,1,0,1
05610065,6,0,6,0,0,0,0,0,1
05610334,42,15,27,0,0,0,0,0,1
05610368,40,14,26,0,0,0,0,0,1
05610952,3,3,0,0,1,1,0,0,0
05610997,16,3,13,0,2,2,0,0,0
05611360,3,2,1,0,3,1,2,1,1
05611445,5,3,2,0,1,1,0,0,1
05611912,31,11,20,0,0,0,0,0,1
05611932,16,0,16,0,0,0,0,0,1
05612068,10,3,7,0,0,0,0,0,1
05612521,41,6,35,0,0,0,0,0,1
05612691,5,0,5,0,0,0,0,0,1
05613060,33,14,19,0,0,0,0,0,1
05614745,7,2,5,0,1,1,0,0,1
05614768,6,5,1,0,4,4,0,0,1
05615473,22,0,22,0,0,0,0,0,1
05615617,10,7,3,0,1,1,0,0,1
05615669,21,2,19,0,1,1,0,1,1
05616083,2,2,0,0,0,0,0,0,0
05616144,4,3,1,0,2,2,0,0,0
05616215,5,0,5,0,0,0,0,0,1
05616525,6,3,3,0,1,1,0,0,1
05616818,9,5,4,0,1,1,0,0,0
05617021,6,3,3,0,1,1,0,0,1
05617499,10,4,6,0,1,1,0,0,1
05617510,8,0,8,0,0,0,0,0,1
05617621,3,2,1,0,1,1,0,0,1
05618003,5,0,5,0,2,2,0,0,1
05618287,11,8,3,0,1,1,0,1,0
05618387,10,4,6,0,1,1,0,1,1
05618557,4,0,4,0,0,0,0,0,1
05618994,29,3,26,0,1,1,0,1,1
05619157,22,3,19,0,1,1,0,1,1
05619222,8,0,8,0,0,0,0,0,1
05619753,13,3,10,0,1,1,0,1,1
05620351,6,0,6,0,1,1,0,1,1
05620707,6,3,3,0,1,1,0,1,1
05620749,18,4,14,0,0,0,0,0,1
05620900,2,1,1,0,1,1,0,0,0
05621425,9,4,5,0,3,1,2,1,1
05621964,11,3,8,0,2,1,1,1,1
05622100,6,3,3,0,2,2,0,0,0
05622384,4,1,3,0,1,1,0,0,1
05622388,4,2,2,0,1,1,0,0,1
05622587,10,5,5,0,1,1,0,1,1
05622590,12,2,10,0,1,1,0,1,1
05622846,4,0,4,0,0,0,0,0,1
05623200,7,4,3,0,3,3,0,0,0
05623899,7,6,1,0,4,1,3,1,0
05623900,6,5,1,0,4,2,2,1,0
05624248,5,0,5,0,0,0,0,0,1
05624580,4,2,2,0,1,1,0,0,0
05624589,16,5,11,0,0,0,0,0,1
05624823,3,1,2,0,1,1,0,0,0
05624885,2,0,2,0,0,0,0,0,1
05624902,2,0,2,0,0,0,0,0,1
05625016,35,9,26,0,1,1,0,1,1
05625079,2,0,2,0,0,0,0,0,1
05625144,7,3,4,0,2,1,1,2,1
05625509,41,20,21,0,0,0,0,0,1
05625783,17,3,14,0,2,2,0,0,1
05625904,4,2,2,0,1,1,0,0,1
05625941,6,2,4,0,1,1,0,0,1
05625964,11,4,7,0,1,1,0,0,1
05626422,38,9,29,0,0,0,0,0,1
05626820,19,6,13,0,1,1,0,1,1
05626933,5,1,4,0,1,1,0,0,1
05626997,27,7,20,0,0,0,0,0,0
05627029,2,1,1,0,1,1,0,0,0
05627129,7,3,4,0,2,2,0,0,1
05627166,5,1,4,0,2,1,1,0,0
05627775,3,1,2,0,1,1,0,0,0
05628046,7,5,2,0,4,4,0,0,0
05628455,5,2,3,0,1,1,0,0,1
05628568,10,4,6,0,2,1,1,2,1
05628657,53,12,41,0,0,0,0,0,1
05628725,13,6,7,0,4,4,0,0,1
05629152,21,6,15,0,1,1,0,1,1
05629393,3,3,0,0,2,2,0,0,1
05629540,19,3,16,0,0,0,0,0,0
05629686,29,9,20,1,1,1,0,1,1
05629761,3,0,3,0,0,0,0,0,0
05629885,6,3,3,0,0,0,0,0,1
05629903,4,3,1,0,1,1,0,0,0
05629932,3,0,3,0,2,2,0,0,0
05630650,7,4,3,0,3,3,0,0,1
05630988,5,0,5,0,1,1,0,0,1
05631276,3,2,1,0,1,1,0,0,1
05631321,4,0,4,0,2,2,0,0,0
05631562,5,3,2,0,2,2,0,0,1
05631693,7,0,7,0,2,1,1,0,0
05631739,5,2,3,0,2,2,0,0,0
05632086,6,2,4,0,0,0,0,0,0
05632125,7,3,4,0,0,0,0,0,0
05632180,3,0,3,0,1,1,0,0,0
05632255,3,0,3,0,0,0,0,0,0
05632260,6,3,3,0,2,2,0,0,1
05632423,13,1,12,0,0,0,0,0,1
05632635,5,3,2,0,2,2,0,0,0
05632901,6,4,2,0,2,2,0,0,0
05633163,17,3,14,0,0,0,0,0,1
05633228,9,7,2,0,2,2,0,0,1
05633501,3,2,1,0,1,1,0,0,0
05634052,4,0,4,0,0,0,0,0,0
05634443,4,0,4,0,0,0,0,0,1
05634458,2,2,0,0,1,1,0,0,0
05634537,14,3,11,0,1,1,0,1,1
05634941,9,3,6,0,1,1,0,1,1
05635710,3,3,0,0,0,0,0,0,1
05636005,3,3,0,0,2,2,0,0,0
05636217,24,5,19,0,0,0,0,0,1
05637762,3,3,0,0,1,1,0,0,1
05638447,12,3,9,0,1,1,0,1,1
05638448,12,3,9,0,1,1,0,1,1
05638449,13,0,13,0,1,1,0,1,1
05638855,6,1,5,0,2,1,1,0,1
05638931,6,3,3,0,2,2,0,0,0
05639234,38,7,31,0,1,1,0,1,1
05639990,7,0,7,0,0,0,0,0,1
05640059,16,0,16,0,0,0,0,0,1
05640154,11,5,6,0,1,1,0,1,1
05640232,12,2,10,0,0,0,0,0,0
05640278,3,3,0,0,2,2,0,0,1
05640420,23,11,12,1,2,0,2,2,1
05640458,4,2,2,0,1,1,0,0,0
05640663,5,3,2,0,0,0,0,0,0
05640740,28,4,24,0,2,1,1,2,1
05640845,16,2,14,0,1,1,0,1,1
05641471,3,1,2,0,1,1,0,0,0
05641515,8,5,3,0,4,4,0,0,1
05641566,11,0,11,0,0,0,0,0,1
05641744,29,6,23,0,0,0,0,0,1
05641765,31,10,21,0,0,0,0,0,1
05641792,7,5,2,0,1,1,0,0,1
05641862,10,0,10,0,0,0,0,0,1
05641947,4,0,4,0,1,1,0,0,1
05641952,11,5,6,0,1,1,0,0,0
05642003,9,0,9,0,0,0,0,0,1
05642022,5,0,5,0,0,0,0,0,1
05642147,5,0,5,0,0,0,0,0,1
05642292,4,0,4,0,0,0,0,0,1
05642379,3,2,1,0,1,1,0,0,0
05643048,18,0,18,0,0,0,0,0,1
05643066,17,0,17,0,0,0,0,0,1
05643230,18,3,15,0,1,1,0,1,0
05643648,4,2,2,0,1,1,0,0,0
05643691,13,4,9,0,1,1,0,1,1
05643793,5,1,4,0,2,1,1,0,0
05644115,6,4,2,0,2,2,0,0,1
05644135,9,3,6,0,1,1,0,0,1
05644398,3,0,3,0,2,2,0,0,1
05644547,3,3,0,0,2,2,0,0,0
05644938,6,0,6,0,0,0,0,0,1
05645055,2,0,2,0,1,1,0,0,0
05645132,3,2,1,0,1,1,0,0,1
05645200,10,0,10,0,0,0,0,0,0
05645331,4,2,2,0,1,1,0,0,0
05645455,6,0,6,0,0,0,0,0,1
05645881,16,5,11,0,0,0,0,0,1
05646366,5,0,5,0,0,0,0,0,0
05646845,4,1,3,0,1,1,0,0,1
05647106,6,1,5,0,1,1,0,1,1
05647349,21,4,17,0,1,1,0,1,1
05647384,5,3,2,0,3,2,1,1,0
05647531,3,0,3,0,0,0,0,0,1
05647566,4,2,2,0,1,1,0,0,1
05647568,9,3,6,0,1,1,0,1,1
05647739,6,2,4,0,0,0,0,0,1
05647878,46,13,33,0,0,0,0,0,1
05648109,5,0,5,0,2,2,0,0,1
05648265,9,3,6,0,1,1,0,0,0
05648776,4,0,4,0,0,0,0,0,1
05648867,4,2,2,0,1,1,0,0,1
05648895,4,1,3,0,1,1,0,0,1
05649413,8,0,8,0,1,1,0,1,1
05649428,8,5,3,0,2,2,0,0,1
05650155,38,11,27,0,0,0,0,0,1
05650214,5,0,5,0,0,0,0,0,1
05650288,5,3,2,0,1,1,0,1,1
05650293,5,3,2,0,1,1,0,1,1
05650294,5,3,2,0,1,1,0,1,1
05650297,5,3,2,0,1,1,0,1,1
05650400,5,3,2,0,1,1,0,1,1
05650451,13,4,9,0,0,0,0,0,1
05650532,7,0,7,0,0,0,0,0,1
05650887,9,0,9,0,0,0,0,0,1
05651120,16,3,13,0,1,1,0,1,1
05651123,16,3,13,0,1,1,0,1,1
05651241,4,0,4,0,2,2,0,0,1
05652345,4,2,2,0,1,1,0,1,0
05652493,5,3,2,0,2,2,0,0,1
05652516,16,5,11,0,1,1,0,1,1
05652705,3,2,1,0,1,1,0,0,1
05652706,3,2,1,0,1,1,0,0,1
05652836,15,7,8,0,1,1,0,0,1
05652863,5,3,2,0,2,2,0,0,1
05652944,6,1,5,0,1,1,0,0,1
05653010,27,0,27,0,0,0,0,0,1
05653202,9,0,9,0,1,1,0,1,1
05653217,12,0,12,0,0,0,0,0,1
05653292,9,5,4,0,3,1,2,1,0
05653293,7,5,2,0,3,1,2,1,0
05653335,45,8,37,0,1,1,0,1,0
05653435,20,7,13,0,1,1,0,1,1
05653549,22,5,17,0,1,1,0,1,1
05653731,10,5,5,0,6,1,5,1,1
05653781,17,7,10,0,1,1,0,1,1
05654040,5,3,2,0,2,2,0,0,1
05654448,14,7,7,0,0,0,0,0,0
05654491,6,0,6,0,0,0,0,0,0
05655183,14,1,13,0,0,0,0,0,1
05655711,27,5,22,0,3,1,2,1,1
05656128,8,4,4,0,1,1,0,0,1
05656218,4,2,2,0,1,1,0,0,1
05656253,19,5,14,0,0,0,0,0,0
05656364,19,3,16,0,1,1,0,1,1
05656440,4,4,0,0,1,1,0,0,1
05656513,23,7,16,0,0,0,0,0,0
05656604,21,4,17,0,0,0,0,0,1
05657314,5,1,4,0,1,1,0,0,0
05657414,14,4,10,0,1,1,0,0,0
05657472,25,1,24,0,1,1,0,1,1
05657691,10,0,10,0,1,1,0,0,1
05657825,5,3,2,0,2,2,0,0,0
05658020,9,4,5,0,1,1,0,0,1
05658119,21,5,16,0,0,0,0,0,1
05658137,13,0,13,0,0,0,0,0,1
05658184,14,5,9,0,0,0,0,0,1
05658357,12,0,12,0,0,0,0,0,1
05658559,15,0,15,0,1,1,0,1,1
05658747,15,3,12,0,0,0,0,0,1
05659063,4,2,2,0,1,1,0,0,0
05659446,3,1,2,0,1,1,0,0,1
05659837,4,0,4,0,0,0,0,0,1
05659840,6,2,4,0,1,1,0,0,1
05659894,3,3,0,0,2,2,0,0,0
05659940,3,3,0,0,2,2,0,0,0
05660108,6,0,6,0,0,0,0,0,1
05660276,5,1,4,0,1,1,0,0,1
05660401,38,13,25,0,0,0,0,0,1
05660568,6,1,5,0,1,1,0,0,1
05660800,4,0,4,0,1,1,0,0,1
05660966,11,7,4,0,0,0,0,0,1
05661019,12,4,8,0,0,0,0,0,0
05661360,7,5,2,0,1,1,0,1,0
05661372,3,3,0,0,2,2,0,0,0
05661538,15,6,9,0,0,0,0,0,1
05661637,11,3,8,0,1,1,0,1,1
05661839,4,0,4,0,0,0,0,0,1
05662101,6,3,3,0,1,1,0,0,0
05662194,29,5,24,0,1,1,0,1,1
05662664,3,0,3,0,0,0,0,0,0
05663001,2,2,0,0,1,1,0,0,0
05663247,5,3,2,0,1,1,0,0,0
05663406,5,0,5,0,0,0,0,0,1
05663642,59,24,35,0,1,1,0,1,1
05663655,21,3,18,0,1,1,0,1,1
05663740,15,2,13,0,0,0,0,0,1
05663771,7,2,5,0,0,0,0,0,1
05663774,6,0,6,0,0,0,0,0,1
05663775,7,0,7,0,0,0,0,0,1
05663776,6,0,6,0,0,0,0,0,1
05663893,3,0,3,0,0,0,0,0,1
05664278,6,4,2,1,4,4,0,0,1
05664757,4,0,4,0,0,0,0,0,0
05665001,3,2,1,0,1,1,0,0,1
05665073,16,3,13,0,1,1,0,0,1
05665271,19,5,14,0,0,0,0,0,1
05665278,14,0,14,0,0,0,0,0,1
05665862,11,4,7,0,3,3,0,0,0
05665863,4,0,4,0,2,2,0,0,0
05666106,20,5,15,0,2,1,1,2,0
05666435,5,3,2,0,1,1,0,0,1
05666455,12,2,10,0,1,1,0,1,1
05666565,9,2,7,0,1,1,0,0,0
05666752,23,3,20,0,2,1,1,0,0
05667980,12,0,12,0,0,0,0,0,1
05667991,5,3,2,0,0,0,0,0,1
05667992,18,0,18,0,0,0,0,0,1
05668085,5,3,2,0,2,2,0,0,0
05668245,4,3,1,0,2,1,1,0,0
05668433,2,2,0,0,1,1,0,0,0
05668463,21,5,16,0,1,1,0,1,1
05668753,11,4,7,0,1,1,0,1,1
05669007,6,3,3,0,3,3,0,3,1
05669115,6,1,5,0,1,1,0,0,1
05669285,21,8,13,0,1,1,0,1,1
05669470,6,0,6,0,0,0,0,0,1
05670369,7,3,4,0,2,2,0,0,1
05670672,6,1,5,0,0,0,0,0,1
05670852,6,0,6,0,0,0,0,0,0
05670947,5,2,3,0,1,1,0,0,0
05671160,7,5,2,0,4,4,0,0,1
05671228,39,12,27,0,1,1,0,0,1
05671523,9,0,9,0,1,1,0,1,1
05671613,7,4,3,0,7,1,6,1,0
05671616,6,4,2,0,4,2,2,1,0
05671684,21,4,17,0,0,0,0,0,0
05671766,10,0,10,0,0,0,0,0,1
05671772,5,3,2,0,2,2,0,0,0
05671831,5,0,5,0,1,1,0,0,1
05672085,9,2,7,0,0,0,0,0,1
05672088,26,9,17,0,0,0,0,0,0
05672320,7,0,7,0,0,0,0,0,1
05672642,8,3,5,0,1,1,0,0,1
05672869,10,2,8,0,1,1,0,1,1
05673039,140,0,140,0,1,1,0,0,1
05673068,8,4,4,0,1,1,0,1,1
05673609,5,0,5,0,0,0,0,0,1
05673738,11,6,5,0,0,0,0,0,0
05673815,20,2,18,0,2,1,1,0,0
05673831,14,0,14,0,0,0,0,0,1
05673888,14,3,11,0,2,0,2,1,1
05675033,9,3,6,0,3,2,1,0,1
05675042,8,3,5,0,1,1,0,1,1
05675378,12,3,9,0,2,1,1,0,0
05675534,5,1,4,0,1,1,0,0,1
05675697,5,0,5,0,0,0,0,0,0
05675800,18,0,18,0,0,0,0,0,1
05676067,5,1,4,0,1,1,0,0,1
05676785,18,3,15,0,1,1,0,1,1
05676894,22,1,21,0,1,1,0,1,1
05677568,9,0,9,0,1,1,0,1,1
05677578,6,2,4,0,1,1,0,0,1
05678007,41,3,38,0,1,1,0,1,1
05678153,12,2,10,0,1,1,0,0,1
05678509,16,0,16,0,0,0,0,0,1
05678757,4,0,4,0,0,0,0,0,1
05678898,2,0,2,0,0,0,0,0,1
05679163,8,3,5,0,2,2,0,0,1
05679423,13,3,10,0,1,1,0,1,1
05679428,10,5,5,0,1,1,0,0,1
05679836,8,3,5,0,1,1,0,1,1
05679844,5,3,2,0,1,1,0,1,0
05679892,32,4,28,0,1,1,0,1,1
05679896,26,2,24,0,0,0,0,0,1
05680002,22,14,8,0,0,0,0,0,1
05680429,9,3,6,0,0,0,0,0,1
05680431,8,0,8,0,0,0,0,0,1
05680898,9,2,7,0,1,1,0,0,1
05681056,9,0,9,0,0,0,0,0,1
05681687,9,5,4,0,0,0,0,0,0
05682208,4,2,2,0,1,1,0,0,0
05683035,4,1,3,0,0,0,0,0,1
05683065,9,0,9,0,0,0,0,0,0
05683101,2,2,0,0,1,1,0,0,1
05683361,5,3,2,0,2,2,0,0,1
05683589,2,0,2,0,0,0,0,0,1
05683772,4,1,3,0,1,1,0,0,1
05684104,10,0,10,0,0,0,0,0,1
05686768,5,3,2,0,1,1,0,0,0
05687000,38,7,31,0,0,0,0,0,0
05687072,4,2,2,0,1,1,0,0,0
05687097,5,0,5,0,0,0,0,0,1
05687183,17,5,12,0,1,1,0,1,1
05687200,6,1,5,0,3,1,2,1,0
05687570,11,6,5,0,1,1,0,0,1
05687659,5,3,2,0,3,2,1,1,1
05687775,22,4,18,0,1,1,0,1,1
05687891,18,8,10,0,0,0,0,0,1
05688533,34,3,31,0,1,1,0,1,0
05688863,5,3,2,0,1,1,0,0,1
05689135,20,3,17,0,1,1,0,1,1
05689162,7,2,5,0,1,1,0,0,0
05689522,2,0,2,0,0,0,0,0,0
02167187,0,0,0,0,0,0,0,0,0
02167675,28,0,28,0,1,1,0,1,1
02168165,43,4,39,0,1,1,0,1,1
02168435,27,3,24,0,1,1,0,1,1
02168706,5,2,3,0,2,1,1,0,1
02168890,63,4,59,0,1,1,0,1,1
02168903,4,3,1,0,1,1,0,0,1
02169057,5,1,4,0,0,0,0,0,0
02169676,8,2,6,0,2,0,2,0,1
02169952,18,3,15,0,1,0,1,0,1
02170011,12,2,10,0,1,1,0,1,1
02170064,24,2,22,0,1,1,0,1,1
02170154,30,3,27,0,1,1,0,1,1
02170324,16,2,14,0,1,0,1,0,1
02170458,56,3,53,0,1,1,0,1,1
02170693,43,2,41,0,1,0,1,0,1
02170697,15,3,12,0,1,0,1,0,1
02170701,20,2,18,0,1,0,1,0,1
02171236,37,3,34,0,1,1,0,1,1
02171496,26,9,17,0,0,0,0,0,1
02171875,8,3,5,0,2,2,0,2,1
02171959,8,3,5,0,1,1,0,0,0
02172239,52,9,43,0,1,1,0,1,1
02172518,39,13,26,0,1,1,0,0,1
02172547,25,0,25,0,0,0,0,0,1
02172877,19,2,17,0,1,1,0,1,1
02172892,35,2,33,0,4,3,1,0,1
02172923,20,10,10,0,0,0,0,0,1
02173133,10,4,6,0,2,2,0,0,1
02173505,17,3,14,0,1,1,0,1,1
02173760,19,4,15,0,0,0,0,0,0
02173888,18,0,18,0,0,0,0,0,1
02174008,43,2,41,0,1,1,0,0,1
02174052,38,6,32,0,1,1,0,1,1
02174160,19,5,14,0,6,6,0,0,1
02174296,13,3,10,0,1,1,0,1,1
02174531,18,6,12,0,0,0,0,0,1
02174809,15,3,12,0,1,1,0,1,1
02174858,18,4,14,0,2,2,0,2,1
02174873,43,0,43,0,2,2,0,0,1
02174878,16,0,16,0,0,0,0,0,1
02174992,1,1,0,0,0,0,0,0,1
02174994,31,5,26,0,1,1,0,1,1
02175146,50,15,35,0,0,0,0,0,1
02175169,12,5,7,0,3,3,0,1,1
02175174,5,2,3,0,1,1,0,0,1
02175366,64,3,61,0,1,1,0,1,1
02175533,8,2,6,0,0,0,0,0,0
02175700,14,4,10,0,1,1,0,1,1
02175886,18,0,18,0,0,0,0,0,1
02175938,75,12,63,0,0,0,0,0,1
02176041,9,0,9,0,0,0,0,0,1
02176276,15,2,13,0,1,1,0,1,1
02176408,24,4,20,0,1,1,0,1,1
02176508,19,4,15,0,1,1,0,1,1
02176723,25,2,23,0,0,0,0,0,0
02176764,8,2,6,0,1,1,0,1,1
02176937,6,2,4,0,0,0,0,0,1
02177090,8,0,8,0,0,0,0,0,1
02177122,21,0,21,0,0,0,0,0,1
02177130,8,0,8,0,0,0,0,0,1
02177179,15,1,14,0,3,1,2,1,1
02177318,36,6,30,0,1,1,0,1,1
02177451,28,3,25,0,1,1,0,1,1
02177954,17,3,14,0,1,1,0,1,1
02177984,16,3,13,0,1,1,0,0,1
02178614,86,10,76,0,1,0,1,0,1
02179048,46,8,38,0,0,0,0,0,1
02179302,18,3,15,0,1,1,0,1,1
02179430,61,8,53,0,0,0,0,0,1
02179517,2,1,1,0,2,2,0,0,0
02179933,17,3,14,0,1,1,0,0,0
02180053,13,4,9,0,1,1,0,1,1
02180132,41,7,34,0,0,0,0,0,0
02180191,43,4,39,0,1,1,0,1,1
02180205,41,3,38,0,0,0,0,0,1
02180483,65,13,52,0,0,0,0,0,1
02180957,7,5,2,0,2,1,1,1,0
02181038,24,2,22,0,1,1,0,1,1
02181268,18,3,15,0,1,1,0,1,1
02181315,64,4,60,0,1,1,0,1,1
02181480,73,3,70,0,1,1,0,1,1
02181679,10,8,2,0,0,0,0,0,0
02181815,38,6,32,0,0,0,0,0,1
02181888,15,7,8,0,5,1,4,1,0
02181926,1,1,0,0,0,0,0,0,1
02181929,2,2,0,0,0,0,0,0,1
02182423,7,3,4,0,0,0,0,0,1
02182501,57,12,45,0,0,0,0,0,0
02182565,2,2,0,0,1,1,0,0,0
02182687,67,9,58,0,0,0,0,0,1
02182758,19,3,16,0,1,1,0,1,1
02182762,63,10,53,0,1,1,0,1,1
02182866,1,0,1,0,0,0,0,0,1
02183021,16,0,16,0,0,0,0,0,1
02183165,19,4,15,0,1,1,0,0,1
02183415,24,0,24,0,0,0,0,0,1
02183572,11,2,9,0,1,1,0,0,1
02183625,38,3,35,0,1,1,0,1,1
02183801,33,0,33,0,0,0,0,0,1
02184041,60,10,50,0,1,1,0,1,1
02184356,7,2,5,0,1,1,0,0,0
02184418,17,0,17,0,0,0,0,0,1
02184757,16,0,16,0,0,0,0,0,1
02184853,84,9,75,0,0,0,0,0,1
02185097,52,5,47,0,1,1,0,1,1
02185099,33,3,30,0,0,0,0,0,1
02185220,13,0,13,0,1,1,0,1,1
02185448,45,2,43,0,2,1,1,2,1
02185684,5,1,4,0,1,1,0,0,1
02185735,14,6,8,0,1,1,0,0,1
02185757,30,13,17,0,0,0,0,0,1
02185772,22,6,16,0,1,1,0,1,1
02185995,5,3,2,0,2,2,0,0,1
02186004,8,5,3,0,1,1,0,0,1
02186101,42,4,38,0,1,1,0,1,1
02186136,14,0,14,0,0,0,0,0,1
02186297,6,5,1,0,2,1,1,1,1
02186480,8,2,6,0,1,1,0,0,0
02186500,3,3,0,0,0,0,0,0,0
02186648,1,1,0,0,0,0,0,0,1
02186882,3,0,3,0,2,2,0,1,0
02186889,15,5,10,0,1,1,0,0,1
02187104,14,0,14,0,0,0,0,0,1
02187213,75,11,64,0,0,0,0,0,1
02187502,33,10,23,0,0,0,0,0,1
02187610,20,0,20,0,0,0,0,0,1
02187670,13,0,13,0,0,0,0,0,0
02188402,62,13,49,0,0,0,0,0,1
02188452,88,15,73,0,0,0,0,0,1
02188468,6,3,3,0,1,1,0,1,0
02188564,13,5,8,0,1,1,0,0,1
02188825,11,2,9,0,1,1,0,1,1
02189028,29,3,26,0,2,1,1,2,1
02189031,29,0,29,0,1,1,0,1,1
02189033,29,0,29,0,1,1,0,1,1
02189139,54,5,49,0,1,1,0,1,1
02189307,17,2,15,0,1,1,0,0,0
02189462,36,0,36,0,0,0,0,0,1
02189764,19,3,16,0,0,0,0,0,1
02189827,22,3,19,0,0,0,0,0,1
02189928,21,3,18,0,1,1,0,1,1
02190815,14,4,10,0,1,1,0,0,1
02191281,6,0,6,0,1,1,0,1,1
02191311,3,3,0,0,2,2,0,0,0
02191603,21,0,21,0,0,0,0,0,1
02191648,14,0,14,0,1,1,0,1,1
02191854,5,0,5,0,0,0,0,0,1
02191905,8,3,5,0,1,1,0,1,1
02192053,13,2,11,0,0,0,0,0,0
02192312,11,2,9,0,1,1,0,0,1
02192370,21,0,21,0,0,0,0,0,1
02192460,5,4,1,0,1,1,0,1,0
02192584,58,13,45,0,0,0,0,0,1
02192813,30,3,27,0,0,0,0,0,1
02192937,47,3,44,0,1,1,0,1,1
02192995,28,4,24,0,0,0,0,0,1
02193005,4,2,2,0,1,1,0,0,1
02193329,8,3,5,0,2,2,0,0,0
02193336,2,2,0,0,1,1,0,0,0
02193684,13,2,11,0,1,1,0,1,1
02193754,14,3,11,0,0,0,0,0,1
02194209,52,0,52,0,1,1,0,1,1
02194834,21,4,17,0,1,1,0,1,1
02195300,34,3,31,0,1,1,0,1,1
02195707,29,0,29,0,0,0,0,0,1
02196149,28,3,25,0,2,1,1,1,1
02196260,8,2,6,0,0,0,0,0,1
02196266,9,3,6,0,1,1,0,0,1
02196607,3,0,3,0,1,1,0,0,1
02196956,0,0,0,0,0,0,0,0,1
02197377,41,0,41,0,0,0,0,0,1
02197737,3,2,1,0,2,2,0,0,1
02197910,65,7,58,0,0,0,0,0,1
02197956,15,9,6,0,0,0,0,0,0
02198179,13,6,7,0,1,1,0,1,0
02198303,10,3,7,0,2,1,1,1,1
02199073,9,2,7,0,1,1,0,0,0
02199095,38,3,35,0,1,1,0,1,1
02199098,13,3,10,0,3,2,1,3,1
02199191,7,4,3,0,6,6,0,2,1
02199282,27,2,25,0,1,1,0,1,1
02199428,46,3,43,0,1,1,0,1,1
02199542,55,13,42,0,0,0,0,0,1
02199674,45,0,45,0,0,0,0,0,1
02199714,20,4,16,0,1,1,0,1,1
02200347,61,0,61,0,0,0,0,0,1
02200510,15,3,12,0,1,1,0,1,1
02200692,38,5,33,0,2,2,0,2,1
02200790,11,3,8,0,0,0,0,0,1
02200831,35,4,31,0,1,1,0,1,1
02201116,20,5,15,0,0,0,0,0,1
02201275,40,3,37,0,1,1,0,1,1
02201331,21,6,15,0,1,1,0,1,1
02201396,38,6,32,0,1,1,0,1,1
02201481,7,3,4,0,1,1,0,0,0
02201530,22,0,22,0,0,0,0,0,1
02201762,18,6,12,0,1,1,0,1,1
02201768,24,0,24,0,0,0,0,0,1
02201925,29,5,24,0,0,0,0,0,0
02201975,27,5,22,0,1,1,0,1,1
02202608,6,4,2,0,1,1,0,0,1
02202681,62,4,58,0,2,2,0,2,1
02202731,8,0,8,0,0,0,0,0,0
02202845,28,5,23,0,1,1,0,1,1
02202907,25,5,20,0,0,0,0,0,1
02202947,7,3,4,0,2,2,0,0,1
02203932,15,4,11,0,0,0,0,0,1
02204018,9,3,6,0,1,1,0,0,1
02204220,57,6,51,0,0,0,0,0,1
02204284,26,5,21,0,1,1,0,1,1
02204746,9,2,7,0,0,0,0,0,1
02204784,20,0,20,0,0,0,0,0,1
02205588,10,0,10,0,0,0,0,0,0
02205809,33,7,26,0,0,0,0,0,1
02205877,10,3,7,0,1,1,0,1,1
02206179,19,5,14,0,4,0,4,0,1
02206443,6,3,3,0,1,1,0,0,0
02206579,2,2,0,0,1,1,0,0,1
02206957,20,7,13,0,0,0,0,0,1
02207198,7,3,4,0,1,1,0,0,1
02207342,24,4,20,0,1,1,0,1,1
02207355,49,6,43,0,1,1,0,1,1
02207374,13,4,9,0,1,1,0,0,1
02208321,25,1,24,0,1,1,0,1,1
02208397,11,5,6,0,0,0,0,0,1
02208568,20,3,17,0,1,1,0,1,1
02208841,20,7,13,0,6,6,0,0,0
02208890,10,2,8,0,1,1,0,0,0
02208921,29,2,27,0,2,2,0,2,0
02209336,38,6,32,0,1,1,0,0,1
02209385,45,12,33,0,0,0,0,0,1
02209567,56,3,53,0,1,1,0,1,1
02209949,111,15,96,0,0,0,0,0,1
02209994,16,4,12,0,1,1,0,1,1
02210414,18,1,17,0,1,1,0,0,1
02210675,35,13,22,0,0,0,0,0,1
02210699,49,7,42,0,0,0,0,0,0
02210925,18,0,18,0,0,0,0,0,1
02210997,60,10,50,0,7,2,5,0,1
02211267,30,6,24,0,0,0,0,0,1
02211998,38,10,28,0,1,1,0,1,1
02212532,22,0,22,0,0,0,0,0,1
02212747,20,2,18,0,5,5,0,2,0
02212959,73,10,63,0,1,1,0,1,1
02213529,26,4,22,0,0,0,0,0,1
02213726,36,2,34,0,0,0,0,0,1
02213727,4,2,2,0,1,1,0,0,1
02213883,23,0,23,0,0,0,0,0,1
02213934,13,5,8,0,4,4,0,1,1
02214188,7,0,7,0,0,0,0,0,1
02214435,18,0,18,0,1,1,0,1,1
02214834,6,3,3,0,1,1,0,0,0
02215322,10,7,3,0,0,0,0,0,1
02215407,18,0,18,0,0,0,0,0,1
02215418,11,2,9,0,1,1,0,0,1
02215465,40,0,40,0,0,0,0,0,1
02215516,4,2,2,0,1,1,0,0,0
02215568,27,0,27,0,0,0,0,0,0
02215615,5,3,2,0,1,1,0,0,0
02215790,23,4,19,0,0,0,0,0,1
02215803,22,0,22,0,0,0,0,0,0
02215915,6,0,6,0,0,0,0,0,1
02215958,98,12,86,0,0,0,0,0,1
02216102,26,4,22,0,0,0,0,0,1
02216162,18,2,16,0,1,1,0,1,1
02216369,50,3,47,0,1,1,0,1,1
02216505,24,0,24,0,0,0,0,0,1
02216551,39,6,33,0,1,1,0,1,1
02216747,12,0,12,0,0,0,0,0,1
02216886,35,12,23,0,0,0,0,0,1
02217099,20,4,16,0,1,1,0,1,1
02217468,14,2,12,0,1,1,0,0,0
02217488,16,0,16,0,0,0,0,0,1
02218202,61,12,49,0,1,1,0,1,1
02218477,11,3,8,0,2,2,0,0,1
02218483,26,4,22,0,1,1,0,1,1
02218531,49,5,44,0,0,0,0,0,1
02218590,22,7,15,0,0,0,0,0,1
02218712,22,4,18,0,1,1,0,0,0
02218729,43,3,40,0,1,1,0,1,1
02218757,10,4,6,0,2,2,0,0,1
02218846,15,0,15,0,0,0,0,0,1
02218994,26,4,22,0,0,0,0,0,1
10535004,4,2,2,0,4,2,2,0,1
10535088,10,6,4,0,0,0,0,0,0
10535137,1,0,1,0,1,1,0,0,0
10535153,3,1,2,0,1,0,1,0,0
10535172,3,3,0,0,1,1,0,1,0
10535209,4,2,2,0,2,1,1,0,0
10535287,3,2,1,0,2,2,0,0,1
10535372,3,2,1,0,2,2,0,0,1
10535374,2,2,0,0,1,1,0,0,0
10535739,7,6,1,0,2,1,1,0,1
10535740,3,3,0,0,3,3,0,0,0
10535750,3,2,1,0,3,2,1,0,1
10535762,4,3,1,0,2,2,0,0,1
10536068,1,1,0,0,1,1,0,0,0
10536126,3,3,0,0,1,1,0,0,1
10536170,1,1,0,0,1,1,0,0,0
10536613,1,0,1,0,1,1,0,0,0
10536645,1,1,0,0,1,1,0,0,0
10536711,1,1,0,0,1,1,0,0,0
10536770,2,1,1,0,2,2,0,0,0
10537186,1,0,1,0,1,1,0,0,0
10537304,4,4,0,0,1,1,0,0,0
10537341,1,1,0,0,1,1,0,0,1
10537653,6,6,0,0,0,0,0,0,0
10537836,3,3,0,0,1,1,0,1,0
10538261,1,0,1,0,1,1,0,0,0
10538529,2,2,0,0,4,2,2,0,0
10538549,3,1,2,0,1,1,0,1,0
10538586,3,1,2,0,1,1,0,1,0
10538678,1,1,0,0,1,1,0,0,0
10538747,4,0,4,0,4,4,0,0,1
10538803,1,1,0,0,1,1,0,0,0
10539127,2,1,1,0,2,1,1,0,0
10539285,1,1,0,0,2,1,1,1,0
10539735,3,2,1,0,1,1,0,0,0
10539840,2,2,0,0,1,1,0,0,0
10539989,5,4,1,0,3,1,2,0,0
10540716,1,1,0,0,1,1,0,0,0
10541530,1,0,1,0,1,1,0,0,0
10541916,2,2,0,0,0,0,0,0,1
10542044,1,1,0,0,1,1,0,0,0
10542288,1,0,1,0,1,1,0,0,1
10542369,1,0,1,0,1,1,0,0,0
10543175,5,5,0,0,2,2,0,2,1
10543833,2,2,0,0,2,2,0,0,1
10544268,1,0,1,0,1,1,0,0,0
10544539,1,0,1,0,1,1,0,0,0
10544601,1,1,0,0,1,1,0,0,0
10544667,1,0,1,0,1,1,0,0,0
10545203,3,3,0,0,3,3,0,1,1
10545288,1,0,1,0,1,1,0,0,0
10545376,3,3,0,0,2,2,0,0,1
10545670,5,4,1,0,3,2,1,0,1
10545916,2,1,1,0,2,1,1,0,0
10546345,1,1,0,0,1,1,0,0,0
10546350,2,2,0,0,1,1,0,0,0
10546384,3,3,0,0,3,3,0,0,0
10546401,1,1,0,0,2,1,1,0,0
10546424,1,1,0,0,1,1,0,0,0
10546575,3,0,3,0,3,3,0,0,0
10546720,2,2,0,0,2,2,0,0,1
10547122,4,4,0,0,1,1,0,0,1
10547353,11,8,3,0,0,0,0,0,0
10547404,6,5,1,0,2,0,2,0,0
10547460,7,5,2,0,3,1,2,1,0
10547522,1,1,0,0,1,1,0,0,1
10547773,1,1,0,0,1,1,0,0,1
10547809,6,6,0,0,9,4,5,2,1
10547843,2,0,2,0,1,1,0,0,0
10548060,1,1,0,0,2,2,0,0,0
10548114,8,6,2,0,1,0,1,0,1
10548306,3,3,0,0,1,1,0,0,0
10548462,4,4,0,0,1,1,0,1,0
10548518,5,3,2,0,1,1,0,1,1
10548544,1,0,1,0,1,1,0,0,0
10548649,1,1,0,0,1,1,0,1,0
10548891,3,1,2,0,2,1,1,0,0
10549345,2,2,0,0,2,2,0,0,0
10549612,3,2,1,0,7,6,1,1,1
10549882,1,1,0,0,1,1,0,0,0
10550332,2,2,0,0,2,2,0,0,0
10550335,1,1,0,0,0,0,0,0,0
10550352,2,1,1,0,2,1,1,0,0
10550485,1,1,0,0,3,1,2,2,0
10550863,1,0,1,0,1,1,0,0,0
10550900,1,1,0,0,1,1,0,0,0
10551247,4,3,1,0,1,1,0,1,1
10551605,2,2,0,0,1,1,0,0,1
10552128,1,1,0,0,1,1,0,0,0
10552280,2,2,0,0,2,2,0,0,0
10552522,1,1,0,0,1,1,0,0,0
10552570,1,1,0,0,1,1,0,0,1
10552607,2,2,0,0,1,1,0,0,0
10552855,1,1,0,0,1,1,0,0,0
10552900,2,2,0,0,2,2,0,0,0
10552904,1,1,0,0,1,1,0,0,1
10552998,1,1,0,0,1,1,0,0,0
10553102,1,1,0,0,1,1,0,0,1
10553903,2,2,0,0,2,1,1,0,1
10553961,2,0,2,0,0,0,0,0,0
10554091,3,2,1,0,1,1,0,0,1
10554111,1,1,0,0,1,1,0,0,0
10554420,1,1,0,0,1,1,0,0,0
10555013,2,0,2,0,0,0,0,0,0
10555171,1,0,1,0,0,0,0,0,0
10555412,2,1,1,0,1,1,0,0,0
10555687,1,1,0,0,1,1,0,0,0
10556338,10,9,1,0,0,0,0,0,1
10556472,1,0,1,0,1,1,0,0,0
10556494,2,2,0,0,1,1,0,0,1
10556538,3,1,2,0,2,1,1,0,0
10556585,1,0,1,0,1,1,0,0,0
10556618,5,2,3,0,1,1,0,1,1
10557278,1,1,0,0,1,1,0,0,0
10557349,1,1,0,0,1,1,0,0,0
10557753,2,0,2,0,2,2,0,0,0
10557963,5,1,4,0,4,1,3,0,0
10558358,6,2,4,0,2,1,1,1,0
10558546,2,2,0,0,0,0,0,0,0
10558898,6,6,0,0,0,0,0,0,0
10559231,5,5,0,0,4,0,4,0,1
10559383,2,2,0,0,1,1,0,0,0
10559668,1,1,0,0,1,1,0,0,0
10560133,2,2,0,0,2,2,0,0,0
10560212,1,1,0,0,1,1,0,0,0
10560944,2,0,2,0,2,2,0,0,0
10560948,2,2,0,0,1,1,0,0,0
10560964,2,0,2,0,1,1,0,0,0
10561315,6,6,0,0,2,2,0,0,1
10561325,2,2,0,0,2,2,0,0,1
10561329,2,1,1,0,1,0,1,0,0
10562129,1,1,0,0,1,1,0,0,0
10563072,8,6,2,0,1,1,0,1,1
10563578,4,0,4,0,0,0,0,0,0
10563849,8,8,0,0,1,1,0,0,1
10564101,3,3,0,0,0,0,0,0,1
10564524,1,1,0,0,1,1,0,0,0
10564777,1,0,1,0,0,0,0,0,0
10564882,1,1,0,0,0,0,0,0,0
10565003,1,1,0,0,1,1,0,0,0
10565065,1,1,0,0,0,0,0,0,0
10565291,3,2,1,0,0,0,0,0,0
10565318,1,1,0,0,1,1,0,0,0
10565359,2,1,1,0,2,2,0,0,1
10565938,2,2,0,0,0,0,0,0,0
10567050,1,1,0,0,1,1,0,0,0
10567135,4,4,0,0,2,0,2,0,1
10567156,1,1,0,0,1,1,0,0,0
10567210,1,0,1,0,1,1,0,0,0
10567303,4,4,0,0,1,1,0,0,1
10567655,1,0,1,0,1,1,0,0,1
10567896,1,1,0,0,1,1,0,0,0
10567985,1,1,0,0,1,1,0,0,0
10568425,5,3,2,0,6,4,2,0,1
10568625,1,1,0,0,1,1,0,0,0
10568765,3,0,3,0,2,2,0,0,0
10568948,4,3,1,0,2,1,1,1,1
10569449,10,4,6,0,2,1,1,2,1
10569513,1,0,1,0,1,1,0,0,0
10569873,1,1,0,0,1,1,0,0,0
10570068,2,0,2,0,1,1,0,0,0
10570450,2,2,0,0,1,1,0,0,0
10570499,4,1,3,0,0,0,0,0,0
10570623,2,2,0,0,2,2,0,1,1
10570663,2,2,0,0,2,2,0,1,1
10570895,2,2,0,0,2,2,0,1,1
10571068,6,4,2,0,3,3,0,3,0
10571084,4,4,0,0,1,1,0,1,1
10571492,4,4,0,0,0,0,0,0,0
10572202,1,1,0,0,1,1,0,0,0
10572441,1,1,0,0,1,1,0,0,0
10572508,2,0,2,0,1,1,0,1,0
10572595,1,1,0,0,1,1,0,0,0
10572802,12,8,4,0,5,2,3,1,1
10572944,9,7,2,0,2,1,1,0,1
10573231,5,5,0,0,0,0,0,0,0
10573411,1,1,0,0,1,1,0,0,0
10574123,5,5,0,0,0,0,0,0,1
10574151,3,3,0,0,3,3,0,0,0
10574204,1,1,0,0,1,1,0,0,0
10574265,5,4,1,0,5,4,1,0,1
10574548,1,1,0,0,1,1,0,0,0
10574807,2,2,0,0,1,1,0,0,0
10574912,3,3,0,0,2,2,0,0,0
10575071,3,3,0,0,1,1,0,0,1
10575178,1,0,1,0,1,1,0,0,0
10575706,1,1,0,0,1,1,0,0,0
10575906,2,2,0,0,1,1,0,0,0
10576000,1,1,0,0,1,1,0,0,0
10576001,2,0,2,0,2,1,1,0,0
10576408,3,3,0,0,2,2,0,0,1
10576584,2,0,2,0,2,1,1,0,0
10576644,2,1,1,0,1,0,1,0,0
10577740,1,0,1,0,0,0,0,0,0
10578350,1,1,0,0,1,1,0,0,0
10579427,1,0,1,0,1,1,0,0,0
10579687,1,1,0,0,0,0,0,0,0
10579954,1,0,1,0,1,1,0,0,0
10580127,5,4,1,0,0,0,0,0,1
10580455,2,2,0,0,1,1,0,0,0
10581254,3,2,1,0,1,1,0,1,0
10581311,5,5,0,0,0,0,0,0,0
10581412,15,8,7,0,1,0,1,0,0
10581540,1,0,1,0,1,1,0,0,1
10582224,3,2,1,0,3,2,1,0,1
10582411,10,8,2,0,0,0,0,0,0
10582469,1,1,0,0,1,1,0,0,0
10582621,2,2,0,0,2,2,0,0,0
10583015,2,0,2,0,2,1,1,0,0
10583051,2,2,0,0,2,2,0,0,0
10583753,2,1,1,0,0,0,0,0,0
10583830,4,3,1,0,3,2,1,0,1
10584076,3,3,0,0,3,3,0,0,0
10584104,1,1,0,0,1,1,0,0,0
10584146,11,7,4,0,0,0,0,0,0
10584420,6,4,2,0,4,4,0,3,1
10584444,2,2,0,0,1,1,0,1,1
10584468,5,0,5,0,0,0,0,0,1
10584471,9,4,5,0,1,0,1,0,0
10584524,1,1,0,0,1,1,0,0,0
10584815,2,2,0,0,1,1,0,0,0
10584835,1,1,0,0,5,5,0,0,0
10585011,2,2,0,0,1,1,0,0,0
10585361,1,1,0,0,1,1,0,0,0
10585561,2,2,0,0,2,2,0,0,0
10585646,1,0,1,0,1,1,0,0,0
10585784,2,1,1,0,2,1,1,0,0
10586362,13,12,1,0,0,0,0,0,1
10586521,2,2,0,0,2,2,0,0,0
10586676,3,3,0,0,1,1,0,0,1
10586823,2,2,0,0,1,1,0,0,0
10586854,1,1,0,0,1,1,0,0,0
10586990,1,0,1,0,1,1,0,0,0
10587640,1,1,0,0,1,1,0,0,0
10587945,1,0,1,0,1,1,0,0,0
10588079,1,0,1,0,1,1,0,0,0
10588094,2,0,2,0,2,2,0,0,1
10588222,2,0,2,0,1,1,0,0,0
10588332,3,3,0,0,2,2,0,1,1
10588399,1,0,1,0,1,1,0,0,0
10588758,3,3,0,1,1,0,1,0,1
10589480,1,0,1,0,1,1,0,0,0
10589992,2,2,0,0,0,0,0,0,1
10590365,4,0,4,0,2,2,0,0,0
10590737,1,1,0,0,1,1,0,0,0
10590970,1,1,0,0,1,1,0,0,0
10591321,1,1,0,0,1,1,0,0,0
10591763,5,2,3,0,1,1,0,1,1
10591905,3,2,1,0,1,1,0,1,1
10591909,1,1,0,0,0,0,0,0,0
10591935,3,3,0,0,2,2,0,0,1
10592501,1,1,0,0,1,1,0,0,0
10592542,2,1,1,0,1,1,0,0,0
10593039,1,1,0,0,0,0,0,0,0
10593143,8,5,3,0,1,1,0,0,0
10593418,2,2,0,0,2,2,0,0,0
10593605,2,2,0,0,2,2,0,0,0
10593951,2,2,0,0,1,1,0,0,1
10593961,4,2,2,0,1,1,0,0,0
10594423,2,2,0,0,1,1,0,0,1
10594618,2,2,0,0,2,2,0,0,0
10594649,1,1,0,0,1,1,0,0,0
10595091,3,2,1,0,1,1,0,1,1
10595477,2,2,0,0,1,1,0,0,0
10596031,1,1,0,0,1,1,0,0,0
10596347,2,1,1,0,2,2,0,1,1
10596356,10,3,7,0,4,1,3,1,1
10596485,3,2,1,0,2,2,0,1,1
10596509,10,3,7,0,7,4,3,0,1
10596589,9,3,6,0,5,2,3,0,1
10596621,10,3,7,0,4,1,3,1,1
10597448,1,1,0,0,1,1,0,0,0
10597606,2,2,0,0,2,2,0,0,0
10598010,1,0,1,0,1,1,0,0,0
10598541,1,1,0,0,2,2,0,0,1
10598631,5,4,1,0,2,1,1,1,0
10598969,3,3,0,0,3,3,0,0,0
10599012,1,0,1,0,1,1,0,0,0
10599050,8,6,2,0,2,2,0,0,1
10599055,2,1,1,0,2,1,1,0,0
10599789,1,1,0,0,2,2,0,1,0
10599929,14,12,2,0,0,0,0,0,1
10599956,1,1,0,0,1,1,0,0,0
10600290,5,2,3,0,2,0,2,0,0
10600329,2,1,1,0,2,1,1,0,1
10600336,1,1,0,0,1,1,0,0,0
10600638,1,1,0,0,1,1,0,0,0
10600815,2,2,0,0,1,1,0,0,0
10601295,1,0,1,0,1,1,0,0,0
10601727,4,3,1,0,2,1,1,0,0
10602117,1,1,0,0,1,1,0,0,0
10602126,1,1,0,0,1,1,0,0,0
10602511,3,1,2,0,2,1,1,0,1
10602552,4,3,1,0,1,0,1,1,1
10602718,3,2,1,0,2,2,0,0,0
10603026,1,0,1,0,0,0,0,0,0
10603145,2,0,2,0,0,0,0,0,1
10603387,1,0,1,0,1,1,0,0,0
10603681,2,2,0,0,2,2,0,0,0
10603891,3,0,3,0,1,1,0,0,0
10604549,1,1,0,0,1,1,0,0,0
10604880,2,2,0,0,2,2,0,0,1
10604890,3,3,0,0,1,1,0,0,0
10605013,1,1,0,0,1,1,0,0,0
10605033,2,2,0,0,2,1,1,0,0
10605273,1,1,0,0,1,1,0,0,0
10605500,2,0,2,0,2,2,0,0,0
10605734,6,3,3,0,2,2,0,2,1
10605822,3,2,1,0,1,1,0,1,1
10605876,7,6,1,0,1,1,0,1,1
10606045,2,2,0,0,1,1,0,0,1
10606179,3,3,0,0,0,0,0,0,1
10606596,8,6,2,0,0,0,0,0,1
10606644,8,6,2,0,0,0,0,0,1
10607317,3,0,3,0,1,1,0,0,0
10607382,1,1,0,0,1,1,0,0,0
10608258,1,1,0,0,1,1,0,0,0
10608281,2,0,2,0,2,2,0,0,0
10608362,3,1,2,0,4,1,3,1,0
10608820,9,6,3,0,3,2,1,1,1
10609093,4,4,0,0,2,1,1,1,1
10609635,7,6,1,0,1,1,0,1,1
10609930,1,0,1,0,1,1,0,0,0
10610333,1,0,1,0,1,1,0,0,0
10610416,1,1,0,0,1,1,0,0,0
10611208,5,3,2,0,1,1,0,0,1
10611722,8,5,3,0,0,0,0,0,0
10611794,7,5,2,0,1,1,0,1,1
10611815,5,4,1,0,2,2,0,2,0
10611841,1,0,1,0,1,1,0,0,0
10611970,2,2,0,0,2,2,0,0,0
10611993,5,5,0,0,0,0,0,0,0
10612238,1,1,0,0,1,1,0,0,1
10612598,2,2,0,0,2,2,0,0,0
10612790,2,2,0,0,2,2,0,0,0
10613213,2,1,1,0,1,1,0,0,0
10613486,2,0,2,0,1,1,0,0,1
10614035,2,2,0,0,0,0,0,0,0
10614424,1,1,0,0,2,1,1,0,0
10614877,2,2,0,0,2,2,0,0,0
10614920,1,1,0,0,1,1,0,0,0
10614921,1,0,1,0,0,0,0,0,0
10615103,2,2,0,0,1,1,0,1,0
10615394,4,3,1,0,1,1,0,0,1
10615484,11,10,1,0,2,0,2,0,0
10615775,1,1,0,0,1,1,0,0,0
10616402,1,1,0,0,1,1,0,0,0
10617031,2,0,2,0,1,1,0,0,0
10617339,2,0,2,0,1,1,0,0,0
10617856,3,2,1,0,2,1,1,0,0
10617898,3,1,2,0,2,1,1,0,0
10617900,1,1,0,0,1,1,0,0,0
10617957,1,1,0,0,1,1,0,0,0
10617998,2,2,0,0,1,1,0,0,0
10618229,9,3,6,0,1,1,0,1,1
10618230,9,3,6,0,1,1,0,1,1
10618661,9,4,5,0,2,1,1,2,0
10618850,3,3,0,0,2,2,0,0,1
10619121,3,1,2,0,2,1,1,1,1
10619376,1,0,1,0,1,1,0,0,0
10619917,10,8,2,0,1,1,0,1,1
10620030,1,0,1,0,1,1,0,0,0
10620289,1,0,1,0,2,1,1,0,0
10620731,1,0,1,0,1,1,0,0,0
10620935,6,5,1,0,1,1,0,1,1
10620966,1,0,1,0,1,1,0,0,0
10620986,1,0,1,0,1,1,0,0,0
10621088,2,0,2,0,1,1,0,0,0
10621107,4,4,0,0,3,2,1,0,1
10621636,2,2,0,0,1,1,0,0,0
10622154,3,3,0,0,3,3,0,1,0
10622548,3,3,0,0,3,3,0,0,0
10622625,2,1,1,0,1,1,0,0,0
10622971,23,22,1,0,0,0,0,0,0
10623017,1,1,0,0,1,1,0,0,0
10623076,2,0,2,0,1,0,1,0,1
10623211,2,2,0,0,3,3,0,0,0
10623655,6,3,3,0,1,1,0,1,1
10623965,6,3,3,0,1,1,0,1,1
10623995,5,0,5,0,4,3,1,0,0
10624253,1,1,0,0,1,1,0,0,0
10624351,4,0,4,0,0,0,0,0,0
10624425,1,1,0,0,1,1,0,0,1
10624671,4,2,2,0,1,1,0,0,0
10624693,2,2,0,0,2,0,2,0,0
10624769,1,1,0,0,1,1,0,0,0
10624887,1,1,0,0,1,1,0,0,0
10624932,1,0,1,0,1,1,0,0,0
10624991,2,0,2,0,1,1,0,0,0
10625209,3,3,0,0,1,1,0,0,0
10625341,2,0,2,0,1,1,0,1,0
10625543,1,0,1,0,1,1,0,0,1
10625563,1,1,0,0,1,1,0,0,0
03738420,9,2,7,0,1,1,0,0,0
03738566,41,11,30,0,10,10,0,0,1
03738616,45,17,28,0,16,0,16,0,1
03738674,28,4,24,0,1,1,0,1,1
03738678,13,0,13,0,2,2,0,0,1
03738846,6,1,5,0,2,2,0,0,0
03739124,36,3,33,0,0,0,0,0,1
03739184,20,2,18,0,1,1,0,1,1
03739319,9,0,9,0,0,0,0,0,1
03739410,36,4,32,0,1,1,0,1,1
03739551,14,2,12,0,2,2,0,2,1
03739557,8,2,6,1,1,1,0,0,1
03739781,26,0,26,0,0,0,0,0,1
03739954,32,3,29,0,2,1,1,2,1
03740476,6,4,2,0,3,3,0,0,0
03740497,5,0,5,0,1,1,0,0,0
03740505,7,0,7,0,0,0,0,0,1
03740620,14,0,14,0,0,0,0,0,1
03740647,58,8,50,0,0,0,0,0,1
03740675,12,5,7,0,7,5,2,0,0
03740741,22,3,19,0,1,1,0,1,1
03740753,10,1,9,0,1,1,0,1,1
03741075,6,1,5,0,0,0,0,0,1
03741198,11,2,9,0,1,1,0,1,1
03741454,13,2,11,0,0,0,0,0,1
03741527,9,5,4,0,1,1,0,0,0
03741554,18,0,18,0,1,1,0,1,1
03741555,31,3,28,0,2,1,1,2,1
03741557,18,0,18,0,1,1,0,1,1
03741768,38,4,34,0,1,1,0,1,1
03742144,4,2,2,0,1,1,0,0,1
03742352,16,2,14,0,1,1,0,0,1
03742521,34,3,31,0,1,1,0,1,1
03742986,32,11,21,0,1,1,0,1,1
03743191,45,5,40,0,0,0,0,0,1
03743251,16,2,14,0,1,1,0,1,1
03743275,8,2,6,0,1,1,0,0,0
03743500,40,3,37,0,1,1,0,1,1
03744372,36,0,36,0,0,0,0,0,1
03744378,48,4,44,0,1,1,0,1,1
03744380,48,4,44,0,1,1,0,1,1
03744383,51,4,47,0,1,1,0,1,1
03744660,26,4,22,0,1,1,0,1,1
03744689,5,2,3,0,1,1,0,0,1
03745273,10,3,7,0,2,2,0,0,1
03745303,17,7,10,0,2,1,1,1,1
03745373,36,11,25,0,1,1,0,0,1
03745578,28,6,22,0,1,1,0,1,1
03745925,16,7,9,0,0,0,0,0,0
03745968,15,0,15,0,0,0,0,0,1
03746052,4,0,4,0,2,2,0,0,0
03746069,10,0,10,0,0,0,0,0,1
03747023,14,4,10,0,1,1,0,1,1
03747084,20,4,16,0,0,0,0,0,1
03747125,5,0,5,0,0,0,0,0,1
03747176,20,0,20,0,0,0,0,0,1
03747506,16,1,15,0,4,2,2,1,1
03747938,11,0,11,0,1,1,0,1,1
03747980,6,2,4,0,2,2,0,0,1
03748354,22,13,9,0,0,0,0,0,1
03748389,6,2,4,0,2,1,1,1,1
03748419,24,9,15,0,0,0,0,0,1
03748492,10,4,6,0,0,0,0,0,0
03748597,7,2,5,0,1,1,0,0,0
03748635,11,3,8,0,1,1,0,1,1
03748862,8,2,6,0,1,1,0,0,0
03749034,19,9,10,0,0,0,0,0,1
03749062,5,1,4,0,1,1,0,0,1
03749063,17,2,15,0,1,1,0,1,1
03749322,10,4,6,0,1,1,0,1,1
03749323,9,4,5,0,1,1,0,1,1
03749328,10,1,9,0,1,1,0,0,1
03749416,5,0,5,0,1,1,0,0,0
03749458,15,4,11,0,2,1,1,0,1
03749536,14,5,9,0,0,0,0,0,1
03749546,8,3,5,0,1,1,0,0,1
03749576,12,5,7,0,6,6,0,1,1
03749618,19,2,17,0,1,1,0,1,1
03749776,6,4,2,0,2,2,0,0,1
03749983,14,0,14,0,0,0,0,0,1
03750367,3,1,2,0,1,1,0,0,1
03750656,28,3,25,0,3,1,2,0,1
03750657,5,2,3,0,1,1,0,0,0
03750674,45,10,35,0,0,0,0,0,1
03751152,6,1,5,0,1,1,0,0,1
03751380,11,0,11,0,1,1,0,0,0
03751525,39,3,36,0,1,1,0,1,1
03751674,33,7,26,0,1,1,0,1,1
03751732,5,3,2,0,2,2,0,0,0
03751959,5,3,2,0,1,1,0,0,1
03752188,5,3,2,0,2,2,0,0,1
03752333,58,4,54,0,2,1,1,0,1
03752343,37,2,35,0,0,0,0,0,1
03752528,18,0,18,0,0,0,0,0,1
03752544,38,7,31,0,2,2,0,0,1
03752582,30,7,23,0,2,2,0,0,1
03752712,21,1,20,0,1,1,0,1,1
03752833,20,6,14,0,0,0,0,0,0
03753219,30,3,27,0,1,1,0,0,0
03753345,53,4,49,0,0,0,0,0,1
03753355,7,0,7,0,0,0,0,0,1
03753765,12,0,12,0,1,1,0,1,1
03754000,34,3,31,0,0,0,0,0,1
03754242,29,13,16,0,1,1,0,0,0
03754243,13,7,6,0,0,0,0,0,1
03754353,42,0,42,0,0,0,0,0,1
03754625,11,3,8,0,2,1,1,1,1
03754942,10,6,4,0,1,1,0,1,0
03754997,14,0,14,0,0,0,0,0,1
03755033,34,4,30,0,1,1,0,1,1
03755238,8,2,6,0,1,1,0,0,1
03755337,5,2,3,0,1,1,0,0,1
03755464,33,0,33,0,1,1,0,1,1
03755668,16,11,5,0,0,0,0,0,1
03755701,9,5,4,0,0,0,0,0,0
03755754,5,0,5,0,0,0,0,0,1
03756152,32,11,21,0,0,0,0,0,0
03756436,16,0,16,0,0,0,0,0,1
03756817,21,2,19,1,1,1,0,1,1
03756872,14,6,8,0,0,0,0,0,0
03757011,10,4,6,0,1,1,0,0,1
03757200,17,2,15,0,0,0,0,0,1
03757248,29,8,21,0,1,1,0,0,0
03757268,4,0,4,0,1,1,0,0,0
03757502,25,3,22,0,1,1,0,1,1
03757651,7,3,4,0,3,1,2,1,1
03757874,40,7,33,0,0,0,0,0,1
03758075,8,5,3,0,6,1,5,3,1
03758317,4,2,2,0,1,1,0,0,1
03758673,14,0,14,0,1,1,0,1,1
03758786,17,6,11,0,0,0,0,0,1
03758842,8,4,4,0,1,1,0,0,1
03759102,25,7,18,0,1,1,0,1,1
03759628,5,2,3,0,1,1,0,0,1
03759658,9,3,6,0,1,1,0,0,0
03759738,4,1,3,0,2,2,0,0,1
03760267,35,11,24,0,2,2,0,2,1
03760451,21,4,17,0,1,1,0,0,1
03760617,23,0,23,0,0,0,0,0,1
03760777,16,3,13,0,1,1,0,1,1
03760824,10,0,10,0,1,1,0,1,1
03761135,22,5,17,0,0,0,0,0,1
03761178,25,3,22,0,1,1,0,1,1
03761194,20,3,17,0,1,1,0,1,1
03761274,12,0,12,0,0,0,0,0,1
03761275,22,2,20,0,2,1,1,2,1
03761316,28,3,25,0,0,0,0,0,0
03761340,21,12,9,0,1,1,0,0,1
03761393,8,4,4,0,2,1,1,2,1
03761421,13,0,13,0,0,0,0,0,1
03761753,8,5,3,0,1,1,0,1,0
03761777,70,12,58,0,0,0,0,0,1
03761793,21,5,16,0,0,0,0,0,1
03761906,6,3,3,0,2,1,1,0,1
03761983,22,3,19,0,1,1,0,1,1
03762366,23,4,19,0,2,2,0,0,1
03762371,32,4,28,0,4,1,3,1,1
03762537,5,2,3,0,2,2,0,0,1
03762879,29,5,24,0,0,0,0,0,1
03762890,26,2,24,0,1,1,0,1,1
03763190,16,6,10,0,1,1,0,1,1
03763419,22,3,19,0,1,1,0,1,1
03763833,22,10,12,0,1,1,0,0,1
03763870,17,6,11,0,1,1,0,0,1
03763946,8,0,8,0,0,0,0,0,1
03764278,9,6,3,0,1,1,0,0,1
03764413,21,4,17,0,1,1,0,1,1
03764415,8,0,8,0,0,0,0,0,1
03764584,7,0,7,0,0,0,0,0,1
03764590,13,0,13,0,1,1,0,1,1
03764647,20,0,20,0,0,0,0,0,1
03764784,6,0,6,0,2,1,1,0,0
03765272,4,2,2,0,1,1,0,0,1
03765744,21,0,21,0,0,0,0,0,1
03766009,6,3,3,0,2,2,0,0,1
03766242,16,5,11,0,0,0,0,0,1
03766382,11,0,11,0,0,0,0,0,1
03766865,30,0,30,0,0,0,0,0,1
03767295,17,2,15,0,1,1,0,0,1
03767312,34,9,25,0,0,0,0,0,1
03767321,13,0,13,0,0,0,0,0,0
03767533,36,11,25,0,1,1,0,0,0
03767752,25,0,25,0,0,0,0,0,1
03767849,8,0,8,0,0,0,0,0,1
03767938,6,0,6,0,0,0,0,0,1
03768096,9,2,7,0,1,1,0,1,0
03768392,6,3,3,0,1,1,0,0,0
03768746,9,2,7,0,1,1,0,0,1
03768838,5,2,3,0,2,2,0,0,1
03769269,7,4,3,0,1,1,0,1,1
03769371,8,2,6,0,1,1,0,0,0
03769516,5,1,4,0,0,0,0,0,1
03769605,25,0,25,0,0,0,0,0,1
03769694,9,6,3,0,1,1,0,0,0
03769702,24,6,18,0,0,0,0,0,1
03769768,19,7,12,0,0,0,0,0,0
03769775,28,15,13,0,0,0,0,0,1
03770007,17,0,17,0,0,0,0,0,1
03770237,8,5,3,0,0,0,0,0,1
03770319,13,7,6,0,6,6,0,0,1
03770430,5,3,2,0,2,2,0,0,1
03770548,35,3,32,0,1,1,0,1,1
03770568,17,6,11,0,1,1,0,1,1
03770577,4,0,4,0,0,0,0,0,1
03770692,17,0,17,0,0,0,0,0,1
03770765,12,5,7,0,3,3,0,1,1
03770985,13,9,4,0,4,3,1,1,0
03771000,26,5,21,0,1,1,0,1,1
03771108,13,2,11,0,3,2,1,1,1
03771572,39,7,32,0,0,0,0,0,1
03771991,31,0,31,0,0,0,0,0,1
03772067,12,5,7,0,1,1,0,1,1
03772150,27,5,22,0,1,1,0,1,1
03772192,19,0,19,0,0,0,0,0,1
03772368,26,0,26,0,0,0,0,0,0
03772449,19,5,14,0,1,1,0,1,1
03772465,27,3,24,0,1,1,0,1,1
03772483,10,5,5,0,1,1,0,1,1
03772745,15,0,15,0,0,0,0,0,1
03772746,37,4,33,0,1,1,0,1,1
03772814,25,3,22,0,1,1,0,1,1
03772954,19,1,18,0,0,0,0,0,1
03773247,21,0,21,0,0,0,0,0,1
03773499,8,3,5,0,2,2,0,0,1
03773541,20,0,20,0,0,0,0,0,1
03773684,23,5,18,0,1,1,0,1,1
03773737,24,8,16,0,0,0,0,0,0
03773789,37,3,34,0,1,1,0,1,1
03773914,81,8,73,0,1,1,0,1,1
03774673,27,4,23,0,0,0,0,0,1
03775012,18,4,14,0,1,1,0,1,1
03775122,33,5,28,0,1,1,0,1,1
03775228,6,0,6,0,0,0,0,0,1
03775272,12,6,6,0,4,1,3,1,1
03775489,65,2,63,0,0,0,0,0,1
03775684,5,0,5,0,1,1,0,0,0
03776520,17,5,12,0,1,1,0,1,1
03776523,20,3,17,0,1,1,0,1,1
03776633,18,0,18,1,0,0,0,0,1
03777037,64,14,50,0,0,0,0,0,1
03777080,10,3,7,0,1,1,0,0,0
03777089,27,3,24,0,1,1,0,1,1
03777102,4,2,2,0,1,1,0,0,0
03777156,33,11,22,0,0,0,0,0,1
03777271,4,0,4,0,2,2,0,0,1
03777276,20,0,20,0,1,1,0,1,1
03777280,5,0,5,0,2,2,0,0,1
03777308,23,14,9,0,0,0,0,0,1
03777473,25,3,22,0,1,1,0,1,1
03777578,21,7,14,0,2,1,1,2,1
03777595,9,0,9,0,0,0,0,0,0
03777797,36,5,31,0,0,0,0,0,1
03778367,28,3,25,0,1,1,0,1,1
03778430,5,3,2,0,0,0,0,0,1
03778452,11,0,11,0,0,0,0,0,1
03778762,19,5,14,0,3,3,0,0,0
03778803,4,2,2,0,1,1,0,0,1
03779289,80,0,80,0,0,0,0,0,1
03779545,38,10,28,0,0,0,0,0,1
03779704,5,3,2,0,1,1,0,0,0
03779971,52,15,37,0,1,1,0,1,1
03779976,46,16,30,0,1,1,0,1,1
03779985,53,16,37,0,1,1,0,1,1
03780160,18,5,13,0,0,0,0,0,1
03780165,27,6,21,0,4,4,0,0,1
03780434,20,4,16,0,1,1,0,1,1
03780594,18,0,18,0,1,1,0,1,1
03781173,22,5,17,0,0,0,0,0,1
03781251,25,5,20,0,0,0,0,0,1
03781302,12,4,8,0,2,2,0,0,0
03781324,5,3,2,0,2,2,0,0,1
03781498,17,0,17,0,0,0,0,0,1
03782342,19,2,17,0,1,1,0,1,1
03782417,2,2,0,0,1,1,0,1,1
03782443,27,3,24,0,2,1,1,2,1
03782471,5,0,5,0,0,0,0,0,1
03782700,40,7,33,0,1,1,0,1,1
03782816,14,5,9,0,0,0,0,0,1
03782838,8,0,8,0,0,0,0,0,1
03782887,6,1,5,0,0,0,0,0,0
03782935,23,0,23,0,0,0,0,0,1
03782943,19,0,19,0,0,0,0,0,1
03782947,12,3,9,0,1,1,0,1,1
03783281,14,3,11,0,2,2,0,0,1
03783386,18,5,13,0,2,1,1,1,1
03783689,7,3,4,0,1,1,0,0,0
03783741,15,2,13,0,1,1,0,0,1
03783747,21,0,21,0,0,0,0,0,0
03783885,19,0,19,0,0,0,0,0,1
03783896,6,3,3,0,2,2,0,0,0
03783920,5,0,5,0,0,0,0,0,1
03783999,4,3,1,0,2,2,0,0,1
03784498,14,2,12,0,0,0,0,0,1
03784514,15,7,8,0,1,1,0,0,1
03784527,31,0,31,0,0,0,0,0,1
03784528,32,6,26,0,1,1,0,1,1
03784577,15,0,15,0,0,0,0,0,1
03784634,9,1,8,0,0,0,0,0,1
03784932,4,2,2,0,1,1,0,0,0
03784996,5,3,2,0,1,1,0,0,0
03785049,11,0,11,1,0,0,0,0,0
03785171,10,3,7,0,1,1,0,1,1
03785417,11,1,10,0,0,0,0,0,1
03785469,19,4,15,0,0,0,0,0,0
03785527,46,11,35,0,0,0,0,0,1
03785692,12,0,12,0,0,0,0,0,1
03786105,7,1,6,0,1,1,0,0,1
03786162,37,6,31,0,1,1,0,1,1
03786339,33,0,33,0,0,0,0,0,1
03786387,10,2,8,0,1,1,0,0,1
03786487,26,4,22,0,1,1,0,1,1
03786657,21,0,21,0,0,0,0,0,1
03786845,21,0,21,0,0,0,0,0,1
03786989,29,0,29,0,1,1,0,1,1
03787039,11,2,9,0,1,1,0,1,1
03787141,6,3,3,0,2,2,0,1,0
03787294,16,0,16,0,0,0,0,0,1
03787518,20,0,20,0,0,0,0,0,1
03787602,7,0,7,0,0,0,0,0,1
03787825,7,2,5,0,2,2,0,0,1
03788040,20,2,18,0,1,1,0,1,1
03788183,16,3,13,0,1,1,0,1,1
03788207,14,0,14,0,0,0,0,0,1
03788579,14,5,9,0,1,1,0,1,1
03788862,4,2,2,0,1,1,0,0,0
03788874,20,4,16,0,3,3,0,0,1
03788956,20,0,20,0,1,1,0,1,1
03789058,25,0,25,0,0,0,0,0,1
03789061,8,2,6,0,1,1,0,0,1
03789231,6,0,6,0,0,0,0,0,1
03789309,4,2,2,0,1,1,0,0,1
03789392,8,1,7,0,1,1,0,0,0
03789782,4,1,3,0,1,1,0,0,1
03789864,37,4,33,0,1,1,0,1,1
03789894,5,0,5,0,1,1,0,0,0
03789898,6,0,6,0,0,0,0,0,1
03789963,21,4,17,0,2,1,1,0,1
03790187,22,0,22,0,0,0,0,0,1
03790222,8,0,8,0,0,0,0,0,1
03790701,6,3,3,0,1,1,0,0,1
03790871,7,1,6,0,1,1,0,0,1
03791447,4,2,2,0,2,2,0,0,1
03791608,10,2,8,0,1,1,0,0,1
03791808,28,0,28,0,1,1,0,1,1
03791859,7,4,3,0,1,1,0,0,1
03791923,6,3,3,0,2,2,0,0,1
03792331,5,3,2,0,1,1,0,0,1
03792408,23,3,20,0,1,1,0,1,1
03792496,11,3,8,0,1,1,0,1,1
03792590,23,0,23,0,0,0,0,0,1
03792761,16,4,12,0,2,1,1,2,1
03792840,23,0,23,0,0,0,0,0,1
03792886,30,4,26,0,2,1,1,1,1
03792911,23,3,20,0,1,1,0,1,1
03792949,8,5,3,0,2,2,0,0,1
03792982,15,9,6,0,0,0,0,0,0
03793191,14,0,14,0,0,0,0,0,1
03793201,27,9,18,0,0,0,0,0,1
03793497,7,3,4,0,2,2,0,0,0
03793946,9,5,4,0,0,0,0,0,1
03793980,9,4,5,0,2,2,0,0,0
03794403,7,2,5,0,1,1,0,1,1
03794640,49,4,45,0,0,0,0,0,1
03794679,4,3,1,0,1,1,0,0,0
03795008,10,4,6,0,1,1,0,0,0
03795232,14,5,9,0,0,0,0,0,1
03795257,7,3,4,0,2,2,0,0,0
03795273,11,2,9,0,1,1,0,1,1
03795539,8,0,8,0,0,0,0,0,1
03795544,6,3,3,0,1,1,0,0,1
03795779,8,3,5,0,1,1,0,0,1
03795868,18,0,18,0,0,0,0,0,1
03795965,11,5,6,0,2,2,0,0,1
03795973,11,4,7,0,1,1,0,0,1
02793101,18,4,14,0,1,1,0,1,1
02793118,18,4,14,0,1,1,0,1,1
02793119,18,4,14,0,1,1,0,1,1
02793120,18,4,14,0,1,1,0,1,1
02793144,20,3,17,0,1,1,0,1,1
02793215,28,8,20,0,1,1,0,0,1
02793570,24,3,21,0,0,0,0,0,1
02793748,14,5,9,0,4,4,0,0,1
02793780,44,11,33,0,0,0,0,0,1
02793799,21,0,21,0,0,0,0,0,1
02793816,44,6,38,0,0,0,0,0,1
02793995,5,0,5,0,0,0,0,0,1
02794022,8,2,6,0,1,1,0,0,1
02794024,40,3,37,0,1,1,0,1,1
02794036,8,3,5,0,0,0,0,0,1
02794326,14,4,10,0,3,3,0,0,1
02794372,5,3,2,0,2,2,0,0,0
02794424,25,2,23,0,1,1,0,0,1
02794821,14,0,14,0,0,0,0,0,1
02794823,19,0,19,0,0,0,0,0,1
02794949,54,5,49,0,1,1,0,1,1
02794955,34,5,29,0,1,1,0,1,1
02794958,20,0,20,0,0,0,0,0,1
02794968,35,0,35,0,1,1,0,1,1
02795072,4,0,4,0,1,1,0,0,1
02795266,22,2,20,0,1,1,0,1,1
02795288,62,7,55,0,0,0,0,0,0
02795460,11,6,5,0,1,1,0,0,1
02795626,28,3,25,0,2,1,1,2,1
02795958,28,2,26,0,1,1,0,1,1
02796130,11,0,11,0,2,1,1,2,1
02796148,38,2,36,0,1,1,0,0,1
02796272,18,3,15,0,0,0,0,0,1
02796297,9,1,8,0,1,1,0,1,0
02796306,19,0,19,0,0,0,0,0,1
02796531,20,3,17,0,1,1,0,1,1
02796631,6,3,3,0,1,1,0,0,1
02796837,20,3,17,0,1,1,0,1,1
02797127,24,2,22,0,1,1,0,0,1
02797365,52,6,46,0,2,2,0,2,1
02797671,18,0,18,0,0,0,0,0,1
02797767,19,0,19,0,0,0,0,0,1
02797826,25,8,17,0,1,0,1,0,1
02797996,19,8,11,0,7,7,0,0,1
02798041,30,5,25,0,1,1,0,1,1
02798157,23,6,17,0,1,1,0,0,1
02798178,28,2,26,0,1,1,0,1,1
02798348,6,3,3,0,1,1,0,1,0
02798380,34,3,31,0,1,1,0,1,1
02798408,29,3,26,0,1,1,0,1,0
02798634,39,7,32,0,0,0,0,0,1
02798718,11,2,9,0,1,1,0,1,1
02799335,12,0,12,0,0,0,0,0,1
02799543,23,3,20,0,0,0,0,0,1
02799669,28,2,26,0,0,0,0,0,1
02799746,9,7,2,0,2,2,0,0,0
02799754,37,3,34,0,1,1,0,1,1
02799815,25,4,21,0,1,1,0,1,1
02799844,34,0,34,0,1,1,0,1,1
02800301,59,9,50,0,1,1,0,0,1
02800636,59,10,49,0,1,1,0,1,1
02800802,32,1,31,0,1,1,0,1,1
02800803,28,0,28,0,0,0,0,0,1
02800965,0,0,0,0,0,0,0,0,1
02801121,32,3,29,0,1,1,0,1,1
02801202,14,3,11,0,1,1,0,1,1
02801247,14,3,11,0,0,0,0,0,0
02801292,20,2,18,0,0,0,0,0,1
02801297,33,3,30,0,0,0,0,0,1
02801299,24,5,19,0,0,0,0,0,1
02801491,17,6,11,0,0,0,0,0,1
02801672,6,3,3,0,0,0,0,0,0
02801721,28,0,28,0,0,0,0,0,1
02802109,61,8,53,0,9,6,3,0,1
02802111,5,3,2,0,1,1,0,0,1
02802125,7,0,7,0,0,0,0,0,1
02802586,27,0,27,0,1,1,0,1,1
02802661,23,0,23,0,0,0,0,0,1
02802736,17,2,15,0,0,0,0,0,1
02802743,20,0,20,0,0,0,0,0,1
02802745,79,9,70,0,0,0,0,0,1
02802758,33,3,30,0,1,1,0,1,1
02802829,23,0,23,0,2,2,0,0,1
02803321,35,3,32,0,0,0,0,0,1
02803347,55,15,40,0,1,1,0,1,1
02803379,58,0,58,0,0,0,0,0,1
02803478,54,3,51,0,6,2,4,0,1
02803500,10,2,8,0,1,1,0,0,1
02803672,19,2,17,0,1,1,0,1,1
02803959,14,0,14,0,0,0,0,0,1
02804041,27,3,24,0,0,0,0,0,1
02804249,15,4,11,0,1,1,0,1,1
02804441,19,0,19,0,0,0,0,0,1
02804492,8,3,5,0,2,2,0,0,1
02804518,127,22,105,0,1,1,0,0,1
02804525,41,2,39,0,1,1,0,1,1
02804586,10,1,9,0,1,1,0,0,1
02804983,7,3,4,0,0,0,0,0,1
02805185,6,2,4,0,1,1,0,0,0
02805230,47,6,41,0,1,1,0,1,0
02805347,33,13,20,0,1,1,0,0,1
02805451,11,0,11,0,0,0,0,0,1
02805523,4,4,0,0,1,1,0,0,0
02805530,20,4,16,0,4,4,0,0,1
02805750,4,3,1,0,2,2,0,0,1
02806007,42,7,35,0,0,0,0,0,1
02806056,7,2,5,0,0,0,0,0,1
02806093,43,2,41,0,1,1,0,1,1
02806171,7,2,5,0,1,1,0,0,1
02806289,8,1,7,0,1,1,0,0,0
02806593,57,10,47,0,0,0,0,0,1
02806604,79,10,69,0,1,1,0,0,1
02806607,33,8,25,0,0,0,0,0,1
02806731,40,4,36,0,1,1,0,1,1
02806910,48,12,36,0,0,0,0,0,1
02806917,19,2,17,0,1,1,0,1,1
02806919,20,3,17,0,1,1,0,1,1
02807031,26,2,24,0,1,1,0,1,1
02807036,35,0,35,0,0,0,0,0,1
02807079,37,4,33,0,4,3,1,0,1
02807159,37,0,37,0,0,0,0,0,0
02807530,8,0,8,0,2,2,0,0,0
02807553,15,3,12,0,2,2,0,0,1
02807579,56,0,56,0,0,0,0,0,1
02807991,33,0,33,0,0,0,0,0,1
02808170,13,2,11,0,3,3,0,1,1
02808390,56,10,46,0,0,0,0,0,1
02808633,38,10,28,0,0,0,0,0,1
02808709,21,5,16,0,1,1,0,1,1
02808717,13,2,11,0,1,1,0,0,1
02808776,12,2,10,0,3,2,1,0,1
02808850,10,2,8,0,1,1,0,0,0
02809202,6,3,3,0,1,1,0,1,0
02809209,10,0,10,0,0,0,0,0,0
02809456,13,3,10,0,1,1,0,1,1
02810054,13,0,13,1,0,0,0,0,1
02810190,12,4,8,0,1,1,0,0,1
02810275,8,4,4,0,2,2,0,0,1
02810402,12,6,6,0,1,1,0,0,1
02810623,35,3,32,0,0,0,0,0,0
02810660,42,2,40,0,1,1,0,1,1
02810685,50,0,50,0,0,0,0,0,1
02811035,42,8,34,0,3,3,0,0,1
02811046,22,9,13,0,0,0,0,0,1
02811057,14,5,9,0,2,1,1,1,1
02811366,54,3,51,0,1,1,0,1,1
02811407,2,2,0,0,2,2,0,0,0
02811437,38,4,34,0,1,1,0,1,1
02811609,24,0,24,0,1,1,0,1,1
02812196,5,3,2,0,2,2,0,0,1
02812304,33,9,24,0,0,0,0,0,1
02812508,7,6,1,0,2,2,0,0,0
02812683,8,2,6,0,0,0,0,0,0
02812697,10,0,10,0,0,0,0,0,1
02812709,7,4,3,0,1,1,0,1,1
02813058,6,3,3,0,2,2,0,0,1
02813292,23,2,21,0,1,1,0,1,1
02813342,28,1,27,0,1,1,0,1,1
02813358,88,12,76,0,1,1,0,1,1
02813598,42,4,38,0,1,1,0,1,1
02814128,19,3,16,0,1,1,0,1,1
02814203,26,8,18,0,0,0,0,0,1
02814431,29,5,24,0,2,2,0,2,1
02814534,62,8,54,0,1,1,0,1,1
02814583,89,9,80,0,0,0,0,0,1
02814725,86,12,74,0,0,0,0,0,1
02814950,35,9,26,0,0,0,0,0,0
02815000,28,2,26,0,1,1,0,1,1
02815114,45,4,41,0,1,1,0,1,1
02815212,49,3,46,0,2,2,0,2,1
02815222,16,0,16,0,0,0,0,0,1
02815227,25,2,23,0,2,2,0,2,1
02815241,19,0,19,0,0,0,0,0,1
02815246,16,2,14,0,0,0,0,0,1
02815248,17,2,15,0,0,0,0,0,1
02815254,18,4,14,0,2,1,1,2,1
02815333,23,0,23,0,1,1,0,1,1
02815563,5,0,5,0,0,0,0,0,1
02815872,32,2,30,0,2,1,1,0,1
02815900,34,6,28,0,1,1,0,0,1
02815942,8,4,4,0,2,2,0,0,1
02816123,17,0,17,0,0,0,0,0,1
02816411,43,3,40,0,2,2,0,2,1
02816525,22,8,14,0,0,0,0,0,1
02816527,38,12,26,0,0,0,0,0,1
02816693,11,2,9,0,1,1,0,0,1
02816740,20,5,15,0,1,1,0,1,1
02816954,19,2,17,0,0,0,0,0,1
02816980,27,6,21,0,0,0,0,0,1
02817039,42,3,39,0,3,1,2,3,1
02817044,9,2,7,0,3,1,2,0,1
02817051,25,8,17,0,0,0,0,0,0
02817269,12,3,9,0,1,1,0,1,1
02817909,94,13,81,0,0,0,0,0,1
02817936,10,3,7,0,2,2,0,0,0
02818086,27,0,27,0,0,0,0,0,1
02818207,8,0,8,0,0,0,0,0,0
02818422,58,14,44,0,0,0,0,0,1
02818602,40,9,31,0,1,1,0,1,1
02818616,10,0,10,0,0,0,0,0,1
02818648,7,2,5,0,2,2,0,1,1
02818721,15,0,15,0,0,0,0,0,1
02818821,10,4,6,0,1,1,0,1,0
02819049,7,2,5,0,1,1,0,0,1
02819220,14,1,13,0,1,1,0,0,1
02819224,28,3,25,0,1,1,0,1,1
02819229,22,6,16,0,1,1,0,0,0
02819255,12,5,7,0,1,1,0,1,1
02819302,23,1,22,0,1,1,0,0,0
02819380,11,2,9,0,1,1,0,0,0
02819411,11,4,7,0,2,2,0,0,1
02819422,8,6,2,0,1,1,0,1,1
02819542,10,4,6,0,1,1,0,0,1
02819727,17,6,11,0,5,5,0,0,1
02819731,7,0,7,0,0,0,0,0,1
02819896,28,4,24,0,1,1,0,1,1
02819935,71,10,61,0,1,1,0,1,1
02820099,7,2,5,0,1,1,0,0,1
02820310,16,0,16,0,0,0,0,0,1
02820374,36,5,31,0,1,1,0,1,1
02820647,17,0,17,0,0,0,0,0,1
02820709,27,9,18,0,0,0,0,0,0
02820813,20,6,14,0,3,1,2,1,0
02820953,9,0,9,0,0,0,0,0,1
02820998,18,2,16,0,1,1,0,1,1
02821011,69,13,56,0,1,1,0,1,1
02821335,8,3,5,0,2,2,0,0,1
02821428,23,3,20,0,0,0,0,0,1
02821608,33,5,28,0,1,1,0,1,1
02821629,12,2,10,0,0,0,0,0,0
02821637,22,0,22,0,0,0,0,0,1
02821970,16,3,13,0,1,1,0,1,1
02822008,13,0,13,0,0,0,0,0,1
02822023,14,0,14,0,0,0,0,0,1
02822203,95,10,85,0,1,1,0,1,1
02822300,90,5,85,0,1,1,0,1,1
02822404,14,0,14,0,0,0,0,0,1
02822565,42,3,39,0,1,1,0,1,1
02822785,55,7,48,0,0,0,0,0,1
02822800,10,4,6,0,1,1,0,1,1
02822923,13,0,13,0,0,0,0,0,1
02823058,21,2,19,0,1,1,0,1,1
02823082,5,3,2,0,1,1,0,0,0
02823181,73,11,62,0,0,0,0,0,1
02823208,13,2,11,0,1,1,0,0,1
02823242,18,0,18,0,0,0,0,0,1
02823368,12,0,12,0,0,0,0,0,0
02823534,24,4,20,0,1,1,0,1,1
02823722,10,2,8,0,1,1,0,0,1
02823749,46,9,37,0,0,0,0,0,1
02823970,43,0,43,0,0,0,0,0,1
02824404,38,6,32,0,1,1,0,0,0
02824417,7,2,5,0,2,2,0,0,1
02824893,51,12,39,0,0,0,0,0,1
02825034,13,0,13,0,0,0,0,0,1
02825067,8,3,5,0,1,1,0,0,0
02825282,10,3,7,0,1,1,0,0,1
02825903,18,3,15,0,1,1,0,1,1
02826093,14,3,11,0,1,1,0,0,1
02826184,40,3,37,0,1,1,0,1,1
02826196,23,2,21,0,0,0,0,0,1
02826318,27,3,24,0,1,1,0,1,0
02826466,19,3,16,0,1,1,0,1,1
02826601,29,3,26,0,1,1,0,1,1
02826785,15,3,12,0,1,1,0,1,1
02826978,63,15,48,0,0,0,0,0,1
02827201,20,6,14,0,1,1,0,0,0
02827261,10,0,10,0,1,1,0,0,1
02827420,25,5,20,0,1,1,0,1,1
02827783,10,3,7,0,1,1,0,1,1
02827908,22,5,17,0,1,1,0,1,1
02828137,13,2,11,0,0,0,0,0,1
02828321,19,2,17,0,1,1,0,1,1
02828373,9,3,6,0,0,0,0,0,0
02828554,25,0,25,0,1,1,0,1,1
02828795,10,1,9,0,1,1,0,0,1
02828827,10,1,9,0,1,1,0,0,1
02828835,10,1,9,0,1,1,0,0,1
02828837,10,1,9,0,1,1,0,0,1
02828896,27,3,24,0,1,1,0,1,1
02828929,25,7,18,0,0,0,0,0,1
02829052,31,4,27,0,1,1,0,1,1
02829156,54,13,41,0,0,0,0,0,1
02829188,25,9,16,1,0,0,0,0,1
02829272,8,2,6,0,1,1,0,0,1
02829474,4,2,2,0,1,1,0,0,1
02829522,37,4,33,0,0,0,0,0,0
02829540,33,4,29,0,0,0,0,0,1
02829834,11,1,10,0,1,1,0,0,1
02829836,107,17,90,0,0,0,0,0,1
02829972,12,5,7,0,1,1,0,1,1
02830090,18,4,14,0,1,1,0,1,1
02830397,38,9,29,0,0,0,0,0,1
02830642,80,3,77,0,0,0,0,0,1
02830644,35,5,30,0,1,1,0,1,1
02830695,28,14,14,0,1,1,0,1,1
02830747,8,3,5,0,2,2,0,0,0
02830749,21,4,17,0,1,1,0,1,1
02830763,17,2,15,0,0,0,0,0,1
02830878,18,4,14,0,5,4,1,0,1
02830974,34,5,29,0,1,1,0,1,1
02831083,36,0,36,0,0,0,0,0,1
02831153,19,3,16,0,0,0,0,0,1
02831165,21,3,18,0,1,1,0,0,1
02831470,56,0,56,0,0,0,0,0,1
02831476,16,4,12,0,1,1,0,0,1
02831788,17,0,17,0,0,0,0,0,0
02831961,16,5,11,0,1,1,0,1,1
02832020,17,3,14,0,1,1,0,1,1
02832085,36,5,31,0,1,1,0,1,1
02832113,6,2,4,0,1,1,0,0,1
02832115,69,4,65,0,0,0,0,0,1
02832212,8,1,7,0,2,1,1,0,1
02832215,8,2,6,0,2,2,0,0,1
02832619,125,0,125,0,0,0,0,0,1
02832947,6,0,6,0,1,1,0,0,0
02833067,15,4,11,0,3,1,2,1,1
02833144,18,0,18,0,0,0,0,0,1
02833153,11,0,11,0,0,0,0,0,1
02833188,36,4,32,0,0,0,0,0,1
02833264,36,4,32,0,1,1,0,1,1
02833331,38,12,26,0,1,1,0,1,1
02833362,21,4,17,0,1,1,0,1,1
02833839,29,9,20,0,1,1,0,1,1
02833915,8,3,5,0,2,2,0,0,1
02834019,16,3,13,0,2,2,0,1,1
02834240,6,3,3,0,1,1,0,0,1
02834555,11,2,9,0,2,2,0,0,1
02834800,21,5,16,0,2,1,1,1,1
02834808,23,3,20,0,0,0,0,0,1
02834830,7,3,4,0,2,2,0,0,0
02835101,24,2,22,0,1,1,0,1,1
02835148,40,4,36,0,1,1,0,1,1
02835220,21,2,19,0,2,1,1,1,1
02835230,41,4,37,0,1,1,0,1,1
02835362,37,3,34,0,1,1,0,1,1
02835454,70,16,54,0,0,0,0,0,1
02835527,21,2,19,0,1,1,0,1,1
02835722,12,4,8,0,0,0,0,0,0
02835753,18,4,14,0,1,1,0,1,1
02835919,27,3,24,0,1,1,0,1,1
02836006,25,7,18,0,1,1,0,0,1
02836091,22,5,17,0,1,0,1,0,0
02836340,38,0,38,0,0,0,0,0,1
02836380,18,4,14,0,1,1,0,1,1
02836382,10,4,6,0,1,1,0,1,1
02836670,6,4,2,0,1,1,0,1,1
02836858,35,4,31,0,3,3,0,0,1
02837136,49,4,45,0,1,1,0,1,1
02837140,38,4,34,0,1,1,0,1,1
02837387,12,4,8,0,1,1,0,0,0
02837793,276,7,269,0,0,0,0,0,1
02837809,34,6,28,0,0,0,0,0,1
02837816,35,0,35,0,0,0,0,0,1
02837875,28,3,25,0,1,1,0,1,1
02837976,5,2,3,0,1,1,0,0,1
02838054,18,4,14,0,1,1,0,1,1
02838092,14,2,12,0,0,0,0,0,1
02838125,18,2,16,0,1,1,0,0,1
02838395,6,1,5,0,1,1,0,1,1
02838773,12,0,12,0,1,1,0,0,1
02838796,7,2,5,0,0,0,0,0,1
02839301,12,0,12,0,0,0,0,0,1
02839371,6,0,6,0,0,0,0,0,1
02839512,13,3,10,0,2,1,1,1,1
02839815,134,13,121,0,0,0,0,0,1
02839836,56,7,49,0,2,2,0,2,1
02839962,15,3,12,0,0,0,0,0,1
06283101,2,0,2,0,0,0,0,0,0
06283278,7,0,7,0,1,1,0,1,1
06283780,9,0,9,0,0,0,0,0,1
06283818,11,4,7,0,1,1,0,1,1
06283829,5,0,5,0,0,0,0,0,1
06284055,4,2,2,0,1,1,0,0,0
06284464,5,0,5,0,0,0,0,0,1
06285637,12,5,7,0,0,0,0,0,0
06286152,2,0,2,0,0,0,0,0,0
06286329,4,0,4,0,0,0,0,0,1
06286364,11,0,11,0,0,0,0,0,1
06286378,4,0,4,0,2,2,0,0,1
06286400,4,0,4,0,0,0,0,0,1
06286767,4,3,1,0,1,1,0,0,1
06287028,21,9,12,0,0,0,0,0,1
06287079,6,3,3,0,2,2,0,0,0
06287335,4,0,4,0,0,0,0,0,1
06287393,4,3,1,0,2,2,0,0,1
06287989,11,2,9,0,1,1,0,1,1
06288440,4,2,2,2,1,1,0,1,1
06288610,19,10,9,0,0,0,0,0,1
06289506,18,0,18,0,0,0,0,0,1
06289659,19,5,14,0,0,0,0,0,1
06289866,4,0,4,0,0,0,0,0,1
06290057,14,5,9,0,0,0,0,0,1
06290078,11,3,8,0,1,1,0,0,1
06290173,12,3,9,0,3,1,2,2,1
06290477,2,2,0,0,2,2,0,0,0
06290649,3,2,1,0,1,1,0,0,0
06290698,3,3,0,0,2,2,0,0,1
06290848,4,0,4,0,0,0,0,0,1
06290941,9,2,7,0,2,2,0,0,1
06291123,13,3,10,0,1,1,0,1,1
06291343,3,0,3,0,0,0,0,0,1
06291496,4,0,4,0,0,0,0,0,1
06291572,2,0,2,0,0,0,0,0,1
06291839,5,3,2,0,1,1,0,0,1
06291841,4,2,2,0,1,1,0,0,1
06291886,74,23,51,0,0,0,0,0,1
06292619,4,0,4,0,0,0,0,0,1
06292620,8,5,3,0,1,1,0,0,1
06292653,9,0,9,0,0,0,0,0,1
06292703,6,2,4,0,1,1,0,0,1
06292983,8,3,5,0,0,0,0,0,1
06293042,5,0,5,0,0,0,0,0,1
06293100,5,1,4,0,1,1,0,0,1
06293127,4,2,2,0,0,0,0,0,1
06293234,21,14,7,0,0,0,0,0,1
06293651,11,5,6,0,1,1,0,0,1
06293667,13,0,13,0,0,0,0,0,1
06293674,12,0,12,0,0,0,0,0,1
06293690,12,0,12,0,0,0,0,0,1
06293921,4,0,4,0,1,1,0,0,0
06293957,5,3,2,0,1,1,0,0,1
06294287,2,2,0,0,1,1,0,0,0
06294307,25,5,20,0,1,1,0,1,1
06294314,5,0,5,0,0,0,0,0,1
06294439,10,3,7,0,1,1,0,1,0
06294646,4,0,4,0,0,0,0,0,1
06294685,10,2,8,0,1,1,0,0,1
06294984,44,25,19,0,0,0,0,0,1
06295350,25,8,17,0,1,1,0,1,1
06295505,7,3,4,0,1,1,0,0,1
06295696,13,4,9,0,0,0,0,0,0
06295717,4,4,0,0,1,1,0,0,1
06295820,6,0,6,0,0,0,0,0,0
06296055,5,0,5,0,0,0,0,0,0
06296381,5,0,5,0,0,0,0,0,1
06296400,12,4,8,0,1,1,0,1,0
06296528,30,9,21,0,1,1,0,1,1
06296546,2,2,0,0,1,1,0,0,0
06296547,6,0,6,0,0,0,0,0,0
06296689,6,4,2,0,1,1,0,1,1
06296811,6,0,6,0,0,0,0,0,1
06296833,9,2,7,0,2,2,0,0,1
06297226,8,3,5,0,1,1,0,1,1
06297245,6,2,4,0,1,1,0,0,1
06297440,15,5,10,0,0,0,0,0,0
06297537,4,2,2,0,2,2,0,0,1
06297619,9,0,9,0,0,0,0,0,1
06297652,15,0,15,0,0,0,0,0,1
06297954,3,0,3,0,2,2,0,0,1
06297980,17,5,12,0,1,1,0,1,1
06298047,3,0,3,0,2,2,0,0,0
06298060,16,0,16,0,0,0,0,0,1
06298302,4,2,2,0,0,0,0,0,1
06298309,11,4,7,0,3,2,1,0,1
06298341,15,0,15,0,0,0,0,0,1
06299113,20,11,9,0,0,0,0,0,1
06299474,5,0,5,0,0,0,0,0,1
06299688,7,3,4,0,0,0,0,0,1
06299935,10,3,7,0,0,0,0,0,1
06300357,5,0,5,0,0,0,0,0,1
06300360,5,0,5,0,0,0,0,0,0
06300382,5,0,5,0,0,0,0,0,1
06300584,5,2,3,0,0,0,0,0,1
06300724,7,4,3,0,1,1,0,1,0
06300883,11,4,7,0,1,1,0,1,1
06301127,6,4,2,0,1,1,0,1,1
06301479,14,3,11,0,1,1,0,0,1
06301868,22,0,22,0,1,1,0,1,1
06301911,6,4,2,0,1,1,0,0,0
06301971,16,4,12,0,1,1,0,1,1
06302304,0,0,0,0,0,0,0,0,1
06302328,16,4,12,0,2,2,0,0,1
06302554,14,8,6,0,2,2,0,2,1
06302560,3,3,0,0,2,2,0,0,0
06302637,6,3,3,0,0,0,0,0,1
06302649,12,0,12,0,0,0,0,0,1
06302743,19,5,14,0,1,1,0,1,0
06302746,19,5,14,0,2,2,0,2,0
06302764,11,7,4,0,0,0,0,0,0
06302777,25,10,15,0,0,0,0,0,1
06302779,4,0,4,0,0,0,0,0,1
06302932,2,2,0,0,1,1,0,0,0
06303148,2,2,0,0,1,1,0,0,0
06303240,16,2,14,0,1,1,0,1,1
06303367,14,6,8,0,1,1,0,0,1
06303413,14,0,14,0,0,0,0,0,1
06303476,16,0,16,0,0,0,0,0,1
06303623,9,2,7,0,0,0,0,0,1
06303923,6,2,4,0,1,1,0,0,1
06304277,20,9,11,0,0,0,0,0,0
06304640,5,3,2,0,2,2,0,0,0
06304726,10,6,4,0,1,1,0,1,0
06304852,10,2,8,0,0,0,0,0,1
06305034,5,3,2,0,2,2,0,0,1
06305055,11,4,7,0,1,1,0,1,1
06305107,4,2,2,0,1,1,0,0,0
06305185,4,2,2,0,1,1,0,0,1
06305292,25,6,19,0,0,0,0,0,1
06305531,4,1,3,0,1,1,0,0,0
06305538,7,0,7,0,2,2,0,0,1
06305548,7,0,7,0,2,2,0,0,1
06305550,7,0,7,0,0,0,0,0,1
06305553,7,0,7,0,0,0,0,0,1
06305565,7,0,7,0,0,0,0,0,1
06305643,3,3,0,0,1,1,0,1,1
06305698,7,0,7,0,2,2,0,0,1
06306539,6,1,5,0,2,2,0,0,1
06306629,3,3,0,0,2,2,0,0,1
06306678,6,0,6,0,0,0,0,0,1
06307002,6,0,6,0,0,0,0,0,1
06307081,2,0,2,0,0,0,0,0,1
06307553,8,5,3,0,1,1,0,1,1
06307570,7,0,7,0,0,0,0,0,1
06307698,3,0,3,0,2,2,0,0,1
06307834,11,0,11,0,0,0,0,0,1
06308049,5,0,5,0,0,0,0,0,1
06308253,17,3,14,0,1,1,0,1,1
06308301,16,0,16,0,1,1,0,1,1
06308309,27,3,24,0,0,0,0,0,1
06308427,8,6,2,0,3,3,0,0,1
06308608,22,5,17,0,1,1,0,1,1
06308702,14,5,9,0,1,1,0,1,1
06308721,11,3,8,0,1,1,0,1,1
06309299,7,2,5,0,1,1,0,0,1
06309368,9,0,9,0,0,0,0,0,1
06309557,7,4,3,0,1,1,0,1,1
06309661,25,0,25,0,0,0,0,0,1
06309791,3,3,0,0,1,1,0,0,1
06310022,2,2,0,0,1,1,0,0,0
06310070,8,2,6,0,1,1,0,1,1
06310104,21,3,18,0,1,1,0,1,1
06310105,20,3,17,0,1,1,0,1,1
06310213,32,0,32,0,0,0,0,0,1
06310215,18,8,10,0,0,0,0,0,1
06310505,8,4,4,0,2,2,0,0,1
06310698,21,5,16,0,1,1,0,1,1
06310796,9,0,9,0,0,0,0,0,1
06311127,38,2,36,0,0,0,0,0,1
06311219,10,2,8,0,0,0,0,0,1
06311492,6,1,5,0,2,2,0,0,0
06311663,6,0,6,0,0,0,0,0,1
06311986,7,0,7,0,0,0,0,0,1
06312190,21,3,18,0,1,1,0,1,1
06312831,14,6,8,0,0,0,0,0,1
06313119,3,3,0,0,2,2,0,0,0
06313123,14,6,8,0,4,1,3,1,1
06313389,5,3,2,0,2,1,1,1,0
06313496,5,0,5,0,0,0,0,0,0
06313719,18,6,12,0,1,1,0,1,1
06313721,10,2,8,0,1,1,0,0,1
06313826,4,2,2,0,1,1,0,0,0
06314118,5,0,5,0,0,0,0,0,0
06314483,8,1,7,0,1,1,0,0,1
06314874,5,2,3,0,2,2,0,0,1
06314885,5,0,5,0,0,0,0,0,1
06314887,5,3,2,0,1,1,0,0,1
06314891,38,7,31,0,4,4,0,4,1
06314896,4,0,4,0,0,0,0,0,1
06314906,4,0,4,0,0,0,0,0,1
06314908,4,1,3,0,1,1,0,0,1
06315112,7,4,3,0,2,1,1,2,1
06315152,6,0,6,0,2,2,0,0,1
06315172,9,1,8,0,1,1,0,0,1
06315181,2,0,2,0,0,0,0,0,1
06315189,4,0,4,0,1,1,0,0,1
06315536,5,0,5,0,0,0,0,0,1
06315651,12,0,12,0,0,0,0,0,1
06315659,12,4,8,0,6,4,2,1,1
06315880,5,2,3,0,1,1,0,0,0
06315906,4,0,4,0,0,0,0,0,1
06315948,5,0,5,0,0,0,0,0,0
06316219,4,0,4,0,1,1,0,0,1
06316243,68,9,59,0,0,0,0,0,0
06316252,4,0,4,0,0,0,0,0,1
06316253,5,4,1,0,4,2,2,2,1
06316299,11,4,7,0,1,1,0,1,1
06316333,10,6,4,0,3,1,2,1,1
06316398,4,2,2,0,1,1,0,0,1
06316439,6,3,3,0,1,1,0,1,1
06316449,14,4,10,0,2,1,1,2,1
06316638,26,8,18,0,1,1,0,0,0
06316696,3,3,0,0,1,1,0,0,0
06317017,7,0,7,0,3,3,0,0,1
06317053,23,6,17,0,0,0,0,0,0
06317072,7,0,7,0,3,3,0,0,1
06317074,19,4,15,0,0,0,0,0,1
06317177,5,3,2,0,2,2,0,0,0
06317219,8,0,8,0,0,0,0,0,1
06317910,6,0,6,0,0,0,0,0,0
06318027,6,3,3,0,0,0,0,0,1
06318070,3,3,0,0,2,2,0,0,0
06318189,13,6,7,0,1,1,0,0,1
06318340,12,3,9,0,2,1,1,1,0
06318357,5,2,3,0,2,2,0,0,1
06318385,4,2,2,0,0,0,0,0,0
06318456,6,3,3,0,2,1,1,1,1
06318538,24,8,16,0,2,2,0,1,1
06318822,6,4,2,0,0,0,0,0,1
06319363,6,4,2,0,1,1,0,0,1
06319487,7,0,7,0,0,0,0,0,1
06319723,6,3,3,0,3,3,0,0,1
06320400,10,6,4,0,2,2,0,0,1
06320609,15,0,15,0,1,1,0,0,1
06320800,2,1,1,0,1,1,0,0,1
06321048,5,0,5,0,0,0,0,0,1
06321439,4,1,3,0,0,0,0,0,1
06321451,11,3,8,0,1,1,0,1,1
06321457,15,4,11,0,0,0,0,0,1
06321669,17,4,13,0,1,1,0,1,1
06321863,8,3,5,0,0,0,0,0,0
06322037,10,4,6,0,1,1,0,1,1
06322060,8,2,6,0,4,4,0,0,1
06322401,5,0,5,0,0,0,0,0,1
06322725,5,0,5,0,0,0,0,0,1
06322787,13,9,4,0,0,0,0,0,1
06322814,19,2,17,0,1,1,0,1,1
06322942,15,0,15,0,0,0,0,0,1
06322952,18,2,16,0,1,1,0,1,1
06323411,8,0,8,0,0,0,0,0,1
06324064,7,0,7,0,1,1,0,0,1
06324356,21,10,11,0,0,0,0,0,1
06324364,5,3,2,0,2,2,0,0,1
06324371,7,0,7,0,1,1,0,0,1
06324411,14,2,12,0,1,1,0,1,1
06324435,4,2,2,0,1,1,0,0,1
06324466,15,3,12,0,1,1,0,1,1
06324517,20,5,15,0,1,1,0,1,1
06324634,6,2,4,0,1,1,0,0,0
06324635,7,0,7,0,0,0,0,0,1
06324863,7,4,3,0,1,1,0,1,0
06325170,5,5,0,0,2,2,0,0,1
06325313,17,3,14,0,0,0,0,0,1
06325347,8,4,4,0,1,1,0,1,1
06325650,6,3,3,0,0,0,0,0,0
06325906,16,0,16,0,0,0,0,0,1
06325936,6,2,4,0,1,1,0,1,1
08603269,2,1,1,0,2,2,0,0,0
08603355,4,3,1,0,2,1,1,1,0
08603360,2,2,0,0,2,2,0,0,0
08603543,16,3,13,0,1,1,0,1,1
08603811,21,0,21,0,4,2,2,0,1
08603985,2,2,0,0,2,2,0,0,0
08604037,14,11,3,0,3,3,0,0,0
08604585,17,11,6,0,0,0,0,0,0
08604736,4,4,0,0,1,0,1,1,1
08604765,6,5,1,0,1,1,0,1,1
08604772,3,1,2,0,1,1,0,0,0
08604791,4,0,4,0,0,0,0,0,1
08604802,4,4,0,0,1,1,0,1,1
08604848,1,1,0,0,1,1,0,0,0
08604931,2,2,0,0,2,2,0,0,1
08605104,3,2,1,0,3,2,1,0,0
08605428,4,0,4,0,0,0,0,0,0
08605536,2,0,2,0,0,0,0,0,0
08605549,14,7,7,0,0,0,0,0,0
08605613,3,0,3,0,0,0,0,0,1
08605736,11,5,6,0,4,3,1,2,1
08606359,1,1,0,0,1,1,0,0,1
08606533,4,0,4,0,0,0,0,0,1
08606539,18,6,12,0,2,2,0,1,1
08606594,2,2,0,0,1,1,0,0,0
08606603,3,0,3,0,0,0,0,0,0
08606915,10,6,4,1,3,2,1,1,0
08606986,1,0,1,0,0,0,0,0,0
08607123,6,3,3,0,0,0,0,0,1
08607157,6,0,6,0,0,0,0,0,1
08607975,4,0,4,0,0,0,0,0,1
08608202,2,2,0,0,2,2,0,0,0
08608223,13,3,10,0,0,0,0,0,1
08608421,3,0,3,0,1,1,0,1,1
08609831,2,0,2,0,0,0,0,0,0
08609837,7,5,2,0,5,5,0,0,0
08610030,7,5,2,0,1,1,0,1,1
08610154,1,1,0,0,2,2,0,0,0
08610708,1,1,0,0,2,1,1,0,0
08610904,2,2,0,0,1,1,0,0,0
08610938,2,0,2,0,0,0,0,0,1
08611386,1,1,0,0,1,1,0,0,0
08612143,3,0,3,0,3,3,0,0,0
08612252,2,2,0,0,2,2,0,0,1
08612333,1,1,0,0,1,1,0,0,0
08612398,2,2,0,0,2,2,0,1,0
08612931,1,1,0,0,1,1,0,0,0
08613038,6,3,3,0,1,1,0,1,1
08613109,2,0,2,0,2,2,0,0,0
08613192,10,7,3,0,2,2,0,2,1
08613854,7,5,2,2,3,1,2,1,0
08613865,9,3,6,0,1,1,0,1,0
08613929,12,6,6,0,0,0,0,0,1
08614024,12,4,8,0,1,1,0,1,1
08614761,2,1,1,0,1,1,0,0,0
08615547,2,2,0,0,2,2,0,0,0
08615669,3,3,0,0,1,1,0,0,0
08615746,8,4,4,0,1,1,0,1,1
08615749,6,4,2,0,1,1,0,0,1
08615765,2,2,0,0,1,1,0,0,1
08615826,32,13,19,0,0,0,0,0,1
08616197,2,2,0,0,1,1,0,0,0
08616260,1,1,0,0,1,1,0,0,0
08616500,3,0,3,0,0,0,0,0,1
08616624,4,3,1,0,1,1,0,0,1
08616778,3,2,1,0,4,2,2,0,0
08616877,5,0,5,0,0,0,0,0,1
08617000,3,0,3,0,0,0,0,0,1
08617120,7,4,3,0,0,0,0,0,0
08618112,4,2,2,0,0,0,0,0,1
08618249,2,0,2,0,0,0,0,0,1
08618312,1,1,0,0,1,1,0,0,0
08618341,6,2,4,0,0,0,0,0,0
08618431,9,0,9,0,0,0,0,0,0
08618570,6,2,4,0,0,0,0,0,0
08618691,2,2,0,0,2,2,0,0,1
08619688,24,2,22,1,2,1,1,2,1
08620664,12,8,4,0,9,6,3,0,0
08621299,10,10,0,0,2,2,0,0,1
08621367,21,10,11,0,1,1,0,1,1
08621670,2,2,0,0,2,2,0,0,1
08621906,2,2,0,0,2,2,0,0,0
08622424,1,1,0,0,1,1,0,0,0
08622645,16,0,16,0,1,0,1,0,0
08623130,3,2,1,0,1,1,0,0,1
08623414,2,2,0,0,2,2,0,0,0
08623447,2,1,1,0,1,1,0,0,0
08623802,3,2,1,0,1,1,0,0,0
08623888,21,10,11,0,1,1,0,1,1
08624157,31,1,30,0,6,2,4,2,0
08624238,3,3,0,0,1,1,0,0,0
08624712,3,0,3,0,1,1,0,0,1
08624932,12,4,8,1,3,2,1,3,1
08625115,9,5,4,0,0,0,0,0,0
08625228,4,0,4,0,0,0,0,0,1
08625268,12,3,9,0,4,4,0,1,1
08625450,10,5,5,0,3,1,2,2,1
08626108,1,0,1,0,0,0,0,0,1
08626142,1,1,0,0,1,1,0,0,1
08626680,1,0,1,0,1,1,0,0,0
08626728,2,0,2,0,0,0,0,0,0
08626745,11,7,4,0,0,0,0,0,0
08626765,2,0,2,0,2,2,0,0,1
08626877,2,2,0,0,2,2,0,0,1
08627030,4,0,4,0,0,0,0,0,1
08627270,1,1,0,0,1,1,0,0,0
08627468,2,2,0,0,2,2,0,0,0
08627543,2,2,0,0,2,2,0,0,0
08627693,2,2,0,0,2,1,1,1,0
08627710,2,2,0,0,2,2,0,0,0
08627720,1,0,1,0,1,1,0,0,1
08628019,18,11,7,0,0,0,0,0,1
08628041,1,1,0,0,1,1,0,0,0
08628275,1,0,1,0,0,0,0,0,0
08629162,2,1,1,0,1,1,0,0,0
08629270,2,0,2,0,1,1,0,0,0
08629348,21,10,11,0,1,1,0,1,1
08629373,21,10,11,0,1,1,0,1,1
08629444,21,10,11,0,1,1,0,1,1
08629445,21,10,11,0,1,1,0,1,1
08630721,2,2,0,0,2,2,0,0,1
08632620,3,0,3,0,0,0,0,0,0
08632774,1,0,1,0,0,0,0,0,0
08633131,2,0,2,0,1,1,0,0,0
08633312,1,1,0,0,1,1,0,0,0
08633415,2,2,0,0,0,0,0,0,0
08633564,4,3,1,0,1,0,1,0,0
08633884,3,0,3,0,0,0,0,0,1
08634188,1,1,0,0,2,2,0,0,0
08634343,2,1,1,0,1,1,0,0,0
08634357,2,1,1,0,1,1,0,0,1
08634443,6,0,6,0,0,0,0,0,1
08634465,7,2,5,0,1,1,0,1,0
08634519,1,1,0,0,1,1,0,0,0
08634734,2,2,0,0,1,1,0,0,0
08634825,3,3,0,0,2,2,0,0,0
08634972,2,1,1,0,1,1,0,0,1
08635305,4,2,2,0,3,3,0,0,0
08635870,10,0,10,1,0,0,0,0,0
08635888,2,0,2,0,0,0,0,0,0
08636349,4,4,0,0,1,1,0,0,0
08636524,1,1,0,0,1,1,0,0,0
08636885,4,4,0,0,3,3,0,1,0
08637109,8,2,6,0,1,1,0,1,0
08637342,1,0,1,0,1,1,0,0,0
08637390,1,0,1,0,0,0,0,0,0
08637622,5,3,2,0,3,1,2,1,1
08637650,1,1,0,0,1,1,0,0,0
08637677,3,2,1,0,1,1,0,0,0
08638109,1,0,1,0,1,1,0,0,0
08638347,1,1,0,0,1,1,0,0,0
08638374,1,1,0,0,2,2,0,0,0
08638564,4,0,4,0,3,3,0,0,1
08638770,1,1,0,0,1,1,0,0,0
08638781,1,1,0,0,1,1,0,0,0
08638819,1,1,0,0,1,1,0,0,0
08639467,5,5,0,0,6,6,0,1,1
08639521,13,2,11,0,1,1,0,1,1
08639923,1,1,0,0,1,1,0,0,0
08640270,4,3,1,0,1,1,0,0,1
08640549,10,4,6,0,1,1,0,1,1
08640648,1,1,0,0,1,1,0,0,0
08641053,1,1,0,0,1,1,0,0,0
08641218,2,2,0,0,2,2,0,0,1
08641873,13,5,8,0,1,1,0,1,1
08641929,1,0,1,0,1,1,0,0,0
08642051,4,2,2,0,2,2,0,0,1
08642111,3,0,3,0,0,0,0,0,0
08642138,4,1,3,0,2,2,0,0,0
08643393,8,5,3,2,3,1,2,1,0
08643420,8,5,3,2,3,1,2,1,0
08643773,5,3,2,0,1,1,0,0,0
08643968,1,1,0,0,2,2,0,0,1
08644101,6,5,1,0,4,4,0,1,0
08644320,23,13,10,0,2,1,1,0,0
08644543,8,6,2,0,3,1,2,1,1
08644596,3,3,0,0,1,1,0,0,0
08644844,6,3,3,0,0,0,0,0,1
08644869,1,1,0,0,2,2,0,0,0
08644945,2,2,0,0,2,2,0,0,0
08644995,5,0,5,0,1,1,0,0,0
08645055,8,8,0,0,0,0,0,0,1
08645846,1,0,1,0,1,1,0,0,1
08645950,2,0,2,0,2,2,0,0,1
08646177,6,3,3,0,1,1,0,1,1
08646628,26,10,16,0,0,0,0,0,1
08646696,1,1,0,0,2,1,1,0,0
08646989,20,4,16,0,4,2,2,2,1
08647241,20,4,16,0,4,2,2,2,1
08647809,1,1,0,0,1,1,0,0,0
08647823,2,2,0,0,2,2,0,0,0
08648861,7,2,5,0,5,1,4,1,0
08648983,2,2,0,0,2,2,0,0,1
08649086,2,1,1,0,0,0,0,0,0
08649153,5,4,1,0,2,0,2,0,1
08649224,1,1,0,0,1,1,0,0,0
08649226,2,2,0,0,2,2,0,0,0
08649273,2,1,1,0,2,2,0,0,1
08649584,4,4,0,0,5,5,0,1,1
08649662,1,1,0,0,1,1,0,0,0
08649710,3,2,1,0,1,1,0,0,0
08650109,1,1,0,0,1,1,0,0,0
08650929,1,1,0,0,1,1,0,0,0
08651034,12,9,3,0,7,7,0,0,0
08651184,5,2,3,0,1,1,0,1,0
08651485,4,0,4,0,0,0,0,0,1
08651728,3,0,3,0,1,1,0,0,1
08652201,3,3,0,0,2,2,0,0,0
08652271,5,0,5,0,3,3,0,0,0
08652619,7,0,7,0,0,0,0,0,0
08652659,6,6,0,0,0,0,0,0,1
08653864,2,2,0,0,2,2,0,0,0
08653879,2,2,0,0,1,1,0,0,1
08653992,42,17,25,0,1,1,0,1,1
08654028,11,7,4,0,0,0,0,0,1
08654072,1,1,0,0,1,1,0,0,0
08654084,2,0,2,0,0,0,0,0,1
08654310,4,3,1,0,1,1,0,0,1
08654336,7,3,4,0,1,1,0,1,1
08654404,4,0,4,0,0,0,0,0,0
08654586,3,2,1,0,1,1,0,0,0
08654591,28,8,20,0,5,2,3,0,0
08654722,4,3,1,0,1,1,0,0,0
08654923,2,2,0,0,2,2,0,0,0
08655006,3,3,0,0,1,1,0,0,0
08655079,1,1,0,0,1,1,0,0,0
08655502,3,0,3,0,0,0,0,0,1
08655880,2,1,1,0,2,1,1,0,0
08656110,5,4,1,0,3,3,0,0,0
08656257,3,0,3,0,1,1,0,0,0
08656387,1,1,0,0,1,1,0,0,0
08656659,4,1,3,0,3,1,2,0,0
08656711,1,0,1,0,1,1,0,0,0
08657564,2,2,0,0,2,2,0,0,1
08658047,26,0,26,0,0,0,0,0,0
08658179,3,0,3,0,2,2,0,0,1
08658766,2,1,1,0,1,1,0,0,0
08658805,15,8,7,0,6,6,0,0,0
08659167,3,1,2,0,1,1,0,0,0
08659318,1,1,0,0,1,1,0,0,0
08659352,2,0,2,0,0,0,0,0,1
08659358,2,2,0,0,2,2,0,0,0
08659472,20,7,13,0,0,0,0,0,0
08659490,4,4,0,0,0,0,0,0,0
08659502,11,3,8,0,1,1,0,1,1
08659545,5,4,1,0,0,0,0,0,1
08659610,3,1,2,0,1,1,0,1,1
08659634,3,1,2,0,1,1,0,1,1
08659691,6,3,3,0,1,1,0,1,1
08659746,13,10,3,0,1,1,0,0,1
08659926,3,2,1,0,2,2,0,0,0
08660397,2,0,2,0,0,0,0,0,0
08660691,2,2,0,0,1,1,0,0,1
08661226,7,4,3,0,0,0,0,0,1
08661460,11,9,2,0,1,1,0,1,1
08661645,2,0,2,0,0,0,0,0,1
08661726,12,10,2,0,2,2,0,1,1
08662349,2,2,0,0,1,1,0,0,1
08662383,1,1,0,0,1,1,0,0,1
08662609,10,3,7,0,1,1,0,1,1
08662633,10,3,7,0,1,1,0,1,1
08662638,2,2,0,0,2,2,0,0,1
08662860,2,2,0,0,2,2,0,0,0
08663401,1,1,0,0,2,2,0,0,0
08663905,3,0,3,0,0,0,0,0,1
08664088,1,0,1,0,0,0,0,0,0
08664238,5,1,4,0,0,0,0,0,1
08665007,3,2,1,0,0,0,0,0,0
08665590,3,3,0,0,2,2,0,0,0
08665948,9,3,6,0,3,1,2,1,1
08666041,10,1,9,0,1,1,0,1,1
08666161,3,2,1,0,2,1,1,1,0
08666190,3,2,1,0,1,1,0,0,1
08667191,14,3,11,0,0,0,0,0,0
08668047,1,1,0,0,2,2,0,0,1
08668234,10,0,10,0,0,0,0,0,1
08668299,1,0,1,0,0,0,0,0,0
08668809,28,15,13,0,5,3,2,4,0
08668881,5,2,3,0,0,0,0,0,1
08668950,1,0,1,0,1,1,0,0,0
08669228,3,0,3,0,0,0,0,0,1
08669422,2,1,1,0,1,1,0,0,0
08669464,32,9,23,0,13,1,12,1,1
08669482,3,3,0,0,0,0,0,0,1
08669668,2,1,1,0,2,1,1,0,1
08669714,2,2,0,0,1,1,0,0,1
08669980,5,5,0,0,2,2,0,0,0
08670040,1,0,1,0,0,0,0,0,0
08670114,2,0,2,0,0,0,0,0,1
08670223,4,3,1,0,1,1,0,0,0
08670394,13,6,7,0,2,1,1,2,1
08670427,11,7,4,0,1,1,0,1,1
08670444,15,8,7,0,0,0,0,0,1
08670461,5,0,5,0,0,0,0,0,1
08670478,6,4,2,0,0,0,0,0,0
08670738,4,3,1,0,1,1,0,0,1
08670984,6,5,1,0,0,0,0,0,0
08671263,1,1,0,0,1,1,0,0,0
08672421,6,0,6,0,1,1,0,0,0
08672590,2,0,2,0,0,0,0,0,1
08672591,7,1,6,0,0,0,0,0,1
08672655,2,0,2,0,0,0,0,0,1
08672658,6,0,6,0,1,1,0,0,0
08672777,2,0,2,0,0,0,0,0,1
08672822,2,0,2,0,0,0,0,0,1
08672913,2,1,1,0,1,1,0,0,0
08673057,2,0,2,0,0,0,0,0,1
08673779,1,1,0,0,1,1,0,0,0
08673784,2,0,2,0,0,0,0,0,0
08673950,7,2,5,0,1,1,0,1,0
08674428,2,2,0,0,2,2,0,0,0
08674640,10,1,9,0,2,1,1,2,1
08674657,10,1,9,0,2,1,1,2,1
08674822,10,0,10,0,1,1,0,1,1
08675023,2,0,2,0,1,1,0,1,1
08675188,1,1,0,0,1,1,0,0,0
08675587,2,2,0,0,3,3,0,1,0
08676158,2,2,0,0,1,1,0,0,0
08676180,4,2,2,0,3,1,2,1,1
08677410,1,1,0,0,1,1,0,0,0
08677425,1,1,0,0,1,1,0,0,0
08677510,1,1,0,0,1,1,0,0,0
SC034024,23,0,23,1,1,1,0,1,1
SC034126,10,3,7,0,0,0,0,0,0
SC034227,29,4,25,0,1,1,0,1,1
SC034349,8,5,3,0,1,1,0,0,0
SC034369,15,2,13,0,1,1,0,1,1
SC034720,33,2,31,0,1,1,0,1,1
SC034748,26,0,26,0,0,0,0,0,1
SC034927,4,4,0,0,0,0,0,0,1
SC035028,5,2,3,0,1,1,0,0,1
SC035033,37,3,34,0,1,1,0,1,1
SC035148,127,16,111,0,0,0,0,0,1
SC035314,9,2,7,0,3,2,1,2,1
SC035603,8,2,6,0,1,1,0,1,1
SC035640,38,4,34,0,1,1,0,1,1
SC035651,7,0,7,0,1,1,0,1,1
SC035770,29,8,21,0,2,1,1,0,1
SC035882,8,3,5,1,2,1,1,0,1
SC035918,8,3,5,0,1,1,0,0,1
SC035943,17,2,15,0,1,1,0,1,1
SC035987,0,0,0,0,0,0,0,0,0
SC036037,57,3,54,0,1,1,0,1,1
SC036047,9,1,8,0,1,1,0,0,1
SC036104,18,1,17,0,1,1,0,1,1
SC036181,24,0,24,0,0,0,0,0,1
SC036219,49,11,38,0,0,0,0,0,1
SC036277,7,0,7,0,0,0,0,0,1
SC036399,3,0,3,0,3,3,0,0,0
SC036463,6,2,4,0,1,1,0,0,1
SC036524,59,9,50,0,0,0,0,0,1
SC036570,7,4,3,0,4,4,0,0,0
SC036599,18,1,17,0,1,1,0,1,1
SC036737,21,1,20,0,1,1,0,1,1
SC036854,178,103,75,0,0,0,0,0,1
SC036922,34,0,34,0,0,0,0,0,1
SC037046,4,1,3,0,1,1,0,0,1
SC037239,6,3,3,0,1,1,0,0,1
SC037270,51,4,47,0,1,1,0,1,1
SC037323,20,3,17,0,1,1,0,1,1
SC037444,57,7,50,0,0,0,0,0,1
SC037531,84,13,71,0,0,0,0,0,1
SC037535,85,5,80,0,0,0,0,0,1
SC037889,16,0,16,0,0,0,0,0,1
SC038080,9,4,5,0,5,4,1,1,1
SC038141,53,10,43,0,1,1,0,1,1
SC038385,47,7,40,0,1,1,0,1,1
SC038501,10,3,7,0,1,1,0,0,1
SC038608,24,2,22,0,1,1,0,1,1
SC038618,19,0,19,0,1,1,0,1,1
SC038919,5,0,5,0,2,2,0,0,0
SC039092,10,3,7,0,1,1,0,1,1
SC039173,10,0,10,0,0,0,0,0,1
SC039175,9,3,6,0,3,3,0,0,1
SC039321,54,4,50,0,1,1,0,1,1
SC039350,0,0,0,0,0,0,0,0,0
SC039353,10,4,6,0,1,1,0,1,1
SC039426,13,1,12,0,1,1,0,1,1
SC039859,15,0,15,0,0,0,0,0,1
SC040127,8,4,4,0,1,1,0,0,0
SC040174,10,3,7,0,1,1,0,0,1
SC040364,6,3,3,1,1,1,0,0,1
SC040497,34,0,34,0,0,0,0,0,1
SC040675,8,3,5,0,1,1,0,0,1
SC040703,7,5,2,0,4,4,0,0,1
SC040892,32,4,28,0,2,2,0,0,1
SC041034,63,15,48,2,0,0,0,0,1
SC041132,12,3,9,1,1,1,0,1,1
SC041151,4,0,4,0,1,1,0,0,0
SC041189,13,0,13,0,1,1,0,1,1
SC041386,7,2,5,0,1,1,0,0,1
SC041529,89,9,80,0,0,0,0,0,1
SC041535,33,4,29,0,2,2,0,2,1
SC041563,25,2,23,0,1,1,0,1,1
SC041594,19,3,16,0,1,1,0,1,1
SC041642,28,2,26,0,1,1,0,1,1
SC041915,7,4,3,0,1,1,0,1,1
SC041917,30,5,25,0,1,1,0,1,1
SC041957,24,3,21,0,1,1,0,1,1
SC041959,25,2,23,0,1,1,0,1,1
SC042020,20,10,10,0,0,0,0,0,1
SC042204,12,2,10,0,1,1,0,0,1
SC042827,11,4,7,0,1,1,0,1,0
SC042973,20,2,18,0,1,1,0,1,1
SC043087,33,6,27,0,2,1,1,2,1
SC043151,23,8,15,0,0,0,0,0,1
SC043289,7,3,4,0,0,0,0,0,1
SC043307,16,6,10,0,0,0,0,0,1
SC043685,48,3,45,0,2,2,0,0,0
SC043732,36,3,33,0,1,1,0,1,1
SC043810,56,11,45,0,0,0,0,0,1
SC043973,6,2,4,0,1,1,0,0,1
SC044625,32,0,32,0,0,0,0,0,1
SC044676,33,5,28,0,1,1,0,1,1
SC044723,87,12,75,1,0,0,0,0,1
SC044771,24,3,21,0,1,1,0,1,1
SC044778,13,6,7,0,0,0,0,0,1
SC044822,82,17,65,0,0,0,0,0,1
SC044980,22,2,20,0,1,1,0,1,1
SC044986,13,5,8,0,1,1,0,1,1
SC045006,98,3,95,0,1,1,0,1,1
SC045060,6,3,3,0,1,1,0,0,1
SC045153,103,3,100,0,1,1,0,1,1
SC045343,19,2,17,0,1,1,0,1,1
SC045427,5,3,2,0,0,0,0,0,0
SC045478,17,3,14,0,4,2,2,1,1
SC045528,8,5,3,0,2,2,0,0,1
SC045534,7,3,4,0,1,1,0,0,1
SC045551,90,13,77,0,0,0,0,0,1
SC045603,17,0,17,0,0,0,0,0,1
SC045693,12,2,10,0,1,1,0,1,1
SC045704,35,4,31,0,0,0,0,0,1
SC045811,11,0,11,0,0,0,0,0,1
SC045870,23,2,21,0,1,1,0,0,1
SC045882,57,17,40,0,0,0,0,0,1
SC045900,18,0,18,0,0,0,0,0,1
SC046001,23,2,21,0,1,1,0,1,1
SC046004,45,4,41,0,1,1,0,0,1
SC046129,28,6,22,0,2,2,0,0,1
SC046564,11,4,7,0,1,1,0,1,1
SC046605,71,16,55,0,0,0,0,0,1
SC046703,45,8,37,0,0,0,0,0,1
SC046883,26,0,26,0,0,0,0,0,1
SC047032,30,6,24,0,1,1,0,1,1
SC047035,22,0,22,0,0,0,0,0,1
SC047052,35,10,25,0,1,1,0,0,1
SC047058,11,0,11,0,0,0,0,0,1
SC047225,12,1,11,0,1,1,0,1,1
SC047289,111,3,108,0,1,1,0,1,1
SC047346,8,6,2,0,3,3,0,0,1
SC047360,13,3,10,0,1,1,0,0,1
SC047453,60,7,53,0,1,1,0,1,1
SC047567,25,8,17,0,1,1,0,1,1
SC047926,42,0,42,0,0,0,0,0,1
SC047949,19,3,16,0,1,1,0,1,1
SC048167,13,0,13,0,1,1,0,1,0
SC048376,40,4,36,0,1,1,0,1,1
SC048530,35,11,24,0,0,0,0,0,1
SC048610,35,4,31,0,1,1,0,1,1
SC048700,60,11,49,0,0,0,0,0,1
SC048739,14,0,14,0,0,0,0,0,1
SC048937,10,4,6,0,2,2,0,0,1
SC049132,22,3,19,0,1,1,0,1,1
SC049538,9,4,5,0,1,1,0,1,1
SC049650,39,3,36,0,1,1,0,1,1
SC049741,14,0,14,0,1,1,0,1,1
SC049830,8,2,6,0,1,1,0,0,1
SC049866,25,2,23,0,1,1,0,1,1
SC049880,6,2,4,0,1,1,0,0,0
SC049945,8,0,8,0,1,1,0,1,1
SC050016,10,5,5,0,1,1,0,1,1
SC050093,8,5,3,0,0,0,0,0,1
SC050136,3,1,2,0,1,1,0,0,0
SC050468,8,4,4,0,1,1,0,1,1
SC050629,5,2,3,0,1,1,0,0,0
SC050691,14,3,11,0,1,1,0,1,1
SC050721,33,5,28,0,1,1,0,1,1
SC050774,11,4,7,0,1,1,0,1,1
SC050835,48,4,44,0,1,1,0,1,1
SC051023,6,4,2,0,1,1,0,0,1
SC051076,5,0,5,0,0,0,0,0,1
SC051078,12,0,12,0,0,0,0,0,1
SC051089,12,7,5,0,0,0,0,0,1
SC051093,41,7,34,0,1,1,0,1,1
SC051098,41,6,35,0,0,0,0,0,1
SC051204,39,9,30,0,1,1,0,1,1
SC051362,35,3,32,0,1,1,0,1,1
SC051544,11,1,10,0,1,1,0,1,1
SC051555,41,0,41,0,0,0,0,0,1
SC051980,13,1,12,0,1,1,0,0,1
SC052082,12,5,7,0,1,1,0,0,1
SC052147,15,4,11,0,1,1,0,0,1
SC052164,40,4,36,0,1,1,0,1,1
SC052273,22,2,20,0,1,1,0,1,1
SC052538,20,0,20,0,1,1,0,0,1
SC052543,11,4,7,0,1,1,0,1,1
SC052705,8,2,6,1,1,1,0,0,1
SC053092,11,1,10,0,0,0,0,0,1
SC053263,5,3,2,0,1,1,0,0,0
SC053382,65,10,55,0,1,1,0,1,1
SC053525,21,4,17,0,1,1,0,1,1
SC053687,47,13,34,1,4,1,3,1,1
SC053751,12,4,8,0,1,1,0,1,1
SC053832,41,5,36,0,1,1,0,1,0
SC053886,106,3,103,0,1,1,0,1,1
SC054011,35,3,32,0,1,1,0,1,1
SC054018,5,3,2,0,2,2,0,0,0
SC054112,23,1,22,0,0,0,0,0,1
SC054204,13,4,9,1,1,1,0,1,1
SC054207,33,4,29,0,3,3,0,3,1
SC054253,7,2,5,0,2,1,1,0,0
SC054257,21,6,15,0,0,0,0,0,0
SC054366,8,7,1,0,1,1,0,0,0
SC054504,72,10,62,0,0,0,0,0,1
SC054505,48,3,45,0,0,0,0,0,1
SC054674,24,0,24,0,0,0,0,0,1
SC054675,22,0,22,0,0,0,0,0,1
SC054823,11,0,11,0,0,0,0,0,1
SC054864,8,3,5,0,1,1,0,1,0
SC054904,19,0,19,0,0,0,0,0,1
SC055005,21,3,18,0,1,1,0,1,1
SC055006,0,0,0,0,0,0,0,0,1
SC055037,29,2,27,0,1,1,0,1,1
SC055295,21,0,21,0,0,0,0,0,1
SC055296,9,4,5,0,3,3,0,0,1
SC055329,30,3,27,0,1,1,0,1,1
SC055377,5,2,3,0,1,1,0,0,0
SC055476,22,3,19,0,1,1,0,1,0
SC055506,26,5,21,0,0,0,0,0,1
SC056222,9,3,6,0,1,1,0,1,1
SC056257,14,7,7,0,1,1,0,1,1
SC056410,18,4,14,0,1,1,0,1,1
SC056430,54,14,40,0,0,0,0,0,1
SC056736,34,0,34,0,0,0,0,0,1
SC057099,36,0,36,0,0,0,0,0,1
SC057614,7,2,5,0,1,1,0,0,1
SC057707,3,3,0,0,1,1,0,0,0
SC057709,27,7,20,0,5,2,3,2,1
SC057943,24,9,15,0,1,1,0,1,1
SC058135,13,5,8,0,2,2,0,0,1
SC058141,25,7,18,0,0,0,0,0,0
SC058143,7,0,7,0,0,0,0,0,1
SC058311,47,5,42,0,1,1,0,0,1
SC058707,7,4,3,0,0,0,0,0,0
SC058810,3,1,2,0,2,2,0,1,0
SC058816,35,0,35,0,0,0,0,0,1
SC058930,21,2,19,0,1,1,0,0,1
SC059085,44,6,38,0,1,1,0,1,1
SC059134,20,0,20,0,0,0,0,0,1
SC059138,10,4,6,0,1,1,0,0,1
SC059231,13,3,10,0,1,1,0,1,1
SC059245,9,5,4,0,2,2,0,0,0
SC059284,10,3,7,0,2,2,0,1,0
SC059285,3,2,1,0,1,1,0,0,0
SC059292,69,10,59,0,0,0,0,0,1
SC059312,9,5,4,0,0,0,0,0,1
SC059329,145,11,134,0,1,1,0,0,1
SC059453,23,3,20,0,1,1,0,1,1
SC059454,20,0,20,0,1,1,0,1,1
SC059456,31,3,28,0,1,1,0,1,1
SC059485,38,6,32,0,0,0,0,0,1
SC059500,91,17,74,0,5,3,2,0,1
SC059549,152,14,138,0,2,1,1,0,1
SC059708,40,13,27,0,0,0,0,0,1
SC059723,9,6,3,0,1,1,0,0,0
SC059915,9,2,7,0,1,1,0,0,0
SC059963,11,3,8,0,0,0,0,0,1
SC060097,12,4,8,0,3,3,0,1,0
SC060114,12,4,8,0,1,1,0,0,1
SC060116,15,3,12,0,1,1,0,1,0
SC060156,30,4,26,0,1,1,0,0,1
SC060289,60,3,57,0,1,1,0,1,1
SC060647,27,4,23,0,1,1,0,1,1
SC060790,6,5,1,0,2,2,0,0,1
SC060810,7,5,2,0,1,1,0,0,1
SC060828,10,3,7,0,1,1,0,1,1
SC060893,21,0,21,0,0,0,0,0,1
SC060928,42,3,39,0,1,1,0,1,1
SC060987,51,22,29,0,1,1,0,1,1
SC061059,5,2,3,0,1,1,0,0,0
SC061223,3,3,0,0,2,2,0,0,1
SC061281,12,3,9,0,1,1,0,1,1
SC061343,37,3,34,0,1,1,0,1,1
SC061536,30,0,30,0,0,0,0,0,1
SC061780,14,5,9,0,4,1,3,1,1
SC062065,84,13,71,0,0,0,0,0,1
SC062108,16,1,15,0,2,1,1,1,0
SC062145,34,3,31,0,1,1,0,1,1
SC062287,64,0,64,0,0,0,0,0,1
SC062293,26,4,22,1,1,1,0,1,1
SC062391,13,0,13,0,1,1,0,1,1
SC062394,14,4,10,0,1,1,0,1,1
SC062886,21,4,17,0,2,2,0,2,1
SC063024,56,2,54,0,1,1,0,1,1
SC063216,106,13,93,0,0,0,0,0,1
SC063241,10,4,6,0,2,2,0,0,0
SC063316,66,9,57,0,0,0,0,0,1
SC063975,13,0,13,0,0,0,0,0,0
SC064099,6,2,4,0,1,1,0,1,1
SC064153,9,2,7,2,1,1,0,0,1
SC064386,7,0,7,0,0,0,0,0,1
SC064429,43,7,36,0,0,0,0,0,1
SC064430,61,8,53,0,0,0,0,0,1
SC064588,55,6,49,0,0,0,0,0,1
SC064653,33,0,33,0,0,0,0,0,1
SC064691,20,6,14,0,1,1,0,1,1
SC064947,0,0,0,0,0,0,0,0,1
SC065227,13,5,8,0,2,2,0,0,0
SC065497,84,14,70,0,0,0,0,0,1
SC065527,66,12,54,0,2,2,0,2,1
SC065605,30,3,27,0,1,1,0,1,1
SC065674,3,3,0,0,2,2,0,0,0
SC065846,5,0,5,0,0,0,0,0,1
SC066024,50,9,41,0,1,1,0,1,1
SC066107,145,6,139,0,1,1,0,1,1
SC066143,7,3,4,0,1,1,0,0,1
SC066739,32,0,32,1,0,0,0,0,1
SC066890,10,4,6,0,2,2,0,0,1
SC067087,90,11,79,0,0,0,0,0,1
SC067589,27,4,23,0,0,0,0,0,1
SC067706,52,0,52,0,1,1,0,1,1
SC067825,12,0,12,0,0,0,0,0,1
SC067908,15,3,12,0,1,1,0,0,1
SC068605,84,8,76,0,1,1,0,0,1
SC068670,8,0,8,0,0,0,0,0,1
SC068798,29,2,27,0,1,1,0,1,1
SC068995,49,10,39,0,0,0,0,0,1
SC069005,27,3,24,0,1,1,0,1,1
SC069051,31,0,31,0,0,0,0,0,1
SC069129,8,2,6,0,2,2,0,1,0
SC069180,5,2,3,0,1,1,0,0,0
SC069419,6,4,2,0,3,3,0,0,0
SC069524,36,11,25,0,2,2,0,0,1
SC069654,11,0,11,0,0,0,0,0,1
SC069672,35,4,31,0,1,1,0,1,1
SC069720,34,8,26,0,0,0,0,0,1
SC069874,17,2,15,0,1,1,0,0,1
SC069888,11,2,9,0,1,1,0,1,1
01938001,13,6,7,0,2,2,0,0,1
01938123,18,8,10,0,1,1,0,1,1
01938239,15,3,12,0,1,1,0,1,1
01938269,4,2,2,0,1,1,0,0,0
01938291,28,5,23,0,1,1,0,1,1
01938746,29,0,29,0,1,1,0,1,1
01938844,17,3,14,0,2,2,0,0,1
01939029,22,13,9,0,1,1,0,1,0
01939565,17,7,10,0,0,0,0,0,0
01939640,41,5,36,0,1,1,0,1,1
01939658,50,7,43,0,0,0,0,0,1
01939690,48,5,43,0,1,1,0,1,1
01939904,3,2,1,0,1,1,0,0,1
01939932,96,13,83,0,0,0,0,0,1
01940208,16,5,11,0,1,1,0,1,1
01940849,19,3,16,0,1,1,0,1,1
01941250,3,3,0,0,0,0,0,0,0
01942151,26,0,26,0,0,0,0,0,1
01942463,6,0,6,0,0,0,0,0,1
01942565,133,5,128,0,2,1,1,2,1
01942924,9,4,5,0,1,1,0,1,1
01942925,55,9,46,0,0,0,0,0,1
01942931,39,5,34,0,1,1,0,0,1
01943043,37,3,34,0,1,1,0,1,1
01943058,13,0,13,0,0,0,0,0,1
01943339,16,0,16,0,0,0,0,0,1
01943341,80,10,70,0,2,1,1,0,0
01943509,34,4,30,0,1,1,0,1,1
01943724,28,3,25,0,0,0,0,0,1
01943787,16,3,13,0,1,1,0,1,1
01943965,57,6,51,0,0,0,0,0,1
01944266,19,4,15,0,1,1,0,1,1
01944694,9,0,9,0,0,0,0,0,1
01944779,54,0,54,0,0,0,0,0,1
01944798,5,3,2,0,1,1,0,0,0
01945130,35,4,31,0,1,1,0,1,1
01945142,21,5,16,0,1,1,0,1,1
01945480,28,9,19,0,0,0,0,0,0
01945689,38,7,31,0,1,1,0,1,1
01945704,25,4,21,0,1,1,0,1,1
01945769,27,0,27,0,2,1,1,1,1
01946101,44,4,40,0,1,1,0,1,1
01946353,16,0,16,0,0,0,0,0,1
01946456,9,3,6,0,1,1,0,1,1
01946592,24,10,14,0,0,0,0,0,1
01946703,11,4,7,0,0,0,0,0,1
01946949,23,0,23,0,0,0,0,0,1
01947085,36,8,28,0,0,0,0,0,1
01947109,4,0,4,0,0,0,0,0,1
01947323,27,9,18,0,0,0,0,0,0
01947613,17,0,17,0,0,0,0,0,1
01947623,287,24,263,0,0,0,0,0,1
01948256,54,0,54,0,0,0,0,0,1
01948405,33,0,33,0,0,0,0,0,1
01948433,23,0,23,0,0,0,0,0,1
01948578,48,10,38,0,0,0,0,0,1
01949076,23,5,18,0,0,0,0,0,1
01949369,13,7,6,0,0,0,0,0,0
01949529,23,5,18,0,0,0,0,0,1
01949696,35,3,32,0,1,1,0,1,1
01949819,41,9,32,0,0,0,0,0,1
01950030,31,7,24,0,1,1,0,0,1
01950048,59,2,57,0,0,0,0,0,1
01950228,23,3,20,0,3,1,2,3,1
01950430,6,5,1,0,2,2,0,0,1
01950497,41,3,38,0,2,1,1,2,1
01950825,7,2,5,0,1,1,0,1,0
01950911,36,4,32,0,1,1,0,1,1
01951092,32,2,30,0,1,1,0,1,1
01951332,28,2,26,0,2,2,0,2,1
01951551,19,0,19,0,0,0,0,0,1
01951635,22,4,18,0,1,1,0,1,1
01951865,7,0,7,0,0,0,0,0,1
01952037,35,0,35,0,0,0,0,0,1
01952080,6,5,1,0,2,2,0,0,1
01952127,80,0,80,0,0,0,0,0,1
01952292,20,7,13,0,2,1,1,0,1
01952298,33,3,30,0,1,1,0,1,1
01952317,18,4,14,0,0,0,0,0,1
01952379,22,0,22,0,1,1,0,1,1
01952739,36,4,32,0,1,1,0,1,1
01952972,13,4,9,0,1,1,0,1,1
01952992,34,3,31,0,1,1,0,1,1
01952998,9,3,6,0,1,1,0,0,0
01953243,8,2,6,0,0,0,0,0,1
01953244,8,2,6,0,1,1,0,1,1
01953344,51,9,42,0,0,0,0,0,1
01953478,33,3,30,0,4,3,1,1,1
01953483,6,0,6,0,0,0,0,0,1
01953498,20,3,17,0,1,1,0,1,1
01953871,7,4,3,0,1,1,0,1,0
01953965,4,0,4,0,0,0,0,0,0
01954313,19,4,15,0,4,1,3,1,1
01954707,8,3,5,0,1,1,0,1,1
01954925,14,3,11,0,1,1,0,0,0
01954996,0,0,0,0,0,0,0,0,1
01954998,61,7,54,0,0,0,0,0,0
01955498,32,5,27,0,1,1,0,1,1
01955756,13,4,9,0,0,0,0,0,1
01955804,5,3,2,0,1,1,0,0,0
01955898,42,6,36,0,0,0,0,0,1
01956063,7,5,2,0,0,0,0,0,0
01956134,16,4,12,0,1,1,0,1,1
01956383,4,3,1,0,2,2,0,0,0
01956764,17,3,14,0,2,1,1,2,1
01957239,19,2,17,0,1,1,0,1,1
01957398,8,2,6,0,1,1,0,1,1
01957593,42,0,42,0,0,0,0,0,1
01957749,27,0,27,0,0,0,0,0,1
01957770,67,3,64,0,1,1,0,1,1
01958292,14,3,11,0,1,1,0,1,1
01959020,11,3,8,0,0,0,0,0,1
01959090,14,4,10,0,1,1,0,1,1
01959287,35,2,33,0,2,1,1,2,1
01959479,75,0,75,0,1,1,0,1,1
01959704,69,4,65,0,1,1,0,1,1
01959777,9,2,7,0,1,1,0,0,1
01960442,25,0,25,0,0,0,0,0,1
01960484,62,8,54,0,2,1,1,2,1
01960526,15,3,12,0,1,1,0,1,1
01960988,118,5,113,0,1,1,0,1,1
01961000,16,3,13,0,2,2,0,0,1
01961252,7,4,3,0,2,2,0,0,0
01961269,4,0,4,0,3,3,0,1,0
01961302,60,0,60,0,1,1,0,0,1
01961457,64,4,60,0,1,1,0,1,0
01961978,54,8,46,0,0,0,0,0,1
01962490,3,3,0,0,2,2,0,0,0
01962495,29,6,23,0,1,1,0,1,1
01962902,274,2,272,0,1,1,0,1,1
01962903,208,10,198,0,1,1,0,1,1
01962946,49,6,43,0,5,4,1,0,1
01962950,44,12,32,0,0,0,0,0,1
01963809,19,5,14,0,0,0,0,0,1
01963989,61,12,49,0,0,0,0,0,1
01964017,8,6,2,0,2,2,0,0,0
01964215,16,4,12,0,4,4,0,1,1
01964639,20,3,17,0,1,1,0,1,1
01964697,50,11,39,0,0,0,0,0,0
01964902,35,6,29,0,1,1,0,1,1
01965328,27,3,24,0,1,1,0,1,1
01965565,6,3,3,0,3,2,1,0,0
01965792,29,6,23,0,1,1,0,1,1
01966140,6,0,6,0,0,0,0,0,0
01966190,64,21,43,0,0,0,0,0,1
01966211,2,2,0,0,1,1,0,0,1
01966277,68,3,65,0,1,1,0,1,1
01966360,6,3,3,0,1,1,0,1,1
01966438,13,3,10,0,1,1,0,1,1
01966619,39,11,28,0,0,0,0,0,1
01967154,56,7,49,0,1,1,0,1,1
01967411,8,4,4,0,2,2,0,0,1
01967587,20,3,17,0,2,1,1,2,1
01967704,27,8,19,0,0,0,0,0,1
01967707,23,10,13,0,3,2,1,1,0
01968041,45,0,45,0,1,1,0,0,0
01968224,22,5,17,0,0,0,0,0,1
01968227,111,5,106,0,0,0,0,0,1
01968746,28,4,24,0,1,0,1,0,1
01969090,26,2,24,0,2,1,1,1,1
01969215,24,0,24,0,0,0,0,0,1
01969549,19,0,19,0,0,0,0,0,1
01970111,5,3,2,0,1,1,0,0,0
01970437,17,3,14,0,1,1,0,1,1
01970542,35,5,30,0,1,1,0,1,1
01970801,27,0,27,0,0,0,0,0,1
01970855,89,9,80,0,1,1,0,1,1
01970895,7,1,6,0,2,2,0,1,1
01971125,14,5,9,0,1,1,0,1,1
01971242,74,12,62,0,0,0,0,0,1
01971245,122,12,110,0,2,2,0,2,1
01971267,11,4,7,0,3,3,0,0,1
01971362,3,3,0,0,5,5,0,0,0
01971635,50,9,41,0,2,2,0,2,1
01971774,22,3,19,0,1,1,0,1,1
01971789,26,3,23,0,1,1,0,1,1
01971914,10,3,7,0,1,1,0,0,0
01971951,10,2,8,0,1,1,0,1,1
01972117,9,4,5,0,4,2,2,0,1
01972141,6,0,6,0,2,2,0,1,1
01972169,9,0,9,0,0,0,0,0,1
01972550,30,0,30,0,0,0,0,0,1
01972630,12,0,12,0,0,0,0,0,1
01972656,192,0,192,0,0,0,0,0,1
01972686,11,4,7,0,1,1,0,1,1
01972694,28,4,24,0,1,1,0,1,1
01972839,21,4,17,0,0,0,0,0,1
01973219,22,7,15,0,2,1,1,2,1
01973267,17,0,17,0,1,1,0,1,1
01973412,80,8,72,0,1,1,0,1,1
01973492,18,0,18,0,0,0,0,0,1
01973524,14,3,11,0,0,0,0,0,1
01973568,19,0,19,0,1,1,0,1,1
01973783,22,0,22,0,0,0,0,0,1
01973936,29,0,29,0,1,1,0,1,1
01973941,20,4,16,0,1,1,0,1,1
01974125,15,3,12,0,1,1,0,1,1
01974135,3,3,0,0,2,2,0,0,0
01974280,18,3,15,0,1,1,0,1,1
01974528,5,1,4,0,2,2,0,0,1
01974699,42,0,42,0,0,0,0,0,1
01974805,44,0,44,0,0,0,0,0,1
01974859,30,3,27,0,1,1,0,1,1
01975338,20,6,14,0,1,1,0,1,1
01975715,30,0,30,0,0,0,0,0,1
01976148,18,4,14,0,0,0,0,0,1
01976437,27,5,22,0,0,0,0,0,0
01976836,34,0,34,0,0,0,0,0,1
01977118,10,3,7,0,2,2,0,0,0
01977350,35,6,29,0,0,0,0,0,1
01977369,17,0,17,0,0,0,0,0,1
01977532,10,4,6,0,1,1,0,0,1
01977742,21,4,17,0,1,1,0,1,1
01977831,30,0,30,0,0,0,0,0,1
01977948,53,9,44,0,1,1,0,1,1
01978309,25,4,21,0,1,1,0,0,1
01978371,10,0,10,0,0,0,0,0,1
01978664,13,5,8,0,0,0,0,0,1
01978805,22,4,18,0,0,0,0,0,1
01978946,20,0,20,0,0,0,0,0,1
01979177,7,2,5,0,1,1,0,0,0
01980029,7,5,2,0,1,1,0,0,0
01980853,32,8,24,0,1,1,0,1,1
01981121,44,6,38,0,1,1,0,1,1
01981122,69,6,63,0,1,1,0,1,1
01981157,47,0,47,0,1,1,0,1,1
01981238,57,2,55,0,1,1,0,1,1
01981312,12,2,10,0,0,0,0,0,0
01981540,20,4,16,0,2,1,1,1,1
01981612,22,0,22,0,0,0,0,0,1
01981669,17,7,10,0,0,0,0,0,1
01981794,16,0,16,0,0,0,0,0,1
01981854,37,9,28,0,0,0,0,0,0
01982084,34,5,29,0,2,2,0,2,1
01982349,22,0,22,0,0,0,0,0,1
01982350,58,4,54,0,1,1,0,1,1
01982532,10,3,7,0,1,1,0,1,1
01982839,5,1,4,0,1,1,0,0,0
01982873,52,11,41,0,1,1,0,1,1
01983051,6,3,3,0,2,2,0,0,0
01983358,93,28,65,0,24,21,3,0,0
01983429,27,2,25,0,1,1,0,1,1
01983540,33,2,31,0,1,1,0,1,1
01983857,43,6,37,0,1,1,0,1,1
01984132,28,3,25,0,0,0,0,0,1
01984357,23,5,18,0,0,0,0,0,0
01985361,142,10,132,0,0,0,0,0,1
01985479,38,4,34,0,1,1,0,1,1
01985536,19,0,19,0,1,1,0,1,1
01985540,49,3,46,0,1,1,0,1,1
01985767,41,4,37,0,2,1,1,1,1
01985799,53,13,40,0,0,0,0,0,1
01985809,33,7,26,0,0,0,0,0,1
01985865,77,0,77,0,0,0,0,0,1
01986016,18,7,11,0,1,1,0,1,1
01986040,30,3,27,0,1,1,0,1,1
01986157,19,0,19,0,0,0,0,0,1
01986161,54,0,54,0,1,1,0,1,1
01986281,47,8,39,0,1,1,0,1,1
01986299,47,9,38,0,0,0,0,0,1
01986476,17,3,14,0,0,0,0,0,1
01986553,21,7,14,0,0,0,0,0,1
01986759,87,7,80,0,2,1,1,2,1
01986784,6,0,6,0,0,0,0,0,1
01986868,46,12,34,0,1,1,0,0,1
01986952,0,0,0,0,0,0,0,0,0
01987009,13,0,13,0,0,0,0,0,1
01987256,41,0,41,0,0,0,0,0,1
01987453,45,2,43,0,1,1,0,1,1
01987572,5,5,0,0,0,0,0,0,1
01987664,13,3,10,0,3,3,0,0,1
01988161,8,4,4,0,1,1,0,0,1
01988167,0,0,0,0,0,0,0,0,0
01988387,49,3,46,0,2,2,0,2,1
01988608,19,7,12,0,4,2,2,3,1
01988706,4,0,4,0,1,1,0,0,0
01989368,29,3,26,0,1,1,0,1,1
01989455,10,0,10,0,0,0,0,0,1
01989823,31,5,26,0,2,2,0,1,1
01989841,17,5,12,0,0,0,0,0,0
01989923,27,12,15,0,1,1,0,1,1
01990062,16,6,10,0,1,1,0,1,0
01990317,39,2,37,0,1,1,0,1,1
01990370,62,7,55,0,1,1,0,1,1
01990893,192,0,192,0,0,0,0,0,1
01991032,12,0,12,0,0,0,0,0,1
01991247,7,1,6,0,0,0,0,0,1
01991362,0,0,0,0,0,0,0,0,1
01991595,49,5,44,0,1,1,0,1,1
01991604,15,3,12,0,0,0,0,0,0
01991745,25,0,25,0,0,0,0,0,1
01991750,23,0,23,0,0,0,0,0,1
01991838,9,4,5,0,1,1,0,1,0
01992401,11,3,8,0,1,1,0,0,1
01992524,20,4,16,0,1,1,0,0,1
01992636,28,2,26,0,1,1,0,1,1
01992860,64,6,58,0,1,1,0,1,1
01992867,195,0,195,0,0,0,0,0,1
01992975,11,4,7,0,1,1,0,1,1
01993086,10,0,10,0,0,0,0,0,1
01993188,7,4,3,0,1,1,0,0,1
01993193,33,3,30,0,1,1,0,1,1
01994861,29,0,29,0,0,0,0,0,1
01994937,0,0,0,0,0,0,0,0,0
01994995,50,6,44,0,1,1,0,1,1
01994997,29,8,21,1,4,3,1,2,1
01995414,13,0,13,0,0,0,0,0,1
01995447,5,0,5,0,0,0,0,0,1
01995498,33,6,27,0,0,0,0,0,1
01995776,6,2,4,0,0,0,0,0,0
01995781,28,2,26,0,0,0,0,0,1
01996056,51,3,48,0,1,1,0,1,1
01996061,19,3,16,0,1,1,0,1,1
01996073,62,3,59,0,1,0,1,1,1
01996137,39,0,39,0,1,1,0,1,1
01996296,23,2,21,0,1,0,1,0,0
01996687,31,5,26,0,1,1,0,1,1
01996711,16,3,13,0,1,1,0,1,1
01997219,53,5,48,0,2,1,1,1,1
01997397,17,7,10,0,1,1,0,1,1
01997554,38,14,24,0,1,1,0,0,1
01997688,7,3,4,0,1,1,0,0,1
01997758,24,0,24,0,0,0,0,0,1
01997791,21,3,18,0,1,1,0,0,0
01998251,46,6,40,0,1,1,0,1,1
01998436,17,3,14,0,2,2,0,2,1
01998668,5,2,3,0,2,2,0,0,0
01998698,29,0,29,0,0,0,0,0,1
01998736,18,1,17,0,0,0,0,0,1
01998780,25,3,22,0,1,1,0,1,1
09267773,1,0,1,0,0,0,0,0,1
09267876,6,3,3,0,2,2,0,2,1
09267988,2,0,2,0,0,0,0,0,0
09268025,5,2,3,0,2,2,0,0,0
09268443,3,2,1,0,1,1,0,0,1
09268793,1,1,0,0,1,1,0,0,0
09268902,2,1,1,0,1,1,0,0,0
09269330,2,2,0,0,4,4,0,0,1
09269425,2,2,0,0,4,4,0,0,1
09269565,2,2,0,0,4,4,0,0,1
09269617,2,0,2,0,0,0,0,0,1
09269775,2,0,2,0,0,0,0,0,1
09269852,2,2,0,0,2,2,0,0,1
09270040,12,7,5,0,3,1,2,1,1
09270095,9,7,2,0,0,0,0,0,1
09270457,3,2,1,0,2,2,0,0,0
09270613,1,0,1,0,0,0,0,0,1
09270626,8,4,4,0,2,2,0,1,0
09270704,15,5,10,0,1,0,1,0,0
09270746,1,1,0,0,1,1,0,0,0
09270984,3,3,0,0,1,1,0,0,0
09271433,2,2,0,0,2,2,0,0,1
09271872,1,1,0,0,1,1,0,0,0
09271889,1,1,0,0,2,2,0,0,0
09272235,14,8,6,0,1,1,0,1,1
09272343,6,3,3,0,0,0,0,0,1
09273127,7,3,4,0,1,1,0,1,1
09273440,1,1,0,0,0,0,0,0,0
09273929,1,1,0,0,1,1,0,0,0
09273984,2,0,2,0,0,0,0,0,1
09274035,6,4,2,0,0,0,0,0,1
09274166,5,4,1,0,2,2,0,0,1
09274183,1,1,0,0,1,1,0,0,0
09274205,3,1,2,0,1,1,0,1,0
09274241,15,7,8,0,2,2,0,1,1
09274379,3,3,0,0,2,2,0,0,1
09274702,3,3,0,0,3,3,0,0,1
09274896,3,3,0,0,3,3,0,0,1
09274969,1,0,1,0,1,1,0,0,0
09275275,9,8,1,0,0,0,0,0,1
09275792,3,2,1,0,2,2,0,0,1
09276083,4,3,1,0,0,0,0,0,1
09276155,2,2,0,0,1,1,0,0,0
09276519,1,1,0,0,2,2,0,0,0
09276774,2,2,0,0,1,1,0,0,0
09276831,4,3,1,0,2,2,0,2,1
09276929,25,11,14,0,0,0,0,0,1
09277018,2,2,0,0,2,2,0,0,0
09277081,6,4,2,0,0,0,0,0,0
09278190,2,0,2,0,0,0,0,0,1
09278198,13,7,6,0,0,0,0,0,1
09278255,24,17,7,1,2,2,0,0,1
09278356,2,2,0,0,1,1,0,0,0
09278458,3,1,2,0,1,1,0,0,0
09278667,1,1,0,0,1,1,0,0,0
09278885,2,2,0,0,1,1,0,0,0
09278948,1,1,0,0,1,1,0,0,0
09279111,4,4,0,0,0,0,0,0,1
09279847,3,3,0,0,1,1,0,0,0
09280000,5,3,2,0,2,2,0,2,0
09281030,2,0,2,0,1,1,0,0,0
09281078,2,2,0,0,0,0,0,0,0
09281829,2,2,0,0,1,1,0,0,0
09282170,1,0,1,0,1,1,0,0,0
09282424,2,1,1,0,1,0,1,0,1
09283518,2,0,2,0,0,0,0,0,0
09283835,1,0,1,0,1,1,0,0,0
09283843,4,2,2,0,4,2,2,0,0
09284360,1,1,0,0,2,2,0,0,0
09284370,12,2,10,0,0,0,0,0,0
09284436,1,1,0,0,1,1,0,0,0
09284440,3,3,0,0,3,3,0,0,1
09284444,5,4,1,0,1,1,0,0,0
09284618,3,2,1,0,2,2,0,0,1
09284867,1,1,0,0,1,1,0,0,0
09285057,3,2,1,0,2,1,1,0,0
09285384,5,4,1,0,0,0,0,0,0
09285935,1,1,0,0,1,1,0,0,0
09286154,3,2,1,0,1,1,0,0,0
09286339,2,0,2,0,0,0,0,0,1
09286802,3,0,3,0,1,1,0,0,1
09286875,4,3,1,0,2,1,1,1,1
09286912,2,2,0,0,1,1,0,1,1
09287042,3,0,3,0,1,1,0,1,0
09287477,1,1,0,0,1,1,0,0,0
09287532,3,2,1,0,0,0,0,0,0
09288067,6,4,2,0,3,2,1,0,1
09288420,3,2,1,0,3,2,1,0,1
09288479,6,4,2,0,2,2,0,0,1
09288783,11,2,9,1,3,1,2,2,1
09288894,1,0,1,0,1,1,0,0,0
09288964,13,4,9,0,2,1,1,2,1
09289161,1,0,1,0,0,0,0,0,0
09289346,1,1,0,0,2,1,1,0,0
09289514,2,2,0,0,2,2,0,0,0
09289682,2,2,0,0,2,2,0,0,0
09290111,1,0,1,0,0,0,0,0,0
09290363,1,0,1,0,1,1,0,0,0
09290499,3,0,3,0,0,0,0,0,1
09291049,1,0,1,0,1,1,0,0,1
09291127,15,7,8,0,0,0,0,0,0
09291225,2,2,0,0,3,3,0,0,1
09291764,3,3,0,0,2,2,0,0,1
09291786,1,1,0,0,1,1,0,1,0
09293057,2,0,2,0,0,0,0,0,1
09293129,2,0,2,0,0,0,0,0,1
09293236,3,3,0,0,1,1,0,1,0
09293735,6,3,3,0,1,1,0,0,0
09293824,1,1,0,0,1,1,0,0,0
09293927,2,2,0,0,2,2,0,0,0
09293932,2,2,0,0,1,1,0,0,0
09294221,4,3,1,0,2,1,1,0,1
09294246,1,0,1,0,0,0,0,0,0
09295312,2,1,1,0,1,1,0,0,0
09295557,23,8,15,0,0,0,0,0,1
09296215,1,0,1,0,1,1,0,0,0
09296338,5,1,4,0,1,1,0,0,0
09296621,7,3,4,0,4,1,3,4,0
09296658,1,0,1,0,1,1,0,0,0
09296727,24,17,7,0,1,1,0,1,1
09297419,5,4,1,0,1,1,0,1,1
09297787,3,3,0,0,2,2,0,0,0
09298317,3,3,0,0,1,1,0,0,0
09298345,5,1,4,0,1,1,0,0,0
09298450,2,2,0,0,2,2,0,0,0
09298542,2,2,0,0,2,2,0,0,0
09298638,12,4,8,0,1,1,0,1,0
09299100,7,6,1,0,1,0,1,0,0
09299627,7,5,2,0,3,1,2,1,1
09299654,7,4,3,0,0,0,0,0,1
09299954,2,2,0,0,3,3,0,0,0
09299975,31,12,19,0,9,5,4,0,1
09300213,7,0,7,0,2,1,1,0,0
09300401,3,2,1,0,1,1,0,0,0
09300631,3,2,1,0,2,2,0,2,0
09300896,1,1,0,0,1,1,0,0,0
09300901,5,4,1,0,1,1,0,0,1
09300902,5,4,1,0,1,1,0,0,1
09300948,5,4,1,0,1,1,0,0,1
09300955,5,4,1,0,1,1,0,0,1
09300959,5,4,1,0,1,1,0,0,1
09301320,6,5,1,0,1,1,0,0,1
09301321,1,0,1,0,2,2,0,1,1
09301325,3,3,0,0,1,1,0,1,1
09301329,10,3,7,0,1,0,1,0,1
09301332,2,2,0,0,1,1,0,0,0
09301339,1,0,1,0,0,0,0,0,1
09301341,1,0,1,0,2,2,0,1,1
09301412,10,1,9,0,4,1,3,0,0
09301446,2,2,0,0,1,1,0,0,1
09301453,2,2,0,0,1,1,0,0,0
09301943,1,1,0,0,1,1,0,0,1
09302031,1,1,0,0,1,1,0,0,0
09302415,2,2,0,0,1,1,0,0,0
09302743,1,1,0,0,2,2,0,0,0
09303104,2,0,2,0,2,2,0,0,1
09303356,1,1,0,0,1,1,0,0,0
09303891,1,1,0,0,1,1,0,0,0
09303994,10,6,4,0,1,1,0,1,1
09304384,2,2,0,0,1,1,0,0,0
09304510,1,0,1,0,0,0,0,0,1
09304538,1,1,0,0,1,1,0,0,0
09304853,3,1,2,0,1,1,0,0,0
09304912,3,1,2,0,1,1,0,0,0
09305035,6,5,1,0,1,1,0,1,1
09305071,3,2,1,0,1,1,0,0,0
09305846,1,1,0,0,1,1,0,0,0
09306360,12,8,4,0,1,1,0,1,1
09306438,4,2,2,0,1,1,0,0,0
09306913,1,1,0,0,1,1,0,0,0
09307000,2,1,1,0,1,1,0,0,1
09307072,1,1,0,0,1,1,0,0,0
09307275,3,2,1,0,2,2,0,0,0
09307334,6,0,6,0,0,0,0,0,0
09307701,11,8,3,0,1,1,0,0,1
09307788,1,1,0,0,2,2,0,0,0
09307995,15,8,7,0,1,1,0,1,0
09308107,6,1,5,0,3,1,2,1,0
09308505,1,0,1,0,2,2,0,0,0
09308676,2,2,0,0,2,2,0,0,0
09308733,5,0,5,0,0,0,0,0,1
09309701,1,1,0,0,1,1,0,0,1
09309759,19,8,11,0,1,1,0,1,1
09310426,7,1,6,0,3,1,2,0,0
09310552,2,2,0,0,1,1,0,0,0
09310800,1,1,0,0,1,1,0,0,0
09311104,1,0,1,0,0,0,0,0,0
09311168,1,1,0,0,2,2,0,0,0
09311356,3,0,3,0,0,0,0,0,1
09311542,9,1,8,0,4,1,3,0,0
09311610,1,1,0,0,4,3,1,0,1
09312195,2,0,2,0,1,1,0,0,0
09312299,3,0,3,0,1,1,0,0,1
09312589,8,3,5,0,2,1,1,1,1
09312676,10,7,3,0,2,2,0,0,1
09313107,7,5,2,0,1,1,0,1,1
09313150,3,3,0,0,0,0,0,0,1
09313205,3,2,1,0,1,1,0,0,1
09313355,1,1,0,0,1,1,0,0,0
09313362,2,0,2,0,0,0,0,0,1
09313424,1,1,0,0,1,1,0,0,0
09313935,5,4,1,0,1,1,0,1,1
09313997,1,1,0,0,1,1,0,0,0
09314802,1,0,1,0,1,1,0,0,0
09314835,7,5,2,0,1,1,0,1,1
09314999,2,0,2,0,2,2,0,0,0
09315039,12,0,12,0,1,1,0,0,1
09315231,2,2,0,0,1,1,0,0,1
09315449,3,0,3,0,2,1,1,0,0
09315694,2,0,2,0,1,1,0,0,1
09315803,2,2,0,0,2,2,0,0,0
09315837,1,1,0,0,1,1,0,0,1
10360012,1,1,0,0,3,3,0,3,0
10360512,6,5,1,0,1,1,0,1,1
10360543,13,6,7,0,2,1,1,2,1
10360589,2,2,0,0,1,1,0,0,1
10360684,6,5,1,0,1,1,0,1,1
10361954,1,1,0,0,1,1,0,1,1
10362200,4,3,1,0,1,1,0,1,0
10362456,4,3,1,0,2,0,2,0,1
10362626,1,0,1,0,1,1,0,0,0
10362628,5,3,2,0,1,1,0,1,1
10362699,2,2,0,0,2,2,0,0,0
10362983,7,3,4,0,1,1,0,1,1
10363078,1,0,1,0,1,1,0,0,0
10363431,1,1,0,0,1,1,0,0,0
10363538,1,0,1,0,1,1,0,0,0
10363855,4,3,1,0,2,1,1,2,1
10364449,2,2,0,0,2,2,0,0,1
10364450,2,2,0,0,2,1,1,0,0
10364451,6,2,4,0,1,1,0,1,1
10364768,7,3,4,0,1,1,0,1,1
10364807,4,3,1,0,1,1,0,1,1
10364831,3,2,1,0,0,0,0,0,0
10364872,2,2,0,0,1,1,0,0,0
10365740,2,0,2,0,1,1,0,0,0
10365758,1,1,0,0,1,1,0,0,0
10365822,2,2,0,0,2,2,0,0,0
10365834,2,2,0,0,1,1,0,1,1
10365911,1,1,0,0,1,1,0,0,0
10366396,2,2,0,0,1,1,0,0,0
10366809,4,0,4,0,1,1,0,0,0
10367299,1,1,0,0,1,1,0,0,0
10368059,4,3,1,0,2,1,1,0,1
10368554,1,1,0,0,1,1,0,0,0
10368557,9,6,3,0,1,1,0,1,1
10369175,2,1,1,0,3,1,2,0,0
10369194,6,6,0,0,2,2,0,0,0
10369246,1,1,0,0,0,0,0,0,0
10369617,1,1,0,0,1,1,0,0,0
10369902,1,1,0,0,0,0,0,0,0
10370242,1,1,0,0,1,1,0,1,0
10370334,5,5,0,0,2,2,0,0,0
10370336,2,2,0,0,3,2,1,0,0
10370530,2,2,0,0,1,1,0,0,1
10370568,1,1,0,0,1,1,0,0,0
10370617,3,0,3,0,2,2,0,0,0
10370870,2,2,0,0,1,1,0,0,0
10370926,3,3,0,0,3,3,0,0,1
10371138,1,1,0,0,2,1,1,0,0
10371157,2,2,0,0,2,2,0,0,0
10371377,7,3,4,0,1,1,0,1,1
10371526,1,0,1,0,1,1,0,0,0
10371713,6,6,0,0,4,4,0,0,0
10371729,1,1,0,0,1,1,0,0,0
10371767,1,1,0,0,1,1,0,0,0
10373110,2,2,0,0,1,1,0,0,1
10373406,1,1,0,0,1,1,0,0,1
10373537,1,0,1,0,1,1,0,0,0
10373979,2,2,0,0,2,2,0,0,0
10374031,2,1,1,0,2,1,1,0,0
10374223,1,1,0,0,1,1,0,0,0
10374227,2,2,0,0,0,0,0,0,1
10374307,2,2,0,0,1,1,0,0,0
10374415,1,1,0,0,1,1,0,0,0
10374879,4,2,2,0,2,2,0,2,0
10374889,2,2,0,0,1,1,0,0,1
10375399,2,1,1,0,1,1,0,0,1
10375524,2,2,0,0,2,2,0,0,1
10376617,2,1,1,0,2,1,1,0,0
10376960,4,0,4,0,3,1,2,1,1
10377063,5,5,0,0,1,1,0,1,1
10377207,1,1,0,0,2,2,0,0,0
10377311,2,0,2,0,1,1,0,1,0
10377590,3,3,0,0,2,2,0,0,0
10377608,2,2,0,0,1,1,0,0,0
10377866,4,4,0,0,1,1,0,1,1
10377884,1,1,0,0,1,1,0,0,0
10378179,4,4,0,0,2,2,0,0,0
10378250,1,1,0,0,1,1,0,0,0
10378577,1,1,0,0,1,1,0,0,0
10379325,11,10,1,0,1,1,0,0,1
10379654,2,2,0,0,2,2,0,0,1
10380187,1,1,0,0,2,2,0,0,0
10380232,4,2,2,0,0,0,0,0,0
10380620,2,0,2,0,2,2,0,0,0
10380694,1,0,1,0,1,1,0,0,0
10380856,4,4,0,0,1,1,0,0,0
10380945,1,1,0,0,1,1,0,0,0
10381021,1,1,0,0,1,1,0,0,1
10381045,7,7,0,0,0,0,0,0,0
10381430,5,5,0,0,0,0,0,0,1
10381572,1,0,1,0,0,0,0,0,0
10381611,5,4,1,0,0,0,0,0,1
10381810,3,3,0,0,3,3,0,0,1
10381812,2,2,0,0,1,1,0,0,0
10381935,4,2,2,0,1,1,0,1,1
10382616,2,2,0,0,3,3,0,0,0
10382968,6,4,2,0,0,0,0,0,1
10383609,2,0,2,0,1,1,0,0,1
10383674,3,0,3,0,1,1,0,0,1
10383730,6,4,2,0,1,0,1,0,1
10383769,4,4,0,0,0,0,0,0,0
10384014,6,3,3,0,1,1,0,1,1
10384087,1,1,0,0,1,1,0,0,0
10385809,12,5,7,0,0,0,0,0,0
10385920,22,14,8,0,3,3,0,2,1
10386078,11,5,6,0,1,0,1,1,1
10386965,1,1,0,0,1,1,0,0,0
10386984,1,1,0,0,1,1,0,1,0
10387111,4,0,4,0,2,2,0,0,1
10387344,1,0,1,0,1,1,0,0,0
10387503,10,5,5,0,1,1,0,1,1
10387610,1,1,0,0,1,1,0,0,0
10387892,10,5,5,0,1,1,0,1,1
10388016,2,2,0,0,2,2,0,0,0
10388074,10,5,5,0,1,1,0,1,1
10388097,1,1,0,0,1,1,0,0,0
10388709,2,2,0,0,2,2,0,0,0
10389014,1,0,1,0,1,1,0,0,0
10389094,1,1,0,0,1,1,0,0,0
10389388,2,2,0,0,2,2,0,0,0
10389720,2,2,0,0,2,2,0,0,0
10390276,7,1,6,0,2,2,0,0,1
10390336,5,3,2,0,2,1,1,2,1
10390613,7,3,4,0,1,1,0,1,1
10390722,2,2,0,0,2,2,0,2,1
10390805,1,1,0,0,1,1,0,0,0
10391007,1,1,0,0,1,1,0,0,0
10391191,1,1,0,0,1,1,0,0,0
10392076,4,0,4,0,3,2,1,0,0
10392130,1,1,0,0,1,1,0,0,0
10392218,2,1,1,0,2,1,1,0,0
10392695,4,3,1,0,1,1,0,1,1
10392943,2,1,1,0,1,1,0,0,0
10393293,3,1,2,0,2,1,1,1,0
10393524,3,3,0,0,1,1,0,0,0
10393744,2,2,0,0,1,1,0,0,0
10393780,4,1,3,0,3,1,2,1,0
10394000,3,1,2,0,2,1,1,1,0
10394974,1,1,0,0,0,0,0,0,0
10395011,1,0,1,0,1,1,0,1,1
10395759,2,0,2,0,1,1,0,0,1
10396134,5,0,5,0,1,1,0,0,1
10396522,5,5,0,0,3,3,0,0,1
10396643,3,3,0,0,1,1,0,1,1
10396779,2,2,0,0,2,2,0,0,0
10397344,1,1,0,0,2,2,0,0,0
10397519,2,0,2,0,2,1,1,0,0
10397757,20,11,9,0,0,0,0,0,0
10398280,1,1,0,0,1,1,0,0,0
10398700,8,6,2,0,1,0,1,1,1
10398974,10,4,6,0,0,0,0,0,0
10399088,1,1,0,0,1,1,0,0,1
10399333,8,5,3,0,1,1,0,1,1
10399357,1,1,0,0,1,1,0,0,0
10399456,2,2,0,0,1,1,0,0,1
10399580,2,2,0,0,1,1,0,0,1
10399739,3,3,0,0,1,1,0,1,1
10399749,1,0,1,0,1,1,0,1,1
10399780,1,0,1,0,1,1,0,1,1
10399916,2,2,0,0,3,2,1,1,1
10400002,2,0,2,0,2,2,0,0,0
10400175,1,1,0,0,1,1,0,0,0
10400888,1,1,0,0,1,1,0,0,0
10400987,2,2,0,0,2,2,0,0,0
10401702,1,1,0,0,1,1,0,0,0
10402087,4,4,0,0,1,1,0,1,0
10402151,3,0,3,0,2,1,1,0,0
10402563,1,1,0,0,1,1,0,0,0
10403407,1,0,1,0,1,1,0,0,0
10403459,1,0,1,0,1,1,0,0,0
10403738,1,1,0,0,1,1,0,0,0
10403740,1,0,1,0,1,1,0,0,0
10404126,2,2,0,0,2,1,1,2,0
10404173,1,1,0,0,1,1,0,0,0
10404406,4,4,0,0,3,2,1,0,1
10404450,2,1,1,0,1,1,0,0,0
10404470,1,1,0,0,1,1,0,0,0
10404723,2,2,0,0,1,1,0,0,0
10404791,2,2,0,0,1,1,0,1,0
10404837,5,5,0,0,3,3,0,0,1
10404909,2,1,1,0,2,2,0,0,0
10404934,1,0,1,0,1,1,0,0,1
10405281,1,1,0,0,1,1,0,0,0
10405734,3,3,0,0,3,2,1,0,0
10405958,3,3,0,0,3,3,0,0,0
10406475,2,1,1,0,2,2,0,0,0
10406610,2,2,0,0,1,1,0,0,0
10407536,1,1,0,0,1,1,0,0,0
10407847,1,1,0,0,1,1,0,0,0
10407894,3,3,0,0,1,1,0,1,0
10407939,2,2,0,0,2,2,0,0,0
10408029,7,3,4,0,0,0,0,0,1
10408040,9,2,7,0,0,0,0,0,1
10408228,2,2,0,0,3,1,2,0,0
10408330,7,5,2,0,2,2,0,0,1
10408465,2,1,1,0,2,1,1,0,0
10408741,3,2,1,0,1,1,0,0,1
10409059,2,2,0,0,1,1,0,0,1
10409075,2,1,1,0,2,2,0,0,0
10409124,17,11,6,0,0,0,0,0,0
10409465,3,2,1,0,1,1,0,0,1
10409890,1,0,1,0,1,1,0,0,1
10409931,1,0,1,0,1,1,0,0,1
10409944,2,2,0,0,1,1,0,0,0
10410631,4,2,2,0,0,0,0,0,0
10410830,10,6,4,0,6,0,6,0,1
10410862,6,4,2,0,1,1,0,1,1
10411011,1,1,0,0,2,2,0,0,0
10411603,2,0,2,0,2,2,0,0,0
10411738,2,0,2,0,2,2,0,0,0
10411893,1,1,0,0,1,1,0,0,0
10412204,4,3,1,0,3,3,0,0,0
10412378,1,1,0,0,2,2,0,0,0
10412837,4,3,1,0,1,1,0,0,1
10413202,4,4,0,0,2,1,1,1,1
10413366,2,2,0,0,2,2,0,0,0
10413452,1,1,0,0,1,1,0,0,0
10414057,16,10,6,0,2,1,1,1,1
10414774,1,1,0,0,1,1,0,0,0
10415213,3,3,0,0,2,2,0,0,0
10415235,9,6,3,0,1,0,1,0,1
10415744,3,3,0,0,1,1,0,0,1
10415832,4,3,1,0,3,2,1,0,1
10415987,1,1,0,0,2,1,1,0,0
10416453,1,0,1,0,1,1,0,0,0
10416545,5,4,1,0,1,1,0,1,0
10416959,1,1,0,0,1,1,0,0,0
10417843,2,1,1,0,4,3,1,0,0
10417864,1,1,0,0,1,1,0,0,0
10418221,2,2,0,0,2,2,0,0,0
10418477,3,0,3,0,3,3,0,0,1
10418682,5,4,1,0,1,1,0,1,0
10419128,1,1,0,0,1,1,0,0,0
10419202,4,3,1,0,2,2,0,0,0
10419287,1,1,0,0,1,1,0,0,0
10419563,3,2,1,0,1,1,0,0,0
10420116,1,0,1,0,0,0,0,0,0
10420147,1,0,1,0,1,1,0,0,0
10420197,3,3,0,0,2,2,0,0,0
10420361,11,10,1,0,2,1,1,1,1
10421306,4,4,0,0,4,3,1,0,1
10421504,2,0,2,0,2,2,0,0,0
10421842,2,1,1,0,2,1,1,0,0
10421968,2,2,0,0,2,2,0,0,0
10422931,2,2,0,0,2,1,1,2,0
10422932,4,2,2,0,1,1,0,0,0
10423117,3,3,0,0,2,1,1,2,0
10423159,3,3,0,0,2,1,1,2,0
10423217,2,2,0,0,2,2,0,0,1
10423228,2,2,0,0,2,2,0,0,0
10423285,3,3,0,0,2,2,0,0,1
10423580,1,1,0,0,1,1,0,0,0
10423717,7,2,5,0,3,1,2,3,1
10423729,1,0,1,0,1,1,0,0,0
10423899,1,1,0,0,1,1,0,0,0
10424185,2,1,1,0,0,0,0,0,0
10424487,3,2,1,0,3,1,2,0,0
10424529,6,6,0,0,2,2,0,0,0
10424658,4,3,1,0,1,1,0,1,0
10424923,1,1,0,0,1,1,0,0,0
10425092,2,2,0,0,1,1,0,0,1
10425616,1,1,0,0,0,0,0,0,0
10425622,1,1,0,0,1,1,0,0,0
10425760,7,3,4,0,2,1,1,1,0
10425928,3,0,3,0,3,3,0,0,0
10426289,2,0,2,0,2,2,0,0,0
10426416,3,3,0,0,1,1,0,0,0
10427188,2,2,0,0,1,1,0,0,0
10427739,2,2,0,0,1,1,0,0,1
10427836,4,0,4,0,0,0,0,0,1
10427838,4,2,2,0,0,0,0,0,1
10428538,2,2,0,0,1,1,0,0,0
10428544,1,1,0,0,1,1,0,0,0
10428804,1,1,0,0,2,2,0,0,0
10429500,5,3,2,0,2,1,1,2,0
10429756,1,0,1,0,1,1,0,0,0
10429922,8,8,0,0,0,0,0,0,0
10429970,4,4,0,0,2,1,1,1,1
10430326,12,6,6,0,1,1,0,1,1
10430403,4,4,0,0,1,0,1,0,1
10430672,5,5,0,0,1,0,1,0,1
10431073,7,5,2,0,2,1,1,2,1
10431195,4,4,0,3,0,0,0,0,1
10431198,1,0,1,0,1,1,0,0,0
10431402,2,2,0,0,1,1,0,1,1
10431771,3,2,1,0,3,2,1,0,0
10432132,5,5,0,0,3,3,0,0,1
10432312,8,6,2,0,1,1,0,1,1
10432372,2,0,2,0,1,1,0,0,0
10432469,3,3,0,0,2,2,0,0,0
10433264,1,1,0,0,1,1,0,0,0
10433923,4,1,3,0,1,1,0,1,1
10434302,2,2,0,0,1,1,0,0,1
10434874,1,1,0,0,1,1,0,0,0
10434877,1,1,0,0,1,1,0,0,0
10434898,6,5,1,2,4,2,2,1,0
10434959,1,1,0,0,1,1,0,0,0
10435089,2,1,1,0,1,1,0,0,0
10435180,1,1,0,0,1,1,0,0,0
10435696,4,3,1,0,6,3,3,4,0
10435992,4,0,4,0,2,1,1,2,1
10436062,4,3,1,0,2,1,1,2,1
10436276,4,3,1,0,1,1,0,1,1
10436281,4,3,1,0,1,1,0,1,1
10436402,5,4,1,0,0,0,0,0,0
10436532,5,0,5,0,1,1,0,1,1
10436807,2,2,0,0,2,2,0,0,0
10436969,11,9,2,2,3,1,2,1,0
10437032,4,4,0,0,4,4,0,0,0
10437134,1,1,0,0,1,1,0,0,0
10437663,3,2,1,0,2,1,1,0,0
10437777,1,0,1,0,1,1,0,0,0
10437910,3,2,1,0,3,3,0,1,1
10437948,1,1,0,0,1,1,0,0,0
10438048,7,2,5,0,4,2,2,0,0
10438262,3,3,0,0,1,1,0,0,0
10438515,2,1,1,0,1,1,0,0,1
10438955,2,2,0,0,2,2,0,0,0
10439295,31,3,28,0,2,1,1,2,1
10439400,3,3,0,0,2,2,0,0,0
10439558,1,0,1,0,1,1,0,0,0
10440123,7,7,0,0,2,0,2,0,1
10440161,2,1,1,0,2,1,1,0,0
10440591,0,0,0,0,1,1,0,1,0
10441144,1,0,1,0,1,1,0,1,0
10441605,3,3,0,0,1,1,0,0,1
10441781,4,2,2,0,4,2,2,0,1
10442521,5,4,1,0,1,1,0,0,0
10443519,13,10,3,0,0,0,0,0,0
10444182,5,3,2,0,2,2,0,0,1
10444318,1,1,0,0,1,1,0,0,0
10444445,4,2,2,0,1,1,0,0,1
10445236,5,4,1,0,1,1,0,1,1
10445388,1,1,0,0,1,1,0,0,0
10445473,3,3,0,0,3,2,1,0,1
10445772,1,1,0,0,0,0,0,0,0
10445960,8,3,5,0,0,0,0,0,1
10446314,1,1,0,0,1,1,0,0,0
10446331,1,1,0,0,1,1,0,0,0
10446567,10,6,4,0,1,1,0,1,1
10447040,1,0,1,0,1,1,0,0,0
10447659,1,1,0,0,1,1,0,0,0
10447667,1,0,1,0,1,1,0,0,0
10447832,5,3,2,0,0,0,0,0,1
10448035,2,2,0,0,2,2,0,0,0
10449246,1,0,1,0,1,1,0,0,0
10449530,6,4,2,0,1,0,1,1,1
10449587,6,5,1,0,1,1,0,1,0
10449797,1,1,0,0,1,1,0,0,0
10449822,1,1,0,0,1,1,0,0,0
10449924,1,1,0,0,1,1,0,0,0
00480080,35,5,30,0,1,1,0,1,1
00480252,32,9,23,0,1,1,0,1,1
00480356,26,3,23,0,0,0,0,0,1
00480410,14,7,7,0,0,0,0,0,1
00480523,89,17,72,0,0,0,0,0,1
00480560,31,5,26,0,1,1,0,1,1
00480578,10,4,6,0,1,1,0,0,1
00480825,17,0,17,0,0,0,0,0,1
00480920,60,7,53,0,5,3,2,0,1
00480992,36,2,34,0,1,1,0,1,1
00481406,34,6,28,0,2,2,0,1,1
00481574,26,3,23,0,1,1,0,1,1
00481677,49,0,49,0,0,0,0,0,1
00482023,22,3,19,0,1,1,0,0,1
00482184,94,6,88,0,0,0,0,0,0
00482552,21,2,19,0,1,1,0,1,1
00483123,64,17,47,0,0,0,0,0,1
00483214,12,4,8,0,3,3,0,0,1
00483257,26,7,19,0,1,1,0,1,1
00483480,32,10,22,0,0,0,0,0,1
00483573,62,9,53,0,6,3,3,0,1
00483832,7,4,3,0,3,3,0,1,0
00484244,23,5,18,0,4,3,1,0,1
00484420,44,13,31,0,0,0,0,0,0
00484523,51,9,42,0,1,1,0,1,0
00484577,16,5,11,0,1,1,0,0,1
00484650,6,0,6,0,0,0,0,0,1
00485525,17,0,17,0,0,0,0,0,1
00485700,61,7,54,0,1,1,0,1,1
00486189,3,2,1,0,0,0,0,0,0
00486282,61,15,46,0,0,0,0,0,1
00486398,19,3,16,0,1,1,0,1,1
00486505,3,1,2,0,1,1,0,0,0
00487036,20,4,16,1,1,1,0,0,1
00487049,65,31,34,0,0,0,0,0,1
00487560,0,0,0,0,0,0,0,0,0
00487648,8,2,6,0,2,2,0,0,0
00488016,38,3,35,0,1,1,0,1,1
00488067,49,5,44,0,1,1,0,1,1
00488572,11,5,6,0,1,1,0,0,1
00489136,34,6,28,0,0,0,0,0,0
00489232,31,5,26,0,1,1,0,1,1
00489266,65,0,65,0,1,1,0,0,1
00489295,12,3,9,0,1,1,0,1,1
00489604,48,14,34,0,1,1,0,1,1
00489657,39,6,33,0,1,1,0,1,1
00489775,115,12,103,0,1,1,0,1,1
00489887,25,3,22,0,1,1,0,1,1
00490212,40,4,36,0,0,0,0,0,1
00490893,30,0,30,0,0,0,0,0,1
00490897,41,2,39,0,2,1,1,2,1
00491058,6,5,1,0,4,4,0,0,1
00491364,89,12,77,0,0,0,0,0,1
00491577,0,0,0,0,0,0,0,0,0
00491580,26,5,21,0,1,1,0,1,1
00491895,27,7,20,0,0,0,0,0,0
00491942,6,3,3,0,3,2,1,0,0
00492334,43,4,39,0,1,1,0,0,1
00492466,55,3,52,0,2,2,0,2,1
00492627,18,3,15,0,1,1,0,1,1
00492761,70,10,60,0,1,0,1,0,1
00493091,7,0,7,0,0,0,0,0,1
00493147,47,4,43,0,2,1,1,2,1
00493282,23,0,23,0,0,0,0,0,1
00493510,39,3,36,0,0,0,0,0,1
00493531,17,6,11,0,2,2,0,1,0
00493724,85,8,77,0,0,0,0,0,1
00493764,113,16,97,0,0,0,0,0,1
00494708,21,5,16,0,1,1,0,1,1
00495464,6,5,1,0,0,0,0,0,1
00495856,13,4,9,0,2,1,1,2,1
00495946,31,4,27,0,2,1,1,2,1
00496062,14,4,10,0,1,1,0,1,1
00496821,57,7,50,0,0,0,0,0,1
00497098,37,3,34,0,1,1,0,1,1
00497131,25,6,19,0,3,3,0,3,1
00497391,23,4,19,0,1,1,0,1,1
00497421,68,10,58,0,1,1,0,1,1
00497624,20,2,18,0,0,0,0,0,0
00497630,130,17,113,0,2,1,1,0,1
00497733,43,8,35,0,0,0,0,0,1
00498042,26,0,26,0,0,0,0,0,1
00498205,7,2,5,0,2,2,0,2,1
00498313,18,3,15,0,1,1,0,1,1
00498554,29,7,22,0,2,2,0,0,0
00498605,41,3,38,0,1,1,0,1,1
00498629,26,0,26,0,0,0,0,0,1
00498760,15,5,10,0,0,0,0,0,0
00498796,20,1,19,0,0,0,0,0,0
00499064,22,4,18,0,1,1,0,1,1
00499150,48,3,45,0,3,2,1,3,1
00499299,16,5,11,0,1,1,0,1,1
00499423,32,3,29,0,1,1,0,1,1
00499508,8,2,6,0,1,1,0,0,0
00499593,39,8,31,0,1,1,0,1,1
00499594,36,6,30,0,1,1,0,1,1
00499779,22,3,19,0,1,1,0,1,1
00499821,44,4,40,0,1,1,0,0,1
00499854,79,9,70,0,0,0,0,0,1
00499930,12,0,12,0,0,0,0,0,1
00499991,25,0,25,0,0,0,0,0,1
00500602,5,3,2,0,2,2,0,0,0
00500614,5,3,2,0,1,1,0,0,1
00500829,29,9,20,0,1,1,0,0,1
00500979,164,25,139,0,0,0,0,0,1
00501054,37,0,37,0,1,1,0,1,1
00501675,45,7,38,0,1,1,0,0,1
00501983,24,3,21,0,2,1,1,2,1
00501986,8,0,8,0,1,1,0,0,1
00502370,33,3,30,0,1,1,0,0,1
00502669,20,5,15,0,1,1,0,1,1
00502692,97,10,87,0,0,0,0,0,1
00502851,30,10,20,0,0,0,0,0,1
00503137,26,5,21,0,0,0,0,0,1
00503636,29,4,25,0,1,1,0,1,1
00503652,33,4,29,0,1,1,0,1,1
00503657,20,3,17,0,1,1,0,1,1
00503870,147,12,135,0,0,0,0,0,1
00504226,16,10,6,0,3,3,0,1,1
00504655,15,3,12,0,1,1,0,1,1
00504858,65,11,54,0,0,0,0,0,1
00504877,77,6,71,0,1,1,0,1,1
00505455,9,5,4,0,2,2,0,0,1
00505456,103,15,88,0,0,0,0,0,1
00505497,70,9,61,1,3,2,1,1,1
00505769,48,7,41,0,1,1,0,1,1
00506057,37,5,32,0,1,1,0,1,1
00506349,24,4,20,0,1,1,0,1,1
00506441,6,3,3,0,3,2,1,0,0
00506559,28,6,22,0,0,0,0,0,1
00506666,38,8,30,0,2,2,0,2,1
00506672,30,9,21,0,0,0,0,0,1
00506827,20,0,20,0,0,0,0,0,1
00507331,7,3,4,0,3,2,1,0,1
00507461,17,5,12,0,1,1,0,0,1
00507597,100,13,87,0,0,0,0,0,1
00507652,76,7,69,0,1,1,0,1,1
00507787,29,0,29,0,0,0,0,0,1
00508200,25,0,25,0,0,0,0,0,1
00508383,21,3,18,0,1,1,0,1,1
00508614,4,2,2,0,1,1,0,0,1
00508616,105,15,90,0,0,0,0,0,1
00508859,17,5,12,0,1,1,0,1,1
00509151,12,0,12,0,0,0,0,0,1
00509263,25,3,22,0,1,1,0,1,1
00509305,27,6,21,0,0,0,0,0,0
00509427,59,12,47,0,0,0,0,0,1
00509508,6,4,2,0,3,2,1,0,1
00509811,110,16,94,0,0,0,0,0,1
00510043,4,3,1,0,1,1,0,0,1
00510503,49,3,46,0,1,0,1,1,1
00510586,22,3,19,0,0,0,0,0,1
00510607,60,4,56,0,1,1,0,1,1
00510618,141,14,127,0,0,0,0,0,1
00511153,86,10,76,0,0,0,0,0,0
00511581,7,2,5,0,1,1,0,0,1
00511634,11,4,7,0,0,0,0,0,1
00511709,75,10,65,0,3,3,0,3,1
00511804,41,3,38,0,1,1,0,1,1
00511844,22,0,22,0,0,0,0,0,1
00512170,40,0,40,0,0,0,0,0,1
00512415,6,4,2,0,0,0,0,0,1
00512570,7,5,2,0,0,0,0,0,0
00513001,25,2,23,0,1,1,0,1,1
00513178,17,0,17,0,0,0,0,0,1
00513286,10,3,7,0,2,2,0,1,1
00513627,40,11,29,0,0,0,0,0,0
00513843,14,4,10,0,1,1,0,0,1
00513910,22,3,19,0,1,1,0,1,0
00513974,14,3,11,0,1,1,0,1,1
00514002,26,3,23,0,1,1,0,1,1
00514077,32,3,29,0,1,1,0,1,1
00514493,19,3,16,0,0,0,0,0,1
00514735,72,19,53,0,0,0,0,0,1
00515174,82,13,69,0,0,0,0,0,1
00515177,45,9,36,0,1,0,1,0,1
00515297,94,16,78,0,0,0,0,0,1
00515526,54,11,43,0,0,0,0,0,1
00515539,62,3,59,0,1,0,1,0,0
00515680,15,0,15,0,0,0,0,0,1
00515707,22,0,22,0,0,0,0,0,1
00515785,25,0,25,0,0,0,0,0,1
00516203,22,0,22,0,0,0,0,0,1
00516266,0,0,0,0,0,0,0,0,1
00516434,38,13,25,0,0,0,0,0,1
00516901,31,4,27,0,1,1,0,1,1
00517253,21,3,18,0,0,0,0,0,1
00517306,9,5,4,0,0,0,0,0,1
00517461,40,5,35,0,1,1,0,1,1
00517550,16,5,11,0,1,1,0,1,1
00517625,77,6,71,0,1,1,0,1,1
00517895,97,4,93,0,1,1,0,1,1
00518031,32,3,29,0,1,1,0,1,1
00518209,75,13,62,0,6,2,4,0,1
00518386,21,3,18,0,1,1,0,1,1
00518466,5,2,3,0,3,3,0,0,0
00518544,5,0,5,0,0,0,0,0,1
00518571,33,11,22,0,0,0,0,0,1
00518573,50,2,48,0,2,1,1,2,0
00518602,49,3,46,0,1,1,0,1,1
00518714,12,3,9,0,1,1,0,1,1
00518895,5,4,1,0,0,0,0,0,0
00519037,20,4,16,0,1,1,0,1,1
00519057,35,8,27,0,0,0,0,0,1
00519212,58,9,49,0,3,2,1,0,1
00519228,120,9,111,0,1,0,1,0,1
00519230,158,7,151,0,0,0,0,0,1
00519615,72,13,59,0,0,0,0,0,1
00520095,43,4,39,0,1,1,0,1,1
00520164,19,2,17,0,1,1,0,1,1
00520241,46,10,36,0,0,0,0,0,1
00520605,11,3,8,0,1,1,0,1,0
00520618,5,3,2,0,2,2,0,0,1
00520619,5,2,3,0,1,1,0,1,1
00520866,102,9,93,0,0,0,0,0,1
00521214,44,2,42,0,1,1,0,1,1
00521228,9,4,5,0,2,2,0,0,1
00521244,31,3,28,0,0,0,0,0,1
00521505,21,2,19,0,0,0,0,0,1
00521970,40,7,33,0,0,0,0,0,1
00522049,24,8,16,0,0,0,0,0,1
00522212,35,3,32,0,1,1,0,1,1
00522385,69,23,46,0,0,0,0,0,1
00522418,6,1,5,0,2,2,0,0,0
00522511,38,3,35,0,1,1,0,1,1
00522538,20,3,17,0,1,1,0,1,1
00522846,45,11,34,0,0,0,0,0,1
00523132,9,4,5,0,4,3,1,0,1
00523804,27,2,25,0,1,1,0,1,1
00523954,3,2,1,0,1,1,0,0,1
00524238,31,11,20,0,0,0,0,0,0
00524284,35,4,31,0,1,1,0,1,1
00524331,56,19,37,0,0,0,0,0,1
00524446,16,5,11,0,1,1,0,1,1
00524469,39,5,34,0,1,1,0,1,1
00524845,104,9,95,0,1,1,0,1,1
00525037,56,7,49,0,1,1,0,1,1
00525186,26,5,21,0,1,1,0,1,1
00525192,41,4,37,0,1,1,0,1,1
00525206,26,5,21,0,2,2,0,2,1
00525721,6,2,4,0,2,2,0,0,0
00525927,47,6,41,0,0,0,0,0,1
00526285,19,0,19,0,0,0,0,0,1
00526711,50,9,41,0,0,0,0,0,0
00526808,6,3,3,0,1,1,0,0,0
00526936,10,0,10,0,0,0,0,0,1
00527041,16,8,8,0,1,0,1,1,1
00527070,81,9,72,0,0,0,0,0,1
00527227,93,19,74,0,0,0,0,0,1
00527483,32,0,32,0,0,0,0,0,1
00527571,143,12,131,0,0,0,0,0,1
00527593,47,5,42,0,1,1,0,1,0
00527643,6,3,3,0,1,1,0,0,0
00527656,12,1,11,0,0,0,0,0,1
00527845,18,0,18,0,0,0,0,0,1
00527864,30,3,27,0,2,2,0,2,0
00529000,20,2,18,1,3,1,2,1,1
00529321,142,6,136,0,0,0,0,0,1
00529362,26,3,23,0,2,1,1,1,1
00530051,43,5,38,0,1,1,0,1,1
00530526,31,3,28,0,1,1,0,1,1
00531142,29,0,29,0,0,0,0,0,1
00531160,7,4,3,0,1,1,0,0,0
00531204,60,6,54,0,0,0,0,0,1
00531634,6,3,3,0,0,0,0,0,0
00532006,45,7,38,0,1,1,0,1,1
00532020,9,5,4,0,3,3,0,0,1
00532081,206,3,203,0,1,1,0,1,1
00532103,13,8,5,0,1,1,0,0,1
00532474,58,8,50,0,0,0,0,0,1
00532610,0,0,0,0,0,0,0,0,0
00532701,22,4,18,0,1,1,0,1,1
00532865,27,4,23,0,3,1,2,3,1
00533082,14,6,8,0,1,1,0,0,1
00533087,62,5,57,0,1,1,0,1,1
00533114,14,3,11,0,1,1,0,1,1
00533163,31,4,27,0,1,1,0,1,0
00533243,28,2,26,0,1,1,0,1,1
00533432,46,2,44,0,1,1,0,1,1
00533707,18,5,13,0,1,1,0,1,1
00533731,9,3,6,0,1,1,0,1,1
00533778,10,2,8,0,2,2,0,0,0
00534048,118,13,105,0,0,0,0,0,1
00534118,32,7,25,0,2,1,1,2,1
00534133,10,5,5,0,4,4,0,0,0
00534147,141,17,124,0,0,0,0,0,1
00534232,18,5,13,0,1,1,0,1,1
00534332,37,2,35,0,1,1,0,1,1
00535148,43,3,40,0,1,1,0,1,1
00535426,3,3,0,0,0,0,0,0,0
00535429,10,4,6,0,1,1,0,0,0
00535519,6,2,4,0,1,1,0,0,0
00535683,203,7,196,0,0,0,0,0,1
00535759,49,5,44,0,0,0,0,0,1
00535901,45,3,42,0,1,1,0,1,1
00535960,26,6,20,0,1,1,0,1,1
00536115,6,4,2,0,1,1,0,0,1
00536224,11,4,7,0,1,1,0,1,1
00536321,53,12,41,0,12,9,3,0,1
00536464,16,5,11,0,1,1,0,1,1
00536549,9,2,7,0,1,1,0,0,0
00536564,4,2,2,0,1,1,0,0,0
00536787,22,0,22,0,0,0,0,0,1
00537204,62,4,58,0,1,1,0,1,1
00537405,54,3,51,0,1,1,0,1,1
00537430,36,5,31,0,1,1,0,1,1
00537728,29,3,26,0,1,1,0,1,1
00538179,16,6,10,0,0,0,0,0,1
00538351,54,9,45,0,0,0,0,0,1
00538415,46,3,43,0,1,1,0,1,1
00538702,6,3,3,0,1,1,0,1,1
00538883,21,0,21,0,1,1,0,1,1
00539175,23,2,21,0,1,1,0,1,1
00539193,118,15,103,0,0,0,0,0,1
00539332,57,12,45,0,0,0,0,0,1
00539865,8,5,3,0,2,2,0,0,1
00539946,5,3,2,0,1,1,0,0,1
00540013,19,4,15,0,1,1,0,1,1
00540073,5,4,1,0,1,1,0,1,1
00540403,50,3,47,0,2,1,1,2,1
00541047,25,4,21,0,1,1,0,1,1
00541295,54,4,50,0,1,1,0,1,1
00541982,5,2,3,0,1,1,0,0,1
00542021,29,3,26,0,1,1,0,1,1
00542022,27,2,25,0,1,1,0,1,1
00542023,27,2,25,0,1,1,0,1,1
00542087,21,4,17,0,2,2,0,2,1
00542449,55,12,43,0,0,0,0,0,0
00542456,20,3,17,0,2,1,1,2,1
00542599,45,0,45,0,0,0,0,0,1
00542693,0,0,0,0,0,0,0,0,0
00542762,18,5,13,0,0,0,0,0,0
00542895,15,4,11,0,0,0,0,0,1
00543180,28,3,25,0,1,1,0,1,1
00543498,15,0,15,0,1,1,0,1,1
00543504,30,2,28,0,1,1,0,1,1
00543548,18,3,15,0,1,1,0,1,1
00543610,35,5,30,0,0,0,0,0,1
00543757,24,5,19,0,1,1,0,1,1
00543821,38,8,30,0,1,1,0,1,1
00543848,3,0,3,0,0,0,0,0,0
00543894,60,10,50,0,0,0,0,0,1
00544113,7,3,4,0,0,0,0,0,1
00544168,22,3,19,0,1,1,0,1,1
00544405,73,12,61,0,0,0,0,0,0
00544525,12,7,5,0,0,0,0,0,1
00544603,2,2,0,0,0,0,0,0,0
00544627,7,3,4,0,1,1,0,0,1
00544683,40,4,36,0,1,1,0,1,1
00545217,66,7,59,0,1,1,0,1,1
00545333,15,7,8,0,1,1,0,1,0
00546037,15,0,15,0,0,0,0,0,1
00546500,9,6,3,0,1,1,0,0,1
00546693,26,2,24,0,1,1,0,1,1
00547018,77,20,57,0,0,0,0,0,1
00547526,24,3,21,0,1,1,0,1,1
00547529,10,3,7,0,1,1,0,1,0
00547640,38,5,33,0,1,1,0,1,1
00547893,38,9,29,0,2,1,1,1,1
00548427,35,3,32,0,2,2,0,2,1
00548648,66,8,58,0,1,1,0,1,1
00548666,3,3,0,0,2,2,0,0,0
00548902,42,0,42,0,0,0,0,0,1
00549034,35,9,26,0,0,0,0,0,1
00549089,98,11,87,0,0,0,0,0,1
00549181,24,5,19,0,1,1,0,1,1
00549377,18,0,18,0,1,1,0,1,1
00549492,26,0,26,0,0,0,0,0,0
00549613,23,4,19,0,2,1,1,2,1
00549690,32,11,21,0,1,1,0,1,1
00549762,37,6,31,0,2,2,0,2,1
00549872,12,4,8,0,2,2,0,1,1
00549944,3,2,1,0,1,1,0,0,0
03839106,11,2,9,0,1,1,0,1,1
03839211,14,3,11,0,1,1,0,1,1
03839319,10,2,8,0,1,1,0,0,1
03839469,34,3,31,0,1,1,0,1,1
03839967,7,2,5,0,1,1,0,1,0
03840005,5,3,2,0,2,2,0,0,1
03840545,9,4,5,0,1,1,0,0,0
03840560,9,4,5,0,2,2,0,0,1
03840597,23,4,19,0,1,1,0,1,1
03840627,24,3,21,0,1,1,0,1,1
03840721,17,5,12,0,0,0,0,0,1
03840736,32,0,32,0,0,0,0,0,0
03840814,6,4,2,0,2,2,0,0,0
03840993,21,3,18,0,0,0,0,0,1
03841309,18,0,18,0,0,0,0,0,1
03841479,22,5,17,0,1,1,0,0,1
03841539,63,22,41,0,2,2,0,0,1
03841761,12,0,12,0,0,0,0,0,1
03841790,11,0,11,0,1,1,0,1,1
03841798,11,0,11,0,1,1,0,1,1
03841801,27,0,27,0,0,0,0,0,1
03841805,11,0,11,0,1,1,0,1,1
03841811,11,0,11,0,1,1,0,1,1
03841815,12,0,12,0,1,1,0,1,1
03841821,31,9,22,0,1,1,0,1,1
03841832,11,0,11,0,1,1,0,1,1
03841835,11,0,11,0,1,1,0,1,1
03841905,8,0,8,0,0,0,0,0,1
03841918,33,6,27,0,1,1,0,1,1
03841924,11,0,11,0,1,1,0,1,1
03842282,18,0,18,0,0,0,0,0,1
03842589,69,0,69,0,0,0,0,0,1
03842603,17,5,12,0,3,2,1,3,1
03842635,4,2,2,0,2,2,0,0,1
03842686,10,3,7,0,0,0,0,0,1
03843123,26,4,22,0,1,1,0,1,0
03843128,28,4,24,0,0,0,0,0,0
03843206,9,0,9,0,0,0,0,0,1
03843233,24,0,24,0,0,0,0,0,1
03843290,10,4,6,0,1,1,0,1,1
03843291,7,2,5,0,1,1,0,0,1
03843465,14,2,12,0,1,1,0,1,1
03844041,14,4,10,0,1,1,0,1,1
03844250,7,3,4,0,1,1,0,1,1
03844271,15,5,10,0,1,1,0,1,0
03844459,15,6,9,0,3,1,2,1,1
03844501,14,4,10,0,1,1,0,1,1
03844507,13,4,9,0,1,1,0,1,1
03844511,16,3,13,0,0,0,0,0,1
03844721,22,4,18,0,3,3,0,3,1
03844767,6,0,6,0,0,0,0,0,0
03844803,6,2,4,0,1,1,0,0,1
03844815,4,0,4,0,0,0,0,0,1
03844914,28,3,25,0,1,1,0,1,1
03844929,69,8,61,0,0,0,0,0,0
03845004,12,3,9,0,3,3,0,2,1
03845066,6,3,3,0,1,1,0,0,1
03845074,7,3,4,0,1,1,0,0,0
03845432,19,7,12,0,2,1,1,1,1
03845467,18,7,11,0,2,1,1,1,1
03845473,23,7,16,0,0,0,0,0,1
03845688,6,0,6,0,0,0,0,0,1
03846007,7,2,5,0,1,1,0,1,1
03846076,14,2,12,0,1,1,0,0,1
03846263,14,3,11,0,1,1,0,0,1
03846299,9,6,3,0,3,3,0,0,1
03846372,27,9,18,0,0,0,0,0,0
03846486,14,3,11,0,1,1,0,1,1
03846492,11,4,7,0,2,1,1,0,1
03846791,30,5,25,0,1,1,0,1,1
03846895,6,2,4,0,1,1,0,0,1
03847224,8,3,5,0,2,2,0,0,1
03847425,4,0,4,0,1,1,0,0,1
03847570,9,0,9,0,1,1,0,1,1
03847584,14,4,10,0,1,1,0,0,1
03847616,25,4,21,0,1,1,0,1,1
03847708,18,2,16,0,1,1,0,1,1
03847917,17,0,17,0,0,0,0,0,1
03847921,43,3,40,0,1,1,0,1,1
03847935,6,1,5,0,1,1,0,0,0
03847949,4,2,2,0,1,1,0,0,1
03847974,23,2,21,0,1,1,0,1,1
03848002,21,4,17,0,1,1,0,1,1
03848334,29,8,21,0,0,0,0,0,0
03848577,14,0,14,0,0,0,0,0,1
03848595,3,3,0,0,1,1,0,0,0
03848732,10,0,10,0,0,0,0,0,1
03848775,6,0,6,0,0,0,0,0,1
03848915,5,1,4,0,1,1,0,0,1
03849103,13,4,9,0,0,0,0,0,1
03849124,6,0,6,0,1,1,0,0,1
03849147,12,0,12,0,0,0,0,0,1
03849149,15,0,15,0,1,1,0,1,1
03849198,39,6,33,0,1,1,0,1,1
03849270,17,0,17,0,0,0,0,0,1
03849276,15,7,8,0,1,1,0,0,0
03849362,17,0,17,0,0,0,0,0,1
03849601,20,6,14,0,1,1,0,1,1
03849878,12,3,9,0,2,2,0,0,1
03849958,33,11,22,0,0,0,0,0,1
03850052,7,2,5,0,1,1,0,0,1
03850154,15,7,8,0,2,0,2,0,1
03850542,27,3,24,0,1,1,0,1,1
03851221,13,5,8,0,0,0,0,0,0
03851251,14,0,14,0,1,1,0,1,1
03851464,7,4,3,0,1,1,0,1,1
03851466,6,1,5,0,1,1,0,1,1
03851629,3,2,1,0,1,1,0,0,1
03851797,13,0,13,0,1,1,0,1,1
03851830,17,5,12,0,1,1,0,1,1
03851841,26,4,22,0,0,0,0,0,1
03851902,10,3,7,0,1,1,0,0,1
03851932,6,2,4,0,1,1,0,0,1
03852147,8,0,8,0,0,0,0,0,1
03852217,26,5,21,0,1,1,0,1,1
03852234,12,0,12,0,0,0,0,0,1
03852243,16,5,11,0,1,1,0,1,1
03852249,40,7,33,0,1,0,1,0,0
03852250,11,0,11,0,1,1,0,1,1
03852298,11,0,11,0,0,0,0,0,1
03852299,26,0,26,0,0,0,0,0,1
03852415,4,2,2,0,2,2,0,0,0
03852457,12,3,9,0,1,1,0,1,1
03852764,9,0,9,0,2,1,1,0,1
03852899,23,3,20,0,1,1,0,1,1
03852923,6,4,2,0,1,1,0,1,1
03853176,26,4,22,0,0,0,0,0,1
03853236,38,0,38,0,0,0,0,0,1
03853246,6,3,3,0,0,0,0,0,1
03853399,12,0,12,0,0,0,0,0,1
03853521,5,0,5,0,0,0,0,0,1
03853532,16,0,16,0,1,1,0,1,1
03853535,7,0,7,0,0,0,0,0,1
03853545,37,9,28,0,0,0,0,0,1
03853602,19,2,17,0,2,2,0,0,1
03853716,33,12,21,0,0,0,0,0,1
03853848,21,6,15,0,1,1,0,1,1
03853942,97,0,97,0,0,0,0,0,1
03853947,43,16,27,0,2,1,1,2,1
03854092,19,0,19,0,1,1,0,1,1
03854275,25,4,21,0,2,1,1,2,1
03854387,7,2,5,0,2,2,0,0,1
03854447,5,2,3,0,1,1,0,0,1
03854469,4,0,4,0,0,0,0,0,0
03854581,21,0,21,0,0,0,0,0,1
03854695,6,3,3,0,1,1,0,0,1
03854826,14,4,10,0,1,1,0,1,1
03854855,19,0,19,0,0,0,0,0,1
03855072,5,3,2,0,2,2,0,0,0
03855642,9,2,7,0,0,0,0,0,0
03855693,49,25,24,0,1,1,0,1,1
03855837,25,3,22,0,1,1,0,1,1
03855973,6,2,4,0,1,1,0,0,1
03856040,13,4,9,0,2,2,0,2,1
03856062,25,6,19,0,1,1,0,1,1
03856111,18,0,18,0,0,0,0,0,1
03856232,5,3,2,0,2,2,0,0,0
03856336,4,0,4,0,0,0,0,0,1
03856988,21,3,18,0,0,0,0,0,1
03857576,21,6,15,1,1,1,0,1,1
03857691,8,4,4,0,3,3,0,0,1
03857752,35,10,25,0,1,1,0,1,1
03857770,27,5,22,0,4,1,3,4,1
03857786,16,3,13,0,2,1,1,2,1
03857870,23,0,23,0,0,0,0,0,1
03857889,22,5,17,0,1,1,0,1,1
03857924,56,7,49,0,1,1,0,0,0
03857998,18,0,18,0,0,0,0,0,1
03858243,12,0,12,0,0,0,0,0,1
03858244,8,0,8,0,1,1,0,1,1
03858505,13,3,10,0,1,1,0,1,1
03858609,9,0,9,0,0,0,0,0,1
03858865,39,0,39,0,1,1,0,1,1
03858881,25,6,19,0,0,0,0,0,1
03859279,11,3,8,0,1,1,0,0,1
03859401,41,10,31,0,0,0,0,0,0
03859507,5,3,2,0,2,2,0,0,0
03859669,14,2,12,0,1,1,0,0,1
03859807,5,3,2,0,1,1,0,0,0
03860052,12,0,12,0,0,0,0,0,1
03860091,11,6,5,0,0,0,0,0,1
03860108,9,2,7,0,0,0,0,0,1
03860142,12,2,10,0,0,0,0,0,1
03860222,6,2,4,0,0,0,0,0,1
03860587,14,0,14,0,0,0,0,0,1
03860676,17,0,17,0,0,0,0,0,1
03860715,17,2,15,0,1,1,0,1,1
03860794,35,13,22,0,0,0,0,0,1
03861194,15,5,10,0,1,1,0,1,1
03861237,16,4,12,0,1,1,0,1,0
03861293,17,3,14,0,1,1,0,1,1
03861337,19,5,14,0,0,0,0,0,1
03861384,25,4,21,0,1,1,0,1,1
03861414,33,5,28,0,0,0,0,0,1
03861464,21,2,19,0,1,1,0,1,1
03861498,11,0,11,0,0,0,0,0,1
03861752,56,9,47,0,1,1,0,0,1
03861759,7,3,4,0,1,1,0,1,0
03861859,37,7,30,0,0,0,0,0,1
03862015,3,2,1,0,1,1,0,0,0
03862174,4,2,2,0,2,2,0,0,1
03862330,6,2,4,0,0,0,0,0,1
03862405,17,3,14,0,1,1,0,1,1
03862584,9,1,8,0,1,1,0,1,1
03862592,83,13,70,0,0,0,0,0,1
03862844,17,5,12,0,1,1,0,1,1
03863304,5,1,4,0,1,1,0,0,1
03863397,13,3,10,0,1,1,0,1,0
03863736,27,0,27,0,0,0,0,0,1
03863990,4,2,2,0,1,1,0,0,0
03864026,5,2,3,0,1,1,0,0,0
03864039,60,22,38,0,2,2,0,0,1
03864111,22,3,19,0,1,1,0,1,1
03864155,10,1,9,0,1,1,0,0,1
03864582,23,3,20,0,0,0,0,0,1
03864620,15,8,7,0,0,0,0,0,1
03865043,18,9,9,0,1,1,0,1,1
03865210,10,5,5,0,1,1,0,0,1
03865254,23,3,20,0,2,2,0,2,1
03865293,9,4,5,0,1,1,0,1,1
03865320,11,3,8,0,0,0,0,0,1
03865370,10,3,7,0,2,2,0,0,1
03865647,82,14,68,0,3,1,2,0,1
03865660,5,2,3,0,1,1,0,0,0
03865871,7,4,3,0,2,2,0,0,1
03865943,5,2,3,0,1,1,0,0,1
03866129,89,12,77,0,13,8,5,0,1
03866274,26,3,23,0,2,2,0,2,1
03866452,13,0,13,0,0,0,0,0,1
03866549,14,4,10,0,0,0,0,0,0
03866604,6,3,3,0,2,2,0,0,1
03866683,114,14,100,0,0,0,0,0,1
03866756,19,8,11,0,7,6,1,0,1
03866886,16,4,12,0,1,1,0,1,0
03866933,7,1,6,0,1,1,0,0,1
03867114,17,0,17,0,0,0,0,0,1
03867128,35,7,28,0,1,1,0,1,1
03867156,29,4,25,0,2,1,1,2,1
03867577,30,5,25,0,3,2,1,3,1
03868366,27,3,24,0,1,1,0,1,1
03868586,17,4,13,0,1,1,0,1,1
03868901,7,4,3,0,1,1,0,0,1
03869002,19,5,14,0,0,0,0,0,0
03869072,11,3,8,0,1,1,0,0,0
03869350,39,4,35,0,1,1,0,1,1
03869419,12,3,9,0,1,1,0,1,1
03869539,27,6,21,0,0,0,0,0,1
03869792,19,0,19,0,0,0,0,0,1
03869797,6,2,4,0,2,1,1,2,1
03870000,29,3,26,0,0,0,0,0,0
03870187,19,5,14,0,0,0,0,0,1
03870327,19,4,15,0,1,1,0,0,1
03870358,17,0,17,0,0,0,0,0,1
03870466,47,10,37,0,0,0,0,0,1
03870484,15,0,15,0,0,0,0,0,1
03870530,32,3,29,0,1,1,0,1,1
03870674,46,7,39,0,0,0,0,0,1
03870728,32,6,26,0,1,1,0,1,1
03870883,93,11,82,0,0,0,0,0,1
03870985,17,3,14,0,1,1,0,1,1
03871048,22,8,14,0,0,0,0,0,1
03871363,7,0,7,0,0,0,0,0,1
03871415,8,2,6,0,1,1,0,0,0
03871419,7,0,7,0,0,0,0,0,1
03871904,13,3,10,0,1,1,0,1,1
03871978,6,5,1,0,1,1,0,0,0
03872010,13,5,8,0,0,0,0,0,1
03872217,7,2,5,0,2,2,0,0,0
03872328,31,5,26,0,2,1,1,1,1
03872943,7,3,4,0,2,2,0,0,1
03873963,18,3,15,0,1,1,0,1,1
03874019,12,3,9,0,1,1,0,1,0
03874038,5,2,3,0,1,1,0,0,0
03874069,8,3,5,0,1,1,0,1,1
03874071,5,0,5,0,0,0,0,0,0
03874197,6,3,3,0,2,2,0,0,1
03874287,4,0,4,0,0,0,0,0,1
03874727,31,6,25,0,2,0,2,0,1
03874855,9,2,7,0,2,2,0,1,1
03874882,25,4,21,0,1,1,0,1,1
03874907,13,9,4,0,1,1,0,0,1
03875074,15,0,15,0,0,0,0,0,1
03875141,13,2,11,0,5,3,2,0,1
03875190,5,0,5,0,0,0,0,0,1
03875201,5,1,4,0,1,1,0,1,0
03875211,17,0,17,0,0,0,0,0,1
03875229,4,0,4,0,0,0,0,0,1
03875469,6,3,3,0,1,1,0,0,1
03875584,10,3,7,0,1,1,0,0,1
03875779,32,2,30,0,1,1,0,1,1
03875826,21,0,21,0,0,0,0,0,1
03875835,92,3,89,0,1,1,0,1,1
03876305,35,9,26,0,13,8,5,0,1
03876372,4,2,2,0,1,1,0,0,1
03876449,14,3,11,0,1,1,0,1,1
03876554,6,2,4,0,1,1,0,0,0
03876999,14,0,14,0,0,0,0,0,1
03877407,29,3,26,0,2,1,1,1,1
03877443,87,10,77,0,0,0,0,0,0
03877455,72,8,64,0,0,0,0,0,0
03877510,6,0,6,0,0,0,0,0,1
03877602,5,0,5,0,0,0,0,0,1
03877786,29,0,29,0,0,0,0,0,1
03877805,8,0,8,0,0,0,0,0,1
03877866,54,3,51,0,1,1,0,1,1
03877871,4,1,3,0,1,1,0,0,0
03878046,18,3,15,0,1,1,0,1,1
03878148,42,4,38,0,4,1,3,4,1
03878221,4,3,1,0,2,2,0,0,1
03878327,5,2,3,0,1,1,0,0,0
03878599,38,0,38,0,2,1,1,2,1
03878758,35,2,33,0,1,1,0,1,1
03878782,27,0,27,0,1,1,0,1,1
03878789,27,2,25,0,1,1,0,1,1
03878799,28,3,25,0,1,1,0,1,1
03878803,27,2,25,0,1,1,0,1,1
03878885,15,0,15,0,0,0,0,0,1
03878948,8,4,4,0,1,1,0,0,1
03879017,16,3,13,0,6,3,3,0,1
03879038,13,2,11,0,1,1,0,0,1
03879072,16,6,10,0,2,1,1,2,1
03879139,13,2,11,0,1,1,0,0,1
03879545,19,2,17,0,2,1,1,2,1
03879556,12,0,12,0,0,0,0,0,1
03879590,50,0,50,0,2,1,1,2,1
03879752,9,0,9,0,0,0,0,0,1
03879872,48,14,34,0,0,0,0,0,1
03879884,11,2,9,0,1,1,0,1,1
03879955,28,5,23,0,1,1,0,1,1
07704020,24,9,15,0,0,0,0,0,1
07704232,7,2,5,0,0,0,0,0,1
07704410,2,2,0,0,1,1,0,0,1
07704664,8,0,8,0,0,0,0,0,1
07704672,11,0,11,0,4,4,0,1,1
07704750,8,0,8,0,0,0,0,0,1
07704895,3,1,2,0,2,1,1,0,1
07704913,8,0,8,0,0,0,0,0,1
07704926,2,1,1,0,0,0,0,0,0
07705065,11,0,11,0,4,4,0,1,1
07705256,1,0,1,0,0,0,0,0,1
07705271,3,3,0,1,1,1,0,1,1
07705484,11,0,11,0,4,4,0,1,1
07705498,11,0,11,0,3,3,0,0,1
07705506,8,0,8,0,0,0,0,0,1
07705519,16,12,4,0,0,0,0,0,1
07705629,9,2,7,0,3,1,2,3,0
07705670,8,0,8,0,0,0,0,0,1
07705693,11,0,11,0,4,4,0,1,1
07705745,5,4,1,0,1,1,0,0,1
07705780,8,0,8,0,0,0,0,0,1
07706461,10,0,10,0,1,1,0,1,1
07706480,3,2,1,0,3,3,0,0,1
07706514,4,0,4,0,0,0,0,0,1
07706662,16,12,4,0,0,0,0,0,1
07706726,25,10,15,0,3,3,0,0,1
07706760,19,8,11,0,0,0,0,0,0
07706774,11,3,8,0,1,1,0,1,1
07706999,17,5,12,0,5,3,2,1,0
07707091,9,3,6,0,1,1,0,0,0
07707108,3,0,3,0,0,0,0,0,0
07707493,3,2,1,0,2,2,0,0,0
07707768,4,0,4,0,0,0,0,0,0
07707936,1,1,0,0,1,1,0,0,1
07708139,1,0,1,0,1,1,0,0,0
07708248,2,1,1,0,1,1,0,0,1
07708423,8,3,5,0,0,0,0,0,1
07708536,3,1,2,0,1,1,0,0,1
07708541,8,6,2,0,1,1,0,0,0
07708678,28,9,19,0,1,1,0,1,1
07708729,2,2,0,0,2,2,0,0,1
07708822,6,4,2,0,3,1,2,1,0
07709347,2,2,0,0,1,1,0,0,1
07709697,4,3,1,0,2,2,0,0,0
07710025,6,2,4,0,1,1,0,0,1
07710305,8,4,4,0,4,4,0,0,0
07710455,1,1,0,0,1,1,0,0,0
07710498,1,1,0,0,1,1,0,0,1
07710764,2,2,0,0,1,1,0,0,0
07710817,3,2,1,0,2,2,0,0,0
07710870,18,11,7,0,3,3,0,0,1
07711071,1,1,0,0,1,1,0,0,0
07711291,2,0,2,0,2,2,0,0,0
07711740,7,3,4,0,3,2,1,0,1
07712039,8,8,0,0,1,1,0,0,0
07712469,4,4,0,0,4,4,0,0,0
07712579,30,9,21,0,0,0,0,0,0
07712706,1,0,1,0,0,0,0,0,0
07712720,19,6,13,0,0,0,0,0,1
07712855,2,1,1,0,1,1,0,0,1
07712913,1,1,0,0,1,1,0,0,0
07713133,1,1,0,0,1,1,0,0,0
07713345,46,20,26,0,0,0,0,0,1
07713452,1,0,1,0,0,0,0,0,1
07713552,10,4,6,0,1,1,0,1,1
07713632,6,2,4,0,2,2,0,1,1
07713704,3,3,0,0,3,3,0,0,0
07714007,28,4,24,0,2,2,0,2,1
07714489,1,1,0,0,1,1,0,0,1
07714497,3,0,3,0,0,0,0,0,1
07714504,2,1,1,0,1,1,0,0,0
07715005,3,2,1,0,1,1,0,1,0
07715011,7,6,1,0,0,0,0,0,1
07715022,7,0,7,0,1,1,0,0,1
07715454,17,6,11,0,0,0,0,0,1
07715596,5,0,5,0,0,0,0,0,1
07715613,41,14,27,0,8,5,3,0,0
07716080,4,0,4,0,0,0,0,0,1
07716118,9,0,9,0,1,1,0,0,1
07716123,2,2,0,0,2,2,0,0,0
07716175,1,1,0,0,1,1,0,0,0
07716201,28,0,28,0,0,0,0,0,1
07716209,4,0,4,0,0,0,0,0,1
07716258,5,0,5,0,0,0,0,0,1
07716530,12,4,8,0,2,2,0,2,1
07716932,3,2,1,0,2,1,1,1,0
07717015,36,13,23,0,4,3,1,0,0
07717201,7,5,2,0,1,1,0,0,0
07717283,3,3,0,0,0,0,0,0,0
07717392,17,5,12,0,1,1,0,1,1
07717482,23,12,11,0,0,0,0,0,1
07717837,10,8,2,0,1,1,0,0,1
07717873,6,4,2,0,2,2,0,0,0
07719049,17,5,12,0,1,1,0,1,1
07719271,2,1,1,0,1,1,0,0,0
07719297,1,1,0,0,1,1,0,0,0
07719334,17,4,13,0,3,1,2,3,1
07719475,2,1,1,0,1,1,0,0,0
07719494,10,3,7,0,0,0,0,0,1
07719922,6,4,2,0,2,2,0,0,1
07720312,2,2,0,0,1,1,0,0,0
07720369,9,9,0,0,1,1,0,0,1
07720426,6,5,1,0,1,1,0,0,1
07720440,6,5,1,0,1,1,0,0,1
07720667,3,3,0,0,3,3,0,1,1
07720733,3,3,0,0,0,0,0,0,0
07720806,3,1,2,0,2,1,1,0,0
07721203,2,0,2,0,0,0,0,0,1
07721470,41,14,27,0,0,0,0,0,1
07721870,6,0,6,0,1,1,0,0,1
07722326,5,3,2,0,1,1,0,0,0
07722453,4,4,0,0,1,1,0,1,0
07722715,12,7,5,0,1,1,0,0,1
07722754,2,2,0,0,1,1,0,0,0
07722777,1,1,0,0,0,0,0,0,0
07722826,4,1,3,0,3,1,2,1,1
07722937,4,0,4,0,0,0,0,0,1
07723021,4,2,2,0,1,1,0,0,0
07723074,2,1,1,0,1,1,0,0,0
07723091,8,3,5,0,3,1,2,0,1
07723269,1,1,0,0,1,1,0,0,0
07723360,3,3,0,0,2,2,0,0,0
07723365,7,4,3,0,4,2,2,0,1
07724287,2,2,0,0,2,2,0,0,0
07724342,40,18,22,0,0,0,0,0,1
07724442,1,1,0,0,1,1,0,0,0
07724623,19,14,5,0,0,0,0,0,1
07724630,11,5,6,0,2,1,1,1,0
07725010,6,5,1,0,0,0,0,0,0
07725178,4,3,1,0,3,3,0,0,1
07725447,1,1,0,0,1,1,0,0,0
07726012,10,1,9,1,1,1,0,1,1
07726116,2,0,2,0,0,0,0,0,1
07726595,4,1,3,0,2,2,0,0,0
07726691,3,0,3,0,0,0,0,0,1
07727445,6,2,4,0,2,1,1,0,1
07727696,2,2,0,0,2,2,0,0,0
07727848,4,4,0,0,3,3,0,0,0
07727893,6,5,1,0,3,2,1,2,1
07727932,4,0,4,0,0,0,0,0,1
07727949,1,1,0,0,1,1,0,0,1
07728097,1,1,0,0,1,1,0,0,0
07728462,4,1,3,0,1,1,0,0,0
07728537,2,1,1,0,1,1,0,0,0
07728630,16,9,7,0,0,0,0,0,1
07728674,5,3,2,0,1,1,0,0,0
07728703,3,3,0,0,2,2,0,0,0
07728863,1,1,0,0,1,1,0,0,0
07729180,2,2,0,0,0,0,0,0,1
07729308,14,7,7,0,0,0,0,0,1
07729971,20,6,14,0,1,1,0,1,1
07730052,3,0,3,0,0,0,0,0,0
07730280,3,2,1,0,1,1,0,0,0
07730719,1,0,1,0,0,0,0,0,0
07730819,3,0,3,0,0,0,0,0,1
07730940,39,16,23,0,0,0,0,0,0
07731035,4,0,4,0,0,0,0,0,1
07731277,31,0,31,0,16,16,0,0,1
07731406,5,0,5,0,0,0,0,0,1
07732408,3,1,2,0,1,1,0,0,1
07732531,1,1,0,0,1,1,0,0,1
07732559,35,7,28,0,0,0,0,0,1
07732707,1,1,0,0,1,1,0,0,0
07732783,8,0,8,0,0,0,0,0,1
07732964,6,0,6,0,1,1,0,0,1
07733025,2,2,0,0,2,2,0,0,0
07733161,1,0,1,0,0,0,0,0,1
07733257,3,2,1,0,2,2,0,0,1
07733481,1,1,0,0,1,1,0,0,0
07733622,2,2,0,0,0,0,0,0,0
07734285,2,2,0,0,2,2,0,0,0
07734313,2,0,2,0,0,0,0,0,1
07734991,2,1,1,0,0,0,0,0,1
07735003,3,3,0,0,3,3,0,0,0
07735282,6,3,3,0,3,2,1,0,1
07735936,2,1,1,0,3,3,0,0,0
07736179,4,0,4,0,0,0,0,0,1
07736232,2,1,1,0,1,1,0,0,1
07737210,2,2,0,0,2,2,0,0,0
07737300,5,0,5,0,0,0,0,0,1
07737430,27,9,18,0,1,1,0,1,1
07737498,3,2,1,0,1,1,0,0,1
07737521,30,9,21,0,1,1,0,1,1
07737554,2,1,1,0,1,1,0,0,1
07737613,8,0,8,0,1,1,0,1,1
07737703,8,5,3,0,1,1,0,1,1
07737738,8,5,3,0,1,1,0,1,1
07737778,9,5,4,0,1,1,0,1,1
07737839,5,3,2,0,1,1,0,1,0
07737841,7,5,2,0,1,1,0,1,0
07737899,3,0,3,0,0,0,0,0,1
07738420,2,0,2,0,0,0,0,0,1
07738648,2,1,1,0,1,1,0,0,0
07738656,3,2,1,0,2,2,0,0,0
07738676,4,2,2,0,1,1,0,1,1
07738829,1,1,0,0,1,1,0,0,0
07739100,2,0,2,0,0,0,0,0,0
07739260,1,1,0,0,1,1,0,0,0
07739278,7,5,2,0,4,4,0,0,0
07739432,1,1,0,0,1,1,0,0,0
07739489,2,0,2,0,2,2,0,0,0
07739876,13,5,8,0,1,1,0,1,0
07740639,15,7,8,0,0,0,0,0,1
07740723,2,2,0,0,1,1,0,0,0
07741052,8,0,8,0,1,1,0,0,0
07741053,3,2,1,0,2,2,0,0,1
07741396,3,0,3,0,0,0,0,0,1
07741421,2,2,0,0,1,1,0,0,0
07741649,13,4,9,0,0,0,0,0,1
07741794,2,2,0,0,0,0,0,0,1
07741904,2,1,1,0,1,1,0,0,0
07742115,27,13,14,0,1,1,0,1,1
07742231,2,2,0,0,1,1,0,0,1
07742268,7,3,4,0,1,1,0,1,1
07742272,7,3,4,0,3,1,2,1,1
07742408,4,3,1,0,1,1,0,0,0
07742547,37,15,22,0,0,0,0,0,1
07743894,6,5,1,0,2,0,2,0,0
07744116,7,0,7,0,1,1,0,0,0
07744789,2,2,0,0,1,1,0,1,1
07744796,1,1,0,0,1,1,0,0,0
07744964,1,1,0,0,1,1,0,0,0
07745653,2,0,2,0,2,2,0,0,1
07745834,9,6,3,0,1,1,0,0,1
07746361,2,1,1,0,1,1,0,1,1
07746517,2,1,1,0,1,1,0,0,0
07746524,4,4,0,0,1,1,0,0,1
07746591,3,2,1,0,1,1,0,0,1
07746738,8,5,3,0,0,0,0,0,0
07746772,3,0,3,0,0,0,0,0,1
07746776,13,4,9,0,1,1,0,1,1
07747088,1,1,0,0,1,1,0,0,0
07747150,1,1,0,0,2,2,0,0,0
07747375,1,1,0,0,1,1,0,0,0
07747755,1,1,0,0,1,1,0,0,1
07748131,3,0,3,0,0,0,0,0,1
07748304,1,1,0,0,1,1,0,0,0
07748482,1,0,1,0,0,0,0,0,1
07749682,4,2,2,0,1,1,0,0,0
07749739,60,18,42,0,0,0,0,0,1
07749860,2,2,0,0,2,2,0,0,0
07750213,5,2,3,0,1,1,0,1,1
07750772,2,2,0,0,2,2,0,0,1
07751614,2,0,2,0,0,0,0,0,0
07751656,2,2,0,0,2,2,0,0,0
07751775,13,4,9,0,0,0,0,0,0
07751778,70,2,68,0,1,1,0,1,1
07752008,3,1,2,0,1,1,0,0,0
07752830,9,7,2,0,0,0,0,0,1
07752960,4,0,4,0,0,0,0,0,0
07752971,14,3,11,0,2,1,1,2,1
07753036,3,3,0,0,2,2,0,0,0
07753274,4,3,1,0,2,1,1,0,0
07754084,5,0,5,0,0,0,0,0,1
07754091,3,1,2,0,1,1,0,1,0
07754205,1,1,0,0,0,0,0,0,1
07754291,4,2,2,0,1,1,0,0,0
07754337,13,0,13,0,0,0,0,0,1
07754698,33,14,19,0,0,0,0,0,0
07754892,3,0,3,0,0,0,0,0,1
07755050,3,0,3,0,0,0,0,0,1
07755110,3,0,3,0,0,0,0,0,1
07755135,2,2,0,0,2,1,1,0,0
07755580,2,0,2,0,1,1,0,0,0
07755692,2,0,2,0,1,1,0,0,0
07755823,5,4,1,0,1,1,0,0,0
07755924,2,0,2,0,1,1,0,0,0
07756042,2,0,2,0,1,1,0,0,0
07756064,2,2,0,0,1,1,0,0,1
07756863,3,2,1,0,2,2,0,0,0
07757032,3,0,3,0,0,0,0,0,1
07757374,3,0,3,0,0,0,0,0,1
07757413,5,2,3,0,0,0,0,0,0
07757596,3,3,0,0,6,6,0,0,1
07758137,14,7,7,0,0,0,0,0,1
07758552,3,0,3,0,0,0,0,0,1
07759277,7,5,2,0,0,0,0,0,1
07759284,10,6,4,0,0,0,0,0,0
07759316,4,2,2,0,2,2,0,1,0
07759543,2,0,2,0,0,0,0,0,1
07759790,2,0,2,0,2,2,0,0,1
07759827,10,4,6,0,1,1,0,1,1
07759860,4,4,0,0,4,3,1,0,0
07759931,4,0,4,0,0,0,0,0,1
07760177,1,1,0,0,1,1,0,0,0
07760448,4,0,4,0,0,0,0,0,0
07760477,26,12,14,0,0,0,0,0,0
07760976,4,4,0,0,4,4,0,0,0
07761136,17,0,17,0,0,0,0,0,1
07761447,2,2,0,0,2,2,0,0,0
07762542,1,0,1,0,0,0,0,0,0
07763676,3,2,1,0,3,3,0,0,0
07763785,1,1,0,0,1,1,0,0,0
07764405,30,0,30,0,0,0,0,0,1
07764589,8,0,8,0,0,0,0,0,1
07764623,3,2,1,0,3,3,0,0,0
07764736,3,3,0,0,1,1,0,0,1
07765026,8,4,4,0,1,1,0,1,1
07765710,4,4,0,0,1,1,0,0,1
07765907,2,1,1,0,1,1,0,0,1
07766083,4,0,4,0,1,1,0,0,1
07766237,6,6,0,0,0,0,0,0,1
07766256,4,1,3,0,3,1,2,0,0
07766400,3,2,1,0,2,2,0,0,1
07766672,1,0,1,0,0,0,0,0,0
07766681,1,0,1,0,0,0,0,0,0
07766729,18,1,17,0,3,3,0,0,1
07766803,7,0,7,0,0,0,0,0,0
07766977,4,0,4,0,1,1,0,1,1
07767234,1,1,0,0,1,1,0,0,1
07767438,3,1,2,0,1,1,0,0,0
07767592,3,0,3,0,0,0,0,0,1
07767624,4,3,1,0,1,1,0,0,0
07767710,4,2,2,0,3,2,1,0,0
07768414,13,8,5,0,0,0,0,0,0
07768452,3,3,0,0,2,2,0,0,0
07768876,2,2,0,0,1,1,0,0,0
07769185,9,4,5,0,0,0,0,0,0
07769260,8,6,2,0,0,0,0,0,1
07769329,1,0,1,0,0,0,0,0,0
07769701,1,0,1,0,0,0,0,0,0
07769832,3,0,3,0,0,0,0,0,1
07770294,3,0,3,0,0,0,0,0,1
07770556,8,2,6,0,1,1,0,0,0
07770605,28,13,15,0,0,0,0,0,0
07770895,8,0,8,0,0,0,0,0,1
07770942,3,2,1,0,2,2,0,1,0
07771055,2,0,2,0,1,1,0,0,0
07771130,6,2,4,0,0,0,0,0,1
07771221,2,1,1,0,1,1,0,0,0
07771665,2,2,0,0,1,1,0,0,1
07771697,3,0,3,0,2,2,0,0,1
07771917,3,0,3,0,1,1,0,1,1
07772143,4,3,1,0,2,1,1,1,0
07772371,2,2,0,0,2,2,0,0,1
07772392,3,3,0,0,1,1,0,0,0
07772414,3,0,3,0,1,1,0,0,1
07772460,4,3,1,0,2,2,0,0,1
07772602,5,0,5,0,0,0,0,0,1
07772609,2,2,0,0,1,1,0,1,0
07772801,4,0,4,0,0,0,0,0,0
07772804,3,1,2,0,1,1,0,0,0
07772831,2,2,0,0,1,1,0,0,0
07772845,5,3,2,0,2,2,0,2,1
07773697,10,4,6,0,1,1,0,1,1
07773718,6,3,3,0,1,1,0,1,1
07773978,11,6,5,0,0,0,0,0,0
07774109,35,11,24,0,0,0,0,0,1
07774204,2,0,2,0,1,1,0,0,0
07774541,2,2,0,0,2,2,0,0,0
07774702,9,4,5,0,1,0,1,1,1
07775453,12,3,9,0,1,1,0,1,1
07775512,9,2,7,0,1,1,0,1,1
07775635,17,6,11,0,0,0,0,0,1
07775749,4,2,2,0,1,1,0,1,1
07775949,2,0,2,0,0,0,0,0,0
07776910,42,17,25,0,0,0,0,0,0
07776979,2,2,0,0,2,2,0,0,0
07777261,21,6,15,0,3,1,2,3,1
07777420,4,2,2,0,1,1,0,0,0
07777841,1,1,0,0,2,2,0,0,0
07778470,2,0,2,0,0,0,0,0,1
07778483,2,0,2,0,0,0,0,0,1
07778589,4,2,2,0,2,2,0,0,1
07778659,9,3,6,0,0,0,0,0,1
07778671,2,2,0,0,2,2,0,0,0
07778713,1,1,0,0,1,1,0,0,0
07778954,4,3,1,2,2,2,0,1,0
07779447,10,4,6,0,1,1,0,0,0
07779565,1,1,0,0,1,1,0,0,0
OC309022,25,21,4,0,0,0,0,0,1
OC309059,72,7,65,0,3,3,0,0,1
OC309132,151,6,145,0,1,1,0,1,1
OC309308,75,0,75,0,0,0,0,0,1
OC309313,31,14,17,0,13,11,2,1,1
OC309328,90,3,87,1,1,1,0,1,1
OC309340,27,0,27,0,0,0,0,0,1
OC309371,28,6,22,0,0,0,0,0,1
OC309409,56,28,28,0,1,1,0,0,1
OC309501,139,65,74,0,0,0,0,0,1
OC309508,163,69,94,0,3,3,0,0,1
OC309568,39,2,37,0,2,1,1,2,1
OC309760,25,3,22,0,4,2,2,0,1
OC309813,32,10,22,0,1,1,0,1,1
OC309965,49,21,28,0,0,0,0,0,1
OC310170,4,2,2,0,2,2,0,0,0
OC310283,8,0,8,0,0,0,0,0,1
OC310321,8,0,8,0,0,0,0,0,1
OC310335,555,366,189,0,0,0,0,0,1
OC310367,130,129,1,0,1,1,0,1,1
OC310420,39,19,20,0,0,0,0,0,0
OC310442,3,2,1,0,1,1,0,0,0
OC310469,15,0,15,0,0,0,0,0,1
OC310691,340,269,71,0,2,2,0,0,1
OC310933,6,0,6,0,0,0,0,0,1
OC310949,2,2,0,0,2,2,0,0,0
OC311075,158,0,158,0,0,0,0,0,1
OC311169,61,38,23,0,0,0,0,0,1
OC311173,94,81,13,0,4,2,2,4,1
OC311297,178,106,72,0,0,0,0,0,1
OC311430,130,40,90,0,0,0,0,0,1
OC311444,9,9,0,0,0,0,0,0,1
OC311850,280,137,143,0,0,0,0,0,1
OC312083,6,4,2,0,2,2,0,0,1
OC312088,10,2,8,0,2,2,0,0,0
OC312094,57,54,3,0,0,0,0,0,1
OC312229,118,114,4,0,1,1,0,0,1
OC312252,175,102,73,0,1,1,0,1,1
OC312300,1720,1058,662,0,0,0,0,0,1
OC312338,29,24,5,0,0,0,0,0,1
OC312339,35,29,6,0,0,0,0,0,1
OC312340,36,31,5,0,0,0,0,0,1
OC312404,614,275,339,0,1,1,0,1,1
OC312546,154,153,1,0,0,0,0,0,1
OC312705,22,13,9,2,1,1,0,1,1
OC312750,65,62,3,0,4,2,2,4,1
OC312798,31,31,0,0,0,0,0,0,1
OC312810,36,0,36,0,0,0,0,0,1
OC312841,8,4,4,0,1,1,0,1,1
OC312846,43,0,43,0,4,3,1,0,1
OC313071,164,34,130,0,10,8,2,0,1
OC313167,3,2,1,0,1,1,0,0,1
OC313335,14,0,14,1,0,0,0,0,1
OC313337,12,0,12,0,0,0,0,0,1
OC313353,12,6,6,0,0,0,0,0,1
OC313398,43,26,17,3,1,1,0,0,1
OC313479,7,0,7,4,0,0,0,0,1
OC313759,39,0,39,0,2,2,0,0,1
OC313768,21,20,1,1,0,0,0,0,1
OC313896,40,22,18,0,0,0,0,0,1
OC314005,67,32,35,1,9,8,1,2,1
OC314069,1397,10,1387,0,1,1,0,1,1
OC314085,3,2,1,0,1,1,0,0,1
OC314112,15,0,15,1,2,2,0,0,1
OC314426,42,15,27,0,0,0,0,0,1
OC314435,23,0,23,0,0,0,0,0,1
OC314442,2,2,0,0,2,2,0,0,1
OC314602,7,0,7,0,1,1,0,0,1
OC314684,3,0,3,0,0,0,0,0,1
OC314714,3,2,1,0,1,1,0,0,1
OC314724,153,79,74,0,0,0,0,0,1
OC314867,4,3,1,0,1,1,0,0,1
OC315057,8,8,0,0,4,4,0,0,1
OC315159,34,0,34,0,0,0,0,0,1
OC315280,53,31,22,0,0,0,0,0,1
OC315403,47,13,34,0,0,0,0,0,1
OC315531,101,63,38,0,0,0,0,0,1
OC315843,27,15,12,0,16,14,2,0,1
OC315867,21,2,19,0,0,0,0,0,1
OC315992,11,7,4,0,4,4,0,1,1
OC316001,83,80,3,0,0,0,0,0,1
OC316291,3,2,1,0,1,1,0,0,0
OC316304,5,0,5,0,0,0,0,0,1
OC316386,4,0,4,0,2,1,1,0,1
OC316487,20,11,9,0,2,2,0,2,1
OC316495,8,6,2,0,1,1,0,0,0
OC316556,2,0,2,0,0,0,0,0,1
OC316601,36,30,6,0,2,2,0,0,1
OC316724,29,7,22,0,1,1,0,0,1
OC316753,6,0,6,0,0,0,0,0,1
OC316817,4,2,2,0,1,1,0,0,1
OC316968,64,2,62,1,1,1,0,1,1
OC317137,4,4,0,0,4,4,0,0,1
OC317146,55,36,19,0,0,0,0,0,1
OC317322,50,45,5,0,0,0,0,0,1
OC317335,33,30,3,0,0,0,0,0,1
OC317343,94,56,38,0,0,0,0,0,1
OC317391,14,5,9,0,1,1,0,0,1
OC317402,156,66,90,0,1,1,0,0,1
OC317481,12,5,7,0,2,1,1,0,1
OC317500,29,0,29,0,0,0,0,0,1
OC317566,6,2,4,0,1,1,0,1,1
OC317578,12,7,5,0,0,0,0,0,1
OC317606,2,0,2,2,0,0,0,0,0
OC317620,59,57,2,0,4,2,2,4,1
OC317622,47,45,2,0,4,2,2,4,1
OC317651,39,38,1,0,0,0,0,0,1
OC317661,237,128,109,0,0,0,0,0,1
OC317675,2,0,2,0,2,2,0,0,0
OC317681,2,2,0,0,4,4,0,0,1
OC317703,6,3,3,0,1,1,0,0,0
OC317704,4,2,2,0,1,1,0,0,0
OC317756,37,35,2,0,1,1,0,0,1
OC317852,205,93,112,0,0,0,0,0,1
OC318149,416,224,192,0,0,0,0,0,1
OC318186,24,14,10,0,0,0,0,0,1
OC318236,2,2,0,0,2,2,0,0,1
OC318258,58,33,25,0,0,0,0,0,1
OC318291,7,3,4,6,1,1,0,1,1
OC318359,12,8,4,0,2,1,1,0,1
OC318393,8,5,3,0,3,3,0,0,1
OC318472,332,204,128,0,0,0,0,0,1
OC318479,11,9,2,0,3,3,0,0,1
OC318532,66,32,34,0,0,0,0,0,1
OC318660,15,0,15,2,0,0,0,0,1
OC318823,82,75,7,0,1,1,0,0,1
OC318950,6,0,6,3,0,0,0,0,1
OC318988,150,13,137,0,0,0,0,0,1
OC319308,150,145,5,0,0,0,0,0,1
OC319354,3,2,1,0,1,1,0,0,0
OC319473,5,0,5,0,0,0,0,0,1
OC319529,37,20,17,0,0,0,0,0,1
OC319549,10,6,4,2,2,2,0,2,1
OC319550,4,2,2,0,2,2,0,2,1
OC319551,10,6,4,2,2,2,0,2,1
OC319702,58,14,44,0,0,0,0,0,1
OC319725,27,16,11,4,0,0,0,0,1
OC319882,6,0,6,0,0,0,0,0,1
OC320188,14,8,6,0,2,2,0,1,1
OC320190,3,2,1,0,2,2,0,0,1
OC320279,12,4,8,0,0,0,0,0,1
OC320318,50,25,25,0,1,1,0,0,1
OC320467,19,0,19,0,1,1,0,1,1
OC320522,60,48,12,0,5,5,0,0,1
OC320531,2,2,0,0,2,2,0,0,1
OC320663,2,0,2,0,0,0,0,0,0
OC320686,7,2,5,0,2,2,0,0,0
OC320692,8,3,5,0,3,3,0,1,1
OC320783,11,10,1,0,0,0,0,0,1
OC320798,128,76,52,0,0,0,0,0,1
OC320936,36,13,23,0,0,0,0,0,1
OC321009,4,4,0,0,3,3,0,0,1
OC321066,48,33,15,0,0,0,0,0,1
OC321208,8,0,8,0,0,0,0,0,1
OC321516,4,2,2,0,1,1,0,1,0
OC321620,155,4,151,0,1,1,0,1,1
OC321845,11,3,8,2,2,2,0,0,1
OC321864,13,2,11,0,2,2,0,2,0
OC321961,3,2,1,0,0,0,0,0,0
OC322045,415,187,228,0,0,0,0,0,1
OC322182,5,4,1,0,1,1,0,0,0
OC322193,120,0,120,0,0,0,0,0,1
OC322256,3,3,0,0,3,3,0,0,0
OC322291,11,0,11,1,2,2,0,0,1
OC322673,2,2,0,0,1,1,0,0,0
OC322739,9,3,6,0,3,1,2,1,0
OC322836,11,9,2,0,0,0,0,0,1
OC322846,12,10,2,0,2,2,0,2,1
OC322935,197,95,102,0,0,0,0,0,1
OC322965,4,2,2,0,1,1,0,0,0
OC323108,4,0,4,0,0,0,0,0,1
OC323137,22,0,22,0,2,2,0,2,1
OC323409,87,50,37,0,0,0,0,0,1
OC323516,25,12,13,0,1,1,0,1,1
OC323570,137,79,58,0,0,0,0,0,1
OC323571,927,412,515,0,0,0,0,0,1
OC323639,620,355,265,0,0,0,0,0,1
OC323910,49,28,21,0,1,1,0,1,1
OC323971,7,3,4,0,0,0,0,0,1
OC324035,5,0,5,0,2,2,0,0,1
OC324045,1958,5,1953,0,0,0,0,0,1
OC324248,9,9,0,0,0,0,0,0,0
OC324268,6,3,3,2,2,2,0,0,1
OC324768,115,14,101,0,1,1,0,1,1
OC324823,21,5,16,0,2,2,0,0,1
OC324954,11,4,7,0,3,3,0,0,1
OC325014,4,4,0,0,1,1,0,0,1
OC325054,88,2,86,0,0,0,0,0,1
OC325075,4,2,2,0,2,1,1,0,1
OC325255,9,8,1,0,3,3,0,1,0
OC325292,5,3,2,4,2,1,1,1,1
OC325346,424,136,288,0,1,1,0,1,1
OC325348,691,353,338,0,1,1,0,1,1
OC325350,250,100,150,0,1,1,0,1,1
OC325464,3,2,1,0,1,1,0,1,1
OC325717,3,2,1,0,2,2,0,0,0
OC325738,24,2,22,0,2,2,0,2,1
OC325775,53,24,29,0,0,0,0,0,1
OC325810,6,5,1,0,4,4,0,2,1
OC325919,16,2,14,1,1,1,0,1,1
OC326014,15,3,12,0,1,1,0,1,1
OC326117,316,196,120,0,3,2,1,0,1
OC326165,175,126,49,0,0,0,0,0,1
OC326180,5,3,2,0,0,0,0,0,1
OC326242,101,51,50,0,0,0,0,0,1
OC326278,119,21,98,0,0,0,0,0,1
OC326292,95,0,95,0,0,0,0,0,0
OC326366,59,37,22,0,0,0,0,0,1
OC326421,5,5,0,0,1,1,0,0,1
OC326546,7,4,3,0,0,0,0,0,0
OC326572,10,6,4,0,2,2,0,0,1
OC326579,16,14,2,0,2,2,0,0,1
OC326586,3,0,3,0,0,0,0,0,1
OC326742,23,6,17,0,2,2,0,2,1
OC326756,2,2,0,0,2,2,0,0,1
OC326906,2,2,0,0,2,2,0,0,0
OC327057,13,0,13,0,0,0,0,0,1
OC327169,30,24,6,0,0,0,0,0,1
OC327176,25,19,6,1,2,2,0,0,1
OC327188,8,6,2,0,1,1,0,1,1
OC327324,14,12,2,0,2,2,0,0,1
OC327396,232,29,203,0,0,0,0,0,1
OC327512,5,3,2,0,4,3,1,0,1
OC327571,4,2,2,0,1,1,0,0,1
OC327590,7,4,3,0,1,1,0,0,1
OC327673,16,16,0,0,2,2,0,0,1
OC327678,39,32,7,0,0,0,0,0,1
OC327860,2,2,0,0,1,1,0,0,0
OC327937,4,4,0,0,2,2,0,0,0
OC328062,5,2,3,0,1,1,0,0,1
OC328243,4,0,4,0,0,0,0,0,1
OC328350,12,5,7,0,1,1,0,1,0
OC328400,2,2,0,0,2,2,0,0,0
OC328592,15,13,2,0,0,0,0,0,1
OC328594,4,2,2,0,2,2,0,0,1
OC328656,4,2,2,0,0,0,0,0,1
OC328672,13,0,13,0,0,0,0,0,1
OC328697,444,244,200,0,0,0,0,0,1
OC328775,85,52,33,0,0,0,0,0,1
OC328787,43,20,23,0,0,0,0,0,1
OC328928,10,2,8,1,2,2,0,0,0
SC256023,10,2,8,0,1,1,0,1,1
SC256024,4,0,4,0,0,0,0,0,1
SC256060,4,0,4,0,0,0,0,0,1
SC256158,3,0,3,0,0,0,0,0,1
SC256160,3,0,3,0,0,0,0,0,1
SC256248,13,10,3,0,1,1,0,1,1
SC256268,33,7,26,0,0,0,0,0,1
SC256386,10,2,8,1,0,0,0,0,1
SC256387,4,2,2,0,1,1,0,0,1
SC256532,9,0,9,0,0,0,0,0,1
SC256559,19,6,13,0,0,0,0,0,0
SC256649,7,2,5,0,1,1,0,1,1
SC256819,5,2,3,0,2,1,1,1,1
SC256859,55,9,46,0,2,1,1,0,0
SC256994,6,0,6,0,0,0,0,0,1
SC257314,5,2,3,0,2,1,1,0,0
SC257431,10,0,10,0,0,0,0,0,0
SC257540,4,0,4,0,2,2,0,1,1
SC257595,5,0,5,0,1,1,0,0,0
SC257787,37,12,25,0,0,0,0,0,0
SC257813,17,6,11,0,1,1,0,1,1
SC257832,4,3,1,0,2,2,0,0,0
SC257868,5,4,1,0,1,1,0,0,0
SC258054,4,1,3,0,1,1,0,0,1
SC258574,29,3,26,0,1,1,0,1,0
SC258645,26,8,18,0,0,0,0,0,1
SC258865,5,1,4,0,1,1,0,0,0
SC259049,16,0,16,0,0,0,0,0,1
SC259129,11,5,6,0,2,2,0,2,1
SC259202,5,3,2,0,2,2,0,0,0
SC259205,6,3,3,0,2,2,0,0,1
SC259298,7,2,5,0,1,1,0,0,0
SC259697,9,3,6,0,1,1,0,0,1
SC259713,8,1,7,0,1,1,0,0,0
SC259737,4,2,2,0,1,1,0,0,1
SC259789,4,1,3,0,2,1,1,0,1
SC259791,6,0,6,0,0,0,0,0,1
SC260002,9,2,7,0,2,1,1,1,1
SC260056,6,3,3,0,1,1,0,0,1
SC260146,5,0,5,0,0,0,0,0,0
SC260213,20,6,14,0,1,1,0,1,1
SC260327,9,6,3,0,1,1,0,1,1
SC260416,9,0,9,0,0,0,0,0,1
SC260501,9,6,3,0,2,2,0,0,1
SC260665,13,1,12,0,1,1,0,0,0
SC260702,7,4,3,0,1,1,0,0,1
SC260855,4,3,1,0,1,1,0,0,0
SC261108,4,3,1,0,2,2,0,0,1
SC261152,18,8,10,0,1,1,0,1,1
SC261299,12,0,12,0,0,0,0,0,1
SC261310,3,0,3,0,1,1,0,0,0
SC261656,9,3,6,0,1,1,0,1,1
SC261791,3,3,0,0,1,1,0,0,1
SC261850,10,1,9,0,1,1,0,0,1
SC261888,15,6,9,0,1,1,0,0,1
SC261968,20,5,15,0,0,0,0,0,1
SC262017,5,3,2,0,2,2,0,0,1
SC262079,10,2,8,0,2,1,1,0,1
SC262177,5,3,2,0,2,2,0,0,0
SC262257,5,3,2,0,2,2,0,0,0
SC262296,5,1,4,0,2,1,1,0,0
SC262441,8,2,6,0,3,2,1,0,1
SC262474,21,6,15,0,2,1,1,2,1
SC262555,19,0,19,0,0,0,0,0,1
SC262556,12,0,12,0,0,0,0,0,1
SC262567,6,0,6,0,0,0,0,0,0
SC262900,5,0,5,0,0,0,0,0,1
SC263017,8,0,8,0,0,0,0,0,1
SC263090,4,0,4,0,2,2,0,0,0
SC263117,8,0,8,0,0,0,0,0,1
SC263298,22,7,15,0,1,1,0,1,1
SC263305,11,0,11,0,0,0,0,0,1
SC263392,5,3,2,1,1,1,0,1,1
SC263415,5,2,3,0,2,2,0,0,1
SC263446,5,3,2,0,2,2,0,0,0
SC263460,16,7,9,0,4,3,1,0,1
SC263491,7,2,5,0,1,1,0,0,0
SC263525,13,3,10,0,0,0,0,0,0
SC263541,17,0,17,0,0,0,0,0,1
SC264024,9,0,9,0,0,0,0,0,1
SC264553,5,3,2,0,2,2,0,0,0
SC264705,16,6,10,0,0,0,0,0,1
SC264859,6,3,3,0,2,1,1,0,0
SC264926,12,0,12,1,1,1,0,1,1
SC265160,27,5,22,0,2,1,1,2,1
SC265161,8,0,8,0,1,1,0,1,1
SC265256,5,2,3,0,1,1,0,0,1
SC265297,12,6,6,0,0,0,0,0,0
SC265334,4,2,2,0,2,2,0,0,1
SC265374,5,3,2,0,2,2,0,0,0
SC265591,11,0,11,0,0,0,0,0,1
SC265648,5,0,5,0,0,0,0,0,1
SC265665,5,0,5,0,0,0,0,0,0
SC265806,5,3,2,0,2,2,0,0,1
SC266044,12,0,12,0,0,0,0,0,1
SC266113,9,1,8,0,0,0,0,0,0
SC266274,9,3,6,1,1,1,0,1,1
SC266403,18,8,10,0,0,0,0,0,0
SC266942,5,2,3,0,2,1,1,0,0
SC266979,9,0,9,0,0,0,0,0,0
SC267043,6,1,5,0,1,1,0,0,0
SC267190,19,3,16,0,1,1,0,1,1
SC267205,12,0,12,0,0,0,0,0,1
SC267317,55,17,38,0,0,0,0,0,1
SC267430,4,2,2,0,3,3,0,0,0
SC267462,7,5,2,0,1,1,0,0,1
SC267476,31,7,24,0,0,0,0,0,1
SC267556,5,2,3,0,1,1,0,0,0
SC267599,9,5,4,0,0,0,0,0,1
SC267600,9,6,3,0,0,0,0,0,1
SC267622,51,7,44,0,0,0,0,0,0
SC267713,37,11,26,0,0,0,0,0,1
SC267783,58,9,49,0,0,0,0,0,1
SC267911,10,0,10,0,0,0,0,0,0
SC268024,28,4,24,1,1,1,0,1,1
SC268061,12,0,12,0,0,0,0,0,1
SC268263,4,0,4,0,0,0,0,0,1
SC268338,8,0,8,0,0,0,0,0,1
SC268479,38,16,22,0,0,0,0,0,1
SC268602,4,3,1,0,2,2,0,0,0
SC268618,4,2,2,2,1,1,0,0,1
SC268718,22,6,16,1,0,0,0,0,0
SC268761,7,4,3,0,3,2,1,0,1
SC268825,4,1,3,0,1,1,0,0,0
SC268834,6,3,3,0,3,2,1,0,0
SC268856,19,9,10,1,0,0,0,0,1
SC268908,10,3,7,1,1,1,0,1,1
SC269074,4,0,4,0,0,0,0,0,0
SC269136,4,0,4,0,0,0,0,0,0
SC269349,37,16,21,0,0,0,0,0,1
SC269415,6,3,3,0,2,2,0,0,0
SC269443,3,3,0,0,2,2,0,0,0
SC269495,11,5,6,0,0,0,0,0,1
SC269566,5,3,2,0,1,1,0,0,1
SC269639,36,1,35,0,1,1,0,1,1
SC269661,3,1,2,1,1,1,0,0,0
SC269796,13,3,10,0,1,1,0,0,0
SC269932,5,4,1,0,1,1,0,0,0
SC269991,4,3,1,0,2,2,0,0,0
SC270028,10,2,8,0,1,1,0,1,1
SC270149,7,3,4,0,2,2,0,1,1
SC270177,2,2,0,0,2,2,0,0,1
SC270227,15,5,10,0,1,1,0,1,1
SC270245,40,10,30,0,0,0,0,0,1
SC270306,9,0,9,1,0,0,0,0,1
SC270307,12,4,8,0,2,2,0,2,1
SC270431,8,4,4,0,0,0,0,0,1
SC270432,7,2,5,1,1,1,0,0,1
SC270595,24,7,17,0,1,1,0,1,1
SC270656,24,0,24,0,0,0,0,0,1
SC270702,42,10,32,0,0,0,0,0,1
SC270952,10,4,6,0,0,0,0,0,1
SC271027,7,0,7,0,0,0,0,0,1
SC271036,9,7,2,0,1,1,0,0,1
SC271163,6,3,3,1,1,1,0,1,0
SC271413,6,2,4,0,1,1,0,0,0
SC271462,47,17,30,0,0,0,0,0,1
SC271562,15,4,11,0,1,1,0,1,1
SC271617,5,3,2,0,2,2,0,0,1
SC271800,8,7,1,0,2,2,0,0,0
SC271982,5,3,2,0,1,1,0,0,1
SC271985,37,21,16,0,0,0,0,0,1
SC272022,7,4,3,0,1,1,0,0,0
SC272383,5,0,5,0,0,0,0,0,0
SC272568,13,6,7,0,0,0,0,0,1
SC272735,9,6,3,0,2,2,0,0,1
SC272852,38,10,28,0,0,0,0,0,0
SC272858,4,1,3,0,1,1,0,0,1
SC272930,7,0,7,0,2,2,0,0,0
SC272959,26,3,23,0,3,3,0,2,1
SC272960,9,0,9,0,0,0,0,0,1
SC273066,11,4,7,0,0,0,0,0,0
SC273215,5,3,2,0,2,2,0,0,0
SC273406,19,0,19,0,0,0,0,0,1
SC273424,11,3,8,0,6,3,3,0,0
SC273906,25,3,22,0,1,1,0,1,1
SC273959,6,5,1,0,1,1,0,0,0
SC273963,6,4,2,0,1,1,0,0,0
SC274123,4,2,2,0,1,1,0,0,0
SC274126,7,0,7,0,0,0,0,0,1
SC274279,34,5,29,0,1,1,0,0,0
SC274474,7,0,7,0,0,0,0,0,0
SC274550,3,1,2,1,1,1,0,0,1
SC274559,11,4,7,0,1,1,0,1,1
SC274595,4,2,2,0,1,1,0,0,0
SC274608,13,2,11,0,3,3,0,1,0
SC274650,17,0,17,0,0,0,0,0,1
SC274651,36,10,26,0,0,0,0,0,1
SC274869,8,0,8,0,2,2,0,2,1
SC275002,8,2,6,0,1,1,0,1,1
SC275014,4,2,2,0,2,2,0,0,0
SC275023,4,1,3,0,2,2,0,0,0
SC275068,5,1,4,0,2,1,1,0,0
SC275077,9,0,9,0,0,0,0,0,1
SC275104,9,0,9,1,0,0,0,0,1
SC275111,30,5,25,0,0,0,0,0,0
SC275155,7,6,1,0,0,0,0,0,1
SC275168,27,7,20,0,9,7,2,0,0
SC275270,6,1,5,0,1,1,0,0,0
SC275661,6,3,3,0,3,3,0,0,0
SC275693,6,3,3,0,2,2,0,0,0
SC275720,7,3,4,0,0,0,0,0,0
SC275764,6,0,6,0,0,0,0,0,1
SC275795,49,9,40,0,0,0,0,0,0
SC275874,6,3,3,0,1,1,0,0,0
SC275926,16,2,14,0,3,1,2,0,0
SC275962,6,0,6,0,1,1,0,0,0
SC275991,16,1,15,0,1,1,0,0,1
SC276139,19,10,9,0,0,0,0,0,1
SC276155,13,4,9,0,0,0,0,0,1
SC276546,10,3,7,0,2,2,0,0,1
SC276700,6,0,6,0,1,1,0,0,1
SC276703,19,9,10,0,0,0,0,0,0
SC277021,5,1,4,0,1,1,0,0,0
SC277099,11,2,9,0,1,1,0,1,1
SC277102,21,9,12,0,0,0,0,0,1
SC277154,4,3,1,0,1,1,0,0,0
SC277210,12,0,12,0,0,0,0,0,1
SC277517,8,3,5,0,3,2,1,0,1
SC277572,5,4,1,0,3,3,0,0,1
SC277786,6,1,5,0,1,1,0,0,1
SC277883,3,1,2,0,0,0,0,0,0
SC277928,3,3,0,0,2,2,0,0,1
SC277995,10,0,10,0,0,0,0,0,1
SC278130,8,3,5,2,2,2,0,0,1
SC278142,38,12,26,0,0,0,0,0,1
SC278196,6,3,3,0,2,1,1,0,0
SC278201,14,3,11,0,1,1,0,0,0
SC278458,6,0,6,0,0,0,0,0,1
SC278464,18,0,18,0,0,0,0,0,1
SC278544,7,5,2,0,0,0,0,0,0
SC278724,30,8,22,0,0,0,0,0,1
SC278743,5,3,2,0,1,1,0,0,1
SC278800,11,1,10,0,3,1,2,0,0
SC278806,5,2,3,0,1,1,0,0,0
SC278814,9,4,5,0,1,1,0,0,1
SC278836,7,2,5,0,2,2,0,0,0
SC278922,5,3,2,0,2,2,0,0,0
SC278976,43,11,32,0,0,0,0,0,1
SC279009,4,2,2,1,2,1,1,0,1
SC279075,8,4,4,0,3,2,1,1,1
SC279104,4,2,2,0,1,1,0,0,1
SC279246,4,3,1,0,0,0,0,0,0
SC279340,25,3,22,0,3,3,0,0,1
SC279380,9,2,7,0,1,1,0,0,1
SC279432,5,0,5,0,0,0,0,0,1
SC279459,35,7,28,0,0,0,0,0,0
SC279499,12,0,12,0,1,1,0,1,0
SC279574,6,0,6,0,0,0,0,0,1
SC279723,9,0,9,0,1,1,0,0,1
SC279749,18,0,18,0,0,0,0,0,1
SC279835,13,3,10,0,0,0,0,0,1
SC279865,35,10,25,1,2,2,0,2,1
SC279866,30,6,24,1,1,1,0,1,1
SC280101,3,2,1,0,1,1,0,0,1
SC280296,21,0,21,0,0,0,0,0,1
SC280388,10,4,6,0,1,1,0,1,1
SC280390,15,9,6,0,1,1,0,0,0
SC280444,7,6,1,0,0,0,0,0,1
SC280589,7,5,2,0,4,4,0,0,0
SC280687,4,0,4,0,0,0,0,0,1
SC280856,25,5,20,0,0,0,0,0,0
SC280865,27,12,15,0,0,0,0,0,0
SC280872,19,8,11,0,0,0,0,0,0
SC281342,2,2,0,0,2,2,0,0,0
SC281394,11,4,7,0,1,1,0,1,1
SC281420,6,2,4,2,1,1,0,0,1
SC281437,8,5,3,0,2,2,0,0,1
SC281567,21,2,19,0,1,1,0,1,1
SC281605,7,2,5,0,2,1,1,0,0
SC281826,25,7,18,0,0,0,0,0,0
SC281848,2,0,2,0,1,1,0,0,0
SC281914,36,7,29,0,0,0,0,0,0
SC281921,4,2,2,0,1,1,0,0,1
SC282026,19,7,12,0,0,0,0,0,0
SC282109,4,1,3,0,1,1,0,0,0
SC282175,25,9,16,0,0,0,0,0,1
SC282199,10,0,10,0,0,0,0,0,1
SC282301,9,0,9,0,0,0,0,0,1
SC282302,10,2,8,0,1,1,0,0,1
SC282315,23,9,14,0,0,0,0,0,0
SC282321,5,0,5,0,2,1,1,0,1
SC282341,10,0,10,1,0,0,0,0,1
SC282416,5,3,2,0,1,1,0,1,1
SC282495,22,3,19,0,2,1,1,2,1
SC282497,5,1,4,0,1,1,0,0,0
SC282612,15,4,11,0,1,1,0,1,1
SC282621,8,0,8,0,0,0,0,0,1
SC282728,7,0,7,0,2,1,1,0,1
SC282730,7,0,7,0,2,1,1,0,1
SC283029,4,0,4,0,0,0,0,0,1
SC283043,5,2,3,0,1,1,0,0,1
SC283056,29,13,16,0,0,0,0,0,0
SC283141,2,2,0,0,1,1,0,0,0
SC283157,16,0,16,0,0,0,0,0,1
SC283164,16,0,16,0,0,0,0,0,1
SC283165,12,0,12,0,1,1,0,0,1
SC283167,10,4,6,0,2,2,0,0,1
SC283168,6,4,2,0,2,2,0,0,1
SC283272,14,6,8,0,0,0,0,0,1
SC283412,4,2,2,0,1,1,0,0,0
SC283431,4,1,3,0,1,1,0,0,1
SC283454,22,4,18,0,0,0,0,0,0
SC283700,31,5,26,0,0,0,0,0,0
SC283771,25,7,18,2,0,0,0,0,1
SC284173,6,0,6,0,2,2,0,1,1
SC284176,21,6,15,0,1,1,0,1,1
SC284185,8,0,8,0,0,0,0,0,1
SC284397,7,0,7,0,0,0,0,0,1
SC284488,73,18,55,0,0,0,0,0,0
SC284506,5,0,5,0,2,1,1,0,1
SC284516,5,0,5,0,2,1,1,0,1
SC284647,10,5,5,0,1,1,0,1,0
SC284668,6,3,3,0,2,2,0,0,1
SC284786,6,2,4,0,0,0,0,0,1
SC284868,10,0,10,0,0,0,0,0,1
SC284983,6,3,3,0,2,2,0,0,0
SC285136,7,0,7,1,0,0,0,0,1
SC285248,5,0,5,0,2,2,0,0,1
SC285250,5,0,5,0,2,2,0,0,1
SC285251,5,0,5,0,2,2,0,0,1
SC285287,19,4,15,0,3,0,3,1,1
SC285399,14,2,12,0,1,1,0,1,1
SC285400,14,2,12,0,1,1,0,1,1
SC285402,8,2,6,0,1,1,0,0,1
SC285432,14,3,11,0,0,0,0,0,0
SC285489,17,12,5,0,1,1,0,0,0
SC285572,5,3,2,0,2,2,0,0,0
SC285597,19,8,11,0,0,0,0,0,0
SC285635,20,3,17,0,1,1,0,1,1
SC285894,13,4,9,0,1,1,0,1,1
SC285935,14,0,14,0,0,0,0,0,1
SC286105,6,4,2,0,2,2,0,0,1
SC286109,5,0,5,0,0,0,0,0,0
SC286315,28,11,17,0,0,0,0,0,1
SC286451,6,2,4,0,1,1,0,0,0
SC286509,13,6,7,0,1,1,0,1,1
SC286667,8,2,6,0,1,1,0,1,0
SC286673,8,7,1,0,0,0,0,0,1
SC286674,17,3,14,0,1,1,0,1,1
SC286675,17,3,14,0,1,1,0,1,1
SC286680,16,3,13,0,1,1,0,1,1
SC286832,47,11,36,0,0,0,0,0,1
SC286833,50,12,38,0,3,1,2,3,1
SC286959,9,0,9,0,0,0,0,0,1
SC286975,7,3,4,0,2,1,1,2,1
SC286980,15,3,12,1,1,1,0,1,1
SC286984,7,3,4,0,2,1,1,2,1
SC286997,6,3,3,0,2,2,0,0,0
SC287166,12,6,6,0,0,0,0,0,0
SC287172,17,4,13,0,3,3,0,1,1
SC287500,35,13,22,0,11,11,0,0,0
SC287650,39,16,23,0,1,1,0,1,1
SC287679,11,3,8,0,2,2,0,1,1
SC287748,7,0,7,0,0,0,0,0,1
SC287765,42,22,20,0,1,1,0,1,1
SC287766,40,20,20,0,1,1,0,1,1
SC287908,10,5,5,0,1,1,0,1,0
SC287929,5,2,3,0,1,1,0,0,0
SC287978,27,9,18,0,0,0,0,0,1
SC288178,16,3,13,0,1,1,0,1,1
SC288201,9,3,6,0,4,4,0,0,0
SC288232,20,4,16,0,2,2,0,0,1
SC288265,6,4,2,0,1,1,0,1,1
SC288351,7,4,3,0,3,3,0,0,1
SC288515,7,0,7,0,0,0,0,0,1
SC288597,4,3,1,0,2,2,0,0,0
SC288654,2,2,0,0,1,1,0,0,0
SC288712,6,2,4,0,2,2,0,0,1
SC288823,5,2,3,0,1,1,0,0,0
SC288860,5,0,5,0,0,0,0,0,1
SC289013,16,8,8,0,1,1,0,1,1
SC289159,6,3,3,0,1,1,0,0,1
SC289335,7,3,4,0,1,1,0,0,1
SC289345,6,4,2,0,3,3,0,0,1
SC289607,26,6,20,0,4,3,1,0,0
SC289856,3,3,0,0,1,1,0,0,1
SC289980,7,3,4,0,2,2,0,2,1
05897001,9,3,6,0,1,1,0,1,0
05897031,8,2,6,0,2,2,0,0,1
05897167,7,2,5,0,2,2,0,0,1
05897177,29,0,29,0,0,0,0,0,1
05897513,10,1,9,0,0,0,0,0,1
05897777,8,0,8,0,0,0,0,0,1
05897805,8,0,8,0,0,0,0,0,1
05898666,4,3,1,0,4,4,0,0,1
05899822,11,0,11,0,0,0,0,0,1
05900593,4,2,2,0,1,1,0,0,0
05900656,30,13,17,0,0,0,0,0,0
05900689,6,3,3,0,1,1,0,1,0
05900711,4,1,3,0,1,1,0,0,0
05900872,14,0,14,0,1,1,0,0,1
05900942,19,3,16,0,7,3,4,0,0
05901125,6,1,5,0,1,1,0,0,0
05901583,3,0,3,0,0,0,0,0,1
05901698,11,0,11,0,0,0,0,0,1
05901899,21,0,21,0,0,0,0,0,1
05902143,25,13,12,0,1,0,1,0,1
05902298,8,3,5,0,2,2,0,0,0
05902446,21,4,17,0,1,1,0,1,0
05902612,17,9,8,0,1,1,0,0,1
05902622,13,6,7,0,0,0,0,0,1
05902755,4,2,2,0,2,2,0,0,0
05902955,3,2,1,0,1,1,0,0,0
05903123,11,5,6,0,4,4,0,0,1
05903477,33,1,32,0,1,1,0,1,1
05903489,13,8,5,0,0,0,0,0,1
05903628,6,0,6,0,1,1,0,0,1
05903713,41,6,35,0,1,1,0,1,1
05903727,16,3,13,0,1,1,0,1,1
05903745,14,2,12,0,1,1,0,1,0
05904029,2,0,2,0,0,0,0,0,1
05904064,8,2,6,0,3,1,2,1,1
05904367,4,0,4,0,1,1,0,0,1
05904946,7,5,2,0,1,1,0,1,0
05905050,21,6,15,0,2,0,2,0,1
05905412,4,4,0,0,2,1,1,0,0
05905521,11,4,7,0,1,1,0,1,0
05905541,30,12,18,0,1,1,0,1,1
05905564,15,4,11,0,4,1,3,1,1
05905828,4,2,2,0,1,1,0,0,0
05905835,7,3,4,0,1,1,0,0,1
05906448,4,2,2,0,1,1,0,1,1
05907189,2,2,0,0,2,2,0,0,0
05907566,17,8,9,0,0,0,0,0,1
05907641,22,8,14,0,0,0,0,0,1
05907679,20,4,16,0,1,1,0,0,0
05907739,2,2,0,0,2,2,0,0,0
05907777,3,0,3,0,0,0,0,0,1
05908016,7,0,7,0,0,0,0,0,1
05908053,17,3,14,0,1,1,0,1,1
05908090,15,0,15,0,0,0,0,0,1
05909399,5,0,5,0,0,0,0,0,1
05909445,7,5,2,0,2,2,0,0,0
05909747,3,3,0,0,2,2,0,0,0
05910179,2,1,1,0,1,1,0,0,1
05910763,8,4,4,0,1,1,0,0,1
05911000,10,5,5,0,3,3,0,0,1
05911004,7,1,6,0,2,2,0,0,1
05911037,7,0,7,0,0,0,0,0,1
05911489,8,0,8,0,0,0,0,0,0
05911606,7,4,3,0,2,1,1,2,1
05912434,6,2,4,0,1,1,0,0,1
05912828,13,5,8,0,0,0,0,0,1
05913246,11,2,9,0,2,2,0,2,1
05913925,3,3,0,0,1,1,0,1,1
05914238,4,0,4,0,0,0,0,0,1
05914295,8,0,8,0,2,2,0,0,1
05914618,8,0,8,0,1,1,0,0,1
05914795,5,0,5,0,1,1,0,1,0
05914930,8,2,6,0,0,0,0,0,1
05915058,3,2,1,0,1,1,0,0,0
05915162,16,2,14,0,0,0,0,0,0
05915563,15,3,12,0,1,1,0,1,0
05915655,4,0,4,0,0,0,0,0,1
05915671,4,0,4,0,0,0,0,0,1
05915728,8,0,8,0,5,5,0,0,1
05915955,9,5,4,0,1,1,0,1,1
05916214,23,8,15,0,0,0,0,0,1
05916238,14,2,12,0,0,0,0,0,0
05916248,10,2,8,0,2,2,0,0,0
05916350,9,7,2,0,0,0,0,0,0
05916362,11,4,7,0,0,0,0,0,1
05916581,8,3,5,0,0,0,0,0,0
05916595,4,2,2,0,1,1,0,0,1
05916642,18,6,12,0,0,0,0,0,1
05916825,11,0,11,0,0,0,0,0,1
05916938,16,5,11,0,0,0,0,0,0
05917006,4,2,2,0,2,2,0,0,0
05917703,4,2,2,0,1,1,0,0,0
05917821,3,2,1,0,2,2,0,1,1
05917837,5,1,4,1,1,1,0,0,0
05918111,15,4,11,0,0,0,0,0,1
05918184,25,7,18,0,1,1,0,1,1
05918197,13,0,13,0,0,0,0,0,1
05918292,3,3,0,0,2,2,0,0,0
05918361,5,1,4,0,1,1,0,0,0
05918513,9,2,7,0,0,0,0,0,0
05918993,4,2,2,0,2,2,0,0,1
05919583,5,3,2,0,1,1,0,0,1
05919649,5,3,2,0,1,1,0,0,1
05919794,36,5,31,0,1,1,0,1,1
05920437,14,4,10,0,0,0,0,0,0
05920587,4,1,3,0,1,1,0,0,0
05921029,22,0,22,0,0,0,0,0,1
05922817,6,5,1,0,0,0,0,0,1
05922822,7,4,3,0,0,0,0,0,0
05923364,3,0,3,0,2,2,0,0,1
05923552,6,2,4,0,2,2,0,0,1
05924091,17,6,11,0,1,1,0,1,1
05924419,8,0,8,0,0,0,0,0,1
05924503,5,4,1,0,1,1,0,0,0
05924664,4,0,4,0,0,0,0,0,1
05924990,9,8,1,0,0,0,0,0,1
05925084,10,0,10,0,0,0,0,0,0
05925677,7,2,5,0,2,2,0,0,1
05926092,5,1,4,0,2,2,0,0,1
05926560,17,1,16,0,1,1,0,1,1
05927198,6,0,6,0,0,0,0,0,1
05927261,14,3,11,0,2,1,1,2,1
05927546,7,1,6,0,1,1,0,0,1
05927586,2,0,2,0,0,0,0,0,1
05927976,6,3,3,0,1,1,0,0,1
05928167,3,3,0,0,2,2,0,0,0
05928334,35,4,31,0,2,2,0,0,1
05928589,6,1,5,0,1,1,0,0,1
05928604,2,1,1,0,1,1,0,0,0
05928737,13,4,9,0,1,1,0,1,1
05929419,4,2,2,0,1,1,0,0,0
05929598,2,2,0,0,2,2,0,0,0
05929681,9,4,5,0,1,1,0,1,1
05929750,22,3,19,0,1,1,0,1,1
05929753,23,3,20,0,1,1,0,1,1
05929901,4,1,3,0,1,1,0,0,1
05929972,22,3,19,0,1,1,0,1,0
05930210,10,2,8,0,1,1,0,0,1
05931081,6,4,2,0,0,0,0,0,0
05931090,12,4,8,0,0,0,0,0,0
05931232,4,2,2,0,2,1,1,0,1
05931495,5,0,5,0,2,2,0,0,1
05931821,4,2,2,0,1,1,0,0,0
05932194,12,2,10,0,1,1,0,1,1
05932632,7,1,6,0,1,1,0,0,1
05932797,17,4,13,0,1,1,0,1,1
05932945,21,10,11,0,0,0,0,0,1
05933528,16,1,15,0,1,1,0,1,1
05933592,6,0,6,0,0,0,0,0,1
05933708,10,5,5,0,3,1,2,1,0
05933725,20,11,9,0,0,0,0,0,1
05933789,3,0,3,0,0,0,0,0,1
05933895,5,1,4,0,3,1,2,0,1
05934373,10,0,10,0,1,1,0,1,1
05935270,9,2,7,0,2,0,2,0,0
05935420,17,3,14,0,1,1,0,1,1
05935553,23,2,21,0,4,1,3,4,1
05935619,6,3,3,0,2,1,1,1,0
05935627,6,4,2,0,3,3,0,0,1
05935873,20,4,16,0,1,1,0,1,1
05935894,6,3,3,0,2,2,0,0,1
05936827,5,1,4,0,1,1,0,0,0
05936830,9,4,5,0,0,0,0,0,1
05936854,23,2,21,0,4,1,3,4,1
05936869,12,4,8,0,0,0,0,0,1
05936970,6,1,5,0,0,0,0,0,0
05937135,3,0,3,0,1,1,0,0,0
05937259,4,4,0,0,3,3,0,0,1
05937295,2,2,0,0,1,1,0,0,0
05937468,9,0,9,0,0,0,0,0,1
05937511,26,9,17,0,4,4,0,0,1
05937535,7,2,5,0,1,1,0,0,0
05937876,3,2,1,0,1,1,0,0,0
05937886,11,0,11,0,0,0,0,0,1
05938575,6,4,2,0,4,3,1,0,1
05938849,5,0,5,0,0,0,0,0,1
05938867,7,2,5,0,1,0,1,0,0
05939297,11,0,11,0,0,0,0,0,1
05939299,14,4,10,0,1,1,0,1,1
05939327,31,11,20,0,0,0,0,0,1
05939573,9,0,9,0,0,0,0,0,0
05939726,11,0,11,0,0,0,0,0,1
05939799,2,2,0,0,1,1,0,0,0
05939858,12,1,11,0,1,1,0,1,1
05940030,6,4,2,0,1,1,0,0,0
05940040,15,7,8,0,1,1,0,0,1
05940087,25,6,19,0,2,1,1,2,1
05940107,19,4,15,0,2,1,1,2,1
05940223,10,0,10,0,0,0,0,0,1
05940762,3,3,0,0,2,2,0,0,1
05940775,11,3,8,0,2,2,0,0,0
05941261,11,4,7,0,0,0,0,0,1
05941464,7,3,4,0,2,1,1,1,0
05941558,18,2,16,0,2,1,1,2,0
05941568,6,3,3,0,1,1,0,1,1
05941659,3,2,1,0,4,4,0,0,0
05942095,5,1,4,0,1,1,0,0,0
05942914,7,4,3,0,1,1,0,0,1
05942972,19,0,19,0,0,0,0,0,1
05943183,4,0,4,0,0,0,0,0,1
05943187,6,0,6,0,0,0,0,0,1
05943299,4,0,4,0,1,1,0,0,0
05943470,28,6,22,0,2,2,0,2,1
05943554,9,0,9,0,0,0,0,0,1
05943852,4,2,2,0,1,1,0,0,1
05943952,19,5,14,0,0,0,0,0,1
05944064,6,2,4,0,1,1,0,0,1
05944123,25,6,19,0,2,1,1,2,1
05944125,25,6,19,0,2,1,1,2,1
05944408,4,3,1,0,0,0,0,0,1
05944762,7,3,4,0,1,1,0,1,1
05945222,25,4,21,0,1,1,0,1,1
05945291,24,4,20,0,1,1,0,1,1
05945307,24,4,20,0,1,1,0,1,1
05945308,24,4,20,0,1,1,0,1,1
05945309,20,3,17,0,1,1,0,1,1
05945310,10,0,10,0,0,0,0,0,1
05945314,24,4,20,0,1,1,0,1,1
05945320,24,4,20,0,1,1,0,1,1
05945357,10,0,10,0,0,0,0,0,1
05945367,24,4,20,0,1,1,0,1,1
05945376,5,2,3,0,1,1,0,0,0
05945487,24,4,20,0,1,1,0,1,1
05945804,10,5,5,0,1,1,0,1,1
05946111,24,4,20,0,1,1,0,1,1
05946230,6,3,3,0,2,2,0,0,0
05946283,7,0,7,0,0,0,0,0,1
05946422,9,0,9,0,1,1,0,1,1
05946559,14,4,10,0,2,2,0,2,1
05946575,5,0,5,0,2,2,0,0,0
05946950,19,4,15,0,2,1,1,2,1
05946999,19,4,15,0,2,1,1,2,1
05947002,19,0,19,0,1,1,0,1,1
05947121,15,6,9,0,2,1,1,1,1
05947132,19,5,14,0,0,0,0,0,1
05947232,2,2,0,0,1,1,0,0,0
05947283,30,9,21,0,0,0,0,0,1
05947391,10,6,4,0,0,0,0,0,1
05947399,2,2,0,0,2,2,0,0,0
05947481,30,11,19,0,0,0,0,0,1
05947493,4,0,4,0,1,1,0,0,0
05947502,10,0,10,0,0,0,0,0,1
05947750,7,4,3,0,1,1,0,0,1
05947941,10,0,10,0,1,1,0,0,1
05948191,7,2,5,0,1,1,0,1,1
05948466,5,3,2,0,1,1,0,0,1
05948620,3,1,2,0,1,1,0,0,1
05948670,3,3,0,0,2,2,0,0,0
05948800,15,2,13,0,1,1,0,1,1
05948858,25,4,21,0,5,4,1,2,1
05948888,14,4,10,0,0,0,0,0,1
05949079,13,0,13,0,0,0,0,0,1
05949879,2,1,1,0,1,1,0,0,0
05950121,3,2,1,0,1,1,0,0,0
05950172,49,11,38,0,0,0,0,0,1
05950494,3,2,1,0,1,1,0,0,1
05950716,3,0,3,0,1,1,0,0,1
05950813,5,0,5,0,2,2,0,0,1
05950862,5,2,3,0,2,1,1,0,1
05951046,26,6,20,0,0,0,0,0,0
05951147,8,0,8,0,1,1,0,1,1
05951571,14,3,11,0,1,1,0,1,1
05951924,14,8,6,0,0,0,0,0,1
05952760,10,4,6,0,0,0,0,0,1
05952785,6,0,6,0,0,0,0,0,1
05952892,8,3,5,0,1,1,0,1,1
05953001,18,5,13,0,1,1,0,0,1
05953015,15,6,9,0,0,0,0,0,1
05953366,8,4,4,0,1,1,0,1,1
05953717,10,3,7,0,0,0,0,0,1
05953769,2,2,0,0,1,1,0,0,1
05953909,8,5,3,0,2,2,0,0,1
05955376,7,5,2,0,3,1,2,1,0
05955832,10,4,6,0,0,0,0,0,0
05956233,6,2,4,0,0,0,0,0,1
05956357,5,3,2,0,0,0,0,0,0
05956590,15,2,13,0,1,1,0,1,1
05956659,3,2,1,0,1,1,0,0,1
05956831,5,1,4,0,1,1,0,0,1
05957026,8,4,4,0,1,1,0,1,1
05957074,23,3,20,0,1,1,0,1,1
05957213,7,3,4,0,1,1,0,0,0
05957409,13,4,9,1,2,2,0,2,1
05957411,9,4,5,0,1,1,0,1,1
05957412,17,3,14,0,0,0,0,0,1
05957729,28,10,18,0,0,0,0,0,1
05957921,28,4,24,0,1,1,0,1,1
05958166,5,4,1,0,0,0,0,0,0
05958372,3,0,3,0,0,0,0,0,1
05958645,20,4,16,0,0,0,0,0,1
05959186,16,3,13,0,1,1,0,1,0
05959193,16,3,13,0,1,1,0,1,0
05959432,11,3,8,0,1,1,0,1,1
05959591,5,3,2,0,3,2,1,1,1
05959834,3,2,1,0,3,3,0,0,0
05960182,5,1,4,0,1,1,0,0,0
05960351,4,0,4,0,0,0,0,0,1
05960394,6,5,1,0,2,1,1,0,0
05960434,9,0,9,0,0,0,0,0,1
05960522,6,0,6,0,0,0,0,0,1
05961112,5,3,2,0,1,1,0,0,0
05961262,5,3,2,0,1,1,0,0,1
05961916,4,1,3,0,1,1,0,0,0
05961974,7,2,5,0,1,1,0,0,0
05962459,11,0,11,0,0,0,0,0,1
05963067,6,2,4,0,2,1,1,0,0
05963314,9,1,8,0,0,0,0,0,0
05963334,9,4,5,0,1,1,0,1,1
05963337,9,4,5,0,1,1,0,1,1
05963433,9,4,5,0,1,1,0,1,1
05963845,5,0,5,0,0,0,0,0,1
05963909,8,5,3,0,1,1,0,0,1
05963927,21,5,16,0,0,0,0,0,1
05964097,16,5,11,0,4,3,1,0,1
05964221,4,1,3,0,2,1,1,0,0
05964261,7,2,5,0,1,1,0,0,0
05965058,6,2,4,0,1,1,0,0,1
05965178,66,24,42,0,3,2,1,0,1
05965359,5,0,5,0,0,0,0,0,1
05965421,25,6,19,0,2,1,1,2,1
05965427,20,1,19,0,3,1,2,3,1
05965794,2,0,2,0,0,0,0,0,1
05965856,19,5,14,0,1,1,0,1,1
05966107,5,3,2,0,2,2,0,0,0
05966601,3,2,1,0,2,2,0,0,1
05967201,10,0,10,0,1,1,0,0,1
05967946,19,0,19,0,0,0,0,0,1
05968408,5,0,5,0,2,2,0,0,1
05968486,11,2,9,0,3,2,1,0,0
05968597,3,2,1,0,1,1,0,0,0
05968908,4,2,2,0,1,1,0,0,0
05968915,3,1,2,0,1,1,0,0,1
05968987,7,4,3,0,3,3,0,0,1
05969256,66,23,43,0,0,0,0,0,1
05969781,21,8,13,0,1,1,0,0,1
05969853,15,4,11,0,0,0,0,0,1
05969869,2,2,0,0,1,1,0,0,0
05969922,19,7,12,0,0,0,0,0,0
06890382,3,1,2,0,1,1,0,0,0
06890546,3,3,0,0,1,1,0,0,1
06890614,15,5,10,0,0,0,0,0,0
06890818,7,2,5,0,2,2,0,0,1
06890842,6,2,4,0,5,4,1,2,1
06890856,3,1,2,0,0,0,0,0,0
06890940,4,0,4,0,1,1,0,0,1
06891281,4,2,2,0,1,1,0,0,0
06891587,11,5,6,0,1,1,0,1,1
06891654,14,4,10,0,2,1,1,2,1
06891794,3,3,0,0,1,1,0,0,0
06891942,8,0,8,0,0,0,0,0,1
06892128,4,2,2,0,2,2,0,0,1
06892458,13,0,13,0,0,0,0,0,0
06892984,4,0,4,0,1,1,0,0,0
06893358,5,1,4,0,1,1,0,0,0
06894130,2,2,0,0,1,1,0,0,1
06894401,34,8,26,0,1,1,0,1,0
06894654,4,3,1,0,1,1,0,0,1
06894946,2,1,1,0,2,1,1,0,0
06895289,7,3,4,0,1,1,0,1,1
06895395,10,2,8,0,0,0,0,0,1
06895426,46,14,32,0,0,0,0,0,1
06895865,27,11,16,0,0,0,0,0,0
06895992,23,13,10,0,0,0,0,0,1
06896303,3,1,2,0,2,1,1,0,1
06896620,2,2,0,0,2,2,0,0,0
06896957,1,1,0,0,1,1,0,0,0
06896963,12,7,5,0,0,0,0,0,1
06896971,3,2,1,0,2,2,0,0,0
06897069,11,4,7,0,1,1,0,1,1
06897074,17,5,12,0,1,1,0,1,1
06897239,24,9,15,0,0,0,0,0,1
06897603,4,3,1,0,2,2,0,0,0
06897721,1,1,0,0,1,1,0,0,0
06898022,2,2,0,0,2,2,0,0,0
06898096,2,2,0,0,1,1,0,0,0
06898099,1,1,0,0,1,1,0,0,0
06898724,1,0,1,0,2,2,0,0,1
06898843,3,0,3,0,1,1,0,0,0
06898879,2,2,0,0,1,1,0,0,0
06899125,4,0,4,0,0,0,0,0,1
06899188,2,1,1,0,1,1,0,0,0
06899287,1,1,0,0,1,1,0,0,0
06899293,18,10,8,0,0,0,0,0,1
06899607,5,5,0,0,2,2,0,0,1
06899877,3,3,0,0,2,2,0,0,0
06899920,13,4,9,0,0,0,0,0,0
06900034,3,3,0,0,2,2,0,0,0
06900359,24,0,24,0,0,0,0,0,1
06900512,10,2,8,0,1,1,0,1,1
06900612,4,3,1,0,1,1,0,0,1
06900631,3,0,3,0,2,2,0,0,0
06900774,7,5,2,0,0,0,0,0,1
06901014,34,8,26,0,0,0,0,0,0
06901168,4,3,1,0,1,1,0,1,1
06901456,3,3,0,0,2,2,0,0,1
06901909,15,7,8,0,1,1,0,1,1
06902078,7,2,5,0,1,1,0,1,1
06902761,2,2,0,0,1,1,0,0,1
06902763,22,2,20,0,2,1,1,2,1
06902964,2,2,0,0,1,1,0,0,0
06903392,6,1,5,0,1,1,0,0,0
06904145,5,4,1,0,0,0,0,0,0
06904342,4,0,4,0,0,0,0,0,1
06904358,4,0,4,0,0,0,0,0,1
06904392,5,3,2,0,1,1,0,1,1
06904906,6,4,2,0,2,2,0,0,0
06904951,11,0,11,0,1,1,0,1,1
06905043,6,0,6,0,1,1,0,1,1
06905045,6,2,4,0,1,1,0,0,0
06905613,4,2,2,0,0,0,0,0,1
06905709,5,4,1,0,1,1,0,0,1
06905786,3,0,3,0,1,1,0,0,1
06905803,11,1,10,0,0,0,0,0,1
06905952,9,7,2,0,3,1,2,1,0
06906157,35,6,29,0,1,1,0,1,0
06906160,9,7,2,0,3,1,2,1,0
06906222,36,6,30,0,1,1,0,1,0
06906545,10,7,3,0,2,2,0,0,1
06907048,14,2,12,0,2,1,1,2,1
06907674,2,2,0,0,2,2,0,0,0
06908653,2,0,2,0,0,0,0,0,0
06908856,4,3,1,0,1,1,0,0,1
06908935,8,6,2,0,0,0,0,0,0
06908954,6,4,2,0,0,0,0,0,0
06909544,3,2,1,0,1,1,0,0,0
06909719,12,0,12,0,0,0,0,0,1
06909802,5,3,2,0,5,2,3,1,0
06910720,2,2,0,0,1,1,0,1,0
06910963,3,1,2,0,1,1,0,0,0
06911392,2,0,2,0,0,0,0,0,1
06911431,3,0,3,0,0,0,0,0,1
06911519,3,1,2,0,1,1,0,0,0
06912296,14,3,11,0,1,1,0,1,1
06912935,10,3,7,0,0,0,0,0,0
06913103,4,3,1,0,2,2,0,0,0
06914263,36,0,36,0,0,0,0,0,0
06914352,2,2,0,0,2,2,0,0,1
06914567,5,2,3,0,2,2,0,0,0
06914843,1,1,0,0,1,1,0,0,1
06914849,4,0,4,0,0,0,0,0,0
06914924,2,1,1,0,1,1,0,0,0
06914930,5,4,1,0,1,1,0,0,1
06915316,3,2,1,0,2,2,0,0,0
06915475,3,1,2,0,1,1,0,0,0
06915491,5,2,3,0,1,1,0,0,0
06915576,9,2,7,0,1,1,0,1,1
06915625,2,2,0,0,2,2,0,0,0
06916662,7,4,3,0,1,1,0,1,1
06917167,7,0,7,0,0,0,0,0,1
06917325,27,3,24,0,1,1,0,1,1
06917703,17,3,14,0,0,0,0,0,1
06918031,5,2,3,0,0,0,0,0,0
06918246,31,10,21,0,0,0,0,0,1
06918476,22,7,15,0,0,0,0,0,1
06918520,3,0,3,0,0,0,0,0,0
06919023,4,0,4,0,0,0,0,0,1
06919066,2,2,0,0,2,2,0,0,0
06919167,17,4,13,0,1,1,0,1,1
06919439,4,0,4,0,0,0,0,0,1
06919806,6,4,2,0,0,0,0,0,1
06919943,6,0,6,0,2,2,0,0,0
06920294,2,1,1,0,1,1,0,0,1
06920314,2,1,1,0,1,1,0,0,1
06920368,7,3,4,0,2,2,0,0,1
06920583,2,1,1,0,1,1,0,0,1
06920603,2,1,1,0,1,1,0,0,1
06920632,2,1,1,0,1,1,0,0,1
06920636,2,1,1,0,1,1,0,0,1
06920779,6,0,6,0,0,0,0,0,1
06920996,9,0,9,0,0,0,0,0,0
06921165,3,3,0,0,2,2,0,0,0
06921418,5,0,5,0,0,0,0,0,1
06921478,12,4,8,0,2,2,0,2,1
06921652,8,5,3,0,4,0,4,0,0
06921674,7,3,4,0,0,0,0,0,1
06921747,8,7,1,0,1,1,0,0,0
06921786,3,3,0,0,3,3,0,0,0
06921901,3,0,3,0,0,0,0,0,1
06922046,1,0,1,0,1,1,0,0,0
06922090,1,0,1,0,0,0,0,0,0
06922092,6,3,3,0,2,2,0,2,1
06922981,13,5,8,0,8,7,1,0,1
06923228,2,0,2,0,0,0,0,0,1
06923384,3,1,2,0,4,1,3,1,1
06923694,4,0,4,0,0,0,0,0,1
06923809,3,1,2,0,1,1,0,0,0
06923903,3,1,2,0,1,1,0,0,0
06924175,3,0,3,0,0,0,0,0,1
06924182,6,0,6,0,0,0,0,0,1
06924317,3,3,0,0,2,2,0,0,0
06924361,8,2,6,0,2,1,1,2,1
06924791,21,9,12,0,0,0,0,0,0
06924822,4,0,4,0,1,1,0,0,1
06925155,6,2,4,0,2,2,0,0,1
06925188,1,0,1,0,1,1,0,0,0
06925271,4,1,3,0,0,0,0,0,0
06925736,3,0,3,0,0,0,0,0,1
06925838,6,0,6,0,0,0,0,0,1
06926691,1,1,0,0,1,1,0,0,0
06927174,14,2,12,0,1,1,0,1,1
06927314,2,0,2,0,0,0,0,0,0
06927418,12,3,9,0,1,1,0,1,1
06927434,8,2,6,0,1,1,0,1,1
06927487,3,1,2,0,1,1,0,0,0
06927626,3,1,2,0,2,2,0,0,1
06927732,3,3,0,0,2,2,0,0,0
06927929,18,5,13,0,1,1,0,1,1
06928056,14,2,12,0,1,1,0,1,1
06928448,4,1,3,0,1,1,0,1,1
06928661,5,0,5,0,0,0,0,0,1
06928995,3,0,3,0,0,0,0,0,0
06929000,3,3,0,0,2,2,0,0,1
06929311,2,2,0,0,1,1,0,0,1
06929526,21,14,7,0,1,1,0,1,1
06929745,10,4,6,0,0,0,0,0,1
06929890,11,0,11,0,0,0,0,0,1
06929953,3,2,1,0,3,2,1,0,0
06930025,17,5,12,0,1,1,0,1,0
06930180,14,4,10,0,2,1,1,2,1
06930253,5,2,3,0,4,4,0,0,0
06930324,11,0,11,0,0,0,0,0,1
06930640,4,0,4,0,0,0,0,0,1
06930689,3,3,0,0,2,2,0,0,0
06931024,3,1,2,0,0,0,0,0,0
06931450,13,4,9,0,0,0,0,0,0
06931642,25,5,20,0,1,1,0,1,1
06931764,11,7,4,0,1,1,0,0,0
06931922,25,5,20,0,1,1,0,1,1
06932690,2,0,2,0,0,0,0,0,0
06933134,5,1,4,0,1,1,0,0,0
06933196,32,13,19,0,0,0,0,0,0
06933198,7,2,5,0,0,0,0,0,0
06933355,1,1,0,0,1,1,0,0,0
06933633,5,3,2,0,2,1,1,0,1
06933761,5,2,3,0,3,1,2,1,0
06934395,3,0,3,0,0,0,0,0,1
06934610,3,2,1,0,2,2,0,0,1
06934615,3,1,2,0,1,1,0,0,1
06934670,16,11,5,0,1,1,0,1,1
06934910,17,0,17,0,0,0,0,0,0
06935035,3,3,0,0,2,2,0,0,0
06935542,7,1,6,0,1,1,0,0,1
06935772,2,2,0,0,2,2,0,0,1
06935938,4,3,1,0,1,1,0,0,0
06936145,9,3,6,0,1,1,0,1,1
06936220,7,2,5,0,1,1,0,1,1
06936624,3,2,1,0,1,1,0,0,0
06936835,16,5,11,0,1,1,0,1,1
06936840,6,0,6,0,0,0,0,0,1
06936917,4,3,1,0,1,1,0,0,1
06937785,3,1,2,0,1,1,0,0,0
06937966,10,5,5,0,4,4,0,2,0
06938019,1,0,1,0,0,0,0,0,0
06938448,7,0,7,0,1,1,0,1,1
06938658,2,0,2,0,0,0,0,0,0
06939433,2,2,0,0,2,2,0,0,0
06939446,3,1,2,0,1,1,0,0,1
06939892,2,0,2,0,0,0,0,0,1
06939918,8,3,5,0,4,4,0,1,0
06940256,1,1,0,0,1,1,0,0,0
06940517,3,3,0,0,1,1,0,0,0
06940698,4,0,4,0,0,0,0,0,1
06941019,2,0,2,0,0,0,0,0,1
06941120,3,1,2,0,1,1,0,0,0
06941278,17,8,9,0,1,1,0,0,1
06941802,10,5,5,0,1,1,0,0,1
06942440,8,0,8,0,0,0,0,0,1
06942668,3,3,0,0,0,0,0,0,0
06942787,2,0,2,0,0,0,0,0,1
06942833,4,1,3,0,1,1,0,0,1
06942904,2,2,0,0,1,1,0,0,0
06943331,16,6,10,0,1,1,0,1,1
06943469,14,0,14,0,0,0,0,0,1
06943490,10,4,6,0,1,1,0,0,1
06943531,17,7,10,0,1,1,0,0,0
06943565,11,11,0,0,0,0,0,0,1
06943819,2,2,0,0,1,1,0,0,0
06944210,5,0,5,0,0,0,0,0,1
06944238,6,2,4,0,1,1,0,0,0
06944259,12,4,8,2,0,0,0,0,1
06944461,17,4,13,0,2,2,0,2,1
06944579,1,1,0,0,0,0,0,0,0
06944688,12,3,9,0,3,3,0,0,1
06945428,3,3,0,0,3,3,0,0,0
06945711,2,2,0,0,1,1,0,0,1
06945810,11,6,5,0,0,0,0,0,0
06946004,3,1,2,0,2,2,0,0,1
06946098,19,12,7,0,0,0,0,0,1
06946157,3,0,3,0,0,0,0,0,1
06946160,6,1,5,0,3,1,2,3,1
06946165,11,4,7,0,3,2,1,0,0
06946189,3,2,1,0,1,1,0,0,0
06947307,6,0,6,0,0,0,0,0,1
06947371,8,7,1,0,2,2,0,0,1
06947708,6,0,6,0,0,0,0,0,1
06948160,10,0,10,0,1,1,0,1,1
06948499,27,0,27,0,0,0,0,0,1
06948732,27,3,24,0,1,1,0,1,1
06948809,4,0,4,0,0,0,0,0,1
06948882,2,2,0,0,1,1,0,0,1
06949000,10,0,10,0,0,0,0,0,1
06949084,2,1,1,0,2,2,0,0,0
06949095,4,2,2,0,1,1,0,0,0
06949279,3,2,1,0,2,1,1,2,1
06949431,4,0,4,0,0,0,0,0,1
06949595,6,4,2,0,2,2,0,0,0
06949793,2,0,2,0,1,1,0,0,1
06949957,14,8,6,0,0,0,0,0,0
06950167,5,0,5,0,0,0,0,0,1
06950168,5,0,5,0,0,0,0,0,1
06950880,1,1,0,0,1,1,0,0,0
06951346,6,4,2,0,0,0,0,0,0
06951617,3,2,1,0,1,1,0,0,1
06951808,9,0,9,0,1,1,0,1,1
06952266,2,2,0,0,2,2,0,0,1
06952311,45,14,31,0,1,1,0,1,1
06952533,1,1,0,0,2,2,0,0,0
06952665,4,0,4,0,0,0,0,0,1
06952856,11,4,7,0,1,1,0,0,1
06953098,10,4,6,0,1,1,0,1,1
06953114,13,4,9,0,2,1,1,2,1
06953650,28,7,21,0,0,0,0,0,1
06953712,5,0,5,0,1,1,0,0,1
06953890,8,3,5,0,1,1,0,1,1
06953891,8,0,8,0,1,1,0,1,1
06954419,5,2,3,0,1,1,0,0,0
06954548,11,5,6,0,0,0,0,0,1
06954762,10,2,8,0,3,1,2,3,0
06954794,3,3,0,0,2,2,0,0,0
06954800,10,2,8,0,3,1,2,3,0
06955165,10,2,8,0,3,1,2,3,0
06955372,20,4,16,0,1,1,0,1,1
06955715,10,2,8,0,3,1,2,3,0
06955969,3,3,0,0,1,1,0,0,1
06956368,4,1,3,0,1,1,0,0,0
06956383,17,4,13,0,2,2,0,2,1
06956432,7,3,4,0,1,1,0,0,1
06956490,5,0,5,0,0,0,0,0,1
06956588,12,9,3,0,0,0,0,0,0
06956649,3,0,3,0,1,1,0,0,1
06956929,2,1,1,0,1,1,0,1,0
06957186,2,1,1,0,1,1,0,0,0
06957593,16,5,11,0,1,1,0,1,1
06957623,3,3,0,0,1,1,0,0,1
06958072,12,5,7,0,1,1,0,0,1
06958074,4,0,4,0,1,1,0,0,0
06958449,2,2,0,0,1,1,0,0,1
06958589,8,5,3,0,4,4,0,0,0
06958711,4,3,1,0,4,4,0,4,1
06958771,1,1,0,0,1,1,0,0,0
06958799,19,3,16,0,2,1,1,0,1
06959028,1,1,0,0,1,1,0,1,0
06959165,14,7,7,0,1,1,0,1,1
06959581,14,3,11,0,1,1,0,1,1
06959601,6,0,6,0,0,0,0,0,1
06959621,8,3,5,0,0,0,0,0,0
06959725,2,2,0,0,1,1,0,0,0
06959738,4,3,1,0,1,1,0,0,0
06959787,18,4,14,0,3,1,2,0,0
06959885,2,0,2,0,1,1,0,0,0
06032131,24,3,21,0,1,1,0,1,1
06032145,4,2,2,0,1,1,0,0,1
06032206,9,3,6,0,1,1,0,1,1
06032270,14,3,11,0,1,1,0,1,1
06032370,4,0,4,0,1,1,0,0,1
06032719,5,0,5,0,0,0,0,0,1
06032746,11,6,5,0,0,0,0,0,1
06032755,11,3,8,0,0,0,0,0,1
06033097,7,3,4,0,2,2,0,1,1
06033238,90,16,74,0,0,0,0,0,1
06033644,15,5,10,0,0,0,0,0,0
06033814,5,2,3,0,1,1,0,0,0
06033841,4,0,4,0,0,0,0,0,1
06033864,4,0,4,0,0,0,0,0,1
06033909,8,5,3,0,0,0,0,0,0
06034018,13,3,10,0,3,3,0,1,1
06034019,5,3,2,0,1,1,0,1,1
06034081,6,2,4,0,1,1,0,0,0
06034192,4,3,1,0,1,1,0,1,1
06034211,9,0,9,0,0,0,0,0,1
06034226,19,4,15,0,0,0,0,0,1
06034396,20,6,14,0,1,1,0,1,1
06034440,4,0,4,0,1,1,0,0,1
06034459,8,4,4,0,0,0,0,0,0
06034762,10,3,7,0,0,0,0,0,1
06035106,23,8,15,0,0,0,0,0,1
06035134,6,4,2,0,3,3,0,0,1
06035165,34,11,23,0,0,0,0,0,1
06035252,7,3,4,0,3,3,0,0,1
06035320,19,3,16,0,1,1,0,1,1
06035375,3,0,3,0,0,0,0,0,1
06035450,13,2,11,0,0,0,0,0,1
06035503,3,0,3,0,0,0,0,0,1
06035564,4,0,4,0,0,0,0,0,1
06035588,4,3,1,0,2,2,0,0,1
06035589,11,4,7,0,0,0,0,0,1
06035604,2,2,0,0,1,1,0,0,1
06035675,5,3,2,0,1,1,0,0,0
06035691,17,4,13,0,1,1,0,0,1
06035820,13,6,7,0,1,1,0,1,1
06035967,8,3,5,0,0,0,0,0,1
06035972,7,2,5,0,2,1,1,0,1
06035973,7,1,6,0,2,2,0,0,1
06036097,10,0,10,0,0,0,0,0,1
06036339,5,3,2,0,2,2,0,0,1
06036574,7,4,3,0,0,0,0,0,1
06036603,6,5,1,0,3,3,0,0,1
06036661,7,5,2,0,2,2,0,0,0
06036724,6,4,2,0,1,1,0,0,1
06036729,2,1,1,0,2,2,0,0,0
06037086,5,3,2,0,2,2,0,0,1
06037108,12,0,12,0,0,0,0,0,1
06037448,8,2,6,0,1,1,0,1,1
06037454,23,3,20,2,1,1,0,1,1
06037565,7,2,5,0,1,1,0,0,1
06037609,5,3,2,0,1,1,0,0,1
06037612,4,2,2,0,2,2,0,0,1
06037742,21,8,13,0,0,0,0,0,0
06037745,10,1,9,0,4,2,2,1,1
06037879,9,0,9,0,1,1,0,0,0
06038066,15,0,15,0,0,0,0,0,1
06038135,6,3,3,0,2,2,0,0,1
06038374,11,3,8,0,0,0,0,0,0
06038746,5,3,2,0,1,1,0,0,1
06039070,8,2,6,0,1,1,0,0,1
06039536,6,2,4,0,1,1,0,0,1
06039570,11,3,8,0,1,1,0,1,1
06039601,18,4,14,0,1,1,0,1,1
06039745,17,0,17,1,0,0,0,0,1
06039751,6,1,5,0,1,1,0,0,0
06040232,15,6,9,0,0,0,0,0,1
06040296,8,4,4,0,1,1,0,0,1
06040341,8,5,3,0,3,3,0,0,1
06040753,8,0,8,0,0,0,0,0,1
06040831,3,3,0,0,2,2,0,0,0
06040951,9,3,6,0,3,1,2,1,1
06041033,19,3,16,0,1,1,0,1,0
06041260,5,3,2,0,2,2,0,0,1
06041318,13,6,7,0,1,1,0,1,1
06041354,31,7,24,0,1,1,0,0,0
06041418,7,3,4,0,2,2,0,0,1
06041569,18,4,14,0,1,1,0,0,1
06041629,15,9,6,0,0,0,0,0,1
06041711,5,0,5,0,0,0,0,0,1
06042073,5,3,2,0,1,1,0,0,0
06042454,4,1,3,0,1,1,0,0,1
06042482,4,2,2,0,1,1,0,0,1
06042537,2,2,0,0,2,2,0,0,0
06042731,22,0,22,0,1,1,0,1,1
06042968,12,2,10,0,1,1,0,0,0
06042995,5,0,5,1,0,0,0,0,1
06043080,6,0,6,0,2,2,0,0,1
06043249,11,4,7,0,0,0,0,0,1
06043262,7,3,4,0,2,2,0,0,0
06043366,5,1,4,0,2,1,1,0,1
06043445,5,0,5,0,1,1,0,0,1
06043492,7,0,7,0,0,0,0,0,1
06043500,2,0,2,0,1,1,0,0,0
06043508,17,4,13,0,1,1,0,1,1
06043840,10,2,8,1,2,1,1,1,1
06043968,2,2,0,0,1,1,0,0,0
06044108,10,8,2,0,1,1,0,0,1
06044218,28,9,19,0,1,1,0,0,0
06044437,5,3,2,0,1,1,0,0,1
06044483,4,1,3,0,1,1,0,0,1
06044575,6,3,3,0,1,1,0,1,1
06044647,7,2,5,0,2,2,0,0,1
06044978,15,4,11,0,2,2,0,2,1
06044990,21,3,18,0,2,1,1,1,1
06045009,7,0,7,0,1,1,0,0,1
06045013,4,2,2,0,2,2,0,0,1
06045019,4,0,4,0,0,0,0,0,1
06045039,5,3,2,0,2,2,0,0,1
06045044,5,2,3,0,2,2,0,0,1
06045079,11,4,7,0,1,1,0,0,1
06045092,6,3,3,0,1,1,0,0,1
06045490,14,2,12,0,2,2,0,0,1
06045608,4,0,4,0,1,1,0,0,1
06045680,9,6,3,0,6,6,0,0,1
06045717,4,0,4,0,0,0,0,0,1
06045776,6,1,5,0,1,1,0,0,1
06045886,5,3,2,0,2,2,0,0,1
06045964,6,2,4,0,2,2,0,0,1
06046081,6,0,6,0,0,0,0,0,0
06046296,13,0,13,0,0,0,0,0,1
06046341,4,0,4,0,1,1,0,0,1
06046519,5,3,2,0,2,2,0,0,1
06046630,6,2,4,0,1,1,0,0,1
06046754,6,5,1,0,1,1,0,0,1
06046758,5,3,2,0,1,1,0,0,1
06046870,13,5,8,0,3,1,2,1,1
06046892,12,5,7,0,2,2,0,2,1
06046899,11,4,7,0,1,1,0,1,1
06046949,5,2,3,0,1,1,0,0,1
06047122,12,3,9,0,1,1,0,1,1
06047212,10,0,10,0,0,0,0,0,1
06047312,24,6,18,0,2,2,0,2,1
06047526,4,2,2,0,1,1,0,0,1
06047633,7,4,3,0,1,1,0,1,1
06047642,7,4,3,0,1,1,0,1,1
06047720,7,4,3,0,1,1,0,1,1
06047748,4,1,3,0,1,1,0,0,1
06047763,9,1,8,0,1,1,0,1,1
06047786,5,3,2,0,1,1,0,0,1
06047813,6,2,4,0,1,1,0,1,1
06047829,5,2,3,0,1,1,0,0,1
06047833,6,0,6,0,0,0,0,0,1
06047840,8,4,4,0,0,0,0,0,1
06047841,5,3,2,0,1,1,0,0,1
06047888,4,2,2,0,2,2,0,0,1
06047906,7,3,4,0,2,2,0,0,1
06047926,4,2,2,0,1,1,0,0,1
06048018,5,0,5,0,0,0,0,0,1
06048319,5,3,2,0,1,1,0,0,1
06048403,5,3,2,0,1,1,0,0,1
06048589,13,5,8,0,2,1,1,2,1
06048596,26,0,26,0,0,0,0,0,1
06048607,3,3,0,0,2,2,0,0,0
06048739,9,4,5,0,1,1,0,0,1
06048751,5,3,2,0,2,2,0,0,1
06048760,5,3,2,0,1,1,0,0,1
06048769,5,0,5,0,0,0,0,0,1
06048814,4,1,3,0,1,1,0,0,1
06048822,4,1,3,0,3,1,2,1,1
06048853,13,3,10,0,2,2,0,2,1
06048916,6,3,3,0,2,2,0,0,1
06049099,6,1,5,0,0,0,0,0,1
06049216,27,10,17,0,0,0,0,0,1
06049295,6,0,6,0,0,0,0,0,1
06049492,7,0,7,0,0,0,0,0,1
06049504,4,2,2,0,0,0,0,0,1
06049984,4,2,2,0,1,1,0,0,1
06050162,3,0,3,0,0,0,0,0,1
06050200,4,1,3,0,1,1,0,0,1
06050223,3,1,2,0,1,1,0,0,1
06050283,5,3,2,0,2,2,0,0,1
06050314,3,1,2,0,1,1,0,0,1
06050393,4,2,2,0,1,1,0,0,1
06050409,7,2,5,0,1,1,0,0,1
06050461,4,3,1,0,2,2,0,0,1
06050638,11,3,8,0,0,0,0,0,0
06050671,4,1,3,0,0,0,0,0,1
06050743,4,0,4,0,0,0,0,0,1
06050767,12,7,5,0,1,1,0,0,1
06050780,12,7,5,0,1,1,0,0,1
06050908,3,0,3,0,0,0,0,0,1
06050916,5,3,2,0,2,2,0,0,1
06050933,5,0,5,0,0,0,0,0,1
06050955,4,2,2,0,1,1,0,0,1
06050970,6,3,3,0,2,2,0,0,1
06051030,23,3,20,0,3,3,0,0,1
06051085,31,7,24,0,1,1,0,0,0
06051096,27,6,21,0,0,0,0,0,0
06051119,4,2,2,0,2,2,0,0,1
06051253,12,2,10,0,0,0,0,0,1
06051328,4,3,1,0,0,0,0,0,0
06051356,6,2,4,0,2,1,1,0,1
06051415,7,5,2,0,2,2,0,0,1
06051438,13,3,10,0,1,1,0,1,0
06051644,28,10,18,0,1,1,0,1,1
06051736,6,3,3,0,2,2,0,1,1
06051768,5,0,5,0,0,0,0,0,1
06051894,4,2,2,0,1,1,0,0,1
06052133,4,2,2,0,2,2,0,0,1
06052252,4,2,2,0,1,1,0,0,1
06052267,5,3,2,0,1,1,0,0,1
06052309,4,1,3,0,1,1,0,0,0
06052337,6,4,2,0,1,1,0,1,1
06052346,17,7,10,0,0,0,0,0,0
06052401,5,0,5,0,0,0,0,0,1
06052402,5,0,5,0,0,0,0,0,1
06052741,10,0,10,0,2,2,0,1,1
06052827,5,0,5,0,0,0,0,0,1
06052887,6,0,6,0,0,0,0,0,1
06052905,8,0,8,0,0,0,0,0,1
06052914,5,3,2,0,2,2,0,0,1
06052980,49,15,34,0,0,0,0,0,0
06053000,6,4,2,0,1,1,0,0,1
06053066,4,0,4,0,0,0,0,0,1
06053078,6,2,4,0,2,2,0,0,1
06053274,12,0,12,0,0,0,0,0,1
06053280,16,3,13,1,1,1,0,1,1
06053314,10,6,4,0,7,6,1,0,1
06053385,6,4,2,0,2,2,0,0,1
06053457,4,2,2,0,1,1,0,0,1
06053504,7,0,7,0,0,0,0,0,1
06053786,4,0,4,0,0,0,0,0,1
06053836,5,3,2,0,1,1,0,0,0
06053858,9,4,5,0,1,1,0,1,1
06053979,12,4,8,0,5,3,2,0,1
06053987,5,3,2,0,2,2,0,0,1
06053995,18,3,15,0,1,1,0,1,1
06054071,6,3,3,0,2,1,1,0,1
06054191,4,2,2,0,1,1,0,0,1
06054194,3,1,2,0,2,1,1,0,1
06054257,6,3,3,1,0,0,0,0,0
06054300,5,0,5,0,0,0,0,0,1
06054422,28,4,24,0,1,1,0,1,0
06054904,6,3,3,0,0,0,0,0,1
06055015,6,3,3,0,1,1,0,0,1
06055169,4,3,1,0,1,1,0,0,1
06055468,6,0,6,0,2,2,0,0,1
06055526,17,1,16,0,2,2,0,2,1
06055540,20,1,19,0,1,1,0,1,1
06055550,4,1,3,0,0,0,0,0,1
06055621,4,0,4,0,0,0,0,0,1
06055750,3,0,3,0,1,1,0,0,1
06055759,5,1,4,0,1,1,0,0,1
06055768,10,2,8,0,3,1,2,1,0
06055779,11,5,6,0,1,1,0,0,1
06055967,5,0,5,0,0,0,0,0,1
06056094,6,4,2,0,1,1,0,1,1
06056341,5,3,2,0,1,1,0,1,1
06056448,21,8,13,0,1,1,0,1,1
06056605,9,4,5,0,1,1,0,0,0
06056706,5,3,2,0,2,2,0,0,1
06056712,6,3,3,0,2,2,0,0,1
06056847,5,0,5,0,0,0,0,0,1
06056889,12,4,8,0,0,0,0,0,1
06056974,7,3,4,0,1,0,1,1,1
06057001,3,2,1,0,1,1,0,0,0
06057018,4,2,2,0,1,1,0,0,1
06057067,19,3,16,0,1,1,0,0,1
06057109,9,3,6,0,0,0,0,0,1
06057115,4,2,2,0,1,1,0,0,1
06057294,5,1,4,0,1,1,0,0,0
06057391,3,0,3,0,0,0,0,0,1
06057412,11,2,9,0,1,1,0,1,0
06057422,13,0,13,0,0,0,0,0,1
06057667,16,5,11,0,1,1,0,1,1
06057726,3,0,3,0,0,0,0,0,1
02572091,31,7,24,0,1,1,0,1,1
02572345,23,2,21,0,1,1,0,1,1
02572439,9,3,6,0,0,0,0,0,0
02572617,0,0,0,0,0,0,0,0,1
02572704,52,3,49,0,2,1,1,2,1
02572950,6,3,3,0,1,1,0,0,1
02573397,4,0,4,0,1,1,0,1,1
02573758,25,3,22,0,0,0,0,0,1
02573862,2,2,0,0,1,1,0,0,1
02574622,20,3,17,0,1,1,0,0,0
02574907,15,3,12,0,0,0,0,0,1
02575013,42,3,39,0,1,1,0,1,1
02575335,17,4,13,0,0,0,0,0,1
02575343,17,5,12,0,0,0,0,0,1
02575441,7,2,5,0,0,0,0,0,1
02575505,13,4,9,0,1,1,0,0,1
02575566,9,6,3,0,4,4,0,0,0
02575789,0,0,0,0,0,0,0,0,1
02575974,22,11,11,0,1,1,0,1,1
02576014,32,6,26,0,0,0,0,0,0
02576044,22,4,18,0,0,0,0,0,1
02576295,26,8,18,0,1,1,0,1,1
02576400,29,0,29,0,0,0,0,0,1
02576495,59,6,53,0,10,6,4,0,0
02576548,5,3,2,0,1,1,0,0,1
02576828,95,15,80,0,0,0,0,0,1
02576833,25,6,19,0,0,0,0,0,0
02577401,18,5,13,0,4,0,4,0,1
02577579,27,0,27,0,0,0,0,0,1
02577757,27,0,27,0,0,0,0,0,1
02577764,26,3,23,0,0,0,0,0,1
02577952,118,4,114,0,3,3,0,1,1
02577955,119,13,106,0,3,3,0,1,1
02577970,9,0,9,0,1,1,0,1,1
02577991,28,3,25,0,1,1,0,1,1
02578005,66,3,63,0,1,1,0,1,1
02578163,42,7,35,0,0,0,0,0,1
02578359,9,0,9,0,0,0,0,0,1
02578411,12,3,9,0,3,3,0,0,0
02578483,12,4,8,0,2,1,1,0,1
02578528,16,1,15,0,4,2,2,1,1
02578942,34,3,31,0,0,0,0,0,1
02579007,4,2,2,0,2,2,0,0,1
02579027,12,3,9,0,1,1,0,1,0
02579065,43,0,43,0,0,0,0,0,1
02579110,38,9,29,0,1,1,0,1,1
02579140,19,5,14,0,0,0,0,0,0
02579178,17,7,10,0,1,1,0,1,1
02579300,8,0,8,0,0,0,0,0,1
02579305,29,0,29,0,0,0,0,0,1
02579308,33,4,29,0,1,1,0,1,1
02579617,73,3,70,0,4,3,1,1,1
02579629,17,4,13,0,3,3,0,1,1
02579637,19,0,19,0,0,0,0,0,1
02579685,14,5,9,0,3,1,2,1,1
02579831,3,2,1,0,1,1,0,0,1
02580154,27,0,27,0,0,0,0,0,1
02580190,8,5,3,0,1,1,0,0,1
02580253,15,0,15,0,0,0,0,0,1
02580377,85,14,71,0,0,0,0,0,1
02580387,20,2,18,0,1,1,0,1,1
02580394,31,3,28,0,1,1,0,1,1
02580425,22,2,20,0,1,1,0,1,1
02580547,26,5,21,0,6,0,6,0,1
02580579,36,8,28,0,0,0,0,0,1
02580785,21,2,19,0,1,1,0,1,1
02580873,14,0,14,0,1,1,0,1,1
02580953,65,9,56,0,0,0,0,0,0
02580979,5,3,2,0,2,2,0,0,1
02581191,27,3,24,0,1,1,0,1,1
02581633,15,5,10,0,1,1,0,0,1
02581663,8,2,6,0,0,0,0,0,1
02581681,30,3,27,0,1,1,0,1,1
02582092,10,6,4,0,0,0,0,0,1
02582323,29,0,29,0,1,1,0,1,1
02582344,27,2,25,0,1,1,0,1,1
02582503,14,2,12,0,1,1,0,1,1
02582818,25,5,20,0,1,1,0,1,1
02582859,19,0,19,0,1,1,0,1,1
02583299,15,0,15,0,0,0,0,0,1
02583342,42,4,38,0,1,1,0,1,1
02584122,32,3,29,0,1,1,0,1,1
02584152,29,3,26,0,1,1,0,1,1
02584476,23,2,21,0,1,1,0,1,1
02584703,37,3,34,0,1,1,0,1,1
02584791,16,0,16,0,0,0,0,0,1
02584919,11,3,8,0,3,3,0,0,0
02584952,36,7,29,0,1,1,0,1,1
02585038,9,3,6,0,1,1,0,1,1
02585114,7,2,5,0,1,1,0,0,0
02585199,34,7,27,0,1,0,1,0,1
02585477,5,3,2,0,0,0,0,0,1
02585612,39,0,39,0,0,0,0,0,1
02585745,38,6,32,0,0,0,0,0,1
02585759,57,7,50,0,1,1,0,1,1
02585763,31,4,27,0,1,1,0,1,1
02585798,45,2,43,0,1,1,0,1,1
02585841,21,2,19,0,1,1,0,0,0
02586027,35,0,35,0,0,0,0,0,1
02586275,0,0,0,0,0,0,0,0,1
02586357,71,6,65,0,1,1,0,1,1
02586929,34,4,30,0,1,1,0,1,1
02586983,8,0,8,0,1,1,0,0,1
02587008,41,13,28,0,0,0,0,0,1
02587035,18,1,17,0,0,0,0,0,1
02587294,13,0,13,0,0,0,0,0,1
02587384,20,3,17,0,1,1,0,1,1
02587577,3,3,0,0,1,1,0,1,0
02587649,57,4,53,0,1,1,0,1,1
02587713,7,2,5,0,2,2,0,0,1
02588074,35,5,30,0,1,1,0,1,1
02588085,34,2,32,0,2,2,0,2,1
02588092,10,0,10,0,0,0,0,0,1
02588230,30,4,26,0,0,0,0,0,1
02588533,34,6,28,0,0,0,0,0,0
02588729,21,4,17,0,1,1,0,1,1
02588783,20,4,16,0,3,3,0,0,1
02588937,17,0,17,0,1,1,0,1,1
02588952,53,2,51,0,1,1,0,1,1
02588989,17,3,14,0,0,0,0,0,0
02589238,111,12,99,0,1,1,0,0,1
02589304,16,5,11,0,1,1,0,0,0
02589391,21,0,21,0,0,0,0,0,1
02589500,7,4,3,0,1,1,0,0,1
02589897,7,4,3,0,2,2,0,0,1
02590405,7,3,4,0,1,1,0,0,1
02590406,15,0,15,0,0,0,0,0,1
02590421,12,2,10,0,1,1,0,0,1
02590560,60,13,47,0,0,0,0,0,1
02590622,12,0,12,0,1,1,0,0,1
02590676,14,3,11,0,1,1,0,0,1
02591188,61,9,52,0,2,2,0,2,1
02591237,64,5,59,0,3,1,2,3,1
02591307,28,4,24,0,1,1,0,1,1
02591468,8,4,4,0,4,4,0,0,1
02591474,206,20,186,0,24,20,4,0,1
02591486,12,4,8,0,1,1,0,1,1
02591631,38,8,30,0,1,0,1,0,1
02591651,18,9,9,0,0,0,0,0,1
02592055,21,5,16,0,0,0,0,0,1
02592238,15,3,12,0,1,1,0,1,1
02592450,53,8,45,0,0,0,0,0,1
02592501,16,2,14,0,1,1,0,1,1
02592604,7,2,5,0,2,2,0,0,0
02592695,16,0,16,0,0,0,0,0,1
02592715,26,0,26,0,1,1,0,1,1
02592742,0,0,0,0,0,0,0,0,1
02592778,24,5,19,0,1,1,0,1,1
02593093,31,5,26,0,0,0,0,0,1
02593515,10,5,5,0,3,1,2,1,0
02593799,14,0,14,0,0,0,0,0,1
02593849,26,3,23,0,0,0,0,0,1
02593851,15,3,12,0,0,0,0,0,1
02593853,15,3,12,0,0,0,0,0,1
02593866,15,3,12,0,0,0,0,0,1
02593879,15,3,12,0,0,0,0,0,1
02593892,18,3,15,0,2,2,0,1,1
02593980,15,3,12,0,0,0,0,0,1
02594188,25,3,22,0,1,1,0,1,1
02594490,44,2,42,0,2,2,0,0,1
02594855,10,4,6,0,0,0,0,0,1
02594874,10,2,8,0,1,1,0,1,1
02594933,12,0,12,0,0,0,0,0,1
02594987,50,3,47,0,1,1,0,1,1
02595016,7,3,4,0,2,2,0,0,0
02595018,58,8,50,0,0,0,0,0,1
02595043,44,3,41,0,1,1,0,1,1
02595189,45,3,42,0,0,0,0,0,1
02595242,50,0,50,0,0,0,0,0,1
02595667,46,0,46,0,0,0,0,0,1
02595814,54,4,50,0,1,1,0,1,1
02596082,11,3,8,0,3,3,0,0,0
02596452,86,5,81,0,1,1,0,1,1
02596568,21,2,19,0,1,1,0,1,1
02596748,12,5,7,0,1,1,0,0,0
02597027,30,2,28,0,1,1,0,1,1
02597050,41,6,35,0,2,2,0,2,1
02597082,41,0,41,0,1,1,0,1,1
02597088,30,2,28,0,1,1,0,1,1
02597113,38,0,38,0,0,0,0,0,1
02597128,42,3,39,0,1,1,0,1,1
02597388,12,0,12,0,0,0,0,0,0
02597413,5,3,2,0,2,2,0,0,1
02597487,6,0,6,0,0,0,0,0,1
02597705,9,4,5,0,1,1,0,1,1
02597785,10,0,10,0,0,0,0,0,1
02597991,9,1,8,0,2,1,1,0,1
02598128,95,37,58,0,0,0,0,0,1
02598141,29,0,29,0,1,1,0,1,1
02598228,95,36,59,0,1,1,0,1,1
02598310,13,2,11,0,0,0,0,0,1
02598317,11,0,11,0,0,0,0,0,0
02598434,7,2,5,0,1,1,0,0,0
02598580,41,0,41,0,0,0,0,0,1
02598686,12,3,9,0,1,1,0,0,1
02598772,78,0,78,0,0,0,0,0,1
02598783,13,7,6,0,0,0,0,0,1
02598826,9,3,6,0,2,2,0,0,1
02599098,4,2,2,0,1,1,0,0,1
02599176,4,0,4,0,1,1,0,0,1
02599217,8,0,8,0,0,0,0,0,1
02599270,29,0,29,0,0,0,0,0,1
02599428,90,12,78,0,0,0,0,0,1
02599802,24,3,21,0,1,1,0,1,1
02600089,20,4,16,0,1,1,0,1,1
02600168,12,5,7,0,1,1,0,1,1
02600192,11,5,6,0,2,2,0,2,1
02600346,40,0,40,0,0,0,0,0,1
02600469,10,4,6,0,1,1,0,0,0
02600483,50,4,46,0,1,1,0,1,1
02600590,80,7,73,0,1,1,0,0,1
02600841,40,6,34,0,2,1,1,2,1
02600994,18,3,15,0,1,1,0,0,1
02601074,14,6,8,0,1,1,0,1,1
02601467,26,4,22,0,1,1,0,0,1
02601480,76,9,67,0,2,1,1,0,1
02601506,6,1,5,0,1,1,0,0,0
02601622,34,0,34,0,0,0,0,0,1
02601741,28,7,21,0,0,0,0,0,1
02601758,17,0,17,0,0,0,0,0,1
02601874,11,4,7,0,1,1,0,1,1
02602425,18,3,15,0,1,1,0,1,0
02602460,17,2,15,0,0,0,0,0,1
02602523,66,0,66,0,1,1,0,0,1
02602888,18,3,15,0,1,1,0,1,1
02603087,27,0,27,0,0,0,0,0,1
02603115,20,4,16,0,0,0,0,0,1
02603321,86,0,86,0,0,0,0,0,1
02603322,65,9,56,0,0,0,0,0,1
02603349,49,0,49,0,0,0,0,0,1
02603456,49,3,46,0,1,1,0,1,1
02603700,78,11,67,0,0,0,0,0,1
02603954,30,2,28,0,1,1,0,1,1
02604188,20,0,20,0,0,0,0,0,1
02604256,12,0,12,0,1,1,0,0,1
02604351,54,3,51,0,1,1,0,1,1
02604354,66,3,63,0,1,1,0,1,1
02604355,48,0,48,0,0,0,0,0,1
02604359,54,8,46,0,1,1,0,1,1
02604361,31,3,28,0,1,1,0,1,1
02604555,6,0,6,0,0,0,0,0,0
02605125,58,4,54,0,1,1,0,1,1
02605138,53,16,37,0,1,1,0,1,1
02605209,12,4,8,0,1,1,0,1,1
02605399,33,7,26,0,1,1,0,1,1
02605568,56,7,49,0,2,1,1,2,1
02605705,21,0,21,0,0,0,0,0,1
02605780,7,2,5,0,1,1,0,1,1
02606147,75,4,71,0,0,0,0,0,0
02606388,15,3,12,0,1,1,0,1,1
02606478,49,9,40,0,1,1,0,1,1
02606680,29,3,26,0,1,1,0,1,1
02606691,12,3,9,0,0,0,0,0,1
02606752,15,4,11,0,1,1,0,1,1
02607081,37,9,28,0,1,1,0,1,1
02607683,39,0,39,0,0,0,0,0,1
02607995,29,6,23,0,0,0,0,0,1
02608391,31,6,25,0,1,1,0,1,1
02608392,19,0,19,0,0,0,0,0,1
02608503,30,0,30,0,0,0,0,0,1
02608515,18,3,15,0,1,1,0,1,1
02608543,28,0,28,0,0,0,0,0,1
02608585,11,3,8,0,2,2,0,0,1
02608610,19,2,17,0,1,1,0,0,1
02608655,12,3,9,0,1,1,0,1,1
02608731,58,8,50,0,1,1,0,1,1
02608790,147,4,143,0,2,1,1,0,1
02608858,5,3,2,0,1,1,0,0,0
02609047,22,7,15,0,0,0,0,0,1
02609100,52,9,43,0,1,1,0,1,1
02609312,27,2,25,0,0,0,0,0,1
02609358,22,7,15,0,0,0,0,0,1
02609486,32,0,32,0,0,0,0,0,1
02609922,19,0,19,0,0,0,0,0,1
02610027,4,0,4,0,0,0,0,0,1
02610170,18,2,16,0,1,1,0,1,1
02610208,62,9,53,0,0,0,0,0,1
02610309,17,2,15,0,1,1,0,0,1
02610451,25,0,25,0,0,0,0,0,1
02610531,19,0,19,0,0,0,0,0,1
02610553,16,6,10,0,0,0,0,0,1
02610559,37,7,30,0,0,0,0,0,1
02610689,17,2,15,0,1,1,0,1,1
02610711,78,4,74,0,0,0,0,0,1
02611160,8,2,6,0,1,1,0,0,1
02611177,5,3,2,0,1,1,0,0,1
02611196,24,0,24,0,0,0,0,0,0
02611343,26,0,26,0,0,0,0,0,1
02611561,27,4,23,0,1,1,0,1,1
02611785,29,8,21,0,1,1,0,1,1
02611800,24,4,20,0,1,1,0,1,1
02612021,24,0,24,0,1,1,0,1,1
02612067,0,0,0,0,0,0,0,0,1
02612286,26,2,24,0,2,1,1,2,1
02612429,34,3,31,0,0,0,0,0,1
02612693,12,3,9,0,2,2,0,0,1
02613025,31,0,31,0,0,0,0,0,1
02613042,13,3,10,0,1,1,0,1,1
02613326,24,3,21,0,1,1,0,1,1
02613405,33,5,28,0,0,0,0,0,1
02613429,41,0,41,0,1,1,0,1,1
02613482,15,3,12,0,1,1,0,1,1
02613491,20,3,17,0,1,1,0,1,1
02613515,6,2,4,0,2,1,1,0,1
02613553,39,9,30,0,0,0,0,0,1
02613614,13,2,11,0,1,1,0,0,1
02613862,28,6,22,0,0,0,0,0,1
02614040,26,0,26,0,0,0,0,0,1
02614050,12,6,6,0,1,1,0,0,1
02614345,15,4,11,0,1,1,0,1,0
02614718,5,2,3,0,1,1,0,0,1
02614795,5,2,3,0,1,1,0,0,0
02614913,29,0,29,0,0,0,0,0,1
02615001,16,7,9,0,1,1,0,0,1
02615156,36,0,36,0,1,1,0,1,1
02615234,39,3,36,0,0,0,0,0,1
02615555,45,5,40,0,1,1,0,1,1
02615558,24,0,24,0,0,0,0,0,1
02615774,4,2,2,0,2,2,0,0,0
02617729,39,0,39,0,0,0,0,0,1
02617972,32,2,30,0,2,1,1,1,1
02617995,5,3,2,0,2,2,0,0,1
02618314,35,0,35,0,0,0,0,0,1
02618322,5,1,4,0,1,1,0,1,1
02618338,21,0,21,0,0,0,0,0,1
02618412,28,2,26,0,0,0,0,0,1
02618453,61,6,55,0,0,0,0,0,0
02618616,35,5,30,0,1,1,0,1,1
02618618,18,2,16,0,0,0,0,0,1
02618629,5,3,2,0,0,0,0,0,1
02618642,12,6,6,0,4,1,3,1,1
02619094,28,0,28,0,1,1,0,1,1
02619290,11,3,8,0,2,2,0,0,0
02620267,5,3,2,0,2,2,0,0,1
02620271,14,3,11,0,3,3,0,0,1
02620275,10,0,10,0,0,0,0,0,1
02620871,11,5,6,0,2,2,0,0,1
02621328,29,3,26,0,1,1,0,1,1
02621398,0,0,0,0,0,0,0,0,1
02621486,10,1,9,0,1,1,0,0,1
02621552,8,3,5,0,1,1,0,0,1
02621683,16,0,16,0,0,0,0,0,0
02621963,19,13,6,0,0,0,0,0,1
02622235,39,5,34,0,0,0,0,0,1
02622374,59,3,56,0,6,3,3,0,1
02622526,4,3,1,0,0,0,0,0,1
02622660,89,14,75,0,1,1,0,0,0
02622689,51,4,47,0,0,0,0,0,1
02622696,20,2,18,0,1,1,0,1,1
02622815,15,2,13,0,1,1,0,0,1
02622895,45,4,41,0,1,1,0,1,1
02623347,13,2,11,0,0,0,0,0,1
02623799,32,6,26,0,1,1,0,0,1
02624695,26,0,26,0,0,0,0,0,1
02624820,19,2,17,0,1,1,0,1,1
02624904,6,5,1,0,1,1,0,0,1
02624905,7,2,5,0,1,1,0,0,1
02624984,44,0,44,0,0,0,0,0,1
02624987,35,3,32,0,1,1,0,1,1
02625210,28,6,22,0,1,1,0,0,1
02625263,32,6,26,0,1,0,1,0,1
02625579,3,2,1,0,1,1,0,0,0
02625673,20,3,17,0,5,2,3,0,0
02625753,14,1,13,0,2,1,1,0,1
02626019,32,0,32,0,0,0,0,0,1
02626061,10,3,7,0,1,1,0,0,0
02626128,32,9,23,0,0,0,0,0,1
02626906,16,3,13,0,1,1,0,1,1
02627250,6,1,5,0,2,1,1,0,1
02627406,35,4,31,0,1,1,0,1,1
02627434,7,0,7,0,0,0,0,0,1
02627438,4,2,2,0,0,0,0,0,1
02627501,34,5,29,0,1,1,0,1,1
02627837,12,0,12,0,0,0,0,0,1
02627909,94,8,86,0,0,0,0,0,1
02628024,4,3,1,0,2,2,0,0,0
02628224,51,9,42,0,0,0,0,0,1
02628517,13,4,9,0,3,3,0,0,1
02628570,23,3,20,0,1,1,0,1,1
02628742,0,0,0,0,0,0,0,0,1
02628803,20,5,15,0,0,0,0,0,1
02628835,12,3,9,0,3,3,0,0,0
02629011,9,3,6,0,2,2,0,0,1
02629347,160,15,145,0,2,0,2,0,1
02629365,6,4,2,0,1,1,0,0,0
02629413,17,4,13,0,2,2,0,2,1
02629674,27,9,18,0,0,0,0,0,1
02629783,11,5,6,0,5,5,0,0,0
02629833,15,0,15,0,0,0,0,0,0
02629866,33,0,33,0,0,0,0,0,1
02629917,23,2,21,0,1,1,0,1,1
02629919,50,5,45,0,2,1,1,2,1
FC026918,5,0,5,0,0,0,0,0,1
FC026987,4,0,4,0,0,0,0,0,1
FC027013,4,4,0,0,0,0,0,0,0
FC027017,4,4,0,0,0,0,0,0,0
FC027018,4,4,0,0,0,0,0,0,0
FC027022,4,4,0,0,0,0,0,0,0
FC027023,8,4,4,1,0,0,0,0,0
FC027059,5,0,5,0,0,0,0,0,1
FC027122,9,9,0,0,0,0,0,0,1
FC027229,11,0,11,0,0,0,0,0,1
FC027254,5,3,2,0,0,0,0,0,1
FC027255,5,4,1,0,0,0,0,0,1
FC027397,13,0,13,0,0,0,0,0,1
FC027412,4,2,2,0,0,0,0,0,1
FC027421,9,0,9,0,0,0,0,0,1
FC027422,9,0,9,0,0,0,0,0,1
FC027423,9,0,9,0,0,0,0,0,1
FC027450,19,0,19,0,0,0,0,0,1
FC027451,20,0,20,0,0,0,0,0,1
FC027504,3,0,3,0,0,0,0,0,1
FC027549,4,2,2,0,0,0,0,0,1
FC027550,4,3,1,0,0,0,0,0,1
FC027557,4,2,2,0,0,0,0,0,0
FC027583,8,0,8,0,0,0,0,0,1
FC027613,8,3,5,1,0,0,0,0,1
FC027655,10,0,10,0,0,0,0,0,1
FC027656,10,0,10,0,0,0,0,0,1
FC027672,18,2,16,0,0,0,0,0,1
FC027728,8,0,8,0,0,0,0,0,1
FC027758,26,6,20,0,0,0,0,0,1
FC027780,10,0,10,0,0,0,0,0,1
FC027787,10,0,10,0,0,0,0,0,1
FC027889,10,0,10,0,0,0,0,0,1
FC027898,17,4,13,0,0,0,0,0,1
FC027902,11,0,11,0,0,0,0,0,1
FC027923,9,0,9,0,0,0,0,0,1
FC027988,20,10,10,0,0,0,0,0,1
FC028009,10,0,10,0,0,0,0,0,1
FC028086,7,0,7,0,0,0,0,0,1
FC028087,7,0,7,0,0,0,0,0,1
FC028088,9,4,5,0,0,0,0,0,1
FC028121,6,0,6,0,0,0,0,0,0
FC028134,5,0,5,0,0,0,0,0,1
FC028175,16,3,13,0,0,0,0,0,1
FC028214,8,0,8,0,0,0,0,0,1
FC028228,7,0,7,0,0,0,0,0,1
FC028288,5,0,5,0,0,0,0,0,1
FC028310,4,0,4,0,0,0,0,0,1
FC028312,4,0,4,0,0,0,0,0,1
FC028313,4,0,4,0,0,0,0,0,1
FC028314,4,0,4,0,0,0,0,0,1
FC028316,4,0,4,0,0,0,0,0,1
FC028318,4,0,4,0,0,0,0,0,1
FC028322,3,0,3,0,0,0,0,0,1
FC028323,4,0,4,0,0,0,0,0,1
FC028324,4,0,4,0,0,0,0,0,1
FC028325,5,0,5,0,0,0,0,0,1
FC028343,6,0,6,0,0,0,0,0,1
FC028351,4,0,4,0,0,0,0,0,1
FC028358,4,0,4,0,0,0,0,0,1
FC028359,4,0,4,0,0,0,0,0,1
FC028627,16,0,16,0,0,0,0,0,1
FC028879,6,0,6,0,0,0,0,0,1
FC028962,12,4,8,0,0,0,0,0,1
FC028973,3,3,0,0,0,0,0,0,1
FC029111,4,0,4,0,0,0,0,0,1
FC029112,4,0,4,0,0,0,0,0,1
FC029214,4,2,2,0,0,0,0,0,1
FC029229,7,4,3,0,0,0,0,0,1
FC029251,5,0,5,0,0,0,0,0,1
FC029295,6,2,4,0,0,0,0,0,1
FC029325,9,0,9,0,0,0,0,0,1
FC029501,7,0,7,0,0,0,0,0,1
FC029517,7,3,4,0,0,0,0,0,1
FC029562,4,0,4,0,0,0,0,0,1
FC029563,8,4,4,0,0,0,0,0,1
FC029668,8,6,2,0,0,0,0,0,1
FC029802,6,2,4,0,0,0,0,0,0
FC029880,7,2,5,0,0,0,0,0,0
FC029983,13,0,13,0,0,0,0,0,1
FC030054,9,4,5,0,0,0,0,0,1
FC030206,5,4,1,0,0,0,0,0,1
FC030220,5,0,5,0,0,0,0,0,1
FC030267,2,2,0,2,0,0,0,0,0
FC030297,6,0,6,0,0,0,0,0,1
FC030616,12,3,9,0,0,0,0,0,1
FC030628,15,8,7,0,0,0,0,0,1
FC030699,8,0,8,0,0,0,0,0,1
FC030825,17,9,8,1,0,0,0,0,1
FC030838,10,4,6,0,0,0,0,0,1
FC030939,8,3,5,1,0,0,0,0,1
FC031236,2,0,2,0,0,0,0,0,1
FC031237,2,0,2,0,0,0,0,0,1
FC031254,3,3,0,0,0,0,0,0,0
FC031256,3,3,0,0,0,0,0,0,0
FC031277,6,6,0,0,0,0,0,0,1
FC031392,7,2,5,0,0,0,0,0,1
FC031426,5,3,2,1,0,0,0,0,1
FC031455,13,5,8,1,0,0,0,0,1
FC031481,10,7,3,0,0,0,0,0,1
FC031512,1,1,0,0,0,0,0,0,0
FC031640,5,3,2,0,0,0,0,0,1
FC031682,4,4,0,1,0,0,0,0,0
FC031693,3,0,3,0,0,0,0,0,1
FC031694,3,0,3,0,0,0,0,0,1
FC031697,3,0,3,0,0,0,0,0,1
FC031758,15,9,6,0,0,0,0,0,1
FC031792,7,2,5,0,0,0,0,0,0
FC031895,8,4,4,1,0,0,0,0,1
FC032058,9,4,5,1,0,0,0,0,1
FC032064,7,0,7,1,0,0,0,0,1
FC032164,7,3,4,0,0,0,0,0,1
FC032231,15,3,12,1,0,0,0,0,1
FC032710,6,3,3,1,0,0,0,0,1
FC032751,5,4,1,1,0,0,0,0,1
FC032799,5,2,3,0,0,0,0,0,1
FC032800,4,3,1,0,0,0,0,0,1
FC032845,5,3,2,0,0,0,0,0,1
FC033059,3,2,1,0,0,0,0,0,1
FC033103,3,3,0,1,0,0,0,0,0
FC033109,5,4,1,0,0,0,0,0,1
FC033181,3,2,1,0,0,0,0,0,0
FC033345,3,3,0,0,0,0,0,0,1
FC033364,4,0,4,0,0,0,0,0,1
FC033365,4,0,4,0,0,0,0,0,1
FC033430,4,4,0,0,0,0,0,0,1
FC033435,5,4,1,0,0,0,0,0,1
FC033474,12,3,9,0,0,0,0,0,1
FC033649,5,5,0,0,0,0,0,0,1
FC033999,8,8,0,0,0,0,0,0,1
FC034025,3,3,0,1,0,0,0,0,0
FC034027,7,4,3,0,0,0,0,0,1
FC034029,7,4,3,0,0,0,0,0,1
FC034202,7,4,3,0,0,0,0,0,1
FC034203,9,5,4,0,0,0,0,0,1
FC034204,8,5,3,0,0,0,0,0,1
FC034250,4,4,0,1,0,0,0,0,0
FC034353,3,1,2,0,0,0,0,0,1
FC034546,15,13,2,0,0,0,0,0,1
FC034866,4,4,0,0,0,0,0,0,0
FC035120,11,9,2,0,0,0,0,0,1
FC035292,5,4,1,1,0,0,0,0,1
FC035293,5,4,1,1,0,0,0,0,1
FC035294,5,4,1,1,0,0,0,0,1
FC035374,4,4,0,0,0,0,0,0,1
FC036098,5,5,0,0,0,0,0,0,1
GE000278,0,0,0,0,0,0,0,0,0
IC000479,0,0,0,0,0,0,0,0,0
IP00001C,0,0,0,0,0,0,0,0,0
IP00005R,0,0,0,0,0,0,0,0,0
IP00020R,0,0,0,0,0,0,0,0,0
IP000215,0,0,0,0,0,0,0,0,0
IP000280,0,0,0,0,0,0,0,0,0
IP000297,0,0,0,0,0,0,0,0,0
IP000301,0,0,0,0,0,0,0,0,0
IP00049C,0,0,0,0,0,0,0,0,0
IP000588,0,0,0,0,0,0,0,0,0
IP000743,0,0,0,0,0,0,0,0,0
IP000777,0,0,0,0,0,0,0,0,0
IP00134C,0,0,0,0,0,0,0,0,0
IP00159R,0,0,0,0,0,0,0,0,0
IP00200C,0,0,0,0,0,0,0,0,0
IP00210C,0,0,0,0,0,0,0,0,0
IP00212C,0,0,0,0,0,0,0,0,0
IP00356C,0,0,0,0,0,0,0,0,0
IP00386C,0,0,0,0,0,0,0,0,0
IP00400C,0,0,0,0,0,0,0,0,0
IP00423C,0,0,0,0,0,0,0,0,0
IP00428C,0,0,0,0,0,0,0,0,0
IP00437C,0,0,0,0,0,0,0,0,0
IP00440C,0,0,0,0,0,0,0,0,0
IP00472C,0,0,0,0,0,0,0,0,0
IP00489C,0,0,0,0,0,0,0,0,0
IP00495C,0,0,0,0,0,0,0,0,0
IP00497C,0,0,0,0,0,0,0,0,0
IP00514C,0,0,0,0,0,0,0,0,0
IP00525C,0,0,0,0,0,0,0,0,0
IP00537C,0,0,0,0,0,0,0,0,0
IP00554C,0,0,0,0,0,0,0,0,0
IP00560C,0,0,0,0,0,0,0,0,0
IP00620C,0,0,0,0,0,0,0,0,0
IP00625C,0,0,0,0,0,0,0,0,0
IP00630C,0,0,0,0,0,0,0,0,0
IP00665C,0,0,0,0,0,0,0,0,0
IP00668C,0,0,0,0,0,0,0,0,0
IP00689C,0,0,0,0,0,0,0,0,0
IP00698C,0,0,0,0,0,0,0,0,0
IP00700C,0,0,0,0,0,0,0,0,0
IP00708C,0,0,0,0,0,0,0,0,0
IP00712C,0,0,0,0,0,0,0,0,0
IP00729R,0,0,0,0,0,0,0,0,0
IP00735C,0,0,0,0,0,0,0,0,0
IP01159R,0,0,0,0,0,0,0,0,0
IP01326R,0,0,0,0,0,0,0,0,0
IP01944R,0,0,0,0,0,0,0,0,0
IP02227R,0,0,0,0,0,0,0,0,0
IP02229R,0,0,0,0,0,0,0,0,0
IP02382R,0,0,0,0,0,0,0,0,0
IP02452R,0,0,0,0,0,0,0,0,0
IP025133,0,0,0,0,0,0,0,0,0
IP025177,0,0,0,0,0,0,0,0,0
IP02610R,0,0,0,0,0,0,0,0,0
IP02721R,0,0,0,0,0,0,0,0,0
IP02756W,0,0,0,0,0,0,0,0,0
IP02854R,0,0,0,0,0,0,0,0,0
IP02961R,0,0,0,0,0,0,0,0,0
IP029922,0,0,0,0,0,0,0,0,0
IP030410,0,0,0,0,0,0,0,0,0
IP030413,0,0,0,0,0,0,0,0,0
IP030420,0,0,0,0,0,0,0,0,0
IP030447,0,0,0,0,0,0,0,0,0
IP030526,0,0,0,0,0,0,0,0,0
IP030560,0,0,0,0,0,0,0,0,0
IP030562,0,0,0,0,0,0,0,0,0
IP030586,0,0,0,0,0,0,0,0,0
IP030593,0,0,0,0,0,0,0,0,0
IP030611,0,0,0,0,0,0,0,0,0
IP030682,0,0,0,0,0,0,0,0,0
IP030703,0,0,0,0,0,0,0,0,0
IP030718,0,0,0,0,0,0,0,0,0
IP030753,0,0,0,0,0,0,0,0,0
IP030762,0,0,0,0,0,0,0,0,0
IP030773,0,0,0,0,0,0,0,0,0
IP030791,0,0,0,0,0,0,0,0,0
IP030811,0,0,0,0,0,0,0,0,0
IP030857,0,0,0,0,0,0,0,0,0
IP030876,0,0,0,0,0,0,0,0,0
IP030906,0,0,0,0,0,0,0,0,0
IP030911,0,0,0,0,0,0,0,0,0
IP030935,0,0,0,0,0,0,0,0,0
IP030951,0,0,0,0,0,0,0,0,0
IP030955,0,0,0,0,0,0,0,0,0
IP030962,0,0,0,0,0,0,0,0,0
IP030967,0,0,0,0,0,0,0,0,0
IP030971,0,0,0,0,0,0,0,0,0
IP030980,0,0,0,0,0,0,0,0,0
IP030988,0,0,0,0,0,0,0,0,0
IP031003,0,0,0,0,0,0,0,0,0
IP03102R,0,0,0,0,0,0,0,0,0
IP031030,0,0,0,0,0,0,0,0,0
IP031070,0,0,0,0,0,0,0,0,0
IP031128,0,0,0,0,0,0,0,0,0
IP031174,0,0,0,0,0,0,0,0,0
IP031256,0,0,0,0,0,0,0,0,0
IP031260,0,0,0,0,0,0,0,0,0
IP031280,0,0,0,0,0,0,0,0,0
IP031311,0,0,0,0,0,0,0,0,0
IP031340,0,0,0,0,0,0,0,0,0
IP031360,0,0,0,0,0,0,0,0,0
IP031377,0,0,0,0,0,0,0,0,0
IP031386,0,0,0,0,0,0,0,0,0
IP031387,0,0,0,0,0,0,0,0,0
IP031395,0,0,0,0,0,0,0,0,0
IP031421,0,0,0,0,0,0,0,0,0
IP031427,0,0,0,0,0,0,0,0,0
IP031479,0,0,0,0,0,0,0,0,0
IP031485,0,0,0,0,0,0,0,0,0
IP031490,0,0,0,0,0,0,0,0,0
IP031499,0,0,0,0,0,0,0,0,0
IP031506,0,0,0,0,0,0,0,0,0
IP031537,0,0,0,0,0,0,0,0,0
IP031555,0,0,0,0,0,0,0,0,0
IP031565,0,0,0,0,0,0,0,0,0
IP031577,0,0,0,0,0,0,0,0,0
IP031619,0,0,0,0,0,0,0,0,0
IP031622,0,0,0,0,0,0,0,0,0
IP031642,0,0,0,0,0,0,0,0,0
IP031671,0,0,0,0,0,0,0,0,0
IP031678,0,0,0,0,0,0,0,0,0
IP031737,0,0,0,0,0,0,0,0,0
IP031757,0,0,0,0,0,0,0,0,0
IP03176R,0,0,0,0,0,0,0,0,0
IP031773,0,0,0,0,0,0,0,0,0
IP031845,0,0,0,0,0,0,0,0,0
IP031911,0,0,0,0,0,0,0,0,0
IP031921,0,0,0,0,0,0,0,0,0
IP031938,0,0,0,0,0,0,0,0,0
IP031950,0,0,0,0,0,0,0,0,0
IP031972,0,0,0,0,0,0,0,0,0
IP031974,0,0,0,0,0,0,0,0,0
IP031980,0,0,0,0,0,0,0,0,0
IP032017,0,0,0,0,0,0,0,0,0
IP032035,0,0,0,0,0,0,0,0,0
IP032053,0,0,0,0,0,0,0,0,0
IP032066,0,0,0,0,0,0,0,0,0
IP032073,0,0,0,0,0,0,0,0,0
IP032107,0,0,0,0,0,0,0,0,0
IP032121,0,0,0,0,0,0,0,0,0
IP032124,0,0,0,0,0,0,0,0,0
IP032159,0,0,0,0,0,0,0,0,0
IP032186,0,0,0,0,0,0,0,0,0
IP032204,0,0,0,0,0,0,0,0,0
IP032273,0,0,0,0,0,0,0,0,0
IP032274,0,0,0,0,0,0,0,0,0
IP032298,0,0,0,0,0,0,0,0,0
IP032333,0,0,0,0,0,0,0,0,0
IP032341,0,0,0,0,0,0,0,0,0
IP032360,0,0,0,0,0,0,0,0,0
IP032362,0,0,0,0,0,0,0,0,0
IP032370,0,0,0,0,0,0,0,0,0
IP03240R,0,0,0,0,0,0,0,0,0
IP032445,0,0,0,0,0,0,0,0,0
IP03369R,0,0,0,0,0,0,0,0,0
IP03729R,0,0,0,0,0,0,0,0,0
IP03882R,0,0,0,0,0,0,0,0,0
IP03956R,0,0,0,0,0,0,0,0,0
IP03992R,0,0,0,0,0,0,0,0,0
IP04036R,0,0,0,0,0,0,0,0,0
IP04048R,0,0,0,0,0,0,0,0,0
IP04222R,0,0,0,0,0,0,0,0,0
IP04239R,0,0,0,0,0,0,0,0,0
IP04278R,0,0,0,0,0,0,0,0,0
IP04311R,0,0,0,0,0,0,0,0,0
IP04425R,0,0,0,0,0,0,0,0,0
IP04451R,0,0,0,0,0,0,0,0,0
IP04461R,0,0,0,0,0,0,0,0,0
IP04462R,0,0,0,0,0,0,0,0,0
IP04536R,0,0,0,0,0,0,0,0,0
IP04572R,0,0,0,0,0,0,0,0,0
IP04594R,0,0,0,0,0,0,0,0,0
IP04627R,0,0,0,0,0,0,0,0,0
IP04635R,0,0,0,0,0,0,0,0,0
IP04649R,0,0,0,0,0,0,0,0,0
IP04654R,0,0,0,0,0,0,0,0,0
IP04681R,0,0,0,0,0,0,0,0,0
IP04684R,0,0,0,0,0,0,0,0,0
IP04721R,0,0,0,0,0,0,0,0,0
IP04735R,0,0,0,0,0,0,0,0,0
IP04763R,0,0,0,0,0,0,0,0,0
IP04945R,0,0,0,0,0,0,0,0,0
IP05024R,0,0,0,0,0,0,0,0,0
IP05158R,0,0,0,0,0,0,0,0,0
IP05197R,0,0,0,0,0,0,0,0,0
IP05254R,0,0,0,0,0,0,0,0,0
IP05260R,0,0,0,0,0,0,0,0,0
IP05266R,0,0,0,0,0,0,0,0,0
IP05273R,0,0,0,0,0,0,0,0,0
IP05293R,0,0,0,0,0,0,0,0,0
IP05297R,0,0,0,0,0,0,0,0,0
IP05333R,0,0,0,0,0,0,0,0,0
IP05346R,0,0,0,0,0,0,0,0,0
IP05349R,0,0,0,0,0,0,0,0,0
IP05372R,0,0,0,0,0,0,0,0,0
IP05426R,0,0,0,0,0,0,0,0,0
IP05442R,0,0,0,0,0,0,0,0,0
IP05451R,0,0,0,0,0,0,0,0,0
IP05460R,0,0,0,0,0,0,0,0,0
IP05463R,0,0,0,0,0,0,0,0,0
IP05471R,0,0,0,0,0,0,0,0,0
IP05476R,0,0,0,0,0,0,0,0,0
IP05513R,0,0,0,0,0,0,0,0,0
IP05580R,0,0,0,0,0,0,0,0,0
IP05592R,0,0,0,0,0,0,0,0,0
IP05595R,0,0,0,0,0,0,0,0,0
IP05598R,0,0,0,0,0,0,0,0,0
IP05655R,0,0,0,0,0,0,0,0,0
IP05725R,0,0,0,0,0,0,0,0,0
IP05807R,0,0,0,0,0,0,0,0,0
IP05822R,0,0,0,0,0,0,0,0,0
IP05870R,0,0,0,0,0,0,0,0,0
IP05898R,0,0,0,0,0,0,0,0,0
IP05983R,0,0,0,0,0,0,0,0,0
IP06004R,0,0,0,0,0,0,0,0,0
IP06115R,0,0,0,0,0,0,0,0,0
IP06127R,0,0,0,0,0,0,0,0,0
IP06160R,0,0,0,0,0,0,0,0,0
IP06181R,0,0,0,0,0,0,0,0,0
IP06302R,0,0,0,0,0,0,0,0,0
IP06334R,0,0,0,0,0,0,0,0,0
IP06358R,0,0,0,0,0,0,0,0,0
IP06365R,0,0,0,0,0,0,0,0,0
IP06377R,0,0,0,0,0,0,0,0,0
IP06399R,0,0,0,0,0,0,0,0,0
IP06442R,0,0,0,0,0,0,0,0,0
IP06454R,0,0,0,0,0,0,0,0,0
IP06458R,0,0,0,0,0,0,0,0,0
IP06614R,0,0,0,0,0,0,0,0,0
IP06639R,0,0,0,0,0,0,0,0,0
IP06645R,0,0,0,0,0,0,0,0,0
IP06692R,0,0,0,0,0,0,0,0,0
IP06718R,0,0,0,0,0,0,0,0,0
IP06731R,0,0,0,0,0,0,0,0,0
IP06797R,0,0,0,0,0,0,0,0,0
IP06853R,0,0,0,0,0,0,0,0,0
IP06855R,0,0,0,0,0,0,0,0,0
IP06881R,0,0,0,0,0,0,0,0,0
IP06906R,0,0,0,0,0,0,0,0,0
IP06907R,0,0,0,0,0,0,0,0,0
IP06921R,0,0,0,0,0,0,0,0,0
IP06944R,0,0,0,0,0,0,0,0,0
IP07023R,0,0,0,0,0,0,0,0,0
IP07096R,0,0,0,0,0,0,0,0,0
IP07116R,0,0,0,0,0,0,0,0,0
IP07137R,0,0,0,0,0,0,0,0,0
IP07146R,0,0,0,0,0,0,0,0,0
IP07285R,0,0,0,0,0,0,0,0,0
IP07291R,0,0,0,0,0,0,0,0,0
IP07302R,0,0,0,0,0,0,0,0,0
IP07317R,0,0,0,0,0,0,0,0,0
IP07376R,0,0,0,0,0,0,0,0,0
IP07421R,0,0,0,0,0,0,0,0,0
IP07476R,0,0,0,0,0,0,0,0,0
IP07530R,0,0,0,0,0,0,0,0,0
IP07762R,0,0,0,0,0,0,0,0,0
IP07771R,0,0,0,0,0,0,0,0,0
IP07848R,0,0,0,0,0,0,0,0,0
IP07923R,0,0,0,0,0,0,0,0,0
IP07939R,0,0,0,0,0,0,0,0,0
IP07959R,0,0,0,0,0,0,0,0,0
IP07965R,0,0,0,0,0,0,0,0,0
IP07976R,0,0,0,0,0,0,0,0,0
07570403,12,9,3,0,0,0,0,0,0
07571015,3,1,2,0,1,1,0,0,0
07571269,8,1,7,0,1,1,0,1,1
07571276,8,0,8,0,2,2,0,2,1
07571340,8,0,8,0,2,2,0,2,1
07571421,1,0,1,0,0,0,0,0,0
07571879,1,1,0,0,1,1,0,0,0
07571956,8,0,8,0,0,0,0,0,1
07572032,6,3,3,0,4,1,3,0,1
07572053,5,0,5,0,0,0,0,0,1
07572128,11,6,5,0,4,1,3,2,1
07572212,1,1,0,0,1,1,0,0,0
07572594,4,0,4,0,0,0,0,0,1
07572689,2,2,0,0,2,2,0,0,0
07572731,8,4,4,0,2,2,0,0,1
07572807,8,4,4,0,2,2,0,0,1
07572889,8,0,8,0,0,0,0,0,1
07572899,9,4,5,0,2,2,0,0,1
07572901,9,4,5,0,2,2,0,0,1
07573098,3,2,1,0,1,1,0,0,0
07573610,8,4,4,0,1,1,0,1,1
07573644,8,4,4,0,1,1,0,1,1
07573802,2,2,0,0,2,1,1,1,0
07573928,2,2,0,0,1,1,0,0,1
07574354,7,0,7,0,0,0,0,0,1
07574584,2,1,1,0,1,1,0,0,1
07574653,3,2,1,0,1,1,0,0,1
07575430,2,2,0,0,2,2,0,0,1
07575625,1,1,0,0,0,0,0,0,0
07575697,8,6,2,0,0,0,0,0,0
07575896,13,5,8,0,0,0,0,0,1
07575914,5,3,2,0,0,0,0,0,1
07576938,23,0,23,0,3,3,0,0,1
07577064,10,5,5,0,0,0,0,0,1
07577287,5,3,2,0,1,1,0,0,1
07577516,2,2,0,0,2,2,0,0,0
07577551,17,0,17,0,0,0,0,0,1
07578698,4,4,0,0,1,1,0,0,0
07578725,4,4,0,0,1,1,0,0,0
07578727,30,6,24,0,5,2,3,0,0
07579351,23,4,19,0,1,1,0,1,1
07579363,13,6,7,0,1,1,0,1,1
07579875,4,3,1,0,2,2,0,0,1
07580631,3,1,2,0,1,1,0,0,0
07580701,5,4,1,0,0,0,0,0,0
07580767,2,0,2,0,0,0,0,0,1
07581094,2,0,2,0,2,2,0,0,0
07581509,1,1,0,0,1,1,0,0,0
07581515,2,1,1,0,1,1,0,0,0
07581621,1,0,1,0,0,0,0,0,1
07581875,4,0,4,0,0,0,0,0,0
07582667,33,9,24,0,0,0,0,0,0
07582827,2,0,2,0,2,1,1,0,1
07583048,3,3,0,0,2,2,0,0,1
07583076,4,4,0,0,3,3,0,0,0
07583369,5,0,5,1,0,0,0,0,1
07583482,1,1,0,0,1,1,0,0,0
07583593,2,2,0,0,1,1,0,0,0
07583788,3,3,0,0,1,1,0,0,0
07583822,5,3,2,0,1,1,0,1,1
07584055,3,1,2,0,1,1,0,0,1
07584063,42,14,28,0,0,0,0,0,1
07584218,23,0,23,0,0,0,0,0,1
07584221,5,4,1,0,2,2,0,1,0
07584392,7,4,3,0,1,1,0,1,1
07584572,4,1,3,0,0,0,0,0,1
07584603,2,2,0,0,1,1,0,0,1
07584616,15,8,7,0,0,0,0,0,0
07584906,22,11,11,0,0,0,0,0,1
07584959,14,6,8,0,0,0,0,0,1
07584988,27,11,16,0,0,0,0,0,1
07585008,1,1,0,0,1,1,0,0,0
07585200,3,3,0,0,1,1,0,0,0
07585782,1,1,0,0,1,1,0,0,0
07586374,6,4,2,0,4,4,0,0,0
07586830,1,1,0,0,1,1,0,0,0
07586990,12,3,9,0,1,1,0,1,1
07587352,5,0,5,0,0,0,0,0,0
07588052,2,1,1,0,1,1,0,0,0
07588108,14,5,9,0,1,1,0,1,1
07588143,14,0,14,0,1,1,0,1,1
07588152,9,0,9,0,0,0,0,0,1
07588284,2,2,0,0,1,1,0,0,0
07588326,2,2,0,0,2,2,0,0,0
07588543,2,0,2,0,1,1,0,0,1
07588736,16,1,15,0,1,1,0,1,1
07589225,8,1,7,0,1,1,0,0,1
07589363,3,1,2,0,1,1,0,0,0
07589481,9,3,6,0,3,3,0,1,0
07589892,12,1,11,0,1,1,0,1,1
07590183,6,2,4,0,2,1,1,1,1
07590509,12,1,11,0,1,1,0,1,1
07590517,18,2,16,0,0,0,0,0,1
07590646,13,1,12,0,1,1,0,1,1
07590914,3,3,0,0,1,1,0,0,0
07591127,9,5,4,0,6,1,5,2,1
07591154,11,3,8,0,0,0,0,0,1
07591304,1,1,0,0,1,1,0,0,0
07591532,1,1,0,0,1,1,0,0,0
07591727,3,3,0,0,1,1,0,0,0
07591938,3,0,3,0,0,0,0,0,1
07591978,8,5,3,0,0,0,0,0,1
07592342,5,0,5,0,0,0,0,0,1
07592407,2,0,2,0,0,0,0,0,1
07592665,12,8,4,0,1,1,0,0,1
07593095,1,0,1,0,0,0,0,0,0
07593130,2,2,0,0,1,1,0,0,0
07593675,3,3,0,0,1,1,0,0,1
07593983,2,1,1,0,1,1,0,0,0
07594009,11,2,9,0,0,0,0,0,0
07594260,2,1,1,0,2,2,0,0,1
07594266,1,1,0,0,1,1,0,0,0
07594438,7,4,3,0,4,0,4,0,1
07594473,1,1,0,0,1,1,0,0,1
07594562,37,13,24,0,0,0,0,0,1
07594985,4,2,2,0,1,1,0,0,0
07595694,10,6,4,0,1,1,0,0,0
07595775,5,4,1,0,2,2,0,0,1
07596275,17,5,12,0,0,0,0,0,1
07596323,16,7,9,2,2,1,1,2,1
07597006,3,0,3,0,0,0,0,0,1
07597324,30,8,22,0,4,3,1,0,1
07597347,9,5,4,0,0,0,0,0,1
07597442,2,0,2,0,0,0,0,0,1
07597478,1,1,0,0,1,1,0,0,0
07597498,15,7,8,0,0,0,0,0,0
07597547,7,0,7,0,0,0,0,0,1
07597952,9,0,9,0,0,0,0,0,1
07598068,2,2,0,0,2,2,0,0,0
07598453,2,0,2,0,0,0,0,0,0
07598700,12,4,8,0,1,1,0,1,1
07599189,2,0,2,0,0,0,0,0,1
07599502,8,6,2,0,1,1,0,1,1
07599565,24,13,11,0,1,1,0,1,1
07599599,3,0,3,0,0,0,0,0,1
07599770,19,10,9,0,0,0,0,0,1
07600042,8,4,4,0,1,1,0,1,1
07600439,1,1,0,0,1,1,0,0,1
07600547,2,2,0,0,2,2,0,0,0
07600844,1,1,0,0,1,1,0,0,0
07601137,4,2,2,0,0,0,0,0,1
07601620,3,2,1,0,1,1,0,0,0
07601963,13,7,6,0,1,1,0,1,1
07602281,1,0,1,0,0,0,0,0,0
07602527,2,2,0,0,2,2,0,0,0
07602900,3,2,1,0,1,1,0,0,1
07603246,1,1,0,0,1,1,0,0,0
07603305,8,4,4,0,0,0,0,0,1
07603317,20,9,11,0,1,1,0,1,1
07603570,2,2,0,0,2,2,0,0,0
07603670,1,1,0,0,0,0,0,0,0
07603747,1,1,0,0,0,0,0,0,0
07603751,2,1,1,0,0,0,0,0,0
07603822,1,1,0,0,1,1,0,0,0
07603973,3,0,3,0,0,0,0,0,0
07604036,1,1,0,0,1,1,0,0,0
07604056,2,2,0,0,1,1,0,0,0
07604237,4,0,4,0,0,0,0,0,1
07604303,5,4,1,0,3,2,1,0,0
07604495,1,1,0,0,1,1,0,0,0
07604508,2,1,1,0,1,1,0,0,0
07604855,24,13,11,0,1,1,0,1,1
07605651,10,3,7,0,2,0,2,0,1
07605742,2,1,1,0,1,1,0,0,0
07606089,1,0,1,0,0,0,0,0,1
07606220,2,0,2,0,0,0,0,0,1
07606234,28,15,13,0,0,0,0,0,1
07606283,5,0,5,0,1,1,0,0,1
07606343,2,2,0,0,1,1,0,0,0
07606415,4,3,1,0,2,2,0,0,1
07606853,8,2,6,0,5,2,3,0,0
07607048,6,6,0,0,1,1,0,1,0
07607180,1,1,0,0,1,1,0,0,0
07607531,2,1,1,0,1,1,0,0,0
07607713,2,0,2,0,0,0,0,0,0
07607795,2,0,2,0,0,0,0,0,0
07607956,18,8,10,0,1,1,0,0,1
07608263,10,5,5,0,4,2,2,1,1
07608464,5,0,5,0,0,0,0,0,1
07608570,2,1,1,0,1,1,0,0,0
07608572,5,4,1,0,0,0,0,0,0
07608774,11,7,4,0,1,1,0,0,1
07608829,2,1,1,0,1,1,0,0,0
07609153,5,0,5,0,0,0,0,0,0
07609252,7,3,4,0,1,1,0,1,1
07609423,21,7,14,0,0,0,0,0,1
07609496,6,6,0,0,1,1,0,0,0
07609633,8,2,6,0,1,1,0,1,1
07609890,3,0,3,0,0,0,0,0,1
07610574,10,0,10,0,0,0,0,0,1
07610726,6,0,6,0,0,0,0,0,1
07610890,12,6,6,0,0,0,0,0,0
07610934,3,3,0,0,2,2,0,0,1
07611016,23,10,13,0,0,0,0,0,1
07611104,12,6,6,0,0,0,0,0,1
07611154,2,2,0,0,1,1,0,0,1
07611216,1,0,1,0,0,0,0,0,0
07611293,12,0,12,0,1,1,0,1,0
07611484,1,0,1,0,0,0,0,0,1
07611738,7,3,4,0,0,0,0,0,0
07611929,2,2,0,0,2,2,0,0,0
07612004,5,2,3,0,1,1,0,0,1
07612083,26,0,26,0,0,0,0,0,1
07612649,12,4,8,0,2,2,0,2,1
07612934,10,5,5,0,0,0,0,0,1
07613189,5,2,3,0,2,2,0,0,0
07613567,7,3,4,0,1,1,0,0,1
07613938,4,1,3,0,1,1,0,0,0
07614721,4,3,1,0,1,1,0,1,1
07614906,27,10,17,0,0,0,0,0,1
07615079,6,2,4,0,1,1,0,1,1
07615142,8,4,4,0,4,3,1,0,0
07616123,3,2,1,0,1,1,0,0,0
07616837,1,1,0,0,2,2,0,0,0
07617194,11,7,4,0,0,0,0,0,1
07617386,15,5,10,0,1,1,0,1,1
07617428,4,0,4,0,0,0,0,0,1
07617431,3,3,0,0,2,2,0,0,0
07617448,2,2,0,0,2,2,0,0,1
07617608,3,0,3,0,0,0,0,0,1
07617803,2,1,1,0,1,1,0,0,0
07618026,1,1,0,0,1,1,0,0,0
07618325,2,2,0,0,2,2,0,0,0
07618348,13,5,8,0,1,1,0,1,1
07618383,25,9,16,0,0,0,0,0,0
07618878,3,1,2,0,1,1,0,0,0
07619276,2,1,1,0,1,1,0,0,0
07619342,1,0,1,0,0,0,0,0,1
07619703,11,6,5,0,0,0,0,0,1
07619883,3,0,3,0,0,0,0,0,1
07619886,7,4,3,0,0,0,0,0,1
07620159,3,2,1,0,1,1,0,0,1
07620214,3,1,2,0,1,1,0,0,0
07620273,2,0,2,0,0,0,0,0,1
07620321,7,4,3,0,2,2,0,0,1
07620338,13,5,8,0,1,1,0,1,1
07620417,2,1,1,0,1,1,0,0,0
07620459,2,0,2,0,0,0,0,0,1
07620500,4,2,2,0,4,3,1,1,1
07621081,2,1,1,0,1,1,0,0,0
07621182,2,0,2,0,1,1,0,0,0
07621355,20,9,11,0,1,1,0,1,1
07621392,11,3,8,0,0,0,0,0,1
07621395,36,0,36,0,0,0,0,0,0
07621435,29,6,23,0,1,1,0,1,1
07621443,2,0,2,0,0,0,0,0,1
07621563,1,0,1,0,0,0,0,0,1
07621600,21,8,13,0,8,6,2,0,1
07621620,2,2,0,0,2,2,0,0,0
07621876,2,0,2,0,0,0,0,0,0
07622219,2,2,0,0,3,3,0,0,0
07622235,11,5,6,0,1,1,0,1,1
07622804,1,0,1,0,0,0,0,0,1
07623446,3,3,0,0,2,2,0,0,0
07623864,5,4,1,0,0,0,0,0,1
07623917,48,14,34,0,0,0,0,0,1
07623961,1,0,1,0,0,0,0,0,0
07624229,5,5,0,0,1,1,0,1,1
07624397,3,0,3,0,0,0,0,0,1
07624752,3,3,0,0,3,3,0,0,0
07624873,10,3,7,0,2,1,1,2,1
07625126,4,4,0,0,2,2,0,0,0
07625485,3,3,0,0,1,1,0,0,0
07625498,2,1,1,0,1,1,0,0,1
07625679,5,5,0,0,0,0,0,0,1
07625798,4,3,1,0,1,1,0,1,0
07626067,15,4,11,0,0,0,0,0,1
07626228,2,0,2,0,0,0,0,0,1
07626797,27,8,19,0,0,0,0,0,0
07626835,11,11,0,0,0,0,0,0,0
07627849,2,0,2,0,2,2,0,0,0
07628175,2,1,1,0,2,2,0,0,0
07628177,6,6,0,0,0,0,0,0,1
07629032,2,1,1,0,2,2,0,0,0
07629609,1,0,1,0,1,1,0,0,0
07629688,1,0,1,0,1,1,0,0,0
07630537,3,1,2,0,1,1,0,0,0
07630693,5,4,1,0,2,2,0,0,0
07630851,2,1,1,0,1,1,0,0,0
07630933,21,12,9,0,0,0,0,0,1
07631021,3,1,2,0,1,1,0,0,0
07631414,1,0,1,0,0,0,0,0,1
07631582,11,3,8,0,1,1,0,1,1
07631790,2,0,2,0,0,0,0,0,1
07631987,2,1,1,0,1,1,0,0,1
07631990,4,2,2,0,0,0,0,0,1
07632910,9,2,7,0,1,1,0,1,1
07632999,9,2,7,0,1,1,0,1,1
07633280,1,1,0,0,1,1,0,0,1
07633601,2,2,0,0,1,1,0,0,1
07633626,3,3,0,0,3,3,0,0,1
07633715,27,13,14,0,3,0,3,0,1
07634170,2,2,0,0,5,5,0,0,0
07634333,9,7,2,0,1,1,0,1,0
07634625,4,1,3,0,1,1,0,0,0
07635223,2,2,0,0,2,2,0,0,1
07635438,20,11,9,0,0,0,0,0,1
07635600,3,2,1,0,1,1,0,0,0
07635628,98,13,85,0,0,0,0,0,1
07635670,3,0,3,0,2,2,0,0,0
07635685,4,4,0,0,2,2,0,0,1
07635780,8,3,5,0,0,0,0,0,0
07635832,15,5,10,0,1,1,0,1,1
07635853,1,0,1,0,0,0,0,0,1
07636408,1,1,0,0,1,1,0,0,1
07636451,2,2,0,0,1,1,0,0,0
07636956,3,3,0,0,2,2,0,0,0
07636978,7,4,3,0,3,3,0,0,0
07637209,4,4,0,0,2,2,0,0,1
07637230,8,5,3,0,2,1,1,1,1
07637289,10,7,3,0,2,2,0,0,1
07637313,20,3,17,0,3,2,1,1,1
07637369,14,9,5,0,0,0,0,0,1
07637509,1,1,0,0,1,1,0,0,0
07637558,2,2,0,0,1,1,0,1,1
07637773,1,1,0,0,0,0,0,0,0
07637968,6,0,6,0,0,0,0,0,0
07637971,6,0,6,0,0,0,0,0,0
07638010,2,2,0,0,1,1,0,1,1
07638023,3,3,0,0,3,3,0,0,0
07638099,1,1,0,0,1,1,0,0,1
07638361,6,1,5,0,1,1,0,0,0
07638396,7,3,4,0,2,2,0,2,1
07638644,24,6,18,0,2,2,0,0,0
07638749,5,3,2,0,2,1,1,1,1
07638800,34,10,24,0,4,3,1,0,0
07638872,6,1,5,0,2,1,1,1,0
07639073,4,2,2,0,1,1,0,0,1
07639245,1,1,0,0,1,1,0,0,0
07639256,2,2,0,0,2,2,0,0,0
07639269,8,7,1,0,1,1,0,0,0
07639348,1,1,0,0,1,1,0,0,0
07639530,8,7,1,0,1,1,0,1,1
SC133118,7,0,7,1,0,0,0,0,1
SC133152,9,2,7,0,1,1,0,1,1
SC133181,5,3,2,1,0,0,0,0,1
SC133245,24,0,24,0,1,1,0,1,1
SC133434,40,7,33,0,2,2,0,2,1
SC133567,22,3,19,0,2,2,0,2,1
SC133590,30,14,16,0,1,1,0,1,1
SC133649,73,9,64,0,0,0,0,0,1
SC133786,7,2,5,0,1,1,0,0,1
SC133846,77,4,73,0,1,1,0,1,1
SC134205,79,5,74,0,1,1,0,1,1
SC134245,30,0,30,0,0,0,0,0,1
SC134249,24,0,24,0,1,1,0,1,0
SC134337,25,3,22,0,1,1,0,1,1
SC134456,21,2,19,0,1,1,0,1,1
SC134602,69,7,62,0,0,0,0,0,1
SC134619,84,13,71,0,0,0,0,0,1
SC134798,19,3,16,0,0,0,0,0,1
SC135020,6,3,3,0,2,2,0,0,1
SC135206,8,0,8,1,2,2,0,1,1
SC135289,7,2,5,1,1,1,0,0,1
SC135353,33,4,29,0,1,1,0,0,1
SC135365,44,2,42,0,1,1,0,1,0
SC135385,15,5,10,0,4,3,1,0,0
SC135469,21,9,12,0,0,0,0,0,1
SC135479,14,3,11,0,2,2,0,0,1
SC135563,187,14,173,0,0,0,0,0,1
SC135573,22,3,19,0,1,1,0,1,1
SC135593,4,1,3,0,2,2,0,1,0
SC135636,30,6,24,1,2,2,0,0,1
SC135648,6,3,3,1,1,1,0,0,1
SC135672,57,6,51,0,1,1,0,0,0
SC135799,26,8,18,0,0,0,0,0,1
SC135886,35,0,35,0,0,0,0,0,1
SC135998,39,3,36,0,1,1,0,1,1
SC136033,9,0,9,0,0,0,0,0,1
SC136118,72,12,60,0,0,0,0,0,0
SC136165,17,2,15,0,1,1,0,1,1
SC136173,16,3,13,0,1,1,0,1,1
SC136186,43,2,41,0,1,1,0,1,1
SC136296,53,3,50,0,1,1,0,1,1
SC136313,34,2,32,0,1,1,0,1,1
SC136616,29,3,26,0,1,1,0,1,1
SC136867,6,2,4,0,2,2,0,0,0
SC136983,17,0,17,0,0,0,0,0,1
SC136984,17,0,17,0,0,0,0,0,1
SC136985,19,0,19,0,0,0,0,0,1
SC136997,89,7,82,0,0,0,0,0,1
SC137003,16,3,13,0,0,0,0,0,0
SC137019,22,4,18,0,3,3,0,3,1
SC137056,16,0,16,0,0,0,0,0,1
SC137068,77,9,68,0,2,1,1,2,1
SC137093,35,0,35,0,0,0,0,0,1
SC137141,10,4,6,0,2,2,0,0,1
SC137308,11,8,3,0,2,2,0,0,1
SC137343,44,8,36,0,0,0,0,0,0
SC137373,17,0,17,0,1,1,0,1,1
SC137374,18,0,18,0,1,1,0,1,1
SC137384,8,2,6,0,1,1,0,0,1
SC137435,0,0,0,0,0,0,0,0,1
SC137531,130,13,117,0,1,1,0,1,1
SC137656,13,2,11,0,1,1,0,1,1
SC137657,17,3,14,0,1,1,0,1,1
SC137691,7,2,5,1,2,2,0,0,1
SC137893,7,2,5,0,3,1,2,1,1
SC138004,13,0,13,0,1,1,0,1,0
SC138202,21,0,21,0,0,0,0,0,1
SC138255,29,3,26,0,1,1,0,1,1
SC138289,14,3,11,0,0,0,0,0,1
SC138299,42,4,38,0,1,1,0,1,1
SC138353,66,17,49,0,0,0,0,0,1
SC138397,15,3,12,0,1,1,0,1,1
SC138404,12,6,6,0,2,2,0,0,1
SC138424,44,0,44,0,0,0,0,0,1
SC138475,20,3,17,0,1,1,0,1,1
SC138534,15,4,11,0,1,1,0,0,1
SC138604,44,14,30,0,1,1,0,0,0
SC138614,20,2,18,0,1,1,0,1,1
SC138633,47,4,43,0,1,1,0,1,1
SC138689,8,5,3,0,1,1,0,1,1
SC138695,38,10,28,0,9,8,1,0,1
SC138807,43,2,41,0,4,4,0,4,0
SC138897,26,0,26,0,0,0,0,0,1
SC138938,37,18,19,0,0,0,0,0,0
SC138981,12,0,12,0,0,0,0,0,1
SC139122,25,3,22,0,3,2,1,0,1
SC139213,37,2,35,0,1,1,0,1,1
SC139238,26,4,22,0,1,1,0,1,1
SC139240,36,6,30,0,1,1,0,0,1
SC139244,94,0,94,0,0,0,0,0,1
SC139260,10,3,7,0,1,1,0,1,0
SC139271,16,7,9,0,0,0,0,0,1
SC139465,36,10,26,0,0,0,0,0,0
SC139534,15,3,12,0,1,0,1,0,1
SC139593,21,1,20,0,1,1,0,1,1
SC139599,9,3,6,0,1,1,0,0,1
SC139616,40,0,40,0,0,0,0,0,1
SC139617,51,3,48,0,1,1,0,1,1
SC139661,5,2,3,0,2,2,0,0,1
SC139953,44,5,39,1,1,1,0,1,1
SC139969,22,4,18,0,1,1,0,1,1
SC140051,16,0,16,0,0,0,0,0,1
SC140053,6,2,4,1,1,1,0,0,0
SC140166,15,3,12,0,1,1,0,1,1
SC140381,25,0,25,0,1,1,0,1,1
SC140803,45,0,45,0,1,1,0,1,1
SC140944,68,6,62,1,1,0,1,1,1
SC140955,8,0,8,0,0,0,0,0,1
SC141092,14,2,12,0,1,1,0,1,1
SC141182,8,2,6,0,1,1,0,0,1
SC141199,26,4,22,0,1,1,0,1,1
SC141277,7,1,6,0,3,1,2,1,0
SC141347,9,3,6,0,2,2,0,1,1
SC141431,51,0,51,0,0,0,0,0,0
SC141496,53,8,45,0,1,1,0,1,1
SC141533,8,1,7,0,1,1,0,0,1
SC141535,10,2,8,0,1,1,0,1,1
SC141590,29,6,23,0,1,1,0,1,1
SC141607,18,7,11,0,2,2,0,0,0
SC141723,16,4,12,0,2,2,0,2,1
SC141799,20,7,13,0,0,0,0,0,1
SC141821,35,0,35,0,1,1,0,1,1
SC141865,9,0,9,0,0,0,0,0,1
SC141866,31,5,26,0,2,2,0,2,1
SC142011,10,2,8,0,1,1,0,1,1
SC142137,4,2,2,0,1,1,0,0,1
SC142344,10,0,10,0,1,1,0,1,1
SC142360,85,9,76,0,0,0,0,0,1
SC142446,44,8,36,0,1,1,0,1,1
SC142495,17,0,17,0,0,0,0,0,1
SC142533,18,0,18,0,0,0,0,0,1
SC142567,1,0,1,0,0,0,0,0,1
SC142591,19,0,19,0,0,0,0,0,1
SC142683,18,3,15,0,1,1,0,1,1
SC142768,25,2,23,0,1,1,0,1,1
SC142782,73,5,68,0,0,0,0,0,0
SC143094,16,6,10,0,1,1,0,0,1
SC143196,3,0,3,0,1,1,0,0,1
SC143209,68,10,58,0,0,0,0,0,1
SC143210,111,19,92,0,0,0,0,0,1
SC143333,5,2,3,0,1,1,0,0,1
SC143359,14,4,10,0,3,3,0,0,0
SC143495,11,4,7,0,3,3,0,1,1
SC143514,88,9,79,0,0,0,0,0,1
SC143658,25,0,25,0,0,0,0,0,1
SC143734,19,0,19,1,0,0,0,0,1
SC143746,57,0,57,0,0,0,0,0,1
SC143812,16,0,16,0,0,0,0,0,1
SC143816,14,0,14,0,0,0,0,0,1
SC143878,42,7,35,0,0,0,0,0,1
SC144005,17,8,9,0,1,1,0,1,1
SC144009,16,8,8,0,1,1,0,1,1
SC144037,4,3,1,0,1,1,0,0,1
SC144062,43,0,43,0,0,0,0,0,1
SC144063,16,0,16,0,0,0,0,0,1
SC144209,25,4,21,0,1,1,0,0,1
SC144406,9,2,7,0,1,1,0,1,0
SC144407,9,2,7,0,1,1,0,1,0
SC144653,44,3,41,0,2,1,1,2,1
SC144702,16,3,13,0,1,1,0,0,0
SC144734,9,5,4,0,1,1,0,1,1
SC144753,26,0,26,0,0,0,0,0,1
SC144767,36,4,32,0,1,1,0,1,1
SC145063,34,0,34,0,1,1,0,1,1
SC145163,17,0,17,0,0,0,0,0,1
SC145196,26,4,22,0,4,2,2,4,1
SC145222,5,3,2,0,2,2,0,0,1
SC145455,19,6,13,0,0,0,0,0,1
SC145500,21,0,21,0,0,0,0,0,1
SC145513,9,4,5,0,3,3,0,3,1
SC145573,78,0,78,0,0,0,0,0,1
SC145574,35,9,26,0,0,0,0,0,1
SC145711,33,0,33,0,0,0,0,0,1
SC145736,55,7,48,1,0,0,0,0,1
SC145739,45,7,38,0,1,1,0,1,1
SC145855,25,4,21,1,2,1,1,1,1
SC145857,25,4,21,1,2,1,1,1,1
SC145858,30,4,26,1,2,1,1,1,1
SC146014,20,7,13,2,1,1,0,0,0
SC146017,28,3,25,0,2,2,0,2,1
SC146403,25,0,25,1,1,1,0,1,1
SC146494,30,2,28,0,1,1,0,1,1
SC146641,7,4,3,0,2,2,0,0,1
SC146692,33,4,29,0,1,1,0,1,1
SC146694,16,7,9,0,2,2,0,0,1
SC146891,15,1,14,0,2,2,0,1,1
SC146992,13,2,11,0,1,1,0,1,1
SC147083,5,3,2,0,1,1,0,0,1
SC147216,29,2,27,0,1,1,0,1,1
SC147230,35,0,35,0,0,0,0,0,1
SC147287,13,3,10,0,1,1,0,1,1
SC147918,40,7,33,0,1,1,0,1,1
SC147919,10,0,10,0,0,0,0,0,1
SC147963,4,2,2,0,1,1,0,0,0
SC147997,24,0,24,0,0,0,0,0,1
SC148049,13,2,11,0,2,2,0,0,1
SC148063,88,3,85,0,1,1,0,1,1
SC148123,57,0,57,0,0,0,0,0,1
SC148145,10,3,7,0,1,1,0,1,1
SC148203,180,19,161,0,0,0,0,0,1
SC148330,44,6,38,0,1,1,0,0,0
SC148569,23,3,20,0,1,1,0,1,1
SC148684,66,8,58,0,1,1,0,1,1
SC148945,18,3,15,0,2,2,0,1,1
SC149069,137,17,120,0,2,1,1,0,1
SC149115,5,3,2,0,1,1,0,0,1
SC149117,55,6,49,0,0,0,0,0,1
SC149193,38,0,38,0,0,0,0,0,1
SC149440,41,10,31,0,1,1,0,1,1
SC149507,52,3,49,0,1,1,0,1,1
SC149587,35,6,29,0,1,1,0,1,1
SC149616,32,4,28,0,1,1,0,1,1
SC149680,21,0,21,0,0,0,0,0,1
SC149799,41,10,31,0,0,0,0,0,1
SC149892,1,0,1,0,0,0,0,0,1
SC150013,16,4,12,0,1,1,0,0,0
SC150062,36,18,18,0,1,1,0,1,1
SC150408,38,7,31,0,1,1,0,1,1
SC150450,22,0,22,0,0,0,0,0,1
SC150493,12,4,8,0,1,1,0,1,1
SC150590,48,11,37,0,0,0,0,0,1
SC150799,1,1,0,0,0,0,0,0,1
SC150976,35,0,35,0,0,0,0,0,1
SC151154,5,0,5,0,0,0,0,0,0
SC151201,14,1,13,0,1,1,0,1,1
SC151223,6,2,4,0,1,1,0,0,0
SC151249,74,8,66,0,1,1,0,1,1
SC151264,19,3,16,0,1,1,0,1,1
SC151271,23,3,20,0,1,1,0,1,1
SC151305,14,0,14,0,1,1,0,1,1
SC151333,23,0,23,0,0,0,0,0,1
SC151357,75,7,68,0,0,0,0,0,1
SC151455,14,0,14,0,1,1,0,1,1
SC151456,32,9,23,0,4,4,0,3,1
SC151508,7,5,2,0,1,1,0,1,1
SC151509,7,5,2,0,1,1,0,1,1
SC151605,60,7,53,0,1,1,0,1,1
SC151673,17,0,17,0,0,0,0,0,1
SC151775,23,5,18,0,2,2,0,0,0
SC151884,3,0,3,0,0,0,0,0,0
SC151890,14,2,12,0,1,1,0,0,1
SC152227,25,0,25,0,1,1,0,1,1
SC152243,38,3,35,0,2,1,1,0,1
SC152258,36,0,36,0,0,0,0,0,0
SC152300,16,0,16,0,0,0,0,0,1
SC152485,10,1,9,0,1,1,0,1,0
SC152607,8,0,8,0,0,0,0,0,0
SC152623,10,3,7,0,1,1,0,0,0
SC152631,24,0,24,0,0,0,0,0,1
SC152729,11,0,11,0,0,0,0,0,1
SC152731,17,4,13,0,1,1,0,0,1
SC152775,8,2,6,1,2,2,0,0,1
SC152949,51,10,41,0,0,0,0,0,1
SC153019,12,4,8,0,1,1,0,1,1
SC153156,9,4,5,0,1,1,0,1,1
SC153205,5,3,2,0,1,1,0,0,0
SC153300,17,5,12,1,2,0,2,2,1
SC153340,21,2,19,0,1,1,0,0,1
SC153441,7,6,1,0,2,2,0,0,1
SC153458,5,0,5,0,0,0,0,0,1
SC153712,8,5,3,0,2,1,1,0,1
SC153807,6,3,3,0,1,1,0,0,1
SC154087,7,3,4,0,1,1,0,0,0
SC154183,41,9,32,0,0,0,0,0,1
SC154199,31,0,31,0,0,0,0,0,1
SC154337,59,11,48,1,0,0,0,0,1
SC154360,10,3,7,0,1,1,0,0,0
SC154537,7,3,4,0,1,1,0,0,0
SC154563,66,10,56,0,0,0,0,0,1
SC154655,43,1,42,0,0,0,0,0,1
SC154663,10,5,5,0,4,4,0,0,0
SC154669,7,4,3,0,1,1,0,1,1
SC154754,17,2,15,0,2,2,0,0,1
SC154761,18,3,15,0,1,1,0,0,1
SC154773,10,3,7,0,1,1,0,0,1
SC154818,13,3,10,0,2,2,0,0,0
SC154876,35,16,19,0,0,0,0,0,1
SC154888,23,0,23,0,0,0,0,0,1
SC154900,30,8,22,0,1,1,0,1,1
05436117,16,5,11,0,1,1,0,0,1
05436301,7,0,7,0,0,0,0,0,1
05436494,7,0,7,0,0,0,0,0,1
05436673,18,0,18,0,1,1,0,1,1
05437166,18,6,12,0,1,1,0,1,1
05437398,29,7,22,0,1,1,0,1,1
05437517,20,3,17,0,1,1,0,1,1
05437768,6,5,1,0,1,1,0,0,1
05438289,6,1,5,0,1,1,0,0,0
05438577,2,2,0,0,1,1,0,1,0
05438910,15,5,10,0,1,1,0,1,1
05439154,8,3,5,0,1,1,0,1,1
05439709,17,4,13,0,5,4,1,2,1
05440004,4,1,3,0,1,1,0,0,1
05440005,4,1,3,0,1,1,0,0,1
05440302,5,1,4,0,0,0,0,0,0
05440367,4,2,2,0,2,2,0,0,1
05440494,18,0,18,0,0,0,0,0,1
05440599,5,3,2,0,2,2,0,0,0
05440605,2,2,0,0,1,1,0,1,0
05440633,13,5,8,0,1,1,0,0,1
05440708,2,2,0,0,1,1,0,0,0
05440719,4,1,3,0,1,1,0,0,1
05441033,5,1,4,0,1,1,0,0,1
05441448,9,6,3,0,2,2,0,0,1
05441702,15,0,15,0,0,0,0,0,1
05441741,17,3,14,0,1,1,0,1,1
05441810,5,1,4,0,1,1,0,0,1
05441867,3,2,1,0,1,1,0,0,1
05441999,2,2,0,0,2,2,0,0,0
05442349,12,3,9,0,2,2,0,0,1
05442364,12,3,9,0,2,2,0,0,1
05443041,12,3,9,0,2,2,0,0,1
05443044,12,3,9,0,2,2,0,0,1
05443181,15,5,10,0,0,0,0,0,0
05443205,4,2,2,0,0,0,0,0,0
05443270,9,4,5,0,0,0,0,0,0
05443333,23,2,21,0,1,1,0,1,1
05443397,2,1,1,0,1,1,0,0,0
05443407,2,1,1,0,1,1,0,0,0
05443517,13,5,8,0,1,1,0,0,1
05444128,2,1,1,0,1,1,0,0,0
05444440,14,0,14,0,0,0,0,0,1
05444672,5,3,2,0,2,2,0,0,0
05444725,6,3,3,0,0,0,0,0,1
05444765,2,2,0,0,1,1,0,0,1
05445495,10,3,7,0,0,0,0,0,1
05445579,23,4,19,0,0,0,0,0,0
05445736,13,3,10,1,1,1,0,1,1
05445929,35,0,35,0,0,0,0,0,1
05445958,4,1,3,0,1,1,0,0,1
05446249,7,0,7,0,0,0,0,0,0
05446603,3,3,0,0,2,2,0,0,1
05446738,4,0,4,0,1,1,0,0,0
05446748,4,0,4,0,1,1,0,0,0
05446797,29,9,20,0,0,0,0,0,0
05447105,47,14,33,0,0,0,0,0,1
05447372,7,3,4,0,0,0,0,0,1
05447670,4,2,2,0,1,1,0,0,0
05447882,25,3,22,0,2,2,0,2,1
05448103,6,0,6,0,0,0,0,0,0
05448421,38,0,38,0,0,0,0,0,1
05448617,10,3,7,0,0,0,0,0,0
05448627,19,6,13,0,0,0,0,0,1
05449001,10,1,9,0,1,1,0,1,1
05449005,4,1,3,0,1,1,0,0,1
05449296,20,0,20,0,0,0,0,0,1
05449300,21,0,21,0,0,0,0,0,1
05449301,5,2,3,0,1,1,0,0,0
05449503,15,0,15,0,0,0,0,0,1
05449827,11,0,11,0,0,0,0,0,1
05450001,4,0,4,0,0,0,0,0,1
05450053,18,5,13,0,1,1,0,1,1
05450695,6,2,4,0,0,0,0,0,0
05450799,10,6,4,0,1,1,0,0,1
05450824,8,2,6,0,0,0,0,0,1
05450826,13,4,9,0,0,0,0,0,1
05450829,13,3,10,0,0,0,0,0,1
05450831,16,6,10,0,0,0,0,0,1
05450832,5,3,2,0,0,0,0,0,1
05450951,4,2,2,0,1,1,0,0,1
05451022,18,3,15,0,0,0,0,0,1
05451061,3,0,3,0,1,1,0,0,0
05451176,13,0,13,0,0,0,0,0,1
05451574,5,4,1,0,2,2,0,0,0
05451630,28,1,27,0,3,1,2,3,1
05451913,14,0,14,0,0,0,0,0,1
05451932,5,3,2,0,2,2,0,0,0
05452162,6,2,4,0,3,2,1,0,0
05452195,16,2,14,0,2,1,1,2,1
05452202,28,4,24,0,1,1,0,1,1
05452278,6,2,4,0,1,1,0,0,0
05452483,15,4,11,0,2,1,1,2,1
05452600,6,2,4,0,2,2,0,0,1
05452648,22,6,16,0,1,1,0,0,1
05452678,50,0,50,0,1,0,1,1,0
05452720,6,2,4,0,2,1,1,0,1
05452847,8,1,7,0,0,0,0,0,0
05453232,9,3,6,0,1,1,0,1,1
05453418,3,0,3,0,0,0,0,0,1
05453434,2,0,2,0,0,0,0,0,0
05453619,7,0,7,0,0,0,0,0,1
05454251,16,0,16,0,0,0,0,0,1
05454426,6,3,3,0,0,0,0,0,0
05454465,4,1,3,0,1,1,0,0,0
05454550,31,3,28,0,0,0,0,0,1
05455081,6,0,6,0,0,0,0,0,1
05455199,4,2,2,0,1,1,0,0,0
05455314,18,9,9,0,0,0,0,0,1
05455434,5,2,3,0,1,1,0,0,0
05455442,12,3,9,0,1,1,0,1,1
05455491,13,0,13,0,0,0,0,0,1
05455644,43,13,30,0,0,0,0,0,1
05455687,11,0,11,0,0,0,0,0,1
05456147,9,2,7,0,2,1,1,2,1
05457216,8,3,5,0,2,2,0,2,1
05457247,4,2,2,0,1,1,0,0,1
05457739,7,0,7,0,0,0,0,0,1
05458086,4,0,4,0,0,0,0,0,1
05458137,6,1,5,0,0,0,0,0,1
05458165,10,3,7,0,0,0,0,0,1
05458655,6,3,3,0,0,0,0,0,1
05458746,4,4,0,0,1,1,0,0,1
05459521,7,1,6,0,1,1,0,0,0
05459919,3,2,1,0,1,1,0,0,1
05460104,15,0,15,0,0,0,0,0,1
05460146,3,3,0,0,2,2,0,0,1
05460413,16,9,7,0,0,0,0,0,1
05460865,8,0,8,0,1,1,0,0,0
05460933,16,5,11,0,1,1,0,1,1
05461090,5,2,3,0,1,1,0,0,0
05461103,4,2,2,0,0,0,0,0,1
05461126,4,2,2,0,0,0,0,0,1
05461184,9,3,6,0,2,2,0,0,1
05462108,2,2,0,0,1,1,0,0,1
05462267,2,2,0,0,1,1,0,0,1
05462286,11,4,7,0,0,0,0,0,1
05462539,16,5,11,0,4,4,0,0,1
05462596,23,5,18,0,0,0,0,0,1
05462708,38,12,26,0,0,0,0,0,1
05462848,23,6,17,0,3,1,2,3,1
05462849,23,6,17,0,3,1,2,3,1
05463157,4,1,3,0,1,1,0,0,1
05464025,6,1,5,0,2,2,0,0,1
05464391,6,1,5,0,1,1,0,0,1
05464880,4,3,1,0,1,1,0,0,0
05465289,8,2,6,0,2,2,0,0,1
05465508,8,4,4,0,1,1,0,0,1
05465512,8,1,7,0,2,2,0,0,1
05466017,9,7,2,0,0,0,0,0,1
05466121,5,3,2,0,0,0,0,0,1
05466943,25,3,22,0,1,1,0,1,1
05467178,4,0,4,0,0,0,0,0,1
05467348,15,0,15,0,0,0,0,0,1
05467350,36,7,29,0,0,0,0,0,1
05467491,5,0,5,0,0,0,0,0,1
05467856,7,0,7,0,0,0,0,0,0
05467860,7,0,7,0,0,0,0,0,0
05467880,14,2,12,0,2,1,1,1,1
05467990,15,0,15,0,0,0,0,0,1
05468223,24,5,19,0,1,0,1,0,0
05468720,5,3,2,0,2,2,0,0,0
05468845,7,5,2,0,5,4,1,0,1
05468846,6,4,2,0,4,3,1,0,1
05468910,6,2,4,0,1,1,0,0,0
05469396,8,4,4,0,1,1,0,1,1
05469453,7,2,5,0,1,1,0,1,0
05469477,5,3,2,0,2,1,1,0,0
05469789,5,0,5,0,0,0,0,0,1
05470555,4,0,4,0,1,1,0,0,0
05470659,21,5,16,0,4,2,2,0,1
05470753,30,6,24,0,0,0,0,0,0
05470971,17,3,14,0,0,0,0,0,0
05471018,21,5,16,0,2,2,0,0,1
05471224,3,2,1,0,2,2,0,0,1
05471868,8,3,5,0,0,0,0,0,0
05471990,4,2,2,0,1,1,0,0,0
05472032,20,3,17,0,1,1,0,1,1
05472050,4,3,1,0,1,1,0,0,1
05472264,19,5,14,0,2,1,1,2,1
05472338,10,0,10,0,0,0,0,0,1
05472341,24,7,17,0,0,0,0,0,1
05472434,9,0,9,0,0,0,0,0,1
05472492,7,0,7,0,0,0,0,0,1
05472922,4,0,4,0,1,1,0,0,0
05473157,27,5,22,0,1,1,0,1,1
05473213,9,4,5,0,0,0,0,0,1
05473738,2,1,1,0,2,2,0,0,0
05473837,4,2,2,0,1,1,0,0,0
05473917,9,0,9,0,0,0,0,0,1
05474163,20,9,11,0,1,1,0,1,1
05474271,4,0,4,0,0,0,0,0,1
05474678,3,0,3,0,0,0,0,0,1
05474839,5,1,4,0,1,1,0,0,0
05474866,6,2,4,0,2,2,0,0,1
05475010,5,2,3,0,2,2,0,0,0
05475037,16,3,13,0,0,0,0,0,1
05475097,2,0,2,0,0,0,0,0,1
05475394,9,3,6,0,1,1,0,1,1
05476467,7,1,6,0,1,1,0,0,1
05476484,7,0,7,0,0,0,0,0,1
05476536,22,7,15,0,0,0,0,0,1
05476853,6,3,3,0,0,0,0,0,1
05476874,11,5,6,0,0,0,0,0,1
05476990,7,4,3,0,1,1,0,0,1
05477377,2,2,0,0,1,1,0,0,0
05477711,6,2,4,0,4,2,2,0,0
05478001,8,4,4,0,0,0,0,0,0
05478508,9,2,7,0,1,1,0,0,1
05478530,7,0,7,0,0,0,0,0,1
05478676,7,5,2,0,2,2,0,0,0
05478680,26,6,20,0,2,1,1,1,1
05478958,5,2,3,0,1,1,0,0,1
05479199,16,0,16,0,1,1,0,1,1
05479637,7,0,7,0,0,0,0,0,1
05479648,9,2,7,0,0,0,0,0,1
11820209,2,2,0,0,2,2,0,0,0
11820264,2,1,1,0,2,1,1,0,0
11820318,1,1,0,0,1,1,0,0,0
11820350,2,2,0,0,1,1,0,1,0
11820657,2,2,0,0,2,2,0,0,0
11820755,3,3,0,0,3,3,0,0,0
11820877,1,1,0,0,2,2,0,1,0
11821034,2,2,0,0,2,2,0,0,0
11821093,2,2,0,0,2,2,0,0,0
11821198,1,1,0,0,1,1,0,0,0
11821751,1,1,0,0,1,1,0,0,0
11821787,2,2,0,0,1,1,0,0,0
11822027,2,2,0,0,1,1,0,0,0
11822129,3,3,0,0,2,2,0,0,0
11822301,4,3,1,0,0,0,0,0,0
11822679,2,2,0,0,2,2,0,0,0
11822770,1,1,0,0,1,1,0,0,1
11823000,1,1,0,0,1,1,0,0,0
11823667,1,1,0,0,1,1,0,0,0
11823946,1,1,0,0,1,1,0,0,0
11824101,2,2,0,0,2,2,0,0,1
11824150,1,1,0,0,1,1,0,0,0
11824505,1,1,0,0,1,1,0,0,0
11824571,1,1,0,0,1,1,0,0,0
11824630,1,1,0,0,1,1,0,0,0
11824712,1,1,0,0,1,1,0,0,0
11824737,2,2,0,0,2,2,0,0,1
11825016,2,2,0,0,2,2,0,0,0
11825629,3,3,0,0,0,0,0,0,1
11825691,1,1,0,0,1,1,0,0,0
11825767,2,2,0,0,1,1,0,1,0
11826526,1,1,0,0,1,1,0,0,0
11826752,1,1,0,0,1,1,0,0,0
11826807,2,2,0,0,1,1,0,0,0
11827384,2,2,0,0,2,2,0,0,0
11827564,4,4,0,0,0,0,0,0,0
11827813,1,1,0,0,1,1,0,0,0
11827829,2,1,1,0,2,1,1,0,0
11827988,1,1,0,0,1,1,0,0,0
11828311,2,2,0,0,2,2,0,0,0
11828394,1,1,0,0,1,1,0,0,0
11828564,1,1,0,0,1,1,0,0,0
11828808,1,1,0,0,1,1,0,0,0
11828916,1,1,0,0,1,1,0,0,0
11828940,1,1,0,0,1,1,0,0,0
11829315,2,2,0,0,1,1,0,1,0
11829457,1,1,0,0,1,1,0,0,0
11829602,2,2,0,0,1,1,0,1,0
11829700,1,1,0,0,1,1,0,0,1
11829767,2,2,0,0,1,1,0,0,0
11829813,2,2,0,0,1,1,0,0,0
11830662,1,1,0,0,1,1,0,1,0
11831035,2,2,0,0,2,2,0,0,0
11831221,2,2,0,0,1,1,0,0,1
11831635,4,3,1,0,1,1,0,0,1
11831697,5,5,0,0,0,0,0,0,0
11831940,2,2,0,0,2,2,0,1,1
11832739,6,6,0,0,1,1,0,0,0
11832879,1,1,0,0,1,1,0,1,0
11832904,2,2,0,0,2,2,0,0,0
11832967,1,1,0,0,1,1,0,0,0
11833502,2,2,0,0,2,2,0,0,0
11833697,1,1,0,0,1,1,0,0,0
11833986,1,1,0,0,1,1,0,0,0
11834210,3,3,0,0,2,2,0,0,0
11834314,1,0,1,0,1,1,0,0,0
11834717,1,1,0,0,1,1,0,0,0
11834934,2,2,0,0,2,2,0,0,0
11835202,1,1,0,0,1,1,0,0,0
11835225,2,2,0,0,1,1,0,1,0
11835234,1,1,0,0,1,1,0,0,0
11835392,1,1,0,0,1,1,0,0,0
11835426,1,1,0,0,1,1,0,0,0
11835473,1,1,0,0,1,1,0,0,0
11835832,2,2,0,0,2,2,0,0,0
11836066,1,1,0,0,1,1,0,0,0
11836120,1,1,0,0,1,1,0,1,0
11836169,2,2,0,0,1,1,0,0,0
11836185,3,3,0,0,0,0,0,0,0
11836455,1,1,0,0,0,0,0,0,0
11836464,1,1,0,0,1,1,0,0,0
11836604,1,1,0,0,1,1,0,0,1
11836641,1,1,0,0,1,1,0,0,0
11836657,1,1,0,0,1,1,0,0,0
11836708,1,1,0,0,1,1,0,0,0
11836827,2,2,0,0,1,1,0,0,0
11836865,1,1,0,0,1,1,0,0,0
11837093,1,1,0,0,1,1,0,0,0
11837504,2,2,0,0,1,1,0,0,0
11837740,2,2,0,0,2,2,0,0,0
11838046,1,1,0,0,1,1,0,0,0
11838931,3,3,0,0,1,0,1,0,1
11838983,2,2,0,0,1,1,0,1,1
11839084,1,1,0,0,1,0,1,1,0
11839278,2,2,0,0,1,1,0,0,1
11839360,2,2,0,0,1,1,0,0,1
11839377,2,2,0,0,2,2,0,0,0
11839870,1,1,0,0,1,1,0,0,0
11839947,2,2,0,0,2,2,0,0,0
11840175,1,1,0,0,1,1,0,0,0
11840552,2,2,0,0,1,1,0,1,1
11840634,1,1,0,0,1,1,0,0,0
11840661,4,4,0,0,3,3,0,0,1
11840709,2,2,0,0,2,2,0,0,0
11841135,2,2,0,0,2,2,0,0,1
11841139,2,2,0,0,2,2,0,0,1
11842330,1,1,0,0,1,1,0,0,0
11842376,4,4,0,0,1,1,0,0,0
11842454,2,2,0,0,1,1,0,0,0
11842491,1,1,0,0,1,1,0,0,0
11842498,1,1,0,0,1,1,0,0,0
11842572,3,3,0,0,2,2,0,2,1
11842592,1,1,0,0,1,1,0,0,0
11842739,1,1,0,0,1,1,0,0,0
11842866,2,2,0,0,1,1,0,1,0
11843120,1,1,0,0,0,0,0,0,0
11843226,2,2,0,0,1,1,0,0,0
11843308,1,1,0,0,1,1,0,1,1
11843748,1,1,0,0,1,1,0,0,0
11843898,1,1,0,0,1,1,0,0,0
11844104,1,1,0,0,1,1,0,0,0
11844924,2,2,0,0,1,1,0,1,1
11844955,1,1,0,0,1,1,0,0,0
11845031,1,1,0,0,1,1,0,0,0
11845800,1,1,0,0,1,1,0,0,1
11845919,1,1,0,0,1,1,0,0,0
11845920,2,2,0,0,1,1,0,0,0
11846409,2,2,0,0,1,1,0,0,0
11846539,1,1,0,0,1,1,0,0,0
11847912,1,1,0,0,1,1,0,0,0
11848580,1,1,0,0,1,1,0,0,0
11848961,3,3,0,0,3,3,0,0,0
11849063,1,1,0,0,1,1,0,0,0
11849262,1,1,0,0,3,3,0,0,0
11849414,2,2,0,0,1,1,0,0,0
11849596,2,2,0,0,1,1,0,1,0
11850009,1,1,0,0,1,1,0,0,0
11850185,1,1,0,0,1,1,0,0,0
11850338,1,1,0,0,1,1,0,0,0
11850432,1,1,0,0,1,1,0,0,0
11850559,1,1,0,0,1,1,0,0,0
11850808,1,1,0,0,1,1,0,0,0
11851336,1,1,0,0,1,1,0,0,0
11851782,1,1,0,0,1,1,0,0,0
11851984,4,4,0,0,0,0,0,0,1
11852528,2,1,1,0,1,1,0,0,0
11852867,2,1,1,0,2,1,1,1,1
11852985,2,2,0,0,2,2,0,0,0
11853050,4,4,0,0,1,1,0,0,1
11853058,2,2,0,0,1,1,0,0,0
11853087,1,1,0,0,1,1,0,0,0
11853707,5,5,0,0,1,1,0,0,0
11853836,1,1,0,0,1,1,0,0,0
11853892,1,1,0,0,1,1,0,0,0
11853968,2,2,0,0,1,1,0,0,0
11854504,1,1,0,0,1,1,0,0,0
11854532,3,3,0,0,3,3,0,3,1
11854541,2,2,0,0,1,1,0,1,1
11854952,1,1,0,0,1,1,0,0,0
11855200,1,1,0,0,0,0,0,0,0
11855442,2,2,0,0,2,2,0,0,0
11855621,3,3,0,0,1,1,0,1,1
11856255,7,7,0,0,0,0,0,0,0
11856582,1,1,0,0,1,1,0,0,0
11856696,2,2,0,0,2,2,0,0,0
11857105,1,1,0,0,1,1,0,1,0
11857109,2,1,1,0,2,1,1,0,0
11857116,1,1,0,0,1,1,0,0,0
11857567,1,1,0,0,1,1,0,0,0
11857840,1,1,0,0,2,2,0,1,0
11858027,2,2,0,0,0,0,0,0,0
11858681,1,1,0,0,1,1,0,0,0
11858727,5,5,0,0,0,0,0,0,1
11859381,2,2,0,0,2,2,0,0,0
11859760,1,1,0,0,1,1,0,0,0
11859812,1,1,0,0,1,1,0,0,0
11860439,8,8,0,0,1,1,0,0,1
11860486,1,1,0,0,1,1,0,0,1
11860487,4,4,0,0,2,1,1,0,1
11860797,1,1,0,0,1,1,0,0,0
11861599,1,1,0,0,1,1,0,0,0
11861902,1,1,0,0,1,1,0,0,0
11862198,1,1,0,0,1,1,0,0,0
11862609,6,6,0,0,0,0,0,0,0
11862630,1,1,0,0,1,1,0,0,0
11862706,3,3,0,0,4,3,1,0,0
11863181,2,2,0,0,1,1,0,0,0
11863429,3,3,0,0,1,1,0,1,1
11863540,3,3,0,0,1,1,0,1,1
11863566,4,4,0,0,1,1,0,1,1
11863622,1,1,0,0,1,1,0,0,0
11863658,1,1,0,0,1,1,0,0,0
11863703,3,3,0,0,1,1,0,1,1
11863746,3,3,0,0,1,1,0,1,1
11863747,3,3,0,0,1,1,0,1,1
11863773,1,1,0,0,1,1,0,0,0
11863895,1,1,0,0,1,1,0,0,1
11863955,2,1,1,0,2,1,1,0,0
11863975,1,1,0,0,1,1,0,0,0
11864074,2,2,0,0,1,1,0,0,0
11864164,1,1,0,0,2,1,1,1,0
11864369,3,3,0,0,1,1,0,1,1
11864462,4,4,0,0,0,0,0,0,1
11864669,1,1,0,0,1,1,0,0,0
11864745,1,1,0,0,1,1,0,0,0
11864869,1,1,0,0,1,1,0,0,0
11864923,2,2,0,0,0,0,0,0,0
11865628,2,2,0,0,2,2,0,0,0
11865898,2,2,0,0,3,3,0,0,0
11866143,1,1,0,0,1,1,0,0,0
11866177,3,3,0,0,2,2,0,0,0
11866376,2,2,0,0,2,2,0,0,0
11866561,1,1,0,0,1,1,0,0,0
11866678,1,1,0,0,1,1,0,0,0
11866794,4,4,0,0,1,1,0,1,0
11866848,2,2,0,0,1,1,0,1,1
11866939,2,2,0,0,0,0,0,0,0
11867066,4,4,0,0,0,0,0,0,1
11867451,1,1,0,0,1,1,0,0,0
11867794,1,1,0,0,1,1,0,0,0
11868626,2,2,0,0,2,2,0,0,1
11868753,1,1,0,0,1,1,0,0,1
11869207,4,4,0,0,1,1,0,1,1
11870212,1,1,0,0,1,1,0,0,0
11870362,1,1,0,0,1,1,0,0,0
11870698,2,2,0,0,2,2,0,0,0
11871083,1,1,0,0,1,1,0,0,0
11871330,1,1,0,0,1,1,0,0,0
11871500,2,2,0,0,2,2,0,0,0
11871933,2,2,0,0,2,2,0,0,0
11872054,4,4,0,0,3,3,0,0,0
11872584,1,1,0,0,1,1,0,0,0
11872762,2,2,0,0,2,2,0,0,0
11872771,2,2,0,0,2,2,0,0,0
11872835,2,2,0,0,1,1,0,0,0
11872885,1,1,0,0,0,0,0,0,0
06625040,14,6,8,0,0,0,0,0,1
06625194,7,1,6,0,1,1,0,1,1
06625203,6,1,5,0,1,1,0,1,1
06625215,21,5,16,0,0,0,0,0,0
06625241,6,0,6,0,1,1,0,1,1
06625244,6,0,6,0,1,1,0,1,1
06625268,6,0,6,0,1,1,0,1,1
06625280,7,0,7,0,1,1,0,1,1
06625319,6,0,6,0,0,0,0,0,1
06625350,10,3,7,0,1,1,0,1,1
06625359,6,1,5,0,1,1,0,1,1
06625551,8,1,7,0,0,0,0,0,0
06625791,19,3,16,0,2,2,0,2,1
06626682,7,2,5,0,3,1,2,3,1
06627036,3,3,0,0,1,1,0,0,1
06627037,11,7,4,0,0,0,0,0,0
06627681,15,4,11,0,0,0,0,0,0
06628157,3,0,3,0,0,0,0,0,1
06628230,3,2,1,0,3,3,0,0,0
06628442,9,4,5,0,1,1,0,0,1
06628569,13,2,11,0,7,1,6,1,1
06628631,23,0,23,0,4,4,0,0,0
06628790,4,0,4,0,0,0,0,0,1
06628835,9,5,4,0,1,1,0,1,1
06629122,8,0,8,0,0,0,0,0,1
06629295,4,2,2,0,1,1,0,0,1
06629807,2,2,0,0,1,1,0,0,1
06629824,5,0,5,0,1,1,0,1,1
06629903,5,0,5,0,0,0,0,0,1
06630327,4,0,4,0,0,0,0,0,1
06630396,2,1,1,0,1,1,0,0,1
06630421,6,4,2,0,6,6,0,5,1
06630555,4,4,0,0,1,1,0,0,0
06631180,1,1,0,0,1,1,0,0,0
06631570,14,2,12,0,1,1,0,1,1
06631593,15,2,13,0,1,1,0,1,1
06631742,2,0,2,0,0,0,0,0,0
06632016,4,0,4,0,0,0,0,0,1
06632271,9,5,4,0,1,1,0,1,1
06632303,41,13,28,0,2,2,0,0,1
06632306,31,9,22,0,0,0,0,0,1
06632447,8,5,3,0,1,1,0,1,1
06632506,9,2,7,0,3,1,2,1,1
06632605,3,0,3,0,0,0,0,0,1
06632634,8,0,8,0,0,0,0,0,1
06632676,15,2,13,0,1,1,0,0,1
06633088,10,7,3,0,1,1,0,1,1
06633157,4,3,1,0,2,1,1,0,1
06633245,2,1,1,0,1,1,0,0,0
06633907,5,0,5,0,2,2,0,0,1
06634408,20,11,9,0,0,0,0,0,1
06635140,1,1,0,0,1,1,0,0,1
06635661,4,1,3,0,2,2,0,0,0
06635706,8,0,8,0,0,0,0,0,1
06635818,5,3,2,0,1,1,0,0,0
06635865,8,0,8,0,1,1,0,0,1
06636008,7,1,6,0,2,1,1,2,1
06636280,2,0,2,0,0,0,0,0,0
06636311,3,0,3,0,1,1,0,0,1
06636358,5,0,5,0,0,0,0,0,1
06636624,15,3,12,0,1,1,0,1,1
06636654,4,0,4,0,0,0,0,0,1
06636660,11,0,11,0,1,1,0,1,1
06636724,12,1,11,0,2,1,1,0,0
06636784,2,2,0,0,1,1,0,0,0
06636870,2,0,2,0,0,0,0,0,1
06637084,5,5,0,0,0,0,0,0,0
06637175,6,0,6,0,0,0,0,0,1
06637991,5,2,3,0,2,2,0,0,0
06638349,3,3,0,0,2,2,0,0,1
06638474,12,5,7,1,1,1,0,1,1
06638829,2,2,0,0,2,2,0,0,0
06639061,2,0,2,0,0,0,0,0,1
06639465,10,0,10,0,0,0,0,0,0
06639476,7,4,3,0,1,1,0,1,1
06640002,4,0,4,0,0,0,0,0,1
06640131,7,4,3,0,1,1,0,0,1
06640185,6,0,6,0,0,0,0,0,1
06640294,8,5,3,0,5,4,1,0,1
06640597,11,6,5,0,1,1,0,0,0
06640999,6,3,3,0,1,1,0,1,1
06641017,12,5,7,0,1,1,0,1,1
06641083,9,4,5,0,0,0,0,0,1
06641153,11,5,6,0,1,1,0,1,1
06641172,2,2,0,0,1,1,0,0,0
06641194,9,3,6,0,1,1,0,1,1
06641234,3,3,0,0,3,3,0,0,0
06641459,4,3,1,0,1,1,0,1,0
06641752,6,3,3,0,2,2,0,0,0
06642099,0,0,0,0,0,0,0,0,1
06642515,6,3,3,0,3,1,2,0,1
06642677,8,1,7,0,2,1,1,2,1
06642891,7,0,7,0,0,0,0,0,1
06643140,6,2,4,0,1,1,0,0,1
06643183,5,2,3,0,1,1,0,0,1
06643208,8,3,5,0,1,1,0,0,1
06643231,22,4,18,0,1,1,0,1,1
06643744,4,0,4,0,2,2,0,0,0
06644602,4,3,1,0,1,1,0,0,0
06645035,2,0,2,0,0,0,0,0,1
06645163,4,2,2,0,1,1,0,0,1
06645239,1,1,0,0,1,1,0,0,0
06645806,11,0,11,0,1,1,0,0,1
06645809,5,3,2,0,1,1,0,0,1
06646230,4,2,2,0,1,1,0,0,0
06646355,4,2,2,0,2,2,0,0,0
06646956,6,0,6,0,1,1,0,1,1
06647081,5,1,4,0,1,1,0,0,0
06647384,8,4,4,0,1,1,0,0,0
06647402,6,2,4,0,4,1,3,1,1
06647404,6,1,5,0,2,1,1,1,1
06647451,3,3,0,0,2,2,0,0,0
06647452,2,0,2,0,0,0,0,0,1
06647462,4,1,3,0,1,1,0,0,1
06647571,15,6,9,0,1,1,0,1,1
06647754,7,5,2,0,2,2,0,0,1
06647990,7,2,5,0,3,1,2,1,1
06648324,1,1,0,0,1,1,0,0,0
06648652,2,1,1,0,1,1,0,0,0
06648728,16,3,13,0,0,0,0,0,1
06648959,5,0,5,0,1,1,0,0,1
06648989,4,1,3,0,2,2,0,0,1
06649183,8,0,8,0,0,0,0,0,1
06649553,5,4,1,0,1,1,0,0,1
06649555,10,5,5,0,0,0,0,0,1
06650014,1,1,0,0,1,1,0,0,0
06650357,4,0,4,0,1,1,0,0,0
06650468,4,2,2,0,0,0,0,0,1
06650504,7,1,6,0,2,2,0,0,0
06650610,4,2,2,0,2,2,0,0,0
06650639,5,3,2,0,0,0,0,0,1
06650882,3,1,2,0,1,1,0,0,0
06651040,3,0,3,0,0,0,0,0,0
06651043,4,2,2,0,1,1,0,0,1
06651483,1,0,1,0,0,0,0,0,1
06651543,12,6,6,0,1,1,0,1,1
06651737,7,0,7,0,0,0,0,0,1
06651886,17,5,12,1,2,0,2,1,1
06652005,5,4,1,0,0,0,0,0,1
06652509,2,1,1,0,1,1,0,0,1
06652796,5,0,5,0,1,1,0,0,1
06653396,9,2,7,0,0,0,0,0,0
06653440,4,0,4,0,1,1,0,1,1
06653969,10,6,4,0,2,1,1,0,1
06653998,8,0,8,0,0,0,0,0,1
06654115,19,13,6,0,0,0,0,0,0
06654336,11,4,7,0,0,0,0,0,1
06654421,2,0,2,0,0,0,0,0,0
06655026,7,0,7,0,0,0,0,0,1
06655242,3,3,0,0,1,1,0,0,0
06655703,3,3,0,0,1,1,0,0,0
06656030,4,0,4,0,0,0,0,0,1
06656192,2,1,1,0,1,1,0,0,1
06656360,7,2,5,0,2,2,0,0,1
06656397,3,2,1,0,1,1,0,0,0
06656512,7,2,5,0,1,1,0,1,0
06656904,5,5,0,0,0,0,0,0,1
06657048,16,8,8,0,0,0,0,0,1
06657184,8,3,5,0,1,1,0,1,1
06657507,8,5,3,0,0,0,0,0,1
06657602,14,5,9,0,1,1,0,1,1
06657849,5,2,3,0,1,1,0,1,1
06658421,3,2,1,0,1,1,0,0,0
06658523,2,1,1,0,1,1,0,0,0
06658655,4,0,4,0,2,2,0,0,0
06658907,1,1,0,0,1,1,0,0,0
06659115,7,2,5,0,0,0,0,0,1
06659192,1,1,0,0,1,1,0,0,0
06659453,24,0,24,0,0,0,0,0,1
06659573,5,2,3,0,2,2,0,1,0
06659865,5,0,5,0,0,0,0,0,0
06659912,1,1,0,0,1,1,0,0,0
06660360,4,2,2,0,1,1,0,1,0
06660465,12,0,12,0,0,0,0,0,1
06660683,7,4,3,0,0,0,0,0,1
06661373,19,4,15,0,2,2,0,2,1
06661561,4,1,3,0,1,1,0,0,0
06662027,25,10,15,0,0,0,0,0,1
06662061,9,0,9,0,0,0,0,0,1
06662497,3,2,1,0,1,1,0,1,0
06662786,19,3,16,0,1,1,0,1,1
06662857,6,2,4,0,1,1,0,0,0
06662891,6,2,4,0,1,1,0,0,0
06663042,4,3,1,0,3,2,1,0,1
06663056,10,3,7,0,0,0,0,0,0
06663088,5,2,3,0,1,1,0,1,1
06663109,3,0,3,0,0,0,0,0,1
06663708,2,0,2,0,2,2,0,0,0
06663766,7,2,5,0,1,1,0,0,1
06663983,1,1,0,0,1,1,0,0,0
06664189,4,3,1,0,2,2,0,0,1
06664958,8,3,5,0,1,0,1,0,1
06665223,3,0,3,0,0,0,0,0,1
06666175,4,3,1,0,3,3,0,0,0
06666259,8,3,5,0,0,0,0,0,0
06666433,2,2,0,0,1,1,0,0,0
06666788,5,1,4,0,1,1,0,0,0
06667092,23,3,20,0,0,0,0,0,1
06667605,8,4,4,0,1,1,0,1,1
06667762,4,0,4,0,0,0,0,0,1
06667896,20,7,13,0,0,0,0,0,1
06668718,15,6,9,0,1,1,0,0,1
06668849,7,3,4,0,1,1,0,1,1
06668993,5,3,2,0,1,1,0,0,0
06669127,4,1,3,0,1,1,0,0,1
06669272,4,2,2,0,1,1,0,0,0
06670147,5,0,5,0,0,0,0,0,0
06670805,23,9,14,0,0,0,0,0,1
06670855,2,2,0,0,0,0,0,0,0
06670975,9,3,6,0,1,1,0,1,1
06671245,3,2,1,0,1,1,0,0,0
06671587,39,3,36,0,1,1,0,1,1
06671721,39,12,27,0,1,1,0,1,0
06672262,4,0,4,0,0,0,0,0,1
06672484,7,6,1,0,5,5,0,0,0
06672610,5,2,3,0,1,1,0,0,0
06672664,4,3,1,0,1,1,0,1,0
06673003,12,0,12,0,2,1,1,0,0
06673042,5,3,2,0,3,3,0,1,0
06673223,9,3,6,0,0,0,0,0,1
06673262,3,2,1,0,0,0,0,0,1
06673364,26,0,26,0,0,0,0,0,1
06673678,5,2,3,0,2,2,0,0,0
06674427,24,5,19,0,0,0,0,0,1
06674463,5,0,5,0,0,0,0,0,1
06674644,6,2,4,0,1,1,0,1,1
06674962,6,2,4,0,1,1,0,1,1
06674973,1,1,0,0,1,1,0,0,0
06675067,7,3,4,0,2,1,1,2,0
06675093,8,1,7,0,3,1,2,1,1
06675130,2,2,0,0,1,1,0,0,0
06675192,3,0,3,0,0,0,0,0,1
06675798,10,6,4,0,0,0,0,0,0
06676556,3,2,1,0,2,2,0,0,1
06676746,2,2,0,0,1,1,0,0,0
06676935,8,0,8,0,4,2,2,0,1
06677095,15,0,15,0,0,0,0,0,1
06677096,12,3,9,0,0,0,0,0,1
06677097,24,2,22,0,0,0,0,0,1
06677805,8,0,8,0,0,0,0,0,1
06677936,7,3,4,0,1,1,0,1,1
06678019,5,4,1,0,1,1,0,0,1
06678308,10,7,3,0,4,2,2,1,0
06678335,7,4,3,0,3,1,2,1,0
06678336,7,0,7,0,0,0,0,0,1
06678337,7,0,7,0,0,0,0,0,1
06678359,11,8,3,0,4,1,3,1,0
06678802,5,0,5,0,1,1,0,1,1
06679087,6,0,6,0,2,2,0,0,1
06679357,6,3,3,0,2,2,0,0,0
06679670,17,4,13,0,1,1,0,0,1
06679774,15,0,15,0,0,0,0,0,1
06679926,8,0,8,0,0,0,0,0,1
06680385,11,3,8,0,1,1,0,1,1
06680701,16,5,11,0,1,1,0,1,1
06681177,16,0,16,0,0,0,0,0,1
06681322,13,4,9,0,0,0,0,0,1
06681395,12,1,11,0,0,0,0,0,1
06681505,2,2,0,0,1,1,0,0,0
06681897,5,3,2,0,1,1,0,0,0
06681948,6,1,5,0,0,0,0,0,1
06682482,1,1,0,0,1,1,0,0,1
06682638,3,0,3,0,0,0,0,0,0
06682673,21,7,14,0,0,0,0,0,1
06683123,2,1,1,0,1,1,0,0,1
06684140,3,3,0,0,2,2,0,0,1
06684259,12,6,6,0,5,5,0,0,0
06684470,5,3,2,0,1,1,0,1,1
06684514,3,0,3,0,0,0,0,0,1
06685276,41,9,32,0,0,0,0,0,1
06685688,22,8,14,0,0,0,0,0,1
06685913,12,4,8,0,1,1,0,1,1
06686100,2,1,1,0,1,1,0,0,0
06686117,4,1,3,0,2,2,0,0,0
06686138,4,1,3,0,2,2,0,0,0
06686170,8,2,6,0,3,1,2,1,1
06686392,2,0,2,0,0,0,0,0,1
06686573,3,2,1,0,1,1,0,0,1
06687000,6,5,1,0,3,1,2,1,0
06687106,6,5,1,0,3,1,2,1,0
06687249,30,6,24,0,1,0,1,0,0
06687274,9,6,3,0,1,1,0,1,1
06687482,11,0,11,0,0,0,0,0,1
06687527,2,1,1,0,1,1,0,0,0
06688128,9,3,6,0,2,0,2,0,1
06688735,14,8,6,0,0,0,0,0,0
06689012,2,1,1,0,1,1,0,0,0
06689220,8,0,8,0,1,1,0,1,1
06689324,9,5,4,0,4,2,2,1,0
06689338,1,1,0,0,1,1,0,0,0
06689355,10,5,5,0,4,1,3,1,0
06689529,2,2,0,0,1,1,0,1,1
06689538,21,5,16,0,1,1,0,1,1
06689614,24,0,24,0,1,1,0,1,1
06689988,2,1,1,0,1,1,0,0,0
06690344,4,0,4,0,2,2,0,0,1
06691126,3,1,2,0,0,0,0,0,0
06691249,4,0,4,0,0,0,0,0,0
06691251,22,9,13,0,0,0,0,0,1
06691982,12,4,8,0,0,0,0,0,0
06692098,3,2,1,0,1,1,0,0,0
06692155,9,4,5,0,0,0,0,0,1
06692246,13,6,7,0,2,1,1,1,1
06692269,8,2,6,0,3,3,0,0,0
06692641,10,0,10,0,0,0,0,0,1
06692661,10,0,10,0,0,0,0,0,1
06692731,4,1,3,0,2,1,1,1,1
06693439,9,5,4,0,0,0,0,0,0
06694104,4,0,4,0,0,0,0,0,1
06694155,9,6,3,0,1,1,0,1,1
06694512,20,4,16,0,1,1,0,1,1
06694702,4,3,1,0,1,1,0,0,0
06694768,31,10,21,0,0,0,0,0,1
06695017,19,3,16,0,1,1,0,1,1
06695464,3,0,3,0,2,2,0,0,0
06695789,6,3,3,0,2,2,0,0,1
06696116,5,1,4,0,2,1,1,0,0
06696174,3,2,1,0,1,1,0,0,0
06696798,7,4,3,0,4,4,0,0,1
06696864,10,5,5,0,1,1,0,1,1
06697217,4,4,0,0,3,3,0,0,1
06697241,8,3,5,0,1,1,0,0,1
06697544,2,2,0,0,1,1,0,0,0
06697612,6,3,3,0,2,2,0,0,0
06697848,6,3,3,0,0,0,0,0,0
06698128,9,4,5,0,1,1,0,1,1
06698414,11,0,11,0,0,0,0,0,1
06698724,7,0,7,0,0,0,0,0,1
06698816,3,0,3,0,1,1,0,0,0
06699516,5,5,0,0,1,1,0,1,0
06699537,11,3,8,0,1,1,0,0,0
SC225116,15,4,11,1,1,1,0,1,1
SC225132,12,0,12,0,0,0,0,0,1
SC225242,32,3,29,1,0,0,0,0,1
SC225393,5,0,5,0,0,0,0,0,1
SC225562,7,3,4,0,1,1,0,0,1
SC225567,5,0,5,0,0,0,0,0,1
SC225588,16,0,16,0,0,0,0,0,1
SC225620,2,1,1,0,1,1,0,0,1
SC225661,35,11,24,1,0,0,0,0,1
SC225667,15,0,15,0,0,0,0,0,1
SC225677,11,0,11,0,0,0,0,0,1
SC225678,4,1,3,0,1,1,0,0,1
SC225880,10,3,7,0,1,1,0,0,1
SC225896,8,2,6,0,1,1,0,1,1
SC225920,53,6,47,0,4,2,2,0,1
SC225975,5,3,2,0,2,2,0,0,1
SC226006,8,2,6,0,1,1,0,0,1
SC226081,11,4,7,0,1,1,0,1,1
SC226082,10,0,10,0,1,1,0,1,1
SC226271,12,6,6,1,3,3,0,0,1
SC226292,13,0,13,0,1,1,0,1,0
SC226345,8,0,8,0,0,0,0,0,1
SC226373,5,3,2,0,2,2,0,0,1
SC226378,14,6,8,0,2,2,0,0,0
SC226438,8,3,5,0,1,1,0,0,0
SC226460,8,3,5,0,2,1,1,1,0
SC226514,14,2,12,0,1,1,0,1,1
SC226523,32,8,24,0,3,1,2,3,1
SC226571,15,6,9,0,0,0,0,0,1
SC226585,23,3,20,0,1,1,0,1,1
SC226712,26,8,18,0,0,0,0,0,1
SC226788,16,5,11,0,0,0,0,0,0
SC226980,15,2,13,0,1,1,0,1,1
SC227021,5,3,2,0,1,1,0,1,1
SC227071,21,0,21,0,0,0,0,0,1
SC227137,11,5,6,2,0,0,0,0,1
SC227381,7,3,4,0,2,2,0,0,0
SC227600,7,2,5,0,2,2,0,0,0
SC227652,5,2,3,1,1,1,0,0,1
SC227701,18,6,12,0,1,1,0,1,0
SC227843,7,3,4,0,0,0,0,0,0
SC227895,7,3,4,0,2,2,0,1,1
SC227985,30,5,25,0,0,0,0,0,0
SC228008,31,0,31,0,0,0,0,0,1
SC228015,6,3,3,0,2,2,0,0,0
SC228175,7,4,3,0,3,3,0,0,0
SC228259,3,1,2,0,1,1,0,0,1
SC228457,8,3,5,0,1,1,0,0,1
SC228524,9,0,9,0,0,0,0,0,1
SC228564,4,0,4,0,0,0,0,0,1
SC228615,14,4,10,0,2,1,1,0,0
SC228668,12,3,9,0,1,1,0,1,1
SC228755,13,0,13,0,2,2,0,0,0
SC228833,23,2,21,0,0,0,0,0,1
SC228859,16,0,16,0,0,0,0,0,1
SC229183,22,0,22,0,0,0,0,0,1
SC229316,18,5,13,0,2,2,0,2,1
SC229409,28,8,20,0,0,0,0,0,1
SC229540,10,5,5,0,1,1,0,0,1
SC229591,4,0,4,0,0,0,0,0,0
SC229602,4,3,1,0,2,2,0,0,1
SC229681,28,4,24,0,1,1,0,1,1
SC229694,22,8,14,1,0,0,0,0,0
SC229817,21,5,16,0,1,1,0,1,1
SC229822,22,5,17,0,1,1,0,1,1
SC229838,39,8,31,0,7,7,0,0,0
SC230050,5,0,5,0,0,0,0,0,1
SC230301,8,4,4,0,2,1,1,0,1
SC230315,40,0,40,0,1,0,1,0,0
SC230486,7,3,4,0,4,3,1,0,1
SC230537,9,3,6,0,1,1,0,1,0
SC230591,5,2,3,0,1,1,0,0,1
SC230613,10,0,10,0,0,0,0,0,1
SC230640,7,1,6,0,1,1,0,0,1
SC230828,6,0,6,0,0,0,0,0,1
SC230854,33,9,24,0,0,0,0,0,0
SC230872,41,1,40,0,1,1,0,1,1
SC230916,4,0,4,0,0,0,0,0,1
SC230949,33,1,32,0,1,1,0,0,1
SC231005,6,3,3,0,1,1,0,0,0
SC231089,19,3,16,0,2,1,1,1,0
SC231140,7,3,4,0,1,1,0,0,0
SC231144,6,0,6,0,0,0,0,0,1
SC231198,24,5,19,0,0,0,0,0,1
SC231284,18,5,13,0,1,1,0,1,1
SC231578,33,0,33,0,0,0,0,0,1
SC231584,11,0,11,0,0,0,0,0,0
SC231661,5,1,4,0,1,1,0,0,1
SC231864,5,3,2,0,3,3,0,0,0
SC232125,23,2,21,0,8,6,2,0,1
SC232195,6,3,3,0,1,1,0,0,0
SC232198,7,5,2,0,2,2,0,0,1
SC232226,16,6,10,0,2,2,0,0,1
SC232415,6,0,6,1,0,0,0,0,1
SC232512,36,4,32,1,1,1,0,1,1
SC232581,11,2,9,0,1,1,0,0,1
SC232772,15,1,14,0,0,0,0,0,1
SC232862,5,3,2,0,1,1,0,0,1
SC232868,8,4,4,0,2,1,1,2,1
SC232869,8,4,4,0,2,1,1,2,1
SC232870,8,4,4,0,2,1,1,2,1
SC233025,9,0,9,0,1,1,0,1,0
SC233084,38,8,30,0,1,1,0,0,1
SC233209,5,3,2,0,1,1,0,0,0
SC233277,32,0,32,0,0,0,0,0,1
SC233302,28,7,21,0,1,1,0,0,1
SC233416,21,3,18,0,2,2,0,2,1
SC233572,5,3,2,0,1,1,0,0,1
SC233625,29,11,18,0,0,0,0,0,1
SC233837,15,0,15,0,0,0,0,0,0
SC234246,10,6,4,0,0,0,0,0,0
SC234270,41,15,26,0,0,0,0,0,1
SC234284,4,0,4,0,0,0,0,0,1
SC234317,6,0,6,0,1,1,0,1,1
SC234318,6,2,4,0,1,1,0,1,1
SC234409,13,6,7,0,1,1,0,1,1
SC234478,16,10,6,0,0,0,0,0,0
SC234480,5,2,3,0,1,1,0,0,0
SC234585,6,1,5,0,1,1,0,0,0
SC234588,11,3,8,0,2,2,0,0,1
SC234775,11,0,11,0,0,0,0,0,1
SC234781,35,11,24,0,0,0,0,0,1
SC234802,7,2,5,0,1,1,0,0,0
SC235054,11,7,4,0,0,0,0,0,1
SC235199,19,4,15,1,1,1,0,1,1
SC235210,33,0,33,0,0,0,0,0,1
SC235261,26,0,26,0,0,0,0,0,1
SC235585,13,0,13,0,0,0,0,0,1
SC235634,9,5,4,0,3,3,0,0,0
SC235636,7,3,4,0,1,1,0,1,1
SC235672,7,2,5,0,2,1,1,2,1
SC235853,16,10,6,0,0,0,0,0,1
SC235980,5,1,4,0,1,1,0,0,1
SC236136,27,2,25,0,1,1,0,1,1
SC236265,9,0,9,0,0,0,0,0,1
SC236377,23,9,14,0,1,1,0,1,1
SC236412,4,1,3,0,1,1,0,0,1
SC236901,17,0,17,0,0,0,0,0,1
SC236975,9,2,7,0,1,1,0,0,0
SC237019,5,3,2,0,3,3,0,0,0
SC237063,47,8,39,0,0,0,0,0,1
SC237253,6,2,4,0,1,1,0,0,1
SC237259,6,4,2,0,3,1,2,0,0
SC237325,21,2,19,0,3,1,2,3,1
SC237393,17,5,12,0,2,2,0,0,1
SC237472,18,5,13,0,1,1,0,1,1
SC237516,10,0,10,0,0,0,0,0,1
SC237628,13,0,13,0,2,2,0,2,1
SC237675,14,3,11,0,3,2,1,0,0
SC237681,5,3,2,0,2,2,0,0,0
SC237692,6,2,4,0,1,1,0,0,0
SC237778,13,6,7,0,0,0,0,0,1
SC237826,10,1,9,0,1,1,0,0,1
SC237857,23,8,15,0,0,0,0,0,0
SC237873,13,3,10,0,2,0,2,0,1
SC238011,5,3,2,0,2,2,0,0,0
SC238106,13,4,9,0,1,1,0,1,1
SC238162,25,2,23,0,1,1,0,1,1
SC238283,6,0,6,1,1,1,0,0,1
SC238333,45,9,36,0,1,1,0,0,0
SC238420,19,3,16,0,2,2,0,0,0
SC238556,7,4,3,0,0,0,0,0,1
SC238713,7,0,7,0,0,0,0,0,1
SC238884,6,4,2,0,0,0,0,0,0
SC238887,9,0,9,0,1,1,0,1,0
SC238922,12,0,12,0,1,1,0,1,1
SC238931,6,1,5,1,1,1,0,0,1
SC238932,4,0,4,0,1,1,0,0,1
SC239146,7,5,2,0,4,4,0,4,1
SC239334,8,2,6,1,2,1,1,0,1
SC239341,15,4,11,0,1,1,0,1,1
SC239366,5,3,2,0,2,2,0,0,0
SC239385,9,2,7,0,3,3,0,0,1
SC239454,7,0,7,0,0,0,0,0,1
SC239467,12,4,8,0,1,1,0,1,0
SC239555,15,5,10,0,2,2,0,0,1
SC239605,11,5,6,0,0,0,0,0,0
SC239648,13,1,12,0,0,0,0,0,1
SC239665,9,3,6,0,1,1,0,1,1
SC239681,12,8,4,0,2,2,0,0,1
SC239873,9,4,5,0,1,1,0,0,1
SC239934,38,0,38,0,0,0,0,0,1
SC239960,15,5,10,1,2,1,1,2,1
SC239975,19,5,14,0,1,1,0,1,1
SC240044,15,2,13,0,1,1,0,0,1
SC240062,10,4,6,0,1,1,0,0,1
SC240234,18,8,10,0,0,0,0,0,1
SC240264,6,0,6,0,0,0,0,0,1
SC240265,5,3,2,0,2,2,0,0,1
SC240884,6,2,4,0,1,1,0,1,1
SC240991,9,0,9,0,0,0,0,0,1
SC240995,28,5,23,0,2,2,0,2,1
SC240996,27,5,22,0,1,1,0,1,1
SC241155,8,3,5,0,4,3,1,0,0
SC241368,35,7,28,0,0,0,0,0,1
SC241462,20,5,15,0,1,1,0,1,1
SC241463,15,3,12,0,1,1,0,1,1
SC241464,16,5,11,0,1,1,0,1,1
SC241465,15,4,11,0,1,1,0,1,1
SC241468,14,0,14,0,0,0,0,0,1
SC241499,13,0,13,0,1,1,0,1,1
SC241500,13,0,13,0,1,1,0,1,1
SC241505,23,2,21,0,2,1,1,2,1
SC241615,5,3,2,0,2,2,0,0,1
SC241639,4,1,3,0,1,1,0,0,1
SC241657,12,0,12,0,0,0,0,0,1
SC241938,7,5,2,0,2,2,0,0,0
SC242060,16,4,12,0,4,3,1,1,0
SC242114,26,4,22,1,1,1,0,1,1
SC242393,5,2,3,0,2,2,0,0,0
SC242571,12,0,12,0,0,0,0,0,1
SC242675,41,9,32,0,0,0,0,0,1
SC242720,5,3,2,0,1,1,0,0,0
SC242724,10,2,8,0,1,1,0,1,1
SC243126,16,3,13,0,2,2,0,2,0
SC243127,16,3,13,0,1,1,0,1,0
SC243133,8,0,8,0,0,0,0,0,1
SC243198,7,5,2,0,2,1,1,1,1
SC243294,19,0,19,0,0,0,0,0,1
SC243323,12,1,11,0,3,3,0,0,1
SC243324,12,1,11,0,3,3,0,0,1
SC243326,7,2,5,0,2,2,0,1,1
SC243327,7,2,5,0,2,2,0,1,1
SC243328,11,3,8,0,1,1,0,0,1
SC243330,20,9,11,0,2,1,1,2,1
SC243331,24,0,24,0,0,0,0,0,1
SC243332,15,2,13,0,1,1,0,1,1
SC243423,4,3,1,0,2,2,0,0,0
SC243497,16,2,14,0,1,1,0,1,1
SC243668,12,6,6,0,1,1,0,1,0
SC243820,12,0,12,0,1,1,0,0,0
SC243965,7,0,7,0,0,0,0,0,1
SC244049,27,0,27,0,0,0,0,0,1
SC244283,18,2,16,0,1,1,0,1,1
SC244325,5,0,5,0,1,1,0,0,0
SC244608,8,0,8,0,0,0,0,0,1
SC244682,7,3,4,0,1,1,0,0,1
SC244741,22,2,20,0,0,0,0,0,0
SC244806,49,4,45,0,0,0,0,0,1
SC244815,10,2,8,0,1,1,0,0,1
SC244816,51,7,44,0,0,0,0,0,0
SC244909,11,5,6,0,2,2,0,0,0
SC245001,12,3,9,0,2,2,0,0,0
SC245151,8,0,8,0,0,0,0,0,1
SC245230,7,5,2,0,2,2,0,0,0
SC245266,5,3,2,0,1,1,0,0,0
SC245711,11,4,7,0,2,1,1,2,1
SC245826,5,2,3,0,0,0,0,0,0
SC245852,15,4,11,1,1,1,0,1,1
SC245910,8,4,4,0,1,1,0,1,1
SC245928,33,5,28,0,2,2,0,2,1
SC246072,5,0,5,0,0,0,0,0,1
SC246290,50,9,41,0,0,0,0,0,1
SC246318,18,4,14,0,0,0,0,0,1
SC246319,7,1,6,0,4,1,3,0,0
SC246391,23,4,19,0,1,1,0,1,1
SC246416,6,3,3,0,3,3,0,0,0
SC246616,3,0,3,0,1,1,0,0,0
SC246746,7,2,5,0,2,2,0,0,1
SC246751,14,0,14,0,0,0,0,0,1
SC246912,29,9,20,0,0,0,0,0,1
SC247045,91,15,76,0,0,0,0,0,1
SC247049,92,15,77,0,0,0,0,0,1
SC247050,28,6,22,0,1,1,0,1,1
SC247071,27,5,22,0,1,1,0,1,1
SC247081,15,3,12,0,1,1,0,1,1
SC247082,17,4,13,0,1,1,0,1,1
SC247109,6,2,4,0,1,1,0,0,0
SC247120,5,2,3,0,1,1,0,0,1
SC247121,6,4,2,0,1,1,0,1,1
SC247163,14,4,10,0,1,1,0,1,1
SC247318,10,2,8,0,1,1,0,0,1
SC247348,14,3,11,0,1,1,0,1,1
SC247376,25,4,21,0,1,1,0,0,1
SC247423,34,8,26,0,2,2,0,2,1
SC247632,7,2,5,0,0,0,0,0,1
SC247669,27,5,22,0,0,0,0,0,0
SC247937,75,12,63,0,0,0,0,0,0
SC248017,4,3,1,0,1,1,0,0,1
SC248112,4,2,2,0,1,1,0,0,1
SC248228,3,3,0,0,2,2,0,0,0
SC248359,8,2,6,0,2,2,0,0,1
SC248426,5,1,4,0,2,1,1,0,0
SC248439,6,2,4,0,1,1,0,0,0
SC248577,6,0,6,0,0,0,0,0,1
SC248711,3,2,1,1,3,3,0,1,1
SC248721,33,8,25,0,0,0,0,0,1
SC248806,26,8,18,0,6,5,1,0,1
SC248910,9,0,9,0,0,0,0,0,1
SC248942,9,1,8,0,2,1,1,0,0
SC249016,7,5,2,0,2,2,0,0,0
SC249391,3,1,2,0,2,2,0,0,1
SC249414,13,0,13,0,0,0,0,0,0
SC249604,6,2,4,0,1,1,0,0,1
SC249969,21,4,17,1,1,1,0,1,1
SC249970,60,17,43,0,1,1,0,0,0
SC250012,34,11,23,0,0,0,0,0,1
SC250015,20,2,18,0,1,1,0,1,1
SC250144,4,2,2,0,1,1,0,0,1
SC250304,5,3,2,0,1,1,0,0,1
SC250375,24,2,22,0,0,0,0,0,1
SC250417,3,0,3,0,0,0,0,0,0
SC250462,19,0,19,0,0,0,0,0,1
SC250551,9,3,6,0,2,2,0,0,1
SC250620,10,4,6,0,0,0,0,0,0
SC250674,6,0,6,0,0,0,0,0,1
SC250688,32,11,21,0,0,0,0,0,1
SC250757,6,0,6,1,0,0,0,0,1
SC250857,5,3,2,0,1,1,0,0,0
SC250925,26,5,21,0,1,1,0,1,1
SC250969,66,11,55,0,0,0,0,0,0
SC251039,4,2,2,0,1,1,0,0,0
SC251104,8,1,7,0,1,1,0,0,0
SC251347,5,3,2,0,2,2,0,0,1
SC251353,7,0,7,0,2,2,0,0,1
SC251477,14,1,13,0,0,0,0,0,1
SC251564,8,0,8,0,0,0,0,0,0
SC251567,8,3,5,0,1,1,0,1,1
SC251568,12,3,9,0,1,1,0,1,1
SC251725,33,0,33,0,2,2,0,2,1
SC251751,14,3,11,0,0,0,0,0,0
SC251896,10,6,4,0,1,1,0,1,1
SC251900,30,4,26,0,1,1,0,1,1
SC252356,3,2,1,1,2,2,0,0,1
SC252357,3,2,1,1,1,1,0,0,1
SC252402,5,3,2,1,2,2,0,0,1
SC252485,9,2,7,0,1,1,0,0,1
SC252599,5,1,4,0,1,1,0,0,1
SC252635,5,0,5,0,1,1,0,0,1
SC252689,23,6,17,0,5,3,2,0,0
SC252725,15,0,15,0,0,0,0,0,1
SC252755,4,0,4,0,1,1,0,0,0
SC252898,4,2,2,0,2,2,0,0,0
SC252985,5,3,2,0,2,2,0,0,0
SC253093,5,2,3,0,2,2,0,0,0
SC253108,10,0,10,0,0,0,0,0,1
SC253124,25,5,20,0,0,0,0,0,0
SC253126,13,0,13,0,0,0,0,0,1
SC253195,6,1,5,0,1,1,0,0,1
SC253226,12,3,9,0,1,1,0,1,1
SC253360,3,2,1,0,1,1,0,0,1
SC253872,4,0,4,0,0,0,0,0,1
SC254107,6,4,2,0,2,2,0,0,1
SC254121,13,0,13,0,1,1,0,1,1
SC254368,4,2,2,0,1,1,0,0,1
SC254440,4,1,3,0,0,0,0,0,0
SC254536,6,2,4,0,1,1,0,0,0
SC254609,9,3,6,0,3,3,0,0,1
SC254620,4,0,4,0,0,0,0,0,1
SC254641,18,3,15,0,2,1,1,2,1
SC254664,16,4,12,0,1,1,0,1,1
SC254745,23,3,20,0,1,1,0,1,1
SC254839,10,5,5,0,3,1,2,1,1
SC255020,36,6,30,0,2,2,0,2,0
SC255402,4,2,2,0,2,2,0,0,0
SC255427,12,3,9,0,1,1,0,1,1
SC255429,37,4,33,0,1,1,0,1,1
SC255430,20,7,13,0,2,1,1,2,1
SC255846,4,0,4,0,0,0,0,0,0
05127162,16,2,14,0,0,0,0,0,1
05127396,6,2,4,0,1,1,0,1,1
05127468,5,1,4,0,1,1,0,0,0
05127605,13,0,13,0,1,1,0,1,1
05127651,17,7,10,0,1,1,0,1,1
05127683,18,4,14,0,1,1,0,1,1
05127949,9,6,3,0,2,2,0,0,1
05128090,19,4,15,0,1,1,0,1,1
05128170,15,3,12,0,1,1,0,1,1
05128281,7,5,2,0,4,4,0,0,0
05128519,7,2,5,0,1,1,0,0,1
05128627,19,0,19,0,0,0,0,0,1
05128649,8,0,8,0,0,0,0,0,1
05129325,6,4,2,0,1,1,0,0,0
05129363,26,8,18,0,0,0,0,0,1
05129801,5,2,3,0,1,1,0,0,0
05130044,15,4,11,0,1,1,0,1,1
05130193,8,0,8,0,1,1,0,1,1
05130424,8,0,8,0,0,0,0,0,1
05130954,5,0,5,0,0,0,0,0,1
05131216,6,0,6,0,1,1,0,0,0
05131356,10,4,6,0,2,2,0,0,0
05131621,17,0,17,0,0,0,0,0,1
05132601,13,2,11,0,1,0,1,0,1
05132940,9,3,6,0,1,1,0,1,1
05132981,20,3,17,0,2,1,1,2,1
05133090,13,4,9,0,0,0,0,0,0
05133141,5,2,3,0,2,2,0,0,0
05133159,16,2,14,0,1,1,0,1,1
05133270,9,0,9,0,0,0,0,0,1
05133284,7,5,2,0,1,1,0,0,0
05133559,17,3,14,0,1,1,0,1,1
05133917,6,4,2,0,1,1,0,1,1
05133939,29,12,17,0,0,0,0,0,0
05133973,0,0,0,0,0,0,0,0,1
05134106,6,0,6,0,0,0,0,0,0
05134126,5,0,5,0,0,0,0,0,1
05134420,34,12,22,0,0,0,0,0,1
05134704,22,2,20,0,2,1,1,2,1
05134729,10,4,6,0,1,1,0,0,1
05134743,10,4,6,0,1,1,0,0,1
05134745,10,0,10,0,1,1,0,0,1
05134753,10,0,10,0,1,1,0,0,1
05134773,17,4,13,0,1,1,0,1,1
05134829,20,9,11,0,0,0,0,0,1
05135232,5,3,2,0,2,2,0,0,0
05135696,8,1,7,0,1,1,0,0,1
05135739,12,0,12,0,0,0,0,0,1
05135777,5,0,5,0,0,0,0,0,1
05135911,14,3,11,0,2,2,0,0,1
05135913,17,0,17,0,0,0,0,0,1
05136061,7,4,3,0,0,0,0,0,0
05136976,16,4,12,0,1,1,0,1,1
05137154,10,3,7,0,1,1,0,1,1
05137619,48,0,48,0,0,0,0,0,1
05137687,28,7,21,0,0,0,0,0,1
05137693,34,10,24,0,0,0,0,0,1
05137814,9,0,9,0,0,0,0,0,1
05137939,4,2,2,0,1,1,0,0,1
05138008,13,0,13,0,0,0,0,0,1
05138114,8,2,6,0,0,0,0,0,1
05138140,23,2,21,0,1,1,0,1,1
05138299,40,12,28,0,0,0,0,0,1
05138352,13,3,10,0,0,0,0,0,1
05138717,9,5,4,0,1,1,0,0,0
05139004,33,4,29,1,1,1,0,1,1
05139331,2,2,0,0,1,1,0,1,1
05139418,6,0,6,0,0,0,0,0,1
05139433,5,3,2,0,1,1,0,0,0
05139920,6,3,3,0,2,2,0,0,0
05139948,6,3,3,0,1,1,0,0,1
05139988,11,2,9,0,0,0,0,0,1
05140024,12,0,12,0,0,0,0,0,1
05140764,10,0,10,0,1,1,0,1,1
05140766,23,4,19,0,2,2,0,2,1
05141101,6,4,2,0,3,3,0,0,0
05141577,14,3,11,0,1,1,0,1,1
05141592,22,7,15,0,1,1,0,1,1
05141767,3,1,2,0,1,1,0,0,1
05142148,11,4,7,0,1,1,0,0,1
05142341,31,8,23,0,0,0,0,0,1
05142355,9,0,9,0,0,0,0,0,1
05142404,20,5,15,0,1,1,0,1,1
05142459,16,5,11,0,0,0,0,0,1
05142745,8,2,6,0,0,0,0,0,1
05143042,29,7,22,0,0,0,0,0,0
05143203,18,2,16,0,1,1,0,1,1
05143224,3,0,3,0,0,0,0,0,1
05143413,4,0,4,0,1,1,0,0,0
05143446,17,6,11,0,1,1,0,0,1
05143729,11,4,7,0,0,0,0,0,1
05143769,7,3,4,0,2,2,0,0,0
05144256,40,14,26,0,1,1,0,0,1
05144355,26,6,20,0,5,5,0,0,1
05144467,17,5,12,0,1,1,0,1,1
05144611,4,2,2,0,1,1,0,1,1
05144757,6,2,4,0,1,1,0,1,1
05144765,6,2,4,0,1,1,0,1,1
05144923,4,3,1,0,2,2,0,0,0
05145056,9,0,9,1,0,0,0,0,1
05145077,8,3,5,0,2,2,0,0,1
05145240,25,7,18,0,5,5,0,5,1
05145334,22,6,16,0,1,1,0,1,1
05145336,20,5,15,0,1,1,0,1,1
05145339,22,6,16,0,1,1,0,1,1
05145341,26,6,20,0,1,1,0,1,1
05145345,23,6,17,0,1,1,0,1,1
05145504,7,1,6,0,1,1,0,0,1
05145603,10,5,5,0,0,0,0,0,1
05145773,8,0,8,0,0,0,0,0,1
05146134,5,0,5,0,0,0,0,0,1
05146323,5,0,5,0,0,0,0,0,1
05146644,19,2,17,0,1,1,0,1,1
05146698,41,13,28,0,0,0,0,0,1
05147132,9,2,7,0,1,1,0,0,1
05147355,4,0,4,0,0,0,0,0,1
05147619,6,0,6,0,0,0,0,0,1
05147637,17,2,15,0,1,1,0,1,1
05147642,6,2,4,0,1,1,0,0,1
05147771,5,0,5,0,0,0,0,0,1
05147799,3,0,3,0,0,0,0,0,1
05147948,11,5,6,0,3,3,0,0,1
05148025,5,3,2,0,1,1,0,0,1
05148075,18,0,18,0,0,0,0,0,1
05148105,7,2,5,0,1,1,0,0,1
05148111,13,0,13,0,0,0,0,0,1
05148134,20,5,15,0,1,1,0,1,1
05148158,20,3,17,0,0,0,0,0,1
05148192,5,1,4,0,1,1,0,0,0
05148195,23,0,23,0,1,1,0,1,1
05148196,2,1,1,0,1,1,0,0,0
05148203,14,3,11,0,1,1,0,1,1
05148211,23,2,21,0,1,1,0,1,1
05148237,19,3,16,0,1,1,0,1,1
05148298,22,4,18,0,1,1,0,1,1
05148404,10,4,6,0,2,0,2,2,0
05148641,21,8,13,0,0,0,0,0,1
05148743,4,0,4,0,1,1,0,0,1
05148744,12,4,8,0,0,0,0,0,0
05148845,34,3,31,0,1,1,0,1,1
05149070,10,5,5,0,2,2,0,0,1
05149111,46,9,37,0,0,0,0,0,1
05149599,12,0,12,0,1,1,0,1,1
05149640,11,0,11,0,0,0,0,0,1
05149681,7,4,3,0,1,1,0,1,1
05149731,11,2,9,0,1,1,0,1,1
05149739,14,3,11,0,1,1,0,1,1
05149751,16,5,11,0,3,1,2,1,1
05149773,7,4,3,0,1,1,0,1,1
05150413,17,2,15,0,1,1,0,1,1
05150453,19,2,17,0,1,1,0,1,1
05150847,16,3,13,0,1,1,0,1,1
05151089,4,2,2,0,1,1,0,0,1
05151151,6,2,4,0,1,1,0,0,0
05151192,12,3,9,0,0,0,0,0,1
05151487,5,3,2,0,1,1,0,0,0
05151494,14,3,11,0,0,0,0,0,0
05151558,7,0,7,0,0,0,0,0,1
05151829,5,3,2,0,1,1,0,0,0
05151972,3,0,3,0,0,0,0,0,1
05152446,40,9,31,0,0,0,0,0,0
05152502,7,0,7,0,0,0,0,0,0
05152645,14,3,11,0,1,1,0,1,1
05152976,7,4,3,0,2,2,0,0,1
05153358,5,3,2,0,1,1,0,0,0
05153381,2,1,1,0,1,1,0,0,0
05153583,12,2,10,0,1,1,0,0,0
05153931,11,4,7,0,0,0,0,0,1
05154176,32,11,21,0,0,0,0,0,1
05154449,12,9,3,0,3,2,1,2,1
05154500,8,0,8,0,0,0,0,0,1
05155035,4,2,2,0,1,1,0,1,0
05155107,14,6,8,0,0,0,0,0,1
05155389,7,1,6,0,1,1,0,1,0
05155508,13,3,10,0,1,1,0,1,1
05155529,5,1,4,0,1,1,0,0,1
05155628,16,3,13,0,0,0,0,0,0
05155662,10,0,10,0,0,0,0,0,1
05156439,10,8,2,0,0,0,0,0,0
05156468,14,9,5,0,1,1,0,0,1
05156597,4,2,2,0,1,1,0,0,1
05156611,3,3,0,0,0,0,0,0,0
05156671,24,4,20,0,1,1,0,1,1
05156687,12,3,9,0,2,2,0,0,0
05156702,40,12,28,0,0,0,0,0,1
05156855,4,1,3,0,1,1,0,0,1
05157388,15,3,12,0,1,1,0,1,1
05157504,4,2,2,0,2,2,0,0,0
05158288,19,5,14,0,1,1,0,1,1
05158326,30,5,25,0,1,1,0,1,1
05158573,14,4,10,0,0,0,0,0,0
05158597,14,3,11,0,1,1,0,1,1
05158607,15,5,10,0,1,1,0,1,1
05158638,7,0,7,0,0,0,0,0,1
05159037,5,2,3,0,1,1,0,0,0
05159071,10,4,6,0,0,0,0,0,1
05159093,11,3,8,0,0,0,0,0,1
05159099,22,6,16,0,0,0,0,0,1
05159152,4,2,2,0,1,1,0,0,0
05159552,4,1,3,0,1,1,0,0,0
05159784,2,2,0,0,1,1,0,0,0
05159841,11,2,9,0,1,1,0,1,1
05160050,40,9,31,0,0,0,0,0,1
05160075,3,3,0,0,2,2,0,0,0
05160374,18,8,10,0,0,0,0,0,1
05160439,7,1,6,0,1,1,0,1,0
05160676,6,3,3,0,1,1,0,1,0
05160942,15,0,15,0,0,0,0,0,1
05161044,8,4,4,0,1,1,0,0,0
05161054,14,1,13,0,1,1,0,1,0
05161119,4,1,3,0,1,1,0,0,1
05161359,89,19,70,0,0,0,0,0,1
05161606,11,3,8,0,0,0,0,0,1
05161745,8,5,3,0,0,0,0,0,1
05162140,10,5,5,0,1,1,0,1,0
05162431,5,3,2,0,2,2,0,0,0
05162520,40,16,24,0,0,0,0,0,1
05162680,8,4,4,0,1,1,0,1,1
05162744,30,3,27,0,1,1,0,1,1
05163086,3,2,1,0,2,2,0,0,1
05163271,6,1,5,0,1,1,0,0,1
05163481,2,1,1,0,1,1,0,0,0
05163501,10,6,4,0,0,0,0,0,0
05163588,5,0,5,0,0,0,0,0,1
05163633,8,6,2,0,2,2,0,0,1
05163752,35,13,22,0,0,0,0,0,1
05163942,25,3,22,0,1,1,0,1,1
05164034,7,2,5,0,1,1,0,0,0
05164762,10,4,6,0,1,1,0,0,1
05164786,13,2,11,0,0,0,0,0,1
05165102,15,7,8,0,0,0,0,0,1
05165782,4,2,2,0,1,1,0,1,0
05165885,4,2,2,0,1,1,0,1,0
05166410,9,0,9,0,1,1,0,0,1
05166640,9,3,6,0,1,1,0,0,1
05166736,9,0,9,0,0,0,0,0,1
05167266,10,5,5,0,1,1,0,0,1
05167687,3,1,2,0,1,1,0,0,1
05167933,13,5,8,0,2,2,0,0,1
05167938,20,0,20,0,0,0,0,0,1
05167995,14,0,14,0,1,1,0,0,0
05168117,3,1,2,0,1,1,0,0,1
05168258,22,0,22,0,0,0,0,0,1
05168480,27,0,27,0,1,0,1,0,0
05168673,12,0,12,0,0,0,0,0,1
05168830,0,0,0,0,0,0,0,0,1
05169180,5,3,2,0,2,2,0,0,0
05169520,5,3,2,0,2,2,0,0,0
05169560,8,3,5,0,1,1,0,1,1
05169669,4,3,1,0,1,1,0,0,1
05169780,24,7,17,0,0,0,0,0,1
05169972,6,3,3,0,2,2,0,0,0
05170241,20,0,20,0,0,0,0,0,1
05170251,25,4,21,0,3,2,1,0,0
05170355,4,2,2,0,1,1,0,0,0
05170380,14,3,11,0,1,1,0,1,1
05170525,16,3,13,0,1,1,0,1,1
05170572,21,0,21,0,0,0,0,0,1
05170671,14,3,11,0,1,1,0,1,1
05170929,4,0,4,0,0,0,0,0,1
05171367,29,7,22,0,0,0,0,0,0
05171646,21,7,14,0,0,0,0,0,0
05171651,8,7,1,0,1,1,0,0,0
05171817,37,6,31,0,1,1,0,1,1
05171986,4,2,2,0,1,1,0,0,0
05172112,7,0,7,0,3,3,0,1,1
05172116,7,5,2,0,4,2,2,2,1
05172187,15,0,15,0,0,0,0,0,1
05172189,14,3,11,0,2,2,0,2,1
05172311,40,8,32,0,1,1,0,1,1
05172721,18,3,15,0,1,1,0,1,1
05173142,15,0,15,0,0,0,0,0,1
05173250,36,5,31,0,0,0,0,0,1
05173265,6,1,5,0,1,1,0,0,1
05173398,10,1,9,0,0,0,0,0,1
05173584,5,3,2,0,1,1,0,0,1
05173595,28,8,20,0,0,0,0,0,1
05173996,13,0,13,0,2,2,0,0,1
05174043,10,3,7,0,1,1,0,1,1
05174256,3,2,1,0,1,1,0,1,0
05174294,23,0,23,0,0,0,0,0,1
05174395,11,6,5,0,0,0,0,0,1
05174456,17,3,14,0,0,0,0,0,1
05174655,20,3,17,0,1,1,0,1,1
05174985,19,0,19,1,0,0,0,0,1
05175186,4,2,2,0,1,1,0,0,0
05175320,5,3,2,0,2,2,0,0,0
05175899,11,9,2,0,0,0,0,0,1
05176330,18,4,14,0,2,2,0,2,1
05176511,12,0,12,0,1,1,0,1,1
05176566,5,0,5,0,0,0,0,0,1
05176957,4,0,4,0,0,0,0,0,1
05176992,18,9,9,0,1,1,0,1,1
05176998,39,11,28,0,0,0,0,0,1
05177125,6,1,5,0,2,2,0,0,1
05177409,31,9,22,0,0,0,0,0,1
05177607,6,2,4,0,1,1,0,0,0
05177694,19,0,19,0,1,1,0,1,1
05177753,4,3,1,0,2,2,0,0,0
05178040,22,7,15,0,0,0,0,0,0
05178677,34,7,27,0,0,0,0,0,1
05178688,30,3,27,0,1,1,0,1,1
05178759,23,2,21,0,1,1,0,1,1
05179403,18,7,11,0,0,0,0,0,1
05179653,13,0,13,0,0,0,0,0,1
05180008,18,3,15,0,3,3,0,0,1
05180233,9,3,6,0,2,1,1,1,1
05180239,9,3,6,0,2,1,1,1,1
05180282,9,4,5,0,2,2,0,2,0
05180290,9,3,6,0,2,1,1,1,1
05180493,8,2,6,0,0,0,0,0,1
05180585,21,6,15,0,0,0,0,0,1
05180733,12,6,6,0,0,0,0,0,0
05180783,29,9,20,0,0,0,0,0,1
05180872,7,2,5,0,2,2,0,0,1
05180993,13,6,7,0,0,0,0,0,1
05181323,7,0,7,0,0,0,0,0,1
05181440,9,4,5,0,0,0,0,0,1
05181790,21,0,21,0,0,0,0,0,1
05181808,17,3,14,0,2,1,1,2,1
05181897,16,4,12,0,1,1,0,1,0
05181993,15,3,12,0,1,1,0,1,1
05182086,5,0,5,0,0,0,0,0,1
05182253,11,1,10,0,3,2,1,2,1
05182269,13,3,10,0,1,1,0,1,1
05182323,4,1,3,0,2,2,0,0,1
05182779,21,13,8,0,1,1,0,0,1
05182780,21,13,8,0,1,1,0,0,1
05182899,4,1,3,0,4,1,3,0,0
05182976,5,2,3,0,1,1,0,0,0
05182977,5,3,2,0,2,2,0,0,1
05183093,33,3,30,0,1,1,0,1,1
05183580,29,6,23,0,0,0,0,0,1
05183868,34,0,34,0,0,0,0,0,1
05184035,11,3,8,0,0,0,0,0,1
05184122,9,3,6,0,1,1,0,0,0
05184164,44,11,33,0,0,0,0,0,1
05184553,5,3,2,0,2,2,0,0,1
05184566,6,0,6,0,0,0,0,0,1
05184754,9,3,6,0,1,1,0,1,1
05184969,11,0,11,0,0,0,0,0,1
05185107,15,9,6,0,0,0,0,0,0
05185254,6,2,4,0,1,1,0,0,0
05185418,7,0,7,0,1,1,0,1,1
05185762,7,5,2,0,1,1,0,0,0
05185814,5,3,2,0,2,2,0,0,1
05185972,3,0,3,0,0,0,0,0,1
05186518,21,0,21,0,1,1,0,1,1
05186877,21,7,14,0,2,2,0,2,1
05186934,2,2,0,0,1,1,0,0,0
05187051,6,2,4,0,1,1,0,0,0
05187138,14,3,11,0,0,0,0,0,1
05187411,4,2,2,0,2,1,1,1,0
05187481,5,2,3,0,1,1,0,0,1
05187755,15,6,9,0,1,1,0,1,1
05187901,6,3,3,0,2,2,0,0,1
05187913,9,4,5,0,1,1,0,1,1
05187942,9,7,2,0,0,0,0,0,1
05187964,13,3,10,0,0,0,0,0,0
05188085,12,3,9,0,0,0,0,0,0
05188098,12,5,7,0,1,1,0,1,1
05188107,7,3,4,0,1,1,0,1,1
05188200,6,0,6,0,0,0,0,0,1
05188268,16,3,13,0,3,2,1,1,1
05188348,4,3,1,0,1,1,0,0,1
05188355,33,6,27,0,1,1,0,0,1
05188390,12,5,7,0,2,1,1,2,1
05188392,12,5,7,0,2,1,1,2,1
05188394,12,5,7,0,1,1,0,1,1
05188770,22,0,22,0,1,1,0,1,1
05188771,25,0,25,0,1,1,0,1,1
05189218,17,3,14,0,6,1,5,1,1
05189340,18,7,11,0,1,1,0,0,1
05189351,22,4,18,0,1,1,0,1,1
05190276,5,0,5,0,2,2,0,0,1
05190371,32,0,32,0,0,0,0,0,1
05190433,8,4,4,0,2,2,0,2,1
05190466,71,14,57,0,0,0,0,0,1
05190644,10,2,8,0,1,1,0,1,0
05190717,25,0,25,0,3,3,0,0,1
05190812,47,5,42,0,0,0,0,0,1
05190828,7,3,4,0,1,1,0,1,1
05190861,7,3,4,0,1,1,0,1,1
05191005,13,4,9,0,0,0,0,0,1
05191057,7,0,7,0,1,1,0,0,1
05191457,7,5,2,0,3,1,2,1,0
05191498,5,0,5,0,0,0,0,0,1
05191950,9,0,9,0,0,0,0,0,1
05192159,5,1,4,0,2,1,1,1,1
05192319,7,1,6,0,1,1,0,0,1
05192834,5,3,2,0,2,2,0,0,0
05193476,2,2,0,0,1,1,0,0,0
05193927,9,0,9,0,1,1,0,0,1
05194115,12,2,10,0,1,1,0,1,1
05194135,16,9,7,0,0,0,0,0,1
05194610,33,3,30,0,1,1,0,1,1
05195125,18,0,18,0,1,1,0,1,1
05195301,9,0,9,0,0,0,0,0,1
05195577,8,0,8,0,0,0,0,0,1
05195589,8,3,5,0,2,2,0,0,1
05195826,20,6,14,0,0,0,0,0,1
05195911,49,17,32,0,1,1,0,1,1
05196041,23,16,7,0,0,0,0,0,1
05196179,2,1,1,0,1,1,0,0,0
05196298,59,19,40,0,0,0,0,0,1
05196354,18,1,17,0,2,2,0,0,1
05197026,7,2,5,0,2,2,0,0,0
05197297,25,5,20,0,1,1,0,1,1
05197298,24,5,19,0,2,2,0,2,1
05197498,5,3,2,0,2,2,0,0,1
05198366,4,1,3,0,1,1,0,0,1
05198621,4,1,3,0,1,1,0,0,1
02056100,20,0,20,0,1,1,0,1,1
02056186,5,2,3,0,2,2,0,1,0
02056189,3,0,3,0,0,0,0,0,0
02056420,147,0,147,0,2,1,1,2,1
02056484,12,0,12,0,0,0,0,0,1
02056801,95,0,95,0,0,0,0,0,1
02057176,14,4,10,0,0,0,0,0,1
02057206,23,0,23,0,0,0,0,0,1
02057233,19,1,18,0,1,1,0,1,1
02057284,33,7,26,0,1,1,0,1,1
02057930,27,0,27,0,1,1,0,1,1
02057974,27,10,17,0,1,1,0,1,1
02058176,48,4,44,0,2,1,1,2,1
02058399,16,3,13,0,2,2,0,0,1
02059168,65,6,59,0,1,1,0,0,1
02059279,46,4,42,0,1,1,0,1,1
02059609,14,2,12,0,1,1,0,1,1
02059633,17,2,15,0,1,1,0,1,1
02059659,48,8,40,0,4,2,2,0,1
02059664,49,8,41,0,0,0,0,0,1
02059737,11,1,10,0,1,1,0,1,1
02060097,34,4,30,0,1,1,0,1,1
02060131,12,1,11,0,1,1,0,1,1
02060139,18,1,17,0,1,1,0,1,1
02060441,9,3,6,0,1,1,0,0,1
02060639,42,4,38,0,1,1,0,1,1
02060641,33,2,31,0,0,0,0,0,1
02060689,37,4,33,0,4,4,0,0,1
02060910,36,3,33,0,2,1,1,2,1
02060925,28,0,28,0,2,2,0,2,1
02061305,37,0,37,0,0,0,0,0,1
02061388,25,2,23,0,1,1,0,1,1
02061420,39,3,36,0,1,1,0,1,1
02061713,25,2,23,0,1,1,0,0,1
02061769,35,5,30,0,1,1,0,1,1
02061828,27,3,24,0,0,0,0,0,1
02062208,24,6,18,0,0,0,0,0,1
02062333,0,0,0,0,0,0,0,0,0
02063604,99,0,99,0,0,0,0,0,1
02063698,8,3,5,0,1,1,0,1,0
02063778,26,0,26,0,1,1,0,1,1
02063899,43,3,40,0,1,1,0,1,1
02063903,29,11,18,0,1,1,0,1,1
02064231,9,5,4,0,1,1,0,1,1
02064348,18,2,16,0,1,1,0,1,1
02065302,24,4,20,0,0,0,0,0,1
02065463,39,2,37,0,1,1,0,1,1
02065577,6,2,4,0,1,1,0,0,1
02065653,9,3,6,0,2,2,0,0,1
02065923,15,6,9,0,3,2,1,0,1
02065958,160,5,155,0,2,1,1,2,1
02066396,30,3,27,0,0,0,0,0,1
02066420,21,2,19,0,1,1,0,1,1
02066450,25,2,23,0,1,1,0,1,1
02066862,70,3,67,0,1,1,0,1,1
02066968,17,5,12,0,1,1,0,1,1
02067075,35,5,30,0,1,1,0,1,1
02067547,20,2,18,0,1,1,0,1,1
02067633,5,4,1,0,1,1,0,0,1
02067701,6,2,4,0,1,1,0,1,0
02067804,60,0,60,0,0,0,0,0,1
02068043,31,2,29,0,0,0,0,0,1
02068119,44,3,41,0,0,0,0,0,1
02068223,24,4,20,0,1,1,0,1,1
02068403,31,0,31,0,0,0,0,0,1
02068452,4,2,2,0,3,3,0,0,0
02068575,18,3,15,0,0,0,0,0,1
02068632,13,1,12,0,1,1,0,1,1
02068635,13,0,13,0,0,0,0,0,1
02068704,43,4,39,0,1,1,0,1,1
02068976,1,0,1,0,0,0,0,0,1
02069185,14,0,14,0,0,0,0,0,1
02069723,45,6,39,0,11,10,1,0,1
02069746,10,0,10,0,2,2,0,1,1
02070206,14,5,9,0,0,0,0,0,0
02070305,33,4,29,0,1,1,0,1,1
02070664,22,3,19,0,0,0,0,0,1
02070684,21,2,19,0,1,1,0,1,1
02070729,3,3,0,0,1,1,0,0,1
02070749,1,1,0,0,0,0,0,0,1
02071223,44,12,32,0,0,0,0,0,1
02071486,9,0,9,0,0,0,0,0,1
02071489,23,3,20,0,1,1,0,1,1
02071638,77,10,67,0,0,0,0,0,1
02071702,45,4,41,0,1,1,0,1,1
02071954,31,15,16,0,0,0,0,0,1
02072115,21,7,14,0,1,1,0,0,1
02072264,52,6,46,0,1,1,0,1,1
02072529,31,0,31,0,0,0,0,0,1
02072938,42,4,38,0,1,1,0,1,1
02073090,3,3,0,0,1,1,0,0,0
02073149,27,0,27,0,0,0,0,0,1
02073465,39,6,33,0,0,0,0,0,1
02074221,33,4,29,0,2,2,0,2,1
02074331,61,4,57,0,2,2,0,2,1
02074604,30,3,27,0,1,1,0,1,1
02074908,30,2,28,0,1,1,0,1,1
02075227,41,0,41,0,1,1,0,1,1
02075721,72,10,62,0,1,1,0,1,1
02075744,20,4,16,0,1,1,0,1,1
02075905,21,0,21,0,1,1,0,1,1
02076014,26,4,22,0,0,0,0,0,1
02076041,23,2,21,0,1,1,0,1,1
02076474,28,0,28,0,0,0,0,0,1
02076479,14,3,11,0,0,0,0,0,0
02076558,4,0,4,0,0,0,0,0,1
02076610,16,4,12,0,1,1,0,1,1
02076958,7,5,2,0,1,1,0,0,1
02077711,12,4,8,0,1,1,0,1,0
02078273,68,4,64,0,1,1,0,1,0
02078277,13,2,11,0,3,3,0,1,0
02078324,19,4,15,0,1,1,0,1,1
02078327,7,3,4,0,1,1,0,0,0
02078629,21,4,17,0,1,1,0,1,1
02078773,65,6,59,0,1,1,0,1,0
02079249,23,2,21,0,1,1,0,1,1
02079271,5,2,3,0,1,1,0,0,0
02079326,18,0,18,0,0,0,0,0,1
02079368,21,4,17,0,1,1,0,1,1
02079570,21,2,19,0,1,1,0,1,0
02080455,5,3,2,0,1,1,0,0,1
02080756,48,10,38,0,0,0,0,0,0
02080758,32,10,22,0,1,1,0,0,1
02081140,28,2,26,0,0,0,0,0,1
02081167,6,0,6,0,1,1,0,0,1
02081261,63,13,50,0,0,0,0,0,1
02081330,41,9,32,0,0,0,0,0,1
02081759,40,7,33,0,13,6,7,0,1
02081960,61,3,58,0,1,1,0,1,1
02082358,3,0,3,0,0,0,0,0,1
02082486,24,0,24,0,0,0,0,0,1
02082542,20,1,19,0,1,1,0,0,1
02082564,7,1,6,0,1,1,0,1,1
02083074,43,3,40,0,1,1,0,1,1
02083169,20,3,17,0,0,0,0,0,1
02083781,3,0,3,0,0,0,0,0,0
02084106,6,2,4,0,1,1,0,0,0
02084205,49,12,37,0,1,1,0,1,1
02084288,5,3,2,0,1,1,0,0,0
02084578,34,0,34,0,0,0,0,0,1
02084595,3,2,1,0,2,2,0,0,1
02084973,10,2,8,0,1,1,0,0,1
02085287,12,2,10,0,0,0,0,0,1
02085568,5,2,3,0,1,1,0,0,0
02085795,11,5,6,0,1,1,0,1,1
02085859,5,0,5,0,0,0,0,0,1
02085882,40,6,34,0,1,1,0,1,1
02086283,25,0,25,0,0,0,0,0,1
02086530,34,0,34,0,0,0,0,0,1
02086582,13,4,9,0,1,1,0,1,1
02086754,56,4,52,0,1,1,0,1,1
02086839,10,5,5,0,2,2,0,0,0
02086914,15,0,15,0,0,0,0,0,1
02087293,30,10,20,0,0,0,0,0,0
02087658,41,5,36,0,1,1,0,1,1
02087786,33,8,25,0,0,0,0,0,1
02088001,16,5,11,0,1,1,0,1,1
02088075,15,2,13,0,0,0,0,0,0
02088132,20,6,14,0,0,0,0,0,1
02088299,30,4,26,0,0,0,0,0,0
02088415,46,0,46,0,0,0,0,0,1
02088643,56,3,53,0,2,2,0,2,1
02089025,46,16,30,0,0,0,0,0,1
02089682,12,0,12,0,0,0,0,0,1
02090008,21,5,16,0,0,0,0,0,0
02090126,30,4,26,0,1,1,0,1,1
02090235,27,0,27,0,0,0,0,0,1
02090310,31,5,26,0,1,1,0,1,1
02090371,3,0,3,0,0,0,0,0,1
02090476,28,3,25,0,1,1,0,1,1
02090576,11,2,9,0,2,1,1,0,1
02090588,77,0,77,0,0,0,0,0,1
02090705,15,4,11,0,0,0,0,0,1
02090838,39,3,36,0,2,1,1,1,1
02091034,108,11,97,0,1,1,0,0,1
02091268,46,2,44,0,1,1,0,1,1
02091581,58,0,58,0,0,0,0,0,1
02091658,16,0,16,0,0,0,0,0,1
02091713,17,0,17,0,0,0,0,0,1
02091878,15,2,13,0,1,1,0,1,1
02091894,54,10,44,0,1,1,0,1,1
02091897,35,9,26,0,2,1,1,2,1
02092072,35,4,31,0,1,1,0,1,1
02092133,10,0,10,0,0,0,0,0,1
02092134,45,4,41,0,1,1,0,1,1
02092159,35,0,35,0,0,0,0,0,1
02092372,10,4,6,0,1,1,0,1,1
02092410,38,0,38,0,1,1,0,1,1
02093340,101,14,87,0,1,1,0,1,1
02093429,52,7,45,0,1,1,0,1,1
02093520,22,4,18,0,1,1,0,0,1
02093521,19,4,15,0,3,3,0,0,1
02093843,27,0,27,0,1,1,0,1,1
02094367,5,2,3,0,1,1,0,0,0
02094531,0,0,0,0,0,0,0,0,0
02094782,48,9,39,0,1,1,0,1,0
02094868,6,3,3,0,2,2,0,0,1
02094879,43,4,39,0,1,1,0,1,1
02094988,11,0,11,0,0,0,0,0,1
02094999,13,0,13,0,0,0,0,0,1
02095011,20,2,18,0,1,1,0,0,1
02095041,16,0,16,0,0,0,0,0,1
02095047,14,3,11,0,1,1,0,1,1
02095117,31,4,27,0,1,1,0,1,1
02095118,9,0,9,0,0,0,0,0,1
02095346,5,2,3,0,0,0,0,0,1
02096375,14,4,10,0,4,3,1,1,1
02096815,14,0,14,0,0,0,0,0,1
02096856,11,2,9,0,2,1,1,2,0
02096876,19,8,11,0,1,1,0,1,1
02098132,33,3,30,0,2,1,1,2,1
02098134,26,0,26,0,1,1,0,1,1
02098139,29,3,26,0,2,1,1,2,1
02098143,23,0,23,0,0,0,0,0,1
02098187,8,1,7,0,1,1,0,0,0
02098205,6,0,6,0,1,1,0,0,1
02098243,16,5,11,0,0,0,0,0,1
02098633,2,2,0,0,0,0,0,0,1
02098758,21,0,21,0,1,1,0,1,1
02098870,12,2,10,0,2,2,0,2,1
02099151,28,4,24,0,1,1,0,1,1
02099602,23,0,23,0,0,0,0,0,1
02100358,18,7,11,0,0,0,0,0,1
02100377,48,0,48,0,0,0,0,0,1
02100497,43,2,41,0,1,1,0,1,1
02100628,34,5,29,0,1,1,0,1,1
02100694,7,0,7,0,1,1,0,0,1
02100837,42,8,34,0,7,7,0,0,1
02100846,38,0,38,0,0,0,0,0,1
02100855,26,7,19,0,0,0,0,0,1
02100955,13,0,13,0,0,0,0,0,1
02101263,37,4,33,0,1,1,0,1,1
02101271,33,8,25,0,3,1,2,0,0
02101315,26,0,26,0,0,0,0,0,1
02101429,13,0,13,0,0,0,0,0,1
02101719,71,10,61,0,0,0,0,0,1
02102576,36,2,34,0,0,0,0,0,1
02102601,27,0,27,0,0,0,0,0,1
02102777,29,3,26,0,1,1,0,1,1
02103030,31,6,25,0,1,1,0,1,1
02103630,33,6,27,0,1,1,0,1,1
02103739,61,3,58,0,1,1,0,1,1
02103830,33,2,31,0,1,1,0,1,1
02103849,21,9,12,0,0,0,0,0,0
02104125,16,0,16,0,0,0,0,0,1
02104264,8,4,4,0,1,1,0,1,1
02104275,30,7,23,0,0,0,0,0,1
02104493,9,2,7,0,0,0,0,0,0
02104553,14,5,9,0,0,0,0,0,1
02104695,35,3,32,0,1,1,0,1,1
02105209,21,0,21,0,1,1,0,1,1
02106200,3,0,3,0,0,0,0,0,0
02106539,26,6,20,0,0,0,0,0,1
02106661,71,16,55,0,0,0,0,0,1
02106677,122,15,107,0,0,0,0,0,0
02106961,6,4,2,0,1,1,0,1,1
02107024,4,2,2,0,2,2,0,0,0
02107035,26,2,24,0,6,6,0,0,1
02107327,38,4,34,0,1,1,0,1,1
02107375,38,6,32,0,1,1,0,1,1
02107383,136,6,130,0,0,0,0,0,1
02107400,89,12,77,0,0,0,0,0,1
02107401,13,0,13,0,0,0,0,0,1
02107637,3,2,1,0,2,2,0,0,0
02107754,34,0,34,0,0,0,0,0,1
02107770,12,0,12,0,0,0,0,0,1
02107783,25,0,25,0,0,0,0,0,1
02108152,17,3,14,0,1,1,0,1,1
02108171,14,3,11,0,1,1,0,0,0
02108517,39,0,39,0,0,0,0,0,1
02108635,103,4,99,0,1,1,0,1,1
02108698,37,3,34,0,1,1,0,1,1
02108920,11,3,8,0,1,1,0,1,1
02108991,30,0,30,0,0,0,0,0,1
02109065,19,0,19,0,0,0,0,0,1
02109235,25,8,17,0,1,1,0,1,1
02109250,24,0,24,0,0,0,0,0,1
02109260,11,3,8,0,1,1,0,1,1
02109349,11,3,8,0,1,1,0,1,1
02109350,11,3,8,0,1,1,0,1,1
02109390,11,3,8,0,1,1,0,1,1
02109630,72,0,72,0,11,3,8,0,1
02109914,11,0,11,0,0,0,0,0,1
02109924,59,0,59,0,0,0,0,0,1
02109945,45,10,35,0,0,0,0,0,1
SC315838,11,2,9,1,1,1,0,1,1
SC315853,10,2,8,0,4,2,2,0,1
SC315862,5,3,2,0,2,2,0,0,0
SC315874,4,2,2,0,1,1,0,0,1
SC315947,5,2,3,0,1,1,0,0,0
SC315965,2,0,2,0,0,0,0,0,0
SC316007,5,3,2,1,2,2,0,0,1
SC316253,8,5,3,1,2,2,0,0,1
SC316261,4,0,4,0,0,0,0,0,1
SC316669,4,2,2,1,1,1,0,0,1
SC316728,16,3,13,0,1,1,0,1,1
SC316871,10,0,10,0,0,0,0,0,0
SC316899,5,2,3,0,1,1,0,0,0
SC317067,39,8,31,0,7,5,2,0,1
SC317304,18,3,15,0,1,1,0,1,1
SC317495,41,16,25,0,2,1,1,0,0
SC317525,22,4,18,0,1,1,0,1,1
SC317533,5,0,5,0,2,1,1,0,1
SC317542,5,0,5,0,2,1,1,0,1
SC317544,5,0,5,0,2,1,1,0,1
SC317546,5,0,5,0,2,1,1,0,1
SC317760,25,4,21,0,1,1,0,1,1
SC317866,5,0,5,1,2,2,0,0,1
SC318143,13,2,11,0,1,1,0,0,0
SC318186,12,2,10,0,1,1,0,1,1
SC318190,7,4,3,0,1,1,0,1,1
SC318198,7,3,4,0,1,1,0,0,1
SC318203,6,0,6,0,0,0,0,0,1
SC318300,35,0,35,0,0,0,0,0,0
SC318303,9,3,6,0,1,1,0,0,1
SC318304,9,3,6,0,1,1,0,0,1
SC318305,9,3,6,0,1,1,0,0,1
SC318307,3,3,0,0,2,2,0,0,0
SC318545,3,3,0,0,2,2,0,0,0
SC318581,2,0,2,0,0,0,0,0,0
SC318799,6,3,3,0,1,1,0,0,0
SC319004,20,3,17,0,0,0,0,0,1
SC319083,10,3,7,1,0,0,0,0,1
SC319100,3,0,3,0,0,0,0,0,1
SC319125,6,0,6,0,0,0,0,0,1
SC319153,10,0,10,0,0,0,0,0,1
SC319323,4,1,3,0,1,1,0,0,1
SC319425,22,3,19,0,2,1,1,2,1
SC319426,19,0,19,0,2,1,1,2,1
SC319454,8,2,6,0,0,0,0,0,1
SC319549,13,2,11,0,3,2,1,2,1
SC319890,8,3,5,0,2,1,1,0,0
SC320088,5,3,2,1,2,2,0,0,1
SC320138,7,2,5,0,2,1,1,2,1
SC320140,10,4,6,0,1,1,0,1,1
SC320141,10,3,7,0,1,1,0,1,1
SC320142,4,2,2,0,1,1,0,0,1
SC320234,5,3,2,0,2,2,0,0,0
SC320482,4,2,2,0,1,1,0,1,1
SC320484,15,4,11,0,1,1,0,1,1
SC320525,10,7,3,0,1,1,0,0,1
SC320591,4,2,2,0,1,1,0,0,0
SC320694,6,0,6,1,0,0,0,0,1
SC320720,5,0,5,0,0,0,0,0,1
SC320736,9,0,9,0,1,1,0,1,1
SC320982,7,2,5,0,0,0,0,0,0
SC321451,22,7,15,0,1,1,0,0,1
SC321584,12,0,12,0,0,0,0,0,1
SC321616,7,1,6,0,2,1,1,0,0
SC321692,5,2,3,0,2,1,1,0,1
SC321693,3,0,3,0,0,0,0,0,1
SC321773,7,0,7,0,0,0,0,0,1
SC321829,7,3,4,0,0,0,0,0,0
SC321863,16,5,11,0,1,1,0,0,0
SC322063,2,2,0,0,1,1,0,0,1
SC322119,12,8,4,0,1,1,0,0,1
SC322153,3,3,0,0,2,2,0,0,0
SC322248,9,5,4,0,1,1,0,0,1
SC322249,3,2,1,1,1,1,0,0,1
SC322250,4,3,1,1,1,1,0,1,1
SC322254,10,4,6,0,1,1,0,1,1
SC322257,7,2,5,0,2,2,0,0,1
SC322483,3,3,0,0,0,0,0,0,0
SC322550,6,4,2,0,0,0,0,0,1
SC322674,3,2,1,0,1,1,0,0,0
SC322922,4,2,2,1,1,1,0,0,1
SC323433,3,0,3,0,0,0,0,0,0
SC323528,4,2,2,0,1,1,0,0,1
SC323634,16,0,16,0,0,0,0,0,0
SC323668,4,1,3,0,1,1,0,0,0
SC323860,4,2,2,1,1,1,0,0,1
SC323861,6,0,6,1,0,0,0,0,1
SC323878,5,3,2,0,2,2,0,0,1
SC323899,9,5,4,0,2,2,0,0,1
SC324012,4,1,3,0,1,1,0,0,0
SC324149,4,0,4,0,0,0,0,0,1
SC324176,7,3,4,0,1,1,0,0,1
SC324569,3,3,0,0,2,2,0,0,0
SC324702,18,6,12,1,1,1,0,0,0
SC324713,7,0,7,0,0,0,0,0,1
SC324716,3,3,0,0,2,2,0,0,0
SC324796,6,0,6,0,0,0,0,0,1
SC324842,2,2,0,0,1,1,0,0,0
SC325066,24,8,16,0,1,1,0,1,0
SC325110,4,3,1,0,0,0,0,0,0
SC325196,5,2,3,0,2,2,0,0,0
SC325256,4,2,2,0,1,1,0,0,0
SC325321,10,4,6,0,1,1,0,1,1
SC325345,17,4,13,0,1,1,0,1,1
SC325348,10,4,6,0,1,1,0,1,1
SC325390,5,4,1,1,2,2,0,0,1
SC325391,4,0,4,1,0,0,0,0,1
SC325559,7,2,5,0,2,2,0,0,1
SC325565,12,7,5,0,3,3,0,0,1
SC325633,4,1,3,0,1,1,0,0,1
SC325649,9,1,8,0,1,1,0,0,1
SC325918,5,4,1,0,3,3,0,3,1
SC325935,5,0,5,0,0,0,0,0,1
SC326250,5,0,5,1,0,0,0,0,1
SC326405,5,2,3,0,1,1,0,0,0
SC327000,60,16,44,0,1,1,0,1,1
SC327107,5,0,5,0,0,0,0,0,1
SC327313,6,0,6,0,0,0,0,0,1
SC327458,20,7,13,0,0,0,0,0,1
SC327562,5,0,5,0,2,2,0,0,1
SC327622,30,0,30,0,0,0,0,0,1
SC327691,2,2,0,0,1,1,0,0,1
SC327766,4,0,4,0,2,2,0,0,1
SC327890,12,0,12,0,0,0,0,0,1
SC328006,7,2,5,0,2,2,0,0,1
SC328024,5,3,2,0,2,2,0,0,0
SC328033,19,6,13,0,1,1,0,1,1
SC328059,8,0,8,0,0,0,0,0,1
SC328061,6,0,6,0,0,0,0,0,1
SC328063,6,0,6,0,0,0,0,0,1
SC328115,23,7,16,0,0,0,0,0,1
SC328174,3,3,0,0,2,2,0,0,1
SC328486,3,2,1,0,1,1,0,0,0
SC328502,4,2,2,1,1,1,0,0,1
SC328507,7,3,4,0,1,1,0,0,0
SC328532,4,0,4,1,0,0,0,0,1
SC328830,4,0,4,1,0,0,0,0,1
SC329017,18,2,16,0,0,0,0,0,0
SC329184,13,8,5,0,1,1,0,1,1
SC329536,4,2,2,0,2,1,1,0,0
SC329549,5,1,4,1,1,1,0,0,1
SC329570,2,2,0,0,1,1,0,0,0
SC329602,3,3,0,0,2,2,0,0,0
SC329641,11,0,11,0,0,0,0,0,1
SC329807,4,2,2,1,1,1,0,0,1
SC329938,2,2,0,0,1,1,0,0,0
SC330389,25,0,25,0,0,0,0,0,1
SC330422,10,4,6,0,3,1,2,1,0
SC330561,5,4,1,0,3,3,0,0,1
SC330681,5,2,3,1,1,1,0,0,1
SC330821,5,3,2,0,3,3,0,0,0
SC331065,31,9,22,0,0,0,0,0,0
SC331115,2,0,2,0,0,0,0,0,1
SC331194,5,3,2,0,2,1,1,0,0
SC331203,3,1,2,0,2,1,1,0,0
SC331257,5,3,2,0,2,2,0,0,1
SC331462,11,0,11,1,0,0,0,0,0
SC331631,2,2,0,0,2,2,0,0,0
SC331643,4,0,4,1,0,0,0,0,1
SC331673,38,12,26,0,0,0,0,0,1
SC331737,20,0,20,0,0,0,0,0,1
SC331742,6,4,2,0,1,1,0,0,1
SC331752,7,5,2,0,3,3,0,0,1
SC331978,4,0,4,0,1,1,0,1,1
SC332096,10,3,7,0,2,1,1,1,1
SC332221,5,0,5,0,0,0,0,0,1
SC332590,7,0,7,0,0,0,0,0,1
SC332676,33,9,24,0,0,0,0,0,0
SC332758,13,2,11,0,1,1,0,1,1
SC332951,23,10,13,0,0,0,0,0,1
SC333105,21,8,13,0,1,1,0,1,0
SC333124,5,2,3,0,1,1,0,0,1
SC333184,10,2,8,0,1,1,0,0,1
SC333202,8,2,6,0,1,1,0,1,1
SC333345,11,4,7,0,2,1,1,1,1
SC333394,6,0,6,0,0,0,0,0,1
SC333416,12,6,6,0,0,0,0,0,1
SC333480,6,3,3,0,3,2,1,0,0
SC333487,13,2,11,0,1,1,0,1,1
SC333575,21,11,10,0,1,1,0,0,0
SC333598,7,0,7,0,0,0,0,0,1
SC333745,15,0,15,0,1,1,0,1,0
SC333876,6,0,6,1,1,1,0,0,1
SC333917,9,0,9,0,0,0,0,0,1
SC334308,14,5,9,0,0,0,0,0,1
SC334344,6,1,5,0,2,1,1,0,0
SC334386,2,0,2,0,0,0,0,0,0
SC334406,4,2,2,0,1,1,0,1,0
SC334407,6,0,6,0,0,0,0,0,1
SC334496,8,4,4,0,1,1,0,0,1
SC334507,6,0,6,1,0,0,0,0,1
SC334574,6,3,3,0,1,1,0,0,1
SC334636,10,4,6,0,2,1,1,1,1
SC334637,15,4,11,0,2,1,1,1,1
SC334714,10,5,5,0,1,1,0,1,1
SC334739,6,3,3,1,2,2,0,1,1
SC334778,2,2,0,0,1,1,0,0,1
SC334801,5,1,4,0,2,2,0,0,0
SC334811,7,0,7,0,0,0,0,0,1
SC334836,10,7,3,1,0,0,0,0,1
SC334867,8,0,8,0,0,0,0,0,1
SC334984,4,0,4,1,0,0,0,0,1
SC335079,5,0,5,1,0,0,0,0,1
SC335093,5,0,5,0,0,0,0,0,1
SC335094,3,2,1,0,1,1,0,0,1
SC335192,14,6,8,0,1,0,1,0,1
SC335203,3,2,1,0,1,1,0,0,1
SC335236,5,1,4,0,1,1,0,0,0
SC335410,7,5,2,0,2,2,0,0,1
SC335502,5,3,2,0,1,1,0,1,1
SC335522,6,1,5,0,1,1,0,0,1
SC335564,2,2,0,0,1,0,1,1,1
SC335804,16,4,12,0,2,2,0,2,1
SC335847,6,2,4,0,1,1,0,0,0
SC335874,28,3,25,0,1,1,0,1,1
SC336159,4,0,4,1,0,0,0,0,1
SC336216,5,0,5,0,0,0,0,0,1
SC336294,20,6,14,0,2,1,1,0,0
SC336414,21,3,18,0,0,0,0,0,1
SC336436,5,3,2,0,1,1,0,0,1
SC336548,6,0,6,1,0,0,0,0,1
SC336659,2,0,2,1,1,1,0,0,1
SC336918,18,4,14,0,1,1,0,1,0
SC337025,3,3,0,0,2,2,0,0,0
SC337106,10,0,10,0,0,0,0,0,1
SC337378,7,3,4,0,1,1,0,1,1
SC337381,19,7,12,0,0,0,0,0,0
SC337533,9,6,3,0,1,1,0,1,1
SC337543,4,2,2,0,1,1,0,0,1
SC337694,3,0,3,0,0,0,0,0,0
SC337739,6,0,6,0,4,4,0,0,1
SC337763,34,10,24,0,0,0,0,0,1
SC337888,7,1,6,1,1,1,0,1,1
SC338033,14,5,9,0,1,1,0,1,1
SC338081,3,3,0,0,2,2,0,2,1
SC338267,3,1,2,0,1,1,0,0,1
SC338536,7,5,2,0,1,1,0,1,0
SC338667,6,3,3,0,3,3,0,0,0
SC338672,4,0,4,0,0,0,0,0,1
SC338754,4,0,4,0,0,0,0,0,0
SC338755,16,5,11,0,1,1,0,1,1
SC338868,5,0,5,0,1,1,0,0,1
SC338895,3,3,0,0,2,2,0,0,1
SC338917,4,2,2,0,1,1,0,0,0
SC338931,4,2,2,0,1,1,0,0,0
SC338939,6,3,3,0,1,1,0,0,0
SC338986,4,0,4,0,0,0,0,0,1
SC339028,11,0,11,0,0,0,0,0,1
SC339123,9,5,4,0,1,1,0,0,1
SC339209,13,3,10,0,1,1,0,1,1
SC339211,23,6,17,0,5,4,1,0,0
SC339331,7,5,2,0,2,2,0,0,0
SC339399,9,4,5,0,3,3,0,1,1
SC339500,6,1,5,0,1,1,0,1,0
SC339621,10,0,10,0,0,0,0,0,1
SC339622,10,0,10,0,0,0,0,0,1
SC339623,10,0,10,0,0,0,0,0,1
SC339667,4,0,4,0,0,0,0,0,1
SC339678,4,1,3,0,1,1,0,0,0
SC339837,7,3,4,0,2,2,0,2,1
SC339840,4,1,3,0,1,1,0,0,0
SC339914,44,16,28,0,0,0,0,0,0
SC339941,10,0,10,0,0,0,0,0,1
SC340081,3,3,0,0,1,1,0,0,0
SC340298,13,6,7,1,1,1,0,1,1
SC340302,8,3,5,0,1,1,0,1,1
SC340439,2,2,0,0,1,1,0,0,0
SC340462,4,1,3,0,1,1,0,0,0
SC340589,5,0,5,0,2,1,1,0,1
SC340742,7,0,7,0,1,1,0,1,1
SC340772,18,2,16,0,1,1,0,1,0
SC340909,7,1,6,0,1,1,0,1,1
SC341063,7,3,4,0,1,1,0,0,1
SC341158,9,2,7,0,1,1,0,0,0
SC341160,4,0,4,0,2,2,0,0,1
SC341257,27,7,20,0,0,0,0,0,0
SC341347,3,0,3,0,0,0,0,0,1
SC341360,6,4,2,0,1,1,0,0,0
SC341432,17,6,11,0,0,0,0,0,1
SC341478,11,5,6,0,1,1,0,1,1
SC341482,6,4,2,0,1,1,0,1,1
SC341664,3,3,0,0,2,2,0,0,0
SC341704,9,6,3,0,2,0,2,0,0
SC341750,5,3,2,0,1,1,0,1,0
SC341775,19,2,17,0,5,5,0,5,1
SC341889,11,6,5,0,3,1,2,1,1
SC342189,2,2,0,0,1,1,0,0,0
SC342197,2,0,2,0,0,0,0,0,0
SC342212,11,4,7,0,0,0,0,0,0
SC342282,3,0,3,0,0,0,0,0,1
SC342295,9,4,5,1,0,0,0,0,1
SC342298,4,0,4,0,0,0,0,0,1
SC342382,5,2,3,0,1,1,0,0,1
SC342435,6,2,4,0,1,1,0,1,1
SC342571,1,0,1,0,0,0,0,0,0
SC342650,35,14,21,0,0,0,0,0,1
SC342868,7,2,5,0,1,1,0,0,1
SC342951,3,1,2,0,1,1,0,0,0
SC343168,3,3,0,0,2,2,0,0,0
SC343275,11,5,6,0,1,1,0,1,1
SC343362,14,4,10,0,1,1,0,1,1
SC343447,3,2,1,0,2,2,0,0,0
SC343464,12,4,8,0,2,1,1,0,1
SC343471,5,3,2,0,1,1,0,0,1
SC343487,13,3,10,0,0,0,0,0,0
SC343490,7,4,3,0,1,1,0,0,0
SC343553,24,8,16,0,0,0,0,0,1
SC343784,1,1,0,0,1,1,0,0,0
04060061,16,4,12,0,3,3,0,0,1
04060139,25,0,25,0,0,0,0,0,1
04060682,14,2,12,0,0,0,0,0,0
04060842,16,2,14,0,3,3,0,0,1
04060921,4,2,2,0,1,1,0,0,0
04060923,16,9,7,0,0,0,0,0,1
04061289,26,0,26,0,0,0,0,0,1
04061351,19,6,13,0,1,1,0,0,0
04061482,11,3,8,0,2,2,0,0,1
04061657,8,4,4,0,1,1,0,1,1
04061658,9,5,4,0,1,1,0,1,1
04061664,31,4,27,0,1,1,0,1,0
04061715,20,3,17,0,1,1,0,1,1
04061756,18,0,18,0,0,0,0,0,1
04061940,25,3,22,0,1,1,0,1,1
04062031,11,5,6,0,0,0,0,0,1
04062240,9,3,6,0,1,1,0,0,1
04062280,6,1,5,0,4,2,2,0,0
04062313,16,6,10,0,0,0,0,0,1
04062617,18,4,14,0,0,0,0,0,0
04062863,13,0,13,0,1,1,0,1,1
04062870,10,4,6,0,2,2,0,0,1
04063003,9,3,6,0,2,2,0,0,1
04063035,11,3,8,0,1,1,0,1,1
04063206,11,3,8,0,1,1,0,1,1
04063209,11,3,8,0,1,1,0,1,1
04063351,24,6,18,0,1,1,0,1,1
04063385,4,2,2,0,1,1,0,0,0
04063411,5,1,4,0,2,2,0,0,0
04063414,5,3,2,0,2,2,0,0,1
04063428,8,3,5,0,1,1,0,0,0
04063452,6,3,3,0,1,1,0,0,0
04064073,7,3,4,0,1,1,0,0,1
04064727,17,4,13,0,1,1,0,1,1
04064929,38,11,27,0,0,0,0,0,1
04065120,15,3,12,0,1,0,1,1,1
04065527,17,4,13,0,1,1,0,1,1
04066168,21,1,20,0,2,2,0,0,1
04066181,22,1,21,0,2,2,0,0,1
04066185,22,1,21,0,2,2,0,0,1
04066209,21,10,11,0,1,1,0,1,1
04066215,12,1,11,0,2,2,0,1,0
04066289,24,3,21,0,0,0,0,0,1
04066327,6,3,3,0,2,2,0,0,1
04066496,6,1,5,0,1,1,0,0,1
04066731,35,0,35,0,0,0,0,0,1
04066871,29,4,25,0,1,1,0,1,1
04067163,22,3,19,0,6,3,3,1,1
04067310,4,2,2,0,1,1,0,0,0
04067463,10,3,7,0,2,2,0,0,1
04067625,17,5,12,0,1,1,0,1,1
04068000,14,0,14,0,1,1,0,1,1
04068014,15,4,11,0,1,1,0,1,1
04068043,9,3,6,0,1,1,0,0,1
04068071,19,4,15,0,1,1,0,1,1
04068081,5,2,3,0,0,0,0,0,0
04068242,20,5,15,0,0,0,0,0,1
04068274,11,2,9,0,3,2,1,0,1
04068365,7,2,5,0,1,1,0,0,1
04068398,45,7,38,0,1,1,0,1,1
04068515,5,3,2,0,2,2,0,0,0
04068662,30,0,30,0,0,0,0,0,1
04068732,24,1,23,0,5,5,0,0,0
04068769,9,5,4,0,2,2,0,0,1
04068966,35,4,31,0,1,1,0,1,1
04068994,45,8,37,0,0,0,0,0,1
04069308,7,2,5,0,2,1,1,0,0
04069369,7,0,7,0,0,0,0,0,1
04069481,39,0,39,0,0,0,0,0,0
04069483,12,4,8,0,0,0,0,0,1
04069891,28,9,19,0,0,0,0,0,1
04069896,11,2,9,0,0,0,0,0,0
04070496,13,4,9,0,0,0,0,0,0
04070688,54,8,46,0,1,1,0,1,1
04070995,9,3,6,0,3,3,0,0,1
04071168,29,3,26,0,1,1,0,1,1
04071208,15,0,15,0,0,0,0,0,1
04071417,22,2,20,0,0,0,0,0,1
04071494,29,5,24,0,1,1,0,1,1
04071564,6,3,3,0,1,1,0,0,1
04071890,26,4,22,0,2,1,1,2,1
04071993,5,2,3,0,1,1,0,0,1
04072059,44,6,38,0,0,0,0,0,1
04072126,10,3,7,0,1,1,0,0,1
04072259,28,6,22,0,0,0,0,0,1
04072270,19,7,12,0,0,0,0,0,0
04072405,30,4,26,0,4,1,3,2,1
04072464,28,4,24,0,2,1,1,2,1
04072543,5,5,0,0,1,1,0,0,1
04072551,30,2,28,0,1,1,0,1,1
04072703,21,8,13,0,0,0,0,0,0
04072786,16,0,16,0,0,0,0,0,1
04072795,10,0,10,0,0,0,0,0,1
04072887,52,0,52,0,0,0,0,0,1
04072979,29,5,24,0,1,1,0,1,1
04073111,4,3,1,0,1,1,0,0,0
04073150,18,0,18,0,0,0,0,0,1
04073309,44,2,42,0,1,1,0,1,1
04073508,28,0,28,0,0,0,0,0,1
04074095,15,0,15,0,0,0,0,0,1
04074170,148,27,121,0,0,0,0,0,1
04074175,146,27,119,0,1,1,0,1,1
04074212,15,0,15,0,1,1,0,1,1
04074803,5,1,4,0,2,1,1,0,0
04074919,51,3,48,0,1,1,0,1,1
04075331,24,4,20,1,0,0,0,0,1
04075344,57,9,48,0,3,0,3,3,1
04075460,6,2,4,0,1,1,0,0,1
04075590,44,8,36,0,3,0,3,0,1
04075649,7,0,7,0,2,2,0,0,0
04075992,24,3,21,0,1,1,0,1,1
04076004,7,2,5,0,1,1,0,0,1
04076191,24,8,16,0,0,0,0,0,1
04076409,4,1,3,0,2,1,1,0,1
04076506,8,1,7,0,0,0,0,0,1
04076558,14,4,10,0,1,1,0,1,1
04076887,7,3,4,0,3,3,0,0,0
04077052,26,7,19,0,2,2,0,2,1
04077156,43,5,38,0,2,2,0,2,1
04077163,73,12,61,0,0,0,0,0,1
04077189,16,5,11,0,0,0,0,0,1
04077764,20,0,20,0,0,0,0,0,1
04077920,8,3,5,0,2,2,0,0,1
04077938,5,2,3,0,1,1,0,0,1
04077972,11,3,8,0,1,1,0,1,1
04077975,30,6,24,0,1,1,0,1,1
04078087,10,3,7,0,1,1,0,1,1
04078323,24,4,20,0,1,0,1,1,1
04078457,9,2,7,0,1,1,0,1,1
04078459,7,2,5,0,1,1,0,1,1
04078485,15,3,12,0,1,1,0,0,1
04078747,36,13,23,0,0,0,0,0,1
04078847,4,0,4,0,0,0,0,0,1
04078899,6,4,2,0,3,3,0,0,0
04079464,14,0,14,0,0,0,0,0,1
04079510,7,3,4,0,1,1,0,0,1
04079521,62,10,52,0,0,0,0,0,0
04079525,12,3,9,0,1,1,0,1,1
04079607,11,3,8,0,1,1,0,1,1
04079634,20,3,17,0,1,1,0,1,1
04079850,34,3,31,0,1,1,0,1,1
04079984,6,3,3,0,1,1,0,0,1
04080051,25,6,19,0,1,1,0,1,1
04080099,9,0,9,0,0,0,0,0,1
04080913,6,4,2,0,2,2,0,0,0
04081213,43,3,40,0,1,1,0,1,1
04081219,49,6,43,0,1,1,0,1,1
04081258,7,4,3,0,1,1,0,1,1
04081354,22,3,19,0,1,1,0,1,1
04081649,6,0,6,0,0,0,0,0,1
04081720,28,3,25,0,1,1,0,1,1
04081753,11,3,8,0,0,0,0,0,1
04081901,37,3,34,0,1,1,0,1,1
04082016,21,2,19,0,0,0,0,0,0
04082127,13,3,10,0,1,1,0,1,0
04082188,25,4,21,0,0,0,0,0,1
04082590,13,2,11,0,1,1,0,1,1
04082663,6,1,5,0,1,1,0,0,1
04082757,11,0,11,0,0,0,0,0,0
04082769,12,2,10,0,1,1,0,1,1
04083134,16,2,14,0,1,1,0,1,1
04083138,4,1,3,0,1,1,0,0,1
04083206,21,3,18,0,4,4,0,4,1
04083318,20,7,13,0,0,0,0,0,0
04083601,4,1,3,0,1,1,0,0,1
04083914,40,12,28,0,0,0,0,0,1
04083947,11,5,6,0,0,0,0,0,1
04084014,48,0,48,0,0,0,0,0,0
04084370,5,3,2,0,0,0,0,0,1
04084432,21,3,18,0,1,1,0,1,1
04084476,25,10,15,0,0,0,0,0,1
04084587,24,6,18,0,1,1,0,1,1
04084626,25,3,22,0,1,1,0,1,1
04084653,90,15,75,0,0,0,0,0,1
04084790,21,2,19,0,1,1,0,1,1
04084957,11,1,10,0,5,3,2,0,1
04085224,7,3,4,0,2,2,0,0,1
04085334,25,4,21,0,1,1,0,1,1
04085498,6,2,4,0,4,4,0,0,0
04085571,33,4,29,0,1,1,0,1,1
04085639,11,3,8,0,4,2,2,0,1
04085727,15,2,13,0,1,1,0,1,1
04085767,22,4,18,0,1,1,0,1,1
04085769,13,3,10,0,2,2,0,1,1
04085933,26,4,22,0,1,1,0,1,1
04086226,7,3,4,0,2,2,0,0,1
04086259,7,3,4,0,1,1,0,0,1
04087522,4,0,4,0,0,0,0,0,0
04087563,6,4,2,0,0,0,0,0,0
04087584,35,2,33,0,1,1,0,1,1
04087659,16,5,11,0,2,1,1,1,0
04087719,17,7,10,0,1,1,0,0,1
04087793,5,0,5,0,0,0,0,0,1
04087848,15,6,9,0,0,0,0,0,1
04087860,3,2,1,0,1,1,0,0,1
04087865,12,7,5,0,0,0,0,0,1
04087902,20,6,14,0,1,1,0,0,1
04088050,20,5,15,0,1,1,0,1,1
04088211,12,6,6,0,1,1,0,0,1
04088384,9,3,6,0,2,2,0,0,1
04088392,26,7,19,0,0,0,0,0,1
04088428,5,3,2,0,1,1,0,0,0
04088472,20,3,17,0,1,1,0,1,0
04088640,14,4,10,0,1,1,0,1,1
04088646,20,6,14,0,2,2,0,1,1
04089206,11,5,6,0,4,4,0,0,1
04089376,24,7,17,0,0,0,0,0,1
04089378,19,2,17,0,1,1,0,1,1
04089911,22,3,19,0,1,1,0,1,1
04090248,28,6,22,0,0,0,0,0,1
04090296,8,2,6,0,0,0,0,0,0
04090390,11,0,11,0,0,0,0,0,1
04090402,7,0,7,0,0,0,0,0,1
04090425,32,3,29,0,1,1,0,1,1
04090580,16,8,8,0,0,0,0,0,1
04090635,5,2,3,0,0,0,0,0,0
04090673,10,4,6,0,5,3,2,0,1
04090701,53,10,43,0,0,0,0,0,0
04091100,44,0,44,0,0,0,0,0,1
04091112,24,3,21,0,1,1,0,1,1
04091255,7,2,5,0,1,1,0,0,1
04091345,26,6,20,1,0,0,0,0,1
04091382,23,0,23,0,1,1,0,1,1
04091453,5,2,3,0,2,2,0,1,0
04091569,5,1,4,0,0,0,0,0,1
04091571,10,2,8,0,2,2,0,0,0
04091740,5,3,2,0,1,1,0,1,1
04092192,23,4,19,0,1,0,1,1,1
04092377,21,6,15,0,1,1,0,1,1
04092471,153,0,153,0,0,0,0,0,1
04092911,30,6,24,0,3,1,2,3,1
04092956,18,0,18,0,1,1,0,1,1
04093102,26,5,21,0,0,0,0,0,1
04093367,11,0,11,0,0,0,0,0,1
04093570,7,4,3,0,1,1,0,1,1
04093862,48,11,37,0,0,0,0,0,1
04094169,15,3,12,0,1,1,0,0,1
04094420,34,6,28,0,0,0,0,0,1
04094509,11,2,9,0,0,0,0,0,0
04094674,5,3,2,0,0,0,0,0,0
04095121,25,7,18,0,0,0,0,0,1
04095261,21,3,18,0,1,1,0,1,1
04095314,5,3,2,0,2,2,0,0,0
04095365,21,3,18,0,1,1,0,1,1
04095400,22,3,19,0,1,1,0,1,1
04095415,30,3,27,0,0,0,0,0,0
04095428,7,3,4,0,1,1,0,0,1
04095538,30,8,22,0,0,0,0,0,1
04095762,11,3,8,0,3,2,1,0,1
04095925,5,3,2,0,2,2,0,0,0
04095968,23,6,17,1,0,0,0,0,1
04096180,11,0,11,0,0,0,0,0,1
04096469,8,1,7,0,1,1,0,0,0
04096481,26,6,20,0,3,3,0,2,1
04096596,3,2,1,0,1,1,0,0,0
04096788,26,10,16,0,1,1,0,1,1
04096846,14,2,12,0,2,1,1,2,1
04096890,29,7,22,0,1,1,0,0,0
04097114,6,2,4,0,3,1,2,1,1
04097586,8,0,8,0,0,0,0,0,1
04097784,9,3,6,0,2,2,0,0,0
04097820,11,0,11,0,0,0,0,0,1
04097913,24,5,19,0,2,2,0,2,1
04098012,5,3,2,0,2,2,0,0,0
04098164,5,2,3,0,1,1,0,0,0
04098170,14,0,14,0,0,0,0,0,1
04098216,34,3,31,0,1,1,0,1,1
04098461,49,14,35,0,1,1,0,1,1
04098516,4,2,2,0,1,1,0,0,0
04098872,9,2,7,0,0,0,0,0,1
04098945,14,2,12,0,0,0,0,0,1
04099287,32,5,27,0,1,1,0,1,1
04099292,32,5,27,0,3,2,1,3,1
04099298,7,0,7,0,0,0,0,0,1
04099352,69,11,58,0,0,0,0,0,1
04099451,14,5,9,0,1,1,0,0,1
04099509,5,2,3,0,1,1,0,0,0
04099791,4,2,2,0,1,1,0,0,0
04099810,28,7,21,0,0,0,0,0,1
04099942,8,0,8,0,0,0,0,0,1
04100166,11,3,8,0,1,1,0,1,1
04100284,10,0,10,0,0,0,0,0,1
04100590,15,2,13,0,1,1,0,0,1
04100996,12,0,12,0,0,0,0,0,1
04101081,15,4,11,0,1,1,0,1,1
04101137,17,0,17,0,0,0,0,0,1
04101324,38,12,26,0,0,0,0,0,1
04101457,2,2,0,0,1,1,0,0,0
04101620,10,3,7,0,1,1,0,0,0
04101629,26,8,18,0,1,1,0,1,1
04101639,8,1,7,0,1,1,0,0,0
04101984,25,0,25,0,0,0,0,0,1
04102052,44,16,28,0,0,0,0,0,1
04102163,5,0,5,0,0,0,0,0,0
04102237,26,4,22,0,1,1,0,1,0
04102352,21,10,11,0,1,1,0,1,1
04102747,11,6,5,0,0,0,0,0,1
04102759,9,4,5,0,2,2,0,2,0
04102762,21,9,12,1,0,0,0,0,1
04102788,7,0,7,0,0,0,0,0,0
04103359,4,2,2,0,1,1,0,0,1
04103605,19,3,16,0,1,1,0,1,1
04103644,21,6,15,0,1,1,0,0,1
04103964,49,9,40,0,2,1,1,2,1
04103997,45,2,43,0,1,0,1,1,1
04104011,49,3,46,0,1,0,1,0,1
04104026,50,9,41,0,1,1,0,1,1
04104079,15,8,7,0,0,0,0,0,1
04104102,50,9,41,0,2,1,1,2,1
04104216,5,1,4,0,1,1,0,0,0
04104341,30,7,23,0,0,0,0,0,1
04104532,57,9,48,0,0,0,0,0,1
04104861,17,6,11,0,2,2,0,2,1
04104944,5,0,5,0,0,0,0,0,0
04105394,7,4,3,0,1,1,0,0,1
04105438,5,3,2,0,1,1,0,0,0
04105526,17,0,17,0,0,0,0,0,1
04106258,5,0,5,0,0,0,0,0,0
04106667,10,4,6,0,3,3,0,1,1
04107308,5,3,2,0,2,2,0,0,0
04107412,8,3,5,0,1,1,0,1,1
04107909,6,0,6,0,1,1,0,0,1
04108188,39,3,36,0,1,1,0,1,1
04108324,28,3,25,0,1,1,0,1,1
04108600,4,3,1,0,2,2,0,0,0
04108931,27,3,24,0,1,1,0,1,1
04108961,27,0,27,0,0,0,0,0,1
04109325,19,7,12,0,1,1,0,1,1
04109407,6,0,6,0,1,1,0,1,1
04109425,30,6,24,0,6,5,1,0,1
04109440,21,3,18,0,1,1,0,1,1
04109446,18,3,15,0,1,1,0,0,1
04109632,22,3,19,0,1,1,0,1,1
04109781,5,0,5,0,0,0,0,0,1
04109942,31,12,19,0,0,0,0,0,1
04110100,8,4,4,0,1,0,1,0,0
04110163,5,2,3,0,2,2,0,1,0
04110299,12,8,4,0,0,0,0,0,1
04110339,13,4,9,0,0,0,0,0,1
04110343,13,5,8,0,0,0,0,0,1
04110615,5,0,5,0,1,1,0,0,0
04110627,8,4,4,0,0,0,0,0,1
04110701,6,2,4,0,1,1,0,0,0
04110786,25,3,22,0,1,1,0,1,1
04110903,25,3,22,0,1,1,0,1,1
04110910,21,3,18,0,1,1,0,1,1
04111164,4,1,3,0,1,1,0,1,0
04111491,36,6,30,0,0,0,0,0,1
04111510,12,0,12,1,1,1,0,0,0
04111586,10,2,8,0,4,3,1,1,0
04111603,64,10,54,0,0,0,0,0,1
04111612,5,2,3,0,1,1,0,1,1
04111631,22,0,22,0,0,0,0,0,1
04112262,7,1,6,0,1,1,0,0,1
04112320,27,7,20,0,1,1,0,1,1
04112326,15,1,14,0,1,1,0,1,1
04112529,6,0,6,0,0,0,0,0,1
04112553,34,5,29,0,1,1,0,1,1
04112710,6,0,6,0,0,0,0,0,1
04112853,17,4,13,0,2,2,0,0,1
04112979,10,0,10,0,0,0,0,0,1
04112992,8,3,5,0,2,2,0,0,0
04113122,21,1,20,0,1,1,0,1,1
04113286,8,0,8,0,0,0,0,0,0
04113296,6,3,3,0,1,1,0,0,1
04113305,16,0,16,0,0,0,0,0,1
04113355,17,3,14,0,1,1,0,1,1
04113658,11,0,11,0,0,0,0,0,1
04113679,4,2,2,0,1,1,0,0,1
04113818,18,0,18,0,0,0,0,0,1
04113850,10,0,10,0,0,0,0,0,1
04113857,7,4,3,0,1,1,0,0,1
04113976,26,7,19,0,1,1,0,1,1
04114101,27,2,25,0,1,1,0,1,1
04114385,12,0,12,0,0,0,0,0,1
04114470,14,0,14,0,0,0,0,0,1
04114482,10,0,10,0,0,0,0,0,1
04115032,6,2,4,0,2,2,0,0,1
04115048,7,1,6,0,1,1,0,0,1
04115082,18,9,9,0,1,1,0,0,1
04115230,40,7,33,0,1,1,0,1,1
04115311,77,5,72,0,0,0,0,0,1
04115329,13,7,6,0,1,1,0,1,1
04115551,15,4,11,0,1,1,0,1,1
04115664,9,1,8,0,1,1,0,1,0
04115679,13,2,11,1,0,0,0,0,0
04115691,30,3,27,0,1,1,0,1,1
04115825,4,1,3,0,0,0,0,0,0
04116600,24,4,20,0,1,1,0,1,1
04116935,40,11,29,0,0,0,0,0,1
04117064,11,0,11,0,0,0,0,0,1
04117347,26,6,20,0,1,1,0,1,1
04117665,62,9,53,0,0,0,0,0,1
04117752,13,6,7,0,0,0,0,0,0
04117777,18,0,18,0,0,0,0,0,1
04117960,18,6,12,0,0,0,0,0,1
04118012,17,3,14,0,1,1,0,1,1
04118128,112,15,97,0,0,0,0,0,0
04118195,16,3,13,0,1,1,0,1,1
04118530,34,3,31,0,1,1,0,1,1
04118651,27,7,20,0,0,0,0,0,0
04118724,52,0,52,0,0,0,0,0,1
04118765,11,0,11,0,1,1,0,1,1
04118783,12,4,8,0,2,2,0,0,1
04118784,13,4,9,0,2,2,0,0,1
04118786,11,4,7,0,2,2,0,0,1
04118788,17,4,13,0,2,2,0,0,1
04118791,11,4,7,0,0,0,0,0,1
04118793,16,4,12,0,2,2,0,0,1
04118796,14,4,10,0,2,2,0,0,1
04118828,14,0,14,0,2,2,0,0,1
04118882,14,4,10,0,2,2,0,0,1
SC155060,5,1,4,0,2,1,1,0,1
SC155131,24,3,21,0,1,1,0,1,1
SC155136,22,0,22,0,0,0,0,0,1
SC155137,20,0,20,0,0,0,0,0,1
SC155219,8,5,3,0,1,1,0,1,1
SC155260,10,3,7,0,1,1,0,0,1
SC155637,22,0,22,0,0,0,0,0,1
SC155787,10,0,10,0,0,0,0,0,1
SC155873,23,3,20,0,1,1,0,1,1
SC155901,15,4,11,0,1,1,0,1,1
SC156035,11,0,11,0,1,1,0,1,0
SC156086,15,3,12,0,1,1,0,1,1
SC156102,7,3,4,0,2,2,0,0,0
SC156302,28,5,23,0,0,0,0,0,1
SC156310,9,6,3,0,2,2,0,0,1
SC156429,5,3,2,0,2,2,0,0,1
SC156472,10,6,4,0,0,0,0,0,1
SC156609,17,3,14,0,1,1,0,1,1
SC156613,7,3,4,0,1,1,0,0,1
SC156631,32,5,27,0,1,1,0,1,1
SC156661,23,2,21,0,2,1,1,2,1
SC156690,9,1,8,0,2,1,1,0,1
SC156874,5,3,2,0,1,1,0,0,1
SC156882,5,0,5,0,0,0,0,0,1
SC156969,18,3,15,0,1,1,0,1,1
SC156996,22,3,19,0,1,1,0,1,1
SC157035,53,12,41,0,0,0,0,0,1
SC157076,16,5,11,0,0,0,0,0,1
SC157099,49,9,40,0,1,1,0,0,0
SC157100,42,7,35,0,0,0,0,0,1
SC157135,13,4,9,0,1,1,0,1,1
SC157176,58,12,46,0,0,0,0,0,1
SC157177,68,8,60,0,0,0,0,0,0
SC157178,29,0,29,0,0,0,0,0,1
SC157180,18,0,18,0,0,0,0,0,1
SC157185,17,8,9,0,1,1,0,1,1
SC157189,47,22,25,0,1,1,0,1,1
SC157240,5,3,2,0,1,1,0,0,1
SC157295,11,3,8,0,1,1,0,0,1
SC157348,11,3,8,0,1,1,0,0,1
SC157375,16,4,12,0,1,1,0,1,1
SC157409,11,3,8,0,1,1,0,0,1
SC157532,20,4,16,0,1,1,0,1,1
SC157564,7,4,3,0,2,2,0,0,0
SC157659,36,4,32,0,1,1,0,1,1
SC157796,53,9,44,0,2,1,1,0,1
SC157919,20,0,20,0,0,0,0,0,1
SC158083,19,4,15,0,1,1,0,1,1
SC158176,16,0,16,1,0,0,0,0,1
SC158220,42,16,26,0,0,0,0,0,1
SC158371,40,9,31,0,0,0,0,0,0
SC158435,12,0,12,0,1,1,0,1,1
SC158471,46,9,37,0,1,1,0,0,1
SC158472,10,2,8,0,1,1,0,1,1
SC158529,4,2,2,0,1,1,0,0,1
SC158565,37,7,30,0,1,1,0,1,1
SC158599,36,7,29,0,1,1,0,1,1
SC158681,24,5,19,0,1,1,0,0,0
SC158728,21,0,21,0,0,0,0,0,1
SC158731,23,5,18,0,1,1,0,1,1
SC158836,16,6,10,0,1,1,0,1,1
SC158838,6,0,6,0,0,0,0,0,1
SC158863,12,1,11,0,1,1,0,0,1
SC158867,66,13,53,0,0,0,0,0,1
SC158880,33,3,30,0,1,1,0,0,1
SC158994,25,1,24,0,1,1,0,1,1
SC159107,14,3,11,0,1,1,0,1,1
SC159424,36,5,31,0,0,0,0,0,0
SC159609,10,3,7,0,1,1,0,1,1
SC159617,14,0,14,0,0,0,0,0,1
SC159755,9,3,6,0,3,3,0,0,1
SC159842,17,3,14,0,1,1,0,1,1
SC159847,5,3,2,0,1,1,0,0,1
SC159852,35,3,32,0,1,1,0,1,1
SC160123,25,3,22,0,2,1,1,2,1
SC160231,16,6,10,0,2,2,0,2,0
SC160302,8,2,6,0,1,1,0,0,1
SC160307,58,0,58,0,0,0,0,0,1
SC160484,40,6,34,0,1,1,0,1,1
SC160619,10,0,10,0,1,1,0,1,1
SC160645,22,0,22,0,0,0,0,0,1
SC160904,12,0,12,0,0,0,0,0,1
SC160930,19,3,16,0,2,2,0,2,1
SC160937,19,3,16,0,0,0,0,0,1
SC160976,70,4,66,0,0,0,0,0,1
SC160991,12,3,9,0,2,2,0,0,0
SC161077,21,4,17,0,1,1,0,1,1
SC161190,10,0,10,0,2,2,0,0,1
SC161193,38,3,35,0,9,7,2,1,1
SC161497,24,3,21,0,1,1,0,1,1
SC161504,18,0,18,0,0,0,0,0,1
SC161511,16,2,14,0,2,2,0,1,1
SC161563,19,5,14,0,1,1,0,0,1
SC161683,13,3,10,0,1,1,0,1,1
SC161777,24,6,18,0,1,1,0,0,1
SC161800,24,2,22,0,1,1,0,1,1
SC161875,35,9,26,0,8,8,0,0,0
SC161937,8,2,6,0,1,1,0,0,1
SC161958,7,6,1,0,0,0,0,0,1
SC162129,7,4,3,0,1,1,0,0,1
SC162147,6,2,4,0,1,1,0,0,1
SC162162,23,2,21,0,0,0,0,0,1
SC162178,11,2,9,0,1,1,0,1,1
SC162205,7,0,7,0,1,1,0,1,1
SC162240,10,6,4,0,1,1,0,1,1
SC162273,40,2,38,0,1,1,0,1,1
SC162310,11,5,6,0,4,1,3,2,1
SC162341,23,0,23,0,0,0,0,0,1
SC162342,13,6,7,0,1,1,0,1,1
SC162386,56,12,44,0,0,0,0,0,1
SC162451,37,10,27,0,1,1,0,0,1
SC162589,23,6,17,0,1,1,0,1,1
SC162625,34,7,27,0,1,1,0,1,1
SC162733,8,3,5,0,2,2,0,0,1
SC162774,31,5,26,0,0,0,0,0,0
SC162781,31,6,25,0,1,1,0,1,1
SC162841,8,0,8,0,0,0,0,0,1
SC162868,23,5,18,0,1,1,0,1,1
SC163083,43,0,43,0,0,0,0,0,1
SC163108,6,1,5,0,1,1,0,0,1
SC163225,13,2,11,1,2,2,0,0,1
SC163604,36,0,36,0,0,0,0,0,1
SC163655,11,0,11,0,0,0,0,0,1
SC163671,16,0,16,0,0,0,0,0,1
SC163762,9,3,6,0,2,2,0,0,1
SC163889,22,0,22,0,0,0,0,0,1
SC163999,8,2,6,0,2,2,0,0,1
SC164014,20,2,18,0,1,1,0,1,1
SC164120,15,0,15,0,0,0,0,0,1
SC164168,13,3,10,0,2,2,0,1,1
SC164189,46,8,38,0,0,0,0,0,0
SC164382,26,9,17,0,1,1,0,0,0
SC164387,22,0,22,0,1,1,0,1,1
SC164534,6,2,4,0,0,0,0,0,1
SC164619,9,0,9,0,0,0,0,0,1
SC164626,14,4,10,0,3,3,0,0,0
SC164731,39,3,36,0,1,1,0,0,0
SC164794,9,0,9,0,0,0,0,0,0
SC164822,8,0,8,0,0,0,0,0,0
SC164841,6,1,5,0,1,1,0,0,1
SC164882,35,3,32,0,2,2,0,2,1
SC165087,7,5,2,0,2,2,0,0,0
SC165107,14,3,11,0,1,1,0,0,1
SC165488,3,2,1,0,2,1,1,0,0
SC165497,13,0,13,0,0,0,0,0,1
SC165498,10,2,8,0,0,0,0,0,1
SC165541,8,2,6,0,2,2,0,0,1
SC165734,12,8,4,0,1,1,0,1,1
SC165744,7,3,4,0,2,2,0,0,0
SC165922,9,4,5,0,3,3,0,0,1
SC165970,17,0,17,0,0,0,0,0,1
SC165976,17,0,17,0,0,0,0,0,1
SC166042,43,7,36,0,2,1,1,0,1
SC166146,27,4,23,0,2,2,0,2,1
SC166199,6,2,4,0,3,1,2,0,0
SC166222,20,1,19,0,1,1,0,1,1
SC166242,16,3,13,0,1,1,0,1,1
SC166662,14,4,10,0,1,1,0,1,1
SC166905,16,5,11,0,1,1,0,1,1
SC166906,16,4,12,0,1,1,0,1,1
SC167018,23,0,23,0,1,1,0,1,1
SC167036,20,4,16,0,0,0,0,0,0
SC167052,15,3,12,0,0,0,0,0,1
SC167124,8,2,6,0,1,1,0,1,1
SC167157,7,3,4,0,2,2,0,0,1
SC167168,11,3,8,0,1,1,0,1,1
SC167177,8,4,4,0,2,2,0,0,1
SC167280,12,2,10,0,4,4,0,1,1
SC167465,29,0,29,0,0,0,0,0,1
SC167468,27,0,27,0,0,0,0,0,1
SC167549,12,2,10,0,1,1,0,0,1
SC167662,10,0,10,0,0,0,0,0,1
SC167687,16,0,16,0,0,0,0,0,1
SC167743,10,3,7,1,2,2,0,0,1
SC167760,6,2,4,0,1,1,0,0,1
SC167875,11,0,11,0,0,0,0,0,1
SC167894,19,0,19,0,0,0,0,0,1
SC167959,23,4,19,0,2,1,1,2,1
SC168611,5,1,4,0,1,1,0,0,0
SC168786,16,3,13,0,1,1,0,1,1
SC168819,32,4,28,0,0,0,0,0,1
SC168919,10,0,10,0,1,1,0,0,1
SC169003,4,1,3,0,1,1,0,0,0
SC169182,44,3,41,0,1,1,0,1,1
SC169288,5,3,2,0,2,2,0,0,0
SC169446,26,0,26,0,0,0,0,0,1
SC169534,9,2,7,0,2,2,0,1,1
SC169606,30,6,24,0,2,1,1,0,0
SC169647,12,7,5,0,1,1,0,0,0
SC169696,17,4,13,0,1,1,0,1,1
SC169717,33,3,30,0,1,1,0,1,1
SC169892,14,4,10,0,1,1,0,1,1
SC169895,14,4,10,0,1,1,0,1,1
SC169901,24,4,20,0,1,1,0,0,1
SC169985,13,3,10,0,3,3,0,0,1
SC170010,7,2,5,0,2,2,0,0,0
SC170059,26,4,22,0,0,0,0,0,1
SC170062,41,5,36,0,1,1,0,1,1
SC170114,75,6,69,0,0,0,0,0,1
SC170124,15,0,15,0,2,2,0,1,1
SC170207,51,6,45,0,0,0,0,0,1
SC170215,6,1,5,0,1,1,0,0,0
SC170217,5,1,4,0,1,0,1,0,1
SC170241,100,12,88,0,0,0,0,0,1
SC170423,12,3,9,0,2,1,1,1,1
SC170524,24,5,19,0,1,1,0,1,1
SC170562,89,39,50,1,0,0,0,0,1
SC170673,38,9,29,0,0,0,0,0,1
SC170830,34,2,32,0,2,2,0,2,1
SC170841,26,3,23,0,1,1,0,1,1
SC170889,24,6,18,0,0,0,0,0,1
SC170890,13,3,10,0,3,3,0,1,1
SC170910,105,10,95,0,0,0,0,0,1
SC170930,11,3,8,1,2,2,0,0,0
SC171133,77,5,72,0,1,1,0,1,1
SC171212,9,3,6,0,2,1,1,0,0
SC171237,35,2,33,0,1,1,0,1,1
SC171506,54,10,44,0,0,0,0,0,0
SC171663,15,7,8,0,1,1,0,1,1
SC171733,16,10,6,0,0,0,0,0,1
SC171820,30,8,22,0,0,0,0,0,1
SC171891,76,4,72,1,0,0,0,0,1
SC171894,5,0,5,0,1,1,0,0,1
SC172002,25,10,15,0,1,1,0,1,1
SC172005,5,2,3,0,3,2,1,0,0
SC172021,23,8,15,0,1,1,0,1,1
SC172157,79,14,65,0,0,0,0,0,1
SC172194,59,4,55,0,4,3,1,0,1
SC172230,12,2,10,0,1,1,0,0,1
SC172232,96,19,77,0,0,0,0,0,1
SC172235,20,11,9,0,0,0,0,0,0
SC172288,41,13,28,1,2,1,1,0,1
SC172312,17,0,17,0,0,0,0,0,1
SC172371,55,12,43,0,1,1,0,1,1
SC172391,21,0,21,0,0,0,0,0,1
SC172766,25,0,25,0,0,0,0,0,1
SC172880,28,4,24,0,1,1,0,1,1
SC172958,5,2,3,0,1,1,0,0,0
SC173103,12,4,8,0,0,0,0,0,1
SC173195,61,12,49,0,0,0,0,0,0
SC173232,89,12,77,0,0,0,0,0,1
SC173308,57,9,48,0,0,0,0,0,0
SC173394,18,5,13,0,0,0,0,0,1
SC173485,77,10,67,0,0,0,0,0,0
SC173542,22,5,17,0,1,1,0,1,1
SC173556,43,11,32,0,1,1,0,1,1
SC173730,23,0,23,0,2,1,1,2,1
SC173733,26,0,26,0,1,1,0,1,1
SC173830,19,4,15,0,1,1,0,1,1
SC173845,3,2,1,1,1,1,0,0,1
SC173886,5,0,5,0,0,0,0,0,0
SC174103,62,16,46,0,0,0,0,0,1
SC174115,29,7,22,0,0,0,0,0,1
SC174166,13,2,11,0,1,1,0,0,0
SC174292,13,3,10,0,1,1,0,0,1
SC174638,50,8,42,0,1,1,0,1,1
SC174710,24,2,22,0,1,1,0,1,1
SC174892,3,0,3,0,1,1,0,0,0
SC174924,21,3,18,0,1,1,0,1,1
SC174986,12,4,8,0,1,1,0,0,1
SC175127,4,0,4,0,0,0,0,0,1
SC175177,19,3,16,0,1,1,0,1,1
SC175435,6,2,4,1,2,2,0,0,1
SC175576,5,2,3,0,1,1,0,0,1
SC175589,11,5,6,0,2,2,0,0,1
SC175628,20,0,20,0,0,0,0,0,1
SC175667,31,0,31,0,0,0,0,0,1
SC175839,21,8,13,0,1,0,1,0,1
SC175918,81,8,73,0,0,0,0,0,1
SC175926,78,16,62,0,1,0,1,0,1
SC175928,8,4,4,0,0,0,0,0,0
SC176020,66,11,55,0,0,0,0,0,0
SC176086,24,4,20,0,1,1,0,1,1
SC176165,61,0,61,0,0,0,0,0,1
SC176354,20,5,15,0,2,0,2,0,1
SC176392,26,0,26,0,0,0,0,0,1
SC176437,39,6,33,0,0,0,0,0,1
SC176505,15,6,9,0,1,1,0,0,1
SC176635,80,7,73,0,0,0,0,0,1
SC176778,11,0,11,0,0,0,0,0,1
SC176845,8,0,8,0,0,0,0,0,1
01800000,52,4,48,0,1,1,0,1,1
01800078,34,6,28,0,1,1,0,1,1
01800986,15,0,15,0,0,0,0,0,1
01801839,3,2,1,0,2,2,0,0,1
01802099,34,3,31,0,0,0,0,0,1
01802101,33,8,25,0,2,1,1,2,1
01803101,25,2,23,0,2,1,1,2,1
01803160,60,10,50,0,0,0,0,0,1
01803233,3,0,3,0,0,0,0,0,0
01803325,5,0,5,0,0,0,0,0,1
01803707,60,10,50,0,0,0,0,0,1
01804108,52,11,41,0,0,0,0,0,1
01805151,34,10,24,0,0,0,0,0,1
01805340,9,3,6,0,1,1,0,0,1
01805705,28,4,24,0,4,4,0,0,0
01805833,4,1,3,0,2,1,1,0,0
01806047,39,14,25,0,0,0,0,0,1
01806055,61,7,54,0,0,0,0,0,0
01806414,61,19,42,0,0,0,0,0,1
01806531,27,4,23,0,1,1,0,1,1
01806690,7,3,4,0,1,1,0,1,1
01806863,86,13,73,0,0,0,0,0,1
01807381,27,4,23,0,1,1,0,1,1
01807728,26,3,23,0,0,0,0,0,1
01807798,4,3,1,0,0,0,0,0,0
01807982,33,8,25,0,0,0,0,0,1
01808488,67,14,53,0,0,0,0,0,1
01808558,7,4,3,0,1,1,0,0,1
01808594,188,15,173,0,13,0,13,0,1
01809098,32,0,32,0,0,0,0,0,1
01809228,49,3,46,0,1,1,0,1,0
01809234,19,5,14,0,2,2,0,0,1
01809650,23,0,23,0,0,0,0,0,1
01809677,3,0,3,0,0,0,0,0,1
01810274,11,3,8,0,1,1,0,1,0
01810360,6,0,6,0,1,1,0,0,1
01810489,15,3,12,0,1,1,0,1,1
01810801,61,5,56,0,1,1,0,1,1
01810866,63,5,58,0,5,5,0,0,1
01811159,13,3,10,0,2,2,0,0,1
01811310,17,0,17,0,1,1,0,1,0
01811355,24,4,20,0,3,2,1,0,1
01811435,55,2,53,0,2,1,1,2,1
01811707,48,0,48,0,0,0,0,0,1
01811716,14,3,11,0,0,0,0,0,1
01812127,49,3,46,0,1,1,0,1,1
01812169,17,5,12,0,1,1,0,1,1
01812511,66,17,49,0,0,0,0,0,1
01812610,32,5,27,0,1,1,0,1,1
01812893,62,10,52,0,0,0,0,0,1
01812908,68,12,56,0,0,0,0,0,1
01812912,24,5,19,0,0,0,0,0,1
01813559,12,0,12,0,0,0,0,0,1
01813905,31,3,28,0,1,1,0,1,1
01813966,44,0,44,0,0,0,0,0,1
01814107,45,3,42,0,1,1,0,1,1
01814110,33,6,27,0,0,0,0,0,0
01814202,26,2,24,0,0,0,0,0,0
01814500,11,4,7,0,0,0,0,0,1
01814558,14,4,10,0,1,1,0,0,1
01814643,24,3,21,0,1,1,0,1,1
01814779,6,0,6,0,0,0,0,0,1
01815329,55,0,55,0,0,0,0,0,1
01815689,42,11,31,0,0,0,0,0,1
01815730,22,3,19,0,1,1,0,1,1
01815782,11,3,8,0,1,1,0,1,1
01815907,3,3,0,0,1,1,0,0,0
01815948,43,0,43,0,0,0,0,0,1
01816004,15,4,11,0,1,1,0,0,1
01816195,0,0,0,0,0,0,0,0,0
01816444,5,0,5,0,1,1,0,0,0
01816502,13,0,13,0,0,0,0,0,1
01816587,32,11,21,0,1,1,0,1,1
01816838,99,14,85,0,0,0,0,0,0
01817002,23,7,16,0,0,0,0,0,1
01817203,29,4,25,0,1,1,0,1,1
01817205,26,4,22,0,1,1,0,1,1
01817304,85,11,74,0,0,0,0,0,1
01817547,16,0,16,0,0,0,0,0,0
01817550,12,0,12,0,0,0,0,0,1
01817702,83,10,73,0,0,0,0,0,1
01817988,0,0,0,0,0,0,0,0,1
01818184,16,4,12,1,2,2,0,0,1
01818606,12,4,8,0,1,1,0,1,1
01819131,14,0,14,0,0,0,0,0,1
01819339,13,2,11,0,1,1,0,0,1
01819676,57,12,45,0,11,7,4,0,1
01819792,33,9,24,0,0,0,0,0,1
01819910,0,0,0,0,0,0,0,0,0
01819937,8,2,6,0,1,1,0,0,1
01820204,45,0,45,0,1,1,0,0,1
01820528,9,0,9,0,1,1,0,1,1
01820834,23,7,16,0,1,1,0,1,1
01821298,75,16,59,0,0,0,0,0,1
01821310,28,10,18,0,1,1,0,0,0
01821312,43,4,39,0,1,1,0,1,1
01821522,15,3,12,0,1,1,0,1,1
01821785,10,3,7,0,2,2,0,0,1
01822075,73,2,71,0,1,1,0,1,1
01822223,7,1,6,0,4,4,0,0,0
01822670,34,4,30,0,1,1,0,1,1
01822908,75,17,58,0,0,0,0,0,1
01823084,20,4,16,0,1,1,0,1,1
01823255,27,4,23,0,0,0,0,0,1
01823410,26,5,21,0,1,1,0,1,1
01823417,26,3,23,0,1,1,0,1,1
01823867,36,3,33,0,1,1,0,1,1
01824828,44,12,32,0,5,5,0,0,1
01824967,24,5,19,0,46,41,5,0,1
01825301,98,14,84,0,0,0,0,0,1
01825358,20,2,18,0,1,1,0,1,1
01825391,43,4,39,0,0,0,0,0,1
01825398,58,5,53,0,0,0,0,0,1
01825478,14,0,14,0,0,0,0,0,1
01826136,4,3,1,0,1,1,0,0,0
01826324,58,9,49,0,0,0,0,0,1
01826436,77,11,66,0,0,0,0,0,0
01826437,47,4,43,0,0,0,0,0,1
01826482,14,0,14,0,1,1,0,1,1
01826602,94,12,82,0,0,0,0,0,0
01827284,6,4,2,0,1,1,0,1,0
01827748,27,7,20,0,0,0,0,0,1
01827827,6,2,4,0,2,1,1,0,0
01827924,13,4,9,0,1,1,0,1,1
01827975,24,0,24,0,0,0,0,0,1
01827982,18,3,15,0,0,0,0,0,1
01828286,14,6,8,0,1,1,0,1,1
01828491,6,2,4,0,1,1,0,0,0
01828642,27,3,24,0,1,1,0,1,1
01828990,34,12,22,0,11,8,3,0,1
01829517,25,0,25,0,0,0,0,0,1
01830148,12,2,10,0,2,2,0,0,1
01830262,82,10,72,0,0,0,0,0,1
01830419,21,0,21,0,0,0,0,0,1
01830643,14,3,11,0,1,1,0,0,1
01830970,26,4,22,0,0,0,0,0,0
01831480,12,2,10,0,1,1,0,1,1
01831618,7,4,3,0,1,1,0,0,1
01832050,16,4,12,0,0,0,0,0,0
01832064,54,12,42,0,0,0,0,0,1
01832067,24,7,17,0,1,1,0,1,1
01832838,39,0,39,0,0,0,0,0,1
01833177,28,3,25,0,2,1,1,2,1
01833275,18,7,11,0,1,1,0,0,1
01833619,3,3,0,0,1,1,0,0,0
01833679,60,13,47,0,0,0,0,0,1
01834082,31,4,27,0,1,1,0,0,1
01834088,24,4,20,0,1,1,0,1,1
01834276,14,2,12,0,1,1,0,0,1
01834869,32,4,28,0,1,1,0,1,1
01835021,20,9,11,0,1,1,0,1,0
01835151,27,0,27,0,0,0,0,0,1
01835199,37,6,31,0,1,1,0,1,1
01835470,11,4,7,0,2,2,0,0,1
01835678,17,2,15,0,1,1,0,1,1
01835691,57,11,46,0,1,1,0,1,1
01835727,31,4,27,0,7,5,2,0,1
01835825,41,0,41,0,0,0,0,0,1
01835984,20,4,16,0,1,1,0,0,1
01836767,3,3,0,0,2,2,0,0,0
01836814,6,0,6,0,0,0,0,0,1
01837040,19,5,14,0,0,0,0,0,1
01837292,24,0,24,0,1,1,0,1,1
01837522,33,3,30,0,1,1,0,1,1
01837942,14,5,9,0,0,0,0,0,1
01837993,57,3,54,0,1,1,0,1,1
01838229,22,3,19,0,1,1,0,1,1
01838313,37,0,37,0,1,1,0,0,1
01838445,23,0,23,0,1,1,0,1,1
01838511,9,4,5,0,2,2,0,0,1
01838522,8,0,8,0,0,0,0,0,1
01838573,20,0,20,0,1,1,0,1,1
01838739,26,3,23,0,1,1,0,1,1
01838878,12,4,8,0,1,1,0,0,1
01839321,22,0,22,0,0,0,0,0,1
01839458,79,10,69,0,0,0,0,0,1
01840185,5,0,5,0,0,0,0,0,1
01840209,31,0,31,0,0,0,0,0,1
01840301,16,2,14,0,1,1,0,1,1
01840597,18,6,12,0,0,0,0,0,1
01840851,14,5,9,0,1,0,1,0,0
01840906,113,0,113,0,0,0,0,0,1
01840979,22,5,17,0,2,2,0,0,1
01840994,11,0,11,0,0,0,0,0,1
01841697,54,5,49,0,1,1,0,1,1
01841906,16,6,10,0,0,0,0,0,1
01842040,12,0,12,0,0,0,0,0,1
01842240,42,9,33,0,1,1,0,0,1
01842252,37,3,34,0,1,1,0,1,1
01842254,56,8,48,0,1,1,0,1,1
01842644,39,0,39,0,1,1,0,1,1
01842652,19,3,16,0,1,1,0,1,1
01843026,24,3,21,0,0,0,0,0,1
01843125,17,4,13,0,1,1,0,0,1
01843557,5,2,3,0,0,0,0,0,0
01843625,4,4,0,0,3,3,0,0,1
01843811,8,2,6,0,2,2,0,1,0
01843827,16,4,12,0,1,1,0,1,1
01843973,14,7,7,0,1,1,0,0,1
01844281,56,15,41,0,0,0,0,0,1
01844549,42,11,31,0,0,0,0,0,0
01844659,27,3,24,0,1,1,0,1,1
01844717,31,5,26,0,1,1,0,1,1
01844738,6,2,4,0,1,1,0,0,1
01844897,24,0,24,0,0,0,0,0,1
01845717,7,3,4,0,0,0,0,0,0
01845732,19,5,14,0,0,0,0,0,0
01846022,10,5,5,0,1,1,0,0,1
01846326,21,0,21,0,0,0,0,0,1
01846804,25,5,20,0,1,1,0,1,1
01847134,85,19,66,0,0,0,0,0,1
01847366,5,2,3,0,1,1,0,0,1
01847414,13,3,10,0,1,1,0,0,1
01847728,38,6,32,0,2,1,1,2,1
01847948,10,4,6,0,4,3,1,1,1
01848053,10,3,7,0,1,1,0,0,0
01848111,45,4,41,0,6,4,2,0,1
01848124,26,4,22,0,2,1,1,1,1
01848309,70,10,60,0,0,0,0,0,1
01848350,3,0,3,0,0,0,0,0,1
01849012,28,5,23,0,0,0,0,0,1
01849668,42,0,42,0,0,0,0,0,1
01849726,4,0,4,0,0,0,0,0,1
01850105,15,4,11,0,1,1,0,1,1
01850376,35,0,35,0,0,0,0,0,1
01850442,24,0,24,0,1,1,0,1,1
01850642,9,3,6,0,1,1,0,0,0
01851210,33,3,30,0,1,1,0,1,1
01851568,13,0,13,0,0,0,0,0,1
01852005,19,2,17,0,1,1,0,1,1
01852009,40,2,38,0,1,1,0,1,1
01852326,3,3,0,0,2,2,0,0,1
01852345,11,4,7,0,0,0,0,0,0
01852669,3,2,1,0,2,2,0,0,0
01852833,24,4,20,0,2,0,2,0,0
01852837,12,5,7,0,0,0,0,0,1
01852933,18,1,17,0,1,1,0,1,1
01852973,28,5,23,0,1,1,0,1,1
01853927,75,11,64,0,21,16,5,0,1
01853932,12,4,8,0,0,0,0,0,0
01854132,48,7,41,0,1,1,0,1,1
01854685,46,0,46,0,0,0,0,0,1
01855020,42,4,38,0,1,1,0,1,1
01855123,9,3,6,0,1,1,0,0,1
01855196,17,8,9,0,1,1,0,0,0
01855768,18,0,18,0,0,0,0,0,1
01856580,39,7,32,0,11,6,5,0,1
01857061,7,2,5,0,2,2,0,1,1
01857625,17,3,14,0,1,1,0,1,1
01857729,52,0,52,0,0,0,0,0,1
01857795,20,3,17,0,1,1,0,1,1
01858017,32,0,32,0,0,0,0,0,1
01858018,33,0,33,0,0,0,0,0,1
01858046,17,4,13,0,1,1,0,0,1
01858278,58,10,48,0,0,0,0,0,1
01858283,9,3,6,0,3,3,0,0,1
01858423,14,0,14,0,3,1,2,3,1
01858447,6,4,2,0,2,2,0,0,1
01858790,52,2,50,0,3,3,0,3,1
01859173,57,11,46,0,0,0,0,0,1
01859632,7,2,5,0,1,1,0,1,0
01860027,0,0,0,0,0,0,0,0,0
01860121,37,0,37,0,0,0,0,0,1
01860163,31,0,31,0,1,1,0,1,1
01860172,43,3,40,0,3,1,2,2,1
01860196,13,0,13,0,0,0,0,0,1
01860220,38,4,34,0,1,1,0,1,1
01860464,40,2,38,0,1,1,0,1,1
01860481,12,5,7,0,0,0,0,0,1
01860680,67,6,61,0,2,2,0,2,1
01861597,19,4,15,0,1,1,0,0,1
01861710,12,2,10,0,1,1,0,0,0
01861836,13,5,8,0,0,0,0,0,0
01862322,26,4,22,0,1,1,0,1,1
01862328,16,3,13,0,1,1,0,1,1
01862440,22,0,22,0,1,1,0,1,1
01862464,28,4,24,0,1,1,0,1,0
01862681,8,1,7,0,0,0,0,0,0
01862971,35,3,32,0,0,0,0,0,1
01863614,104,13,91,0,0,0,0,0,1
01863660,0,0,0,0,0,0,0,0,0
01864009,28,2,26,0,1,1,0,1,1
01864508,47,6,41,0,1,1,0,1,1
01864565,27,0,27,0,0,0,0,0,1
01864686,4,4,0,0,3,3,0,0,1
01864847,6,3,3,0,1,1,0,0,0
01865059,75,13,62,0,0,0,0,0,1
01865061,37,4,33,0,1,1,0,1,1
01865065,7,0,7,0,0,0,0,0,1
01865175,41,9,32,0,0,0,0,0,1
01865661,4,1,3,0,1,1,0,0,1
01865678,8,0,8,0,0,0,0,0,1
01865679,6,0,6,0,0,0,0,0,1
01865768,27,0,27,0,0,0,0,0,1
01866005,16,8,8,0,0,0,0,0,0
01866165,30,1,29,0,1,1,0,1,1
01866196,18,0,18,0,0,0,0,0,1
01866557,19,2,17,0,2,2,0,1,1
01866577,15,3,12,0,1,1,0,1,1
01866642,12,9,3,0,4,1,3,1,0
01867091,5,3,2,0,1,1,0,0,0
01867687,10,3,7,0,1,1,0,0,0
01867871,24,2,22,0,1,1,0,1,1
01867885,44,0,44,0,0,0,0,0,1
01868157,4,2,2,0,1,1,0,0,0
01868225,30,5,25,0,2,2,0,2,1
02459087,42,3,39,0,1,1,0,1,1
02459173,41,0,41,0,0,0,0,0,1
02459405,37,4,33,0,1,1,0,1,1
02459504,3,3,0,0,0,0,0,0,0
02459607,19,3,16,0,1,1,0,0,1
02459659,3,0,3,0,0,0,0,0,0
02459671,68,2,66,0,2,1,1,1,1
02459761,13,2,11,0,1,1,0,1,1
02459997,34,0,34,0,0,0,0,0,1
02460198,19,3,16,0,2,2,0,0,0
02460330,39,10,29,0,0,0,0,0,1
02460355,19,3,16,0,1,1,0,0,1
02460956,7,3,4,0,1,1,0,0,0
02461011,29,0,29,0,1,1,0,1,1
02461283,13,2,11,0,1,1,0,1,1
02461296,27,5,22,0,0,0,0,0,1
02461325,5,1,4,0,1,1,0,0,0
02461523,13,3,10,0,2,1,1,0,1
02461543,24,6,18,0,2,2,0,0,1
02461639,36,8,28,0,1,1,0,1,1
02461931,31,2,29,0,1,1,0,1,1
02462037,33,3,30,0,1,1,0,1,1
02462241,42,0,42,0,0,0,0,0,1
02462336,81,4,77,0,0,0,0,0,1
02462479,39,4,35,0,3,1,2,3,1
02462769,11,0,11,0,1,1,0,1,1
02463182,26,0,26,0,0,0,0,0,1
02463316,36,4,32,0,1,1,0,0,1
02463348,32,8,24,0,0,0,0,0,1
02463452,23,3,20,0,1,1,0,1,1
02463462,61,0,61,0,0,0,0,0,1
02463473,35,6,29,0,1,1,0,0,0
02463497,41,9,32,0,0,0,0,0,1
02463655,17,0,17,0,0,0,0,0,1
02463815,25,3,22,0,2,1,1,1,1
02464038,16,2,14,0,1,1,0,0,1
02464040,122,2,120,0,2,1,1,2,1
02464046,34,4,30,0,1,1,0,1,1
02464094,3,3,0,0,1,1,0,0,1
02464484,29,0,29,0,0,0,0,0,1
02464755,18,5,13,0,4,4,0,0,0
02464929,10,3,7,0,0,0,0,0,1
02465253,11,2,9,0,1,1,0,0,0
02465263,45,5,40,0,1,1,0,1,1
02465319,36,10,26,0,0,0,0,0,1
02465499,29,9,20,0,1,1,0,1,1
02465603,4,0,4,0,0,0,0,0,1
02465953,46,3,43,0,1,1,0,1,1
02466472,13,4,9,0,1,1,0,1,1
02466594,34,0,34,0,0,0,0,0,1
02466698,0,0,0,0,0,0,0,0,1
02466765,13,2,11,0,1,1,0,1,1
02466786,8,2,6,0,1,1,0,1,1
02466791,0,0,0,0,0,0,0,0,1
02467118,28,1,27,0,1,1,0,1,1
02467204,28,3,25,0,1,1,0,1,0
02467207,45,7,38,0,1,1,0,1,1
02467253,43,8,35,0,0,0,0,0,1
02467330,8,0,8,0,0,0,0,0,0
02467364,26,9,17,0,0,0,0,0,1
02467616,1,0,1,0,0,0,0,0,1
02467733,34,3,31,0,2,2,0,2,1
02467769,23,3,20,0,1,1,0,1,1
02467874,12,3,9,0,1,1,0,1,0
02468610,30,4,26,0,1,1,0,1,1
02468686,72,9,63,0,0,0,0,0,1
02468819,23,5,18,0,0,0,0,0,1
02468873,18,3,15,0,2,2,0,0,1
02469133,7,3,4,0,1,1,0,1,1
02469171,2,2,0,0,1,1,0,0,0
02469485,16,0,16,0,1,1,0,1,1
02469561,12,4,8,0,0,0,0,0,0
02469925,4,0,4,0,0,0,0,0,1
02469959,106,0,106,0,0,0,0,0,1
02470387,23,0,23,0,1,1,0,1,0
02470717,6,2,4,0,1,1,0,0,0
02470772,80,2,78,0,1,1,0,0,1
02470848,4,3,1,0,2,2,0,0,1
02470962,4,1,3,0,3,3,0,0,1
02470996,4,0,4,0,0,0,0,0,1
02471287,31,6,25,0,1,1,0,1,1
02471319,15,4,11,0,3,1,2,1,1
02471345,59,10,49,0,1,1,0,0,1
02471382,42,6,36,0,2,0,2,0,0
02471438,42,5,37,0,1,1,0,1,1
02471686,128,17,111,0,0,0,0,0,1
02472345,73,11,62,0,0,0,0,0,1
02472369,52,12,40,0,0,0,0,0,1
02472464,18,4,14,0,0,0,0,0,1
02472666,12,0,12,0,0,0,0,0,1
02472818,29,5,24,0,2,2,0,2,1
02473184,17,3,14,0,1,1,0,1,1
02473227,12,4,8,0,1,1,0,1,1
02474368,3,0,3,0,1,1,0,0,1
02474511,16,6,10,0,1,1,0,0,1
02474514,19,3,16,0,1,1,0,1,1
02474565,8,0,8,0,0,0,0,0,0
02474627,42,7,35,0,1,1,0,1,1
02474866,53,7,46,0,0,0,0,0,1
02474912,39,6,33,0,1,1,0,1,1
02475286,5,5,0,0,1,1,0,0,1
02475402,0,0,0,0,0,0,0,0,1
02475537,29,4,25,0,1,1,0,0,1
02475628,39,0,39,0,0,0,0,0,1
02475731,34,0,34,0,1,1,0,1,1
02475979,14,3,11,0,2,2,0,0,1
02476263,9,7,2,0,2,1,1,1,1
02476284,75,0,75,0,0,0,0,0,1
02476292,20,2,18,0,0,0,0,0,1
02476398,26,6,20,0,1,1,0,1,1
02476402,47,4,43,0,2,2,0,2,1
02476625,4,4,0,0,2,2,0,0,0
02476638,8,3,5,0,0,0,0,0,1
02476642,49,14,35,0,1,0,1,0,1
02476685,23,4,19,0,1,1,0,1,1
02476951,24,4,20,0,1,1,0,0,0
02477006,22,4,18,0,1,1,0,1,1
02477421,43,8,35,0,0,0,0,0,1
02477486,6,2,4,0,1,1,0,0,0
02478112,37,2,35,0,1,1,0,1,1
02478291,11,2,9,0,1,1,0,0,1
02478424,24,0,24,0,0,0,0,0,1
02478500,55,4,51,0,2,1,1,2,1
02478695,104,19,85,0,0,0,0,0,0
02478770,36,5,31,0,2,1,1,2,1
02478802,27,4,23,0,1,1,0,1,1
02479179,74,11,63,0,0,0,0,0,1
02479190,9,0,9,0,0,0,0,0,1
02479300,20,4,16,0,1,1,0,1,1
02479325,23,0,23,0,0,0,0,0,1
02479327,368,10,358,0,0,0,0,0,1
02479329,26,3,23,0,1,1,0,1,1
02479330,39,4,35,0,1,1,0,1,1
02479336,27,4,23,0,2,2,0,2,1
02479448,24,8,16,0,0,0,0,0,1
02479672,44,4,40,0,1,1,0,1,1
02479975,18,7,11,0,0,0,0,0,1
02480139,11,3,8,0,1,1,0,0,1
02480363,11,0,11,0,0,0,0,0,1
02480388,10,3,7,0,1,1,0,0,1
02480430,25,10,15,0,0,0,0,0,1
02480484,15,0,15,0,1,1,0,1,1
02480999,25,3,22,0,1,1,0,1,1
02481019,29,13,16,0,1,1,0,1,1
02481100,41,9,32,0,1,1,0,0,1
02481307,16,3,13,0,1,1,0,1,1
02481321,23,5,18,0,1,1,0,1,1
02481710,15,6,9,0,0,0,0,0,1
02481789,3,3,0,0,1,1,0,0,1
02481804,10,3,7,0,0,0,0,0,1
02482048,40,9,31,0,0,0,0,0,1
02482174,22,0,22,0,1,1,0,1,1
02482274,22,0,22,0,1,1,0,1,1
02482400,15,8,7,0,1,0,1,1,1
02482410,21,4,17,0,2,2,0,0,1
02483161,57,5,52,0,1,1,0,1,1
02483505,36,2,34,0,1,1,0,1,1
02483862,17,0,17,0,0,0,0,0,1
02484273,59,9,50,0,1,1,0,1,1
02484431,14,5,9,0,2,2,0,0,1
02484446,36,3,33,0,1,1,0,1,1
02484623,25,3,22,0,1,1,0,1,1
02484674,5,2,3,0,1,1,0,1,1
02484831,17,4,13,0,2,1,1,2,1
02484952,4,2,2,0,1,1,0,1,0
02485064,5,1,4,0,1,1,0,0,0
02485159,42,7,35,0,0,0,0,0,1
02485266,40,5,35,0,1,1,0,1,1
02485353,34,0,34,0,0,0,0,0,1
02485383,45,10,35,0,1,1,0,0,1
02485637,4,3,1,0,1,1,0,0,0
02485665,34,0,34,0,0,0,0,0,1
02486024,40,9,31,0,0,0,0,0,1
02486368,68,13,55,0,0,0,0,0,1
02486608,25,6,19,0,1,1,0,1,1
02486613,22,5,17,0,1,1,0,1,1
02486702,5,2,3,0,2,1,1,0,0
02486842,18,0,18,0,0,0,0,0,1
02486955,50,0,50,0,0,0,0,0,1
02487135,19,5,14,0,1,1,0,1,1
02487393,23,3,20,0,2,2,0,1,1
02487475,14,0,14,0,0,0,0,0,1
02487502,25,0,25,0,0,0,0,0,1
02487533,32,0,32,0,0,0,0,0,1
02487535,29,0,29,0,0,0,0,0,1
02487620,7,4,3,0,1,1,0,0,0
02487643,15,0,15,0,0,0,0,0,1
02487876,24,5,19,0,1,1,0,1,1
02488037,12,4,8,0,4,2,2,0,0
02488040,33,0,33,0,0,0,0,0,1
02488138,12,3,9,0,0,0,0,0,1
02488264,29,0,29,0,0,0,0,0,1
02488689,17,2,15,0,1,1,0,1,1
02488796,16,3,13,0,1,1,0,0,1
02488927,169,11,158,0,0,0,0,0,1
02488955,17,2,15,0,0,0,0,0,1
02489376,25,1,24,0,1,1,0,1,1
02489384,59,8,51,0,2,2,0,2,1
02489438,13,2,11,0,1,1,0,0,0
02489659,9,4,5,0,1,1,0,0,1
02490024,9,4,5,0,1,1,0,1,1
02490104,26,4,22,0,1,1,0,1,1
02490118,40,7,33,0,1,1,0,1,1
02490136,47,3,44,0,1,1,0,1,1
02490139,34,3,31,0,1,1,0,1,1
02490228,23,0,23,0,0,0,0,0,1
02490359,10,3,7,0,1,1,0,1,1
02490394,11,3,8,0,0,0,0,0,0
02490584,14,2,12,0,1,1,0,1,1
02491155,49,8,41,0,0,0,0,0,1
02491761,7,5,2,0,3,3,0,0,1
02492037,27,4,23,0,3,1,2,2,1
02492148,5,2,3,0,1,1,0,0,1
02492210,5,5,0,0,1,1,0,0,1
02492235,6,1,5,0,1,1,0,0,0
02492411,78,13,65,0,0,0,0,0,1
02492599,34,3,31,0,5,5,0,1,1
02492672,6,3,3,0,0,0,0,0,0
02493041,31,7,24,0,1,1,0,1,1
02493111,3,2,1,0,0,0,0,0,1
02493143,16,2,14,0,2,2,0,0,1
02493145,15,5,10,0,1,1,0,1,1
02493571,96,5,91,0,1,1,0,1,1
02493838,3,3,0,0,2,2,0,0,1
02494214,5,2,3,0,3,3,0,0,0
02494315,47,8,39,0,0,0,0,0,0
02494361,31,13,18,0,1,1,0,1,1
02494406,15,6,9,0,0,0,0,0,0
02494458,91,16,75,0,0,0,0,0,1
02495306,20,4,16,0,0,0,0,0,0
02495472,34,4,30,0,1,1,0,1,1
02495551,31,0,31,0,0,0,0,0,1
02495691,4,2,2,0,1,1,0,0,0
02495958,26,0,26,0,0,0,0,0,1
02496206,25,5,20,0,1,1,0,1,1
02496234,50,5,45,0,1,1,0,0,1
02496240,20,0,20,0,1,1,0,1,1
02496485,4,3,1,0,1,1,0,0,1
02497334,24,2,22,0,1,1,0,0,1
02497353,2,2,0,0,2,2,0,0,1
02498018,184,41,143,0,0,0,0,0,1
02498424,38,0,38,0,0,0,0,0,1
02498499,41,8,33,0,0,0,0,0,0
02498503,24,4,20,0,0,0,0,0,1
02498852,37,0,37,0,1,1,0,1,1
02498977,11,4,7,0,2,2,0,0,1
02499006,69,5,64,0,0,0,0,0,1
02499257,21,0,21,0,0,0,0,0,1
02499280,31,4,27,0,1,1,0,1,1
02499580,19,5,14,0,3,3,0,0,0
02499642,37,7,30,0,1,1,0,1,1
02499697,21,3,18,0,1,1,0,1,1
02499702,16,2,14,0,1,1,0,1,1
02499718,11,0,11,0,0,0,0,0,1
SC344080,6,2,4,0,1,1,0,0,1
SC344189,4,2,2,0,1,1,0,0,1
SC344207,24,12,12,0,0,0,0,0,1
SC344257,14,5,9,0,0,0,0,0,1
SC344270,4,2,2,0,1,1,0,0,1
SC344344,3,0,3,0,0,0,0,0,1
SC344345,3,0,3,0,0,0,0,0,1
SC344509,17,9,8,0,1,1,0,0,1
SC344555,1,0,1,0,0,0,0,0,0
SC344731,6,3,3,0,1,1,0,1,0
SC344732,6,3,3,0,1,1,0,1,0
SC344777,19,8,11,0,1,1,0,1,1
SC344796,6,0,6,0,0,0,0,0,1
SC344823,4,2,2,0,1,1,0,0,1
SC344855,6,4,2,0,3,3,0,0,1
SC345001,13,2,11,0,0,0,0,0,0
SC345194,3,2,1,0,1,1,0,0,0
SC345270,17,0,17,0,0,0,0,0,0
SC345359,5,4,1,0,1,1,0,1,1
SC345445,29,9,20,0,0,0,0,0,1
SC345562,12,0,12,0,0,0,0,0,1
SC345565,18,7,11,0,1,1,0,1,1
SC345855,6,3,3,0,1,1,0,0,0
SC346040,11,5,6,0,1,1,0,0,1
SC346048,3,2,1,0,1,1,0,0,0
SC346207,8,4,4,0,1,1,0,0,1
SC346282,5,2,3,0,1,1,0,0,0
SC346482,3,1,2,0,1,1,0,1,0
SC346781,14,8,6,0,1,1,0,1,1
SC347578,2,2,0,0,1,1,0,0,0
SC347662,8,4,4,0,1,1,0,1,1
SC347668,5,3,2,0,2,2,0,0,1
SC347869,6,0,6,0,0,0,0,0,1
SC348042,12,1,11,0,1,1,0,1,1
SC348290,4,2,2,0,1,1,0,1,0
SC348293,6,6,0,0,5,3,2,4,1
SC348495,6,1,5,0,1,1,0,0,0
SC348499,2,2,0,0,1,1,0,0,1
SC348612,2,2,0,0,1,1,0,0,0
SC348693,3,0,3,0,0,0,0,0,1
SC348710,3,0,3,0,0,0,0,0,0
SC348828,2,2,0,0,2,2,0,0,1
SC349020,4,0,4,0,0,0,0,0,1
SC349126,2,0,2,0,3,3,0,1,1
SC349129,5,3,2,0,1,1,0,0,1
SC349130,4,3,1,0,1,1,0,0,1
SC349513,16,4,12,0,1,1,0,1,1
SC349518,6,3,3,0,1,1,0,1,1
SC349519,7,4,3,0,1,1,0,1,1
SC349524,5,0,5,0,0,0,0,0,1
SC349529,4,0,4,0,0,0,0,0,1
SC349757,5,1,4,0,1,1,0,0,0
SC349806,4,2,2,0,1,1,0,0,0
SC349825,2,0,2,0,0,0,0,0,0
SC350069,11,2,9,0,1,1,0,0,1
SC350253,28,9,19,0,0,0,0,0,0
SC350374,11,5,6,0,0,0,0,0,1
SC350509,4,3,1,0,1,1,0,0,1
SC350566,2,1,1,0,1,1,0,0,1
SC350802,14,2,12,0,1,1,0,1,1
SC350938,12,2,10,0,2,1,1,2,1
SC350952,58,16,42,0,0,0,0,0,1
SC350966,2,2,0,0,2,2,0,0,1
SC350975,15,2,13,0,1,1,0,1,1
SC351011,3,1,2,0,1,1,0,0,0
SC351246,6,3,3,0,1,1,0,0,0
SC351319,8,4,4,0,1,1,0,1,1
SC351451,6,0,6,0,1,1,0,0,0
SC351533,4,2,2,0,2,2,0,0,1
SC351607,12,0,12,0,0,0,0,0,1
SC351654,17,6,11,0,1,1,0,1,1
SC351706,3,3,0,0,3,3,0,0,0
SC352117,26,4,22,0,0,0,0,0,1
SC352260,12,4,8,0,2,2,0,0,1
SC352474,3,2,1,0,0,0,0,0,0
SC352542,20,7,13,0,0,0,0,0,0
SC352618,3,1,2,0,1,1,0,0,1
SC352638,9,4,5,0,1,1,0,0,1
SC352639,4,0,4,0,0,0,0,0,1
SC352640,8,4,4,0,1,1,0,0,1
SC353200,3,0,3,0,0,0,0,0,1
SC353211,7,3,4,1,1,1,0,1,1
SC353364,4,1,3,0,1,1,0,0,0
SC353372,9,5,4,0,0,0,0,0,1
SC353447,3,1,2,0,1,1,0,0,0
SC353448,5,3,2,0,2,2,0,0,1
SC353478,1,1,0,0,1,1,0,0,0
SC353666,4,3,1,0,1,1,0,1,0
SC353684,5,2,3,0,1,1,0,0,0
SC353690,1,0,1,0,0,0,0,0,1
SC353717,7,0,7,0,0,0,0,0,0
SC353734,6,2,4,0,2,2,0,0,1
SC353747,6,3,3,0,1,1,0,0,0
SC353754,43,12,31,0,0,0,0,0,0
SC354093,12,7,5,0,1,1,0,1,1
SC354167,25,6,19,0,0,0,0,0,1
SC354243,9,4,5,0,2,2,0,0,1
SC354361,43,25,18,0,0,0,0,0,1
SC354379,30,5,25,0,1,1,0,0,0
SC354481,1,1,0,0,1,1,0,0,0
SC354581,48,19,29,0,0,0,0,0,1
SC354747,8,0,8,0,0,0,0,0,1
SC354863,8,3,5,0,2,1,1,2,1
SC354867,8,0,8,0,0,0,0,0,1
SC354998,2,1,1,0,0,0,0,0,0
SC355123,3,2,1,0,1,1,0,0,1
SC355383,12,4,8,0,1,1,0,1,1
SC355449,1,1,0,0,2,1,1,0,0
SC355461,3,3,0,0,1,1,0,0,1
SC355617,1,1,0,0,1,1,0,0,0
SC355622,3,2,1,0,1,1,0,0,0
SC355750,5,4,1,0,2,2,0,0,0
SC355909,1,1,0,0,1,1,0,0,0
SC355969,28,9,19,0,0,0,0,0,0
SC355988,1,1,0,0,1,1,0,0,0
SC356107,3,0,3,0,0,0,0,0,0
SC356123,5,3,2,0,1,1,0,0,0
SC356211,15,2,13,0,0,0,0,0,1
SC356241,5,5,0,0,0,0,0,0,1
SC356289,11,5,6,0,1,1,0,1,1
SC356347,37,7,30,0,1,1,0,0,0
SC356419,43,10,33,0,0,0,0,0,0
SC356580,2,1,1,0,1,1,0,0,0
SC356740,5,3,2,0,2,2,0,0,0
SC356745,6,1,5,0,4,1,3,1,1
SC356746,2,1,1,0,2,1,1,1,1
SC356862,16,0,16,0,1,1,0,1,0
SC356918,10,9,1,0,0,0,0,0,0
SC357036,8,5,3,0,1,1,0,0,1
SC357144,11,3,8,0,0,0,0,0,0
SC357173,3,1,2,0,1,1,0,0,0
SC357180,5,3,2,0,2,2,0,0,0
SC357204,26,4,22,0,0,0,0,0,0
SC357234,8,3,5,0,1,1,0,1,1
SC357263,4,2,2,0,1,1,0,0,0
SC357281,3,2,1,0,1,1,0,0,1
SC357345,9,4,5,0,0,0,0,0,0
SC357418,11,4,7,0,1,1,0,1,1
SC357436,57,25,32,0,0,0,0,0,0
SC357437,6,0,6,0,0,0,0,0,1
SC357657,6,0,6,0,2,1,1,0,1
SC357658,6,0,6,0,2,1,1,0,1
SC357776,2,0,2,0,2,2,0,0,0
SC357882,8,0,8,0,0,0,0,0,1
SC357939,13,9,4,1,1,1,0,1,0
SC358018,13,5,8,1,0,0,0,0,1
SC358051,12,6,6,0,1,1,0,0,1
SC358224,3,3,0,0,1,1,0,0,0
SC358582,4,0,4,0,0,0,0,0,1
SC358616,2,2,0,0,1,1,0,0,0
SC358964,28,7,21,0,0,0,0,0,0
SC359222,7,0,7,0,0,0,0,0,1
SC359252,3,2,1,0,2,2,0,0,1
SC359289,2,2,0,0,2,2,0,0,1
SC359311,3,2,1,0,1,1,0,0,0
SC359365,19,3,16,0,1,1,0,1,1
SC359384,16,3,13,0,1,1,0,1,1
SC359609,25,0,25,0,0,0,0,0,1
SC359631,4,0,4,0,0,0,0,0,0
SC359969,3,1,2,0,1,1,0,0,0
SC360269,4,3,1,0,0,0,0,0,1
SC360462,6,0,6,0,2,1,1,0,1
SC360621,31,12,19,0,1,1,0,0,0
SC360709,4,1,3,0,3,1,2,1,0
SC360923,7,3,4,0,2,2,0,0,1
SC361115,1,0,1,0,1,1,0,0,0
SC361449,7,1,6,0,1,1,0,0,0
SC361482,4,3,1,0,2,2,0,0,1
SC362011,5,3,2,0,1,1,0,0,1
SC362208,7,0,7,0,0,0,0,0,1
SC362224,6,0,6,0,1,1,0,0,1
SC362398,4,1,3,0,1,1,0,0,0
SC362431,5,2,3,0,1,1,0,1,1
SC362776,2,0,2,0,0,0,0,0,1
SC363156,3,1,2,0,2,2,0,0,1
SC363158,7,0,7,0,0,0,0,0,1
SC363190,7,5,2,0,1,1,0,0,1
SC363191,8,5,3,0,1,1,0,0,1
SC363193,3,0,3,0,0,0,0,0,1
SC363194,3,2,1,0,1,1,0,0,1
SC363230,2,2,0,0,1,1,0,0,1
SC363237,1,1,0,0,1,1,0,0,1
SC363254,4,3,1,0,1,0,1,0,1
SC363918,8,0,8,0,1,1,0,0,0
SC364055,3,3,0,0,1,1,0,0,0
SC364116,13,4,9,0,1,1,0,1,0
SC364401,2,1,1,0,2,1,1,0,1
SC364588,24,8,16,0,4,0,4,0,1
SC364595,3,2,1,0,1,1,0,0,1
SC364932,8,5,3,0,0,0,0,0,0
SC365019,49,13,36,0,0,0,0,0,1
SC365033,3,3,0,0,1,1,0,1,0
SC365052,8,3,5,0,1,1,0,1,0
SC365125,11,7,4,0,1,1,0,1,1
SC365126,11,7,4,0,10,10,0,0,0
SC365231,25,9,16,0,1,1,0,1,1
SC365338,7,3,4,0,2,1,1,1,1
SC365449,5,3,2,0,2,2,0,0,1
SC365458,1,1,0,0,1,1,0,0,1
SC365498,17,9,8,0,0,0,0,0,0
SC365592,11,6,5,0,0,0,0,0,1
SC365754,7,2,5,0,2,2,0,0,0
SC365926,4,2,2,0,1,1,0,0,0
SC366069,8,4,4,0,2,2,0,2,1
SC366200,6,4,2,0,3,3,0,0,1
SC366208,4,4,0,0,2,2,0,0,1
SC366266,34,13,21,0,0,0,0,0,1
SC366380,19,11,8,0,0,0,0,0,1
SC366385,4,0,4,0,0,0,0,0,1
SC366518,2,2,0,0,2,2,0,0,0
SC366604,7,3,4,0,2,1,1,1,1
SC366628,10,0,10,0,0,0,0,0,1
SC366964,7,0,7,0,0,0,0,0,0
SC367047,2,1,1,0,1,1,0,0,1
SC367171,6,0,6,0,2,1,1,0,1
SC367172,6,0,6,0,2,1,1,0,1
SC367289,9,3,6,0,1,1,0,0,0
SC367458,5,3,2,0,3,3,0,0,1
SC367460,4,2,2,0,2,2,0,0,1
SC367547,30,0,30,0,2,2,0,0,1
SC367563,20,6,14,0,0,0,0,0,1
SC367677,6,4,2,0,1,1,0,0,1
SC367840,24,6,18,0,1,1,0,1,0
SC367876,1,1,0,0,2,2,0,0,0
SC367884,5,4,1,0,3,3,0,0,1
SC367888,4,2,2,0,1,1,0,0,0
SC368059,6,4,2,0,3,3,0,0,0
SC368110,2,0,2,0,0,0,0,0,1
SC368366,8,1,7,0,1,1,0,0,1
SC368534,5,1,4,0,4,1,3,1,0
SC368647,5,4,1,0,2,2,0,0,0
SC368676,7,3,4,0,1,1,0,1,1
SC368706,23,4,19,0,0,0,0,0,0
SC368752,11,5,6,1,3,1,2,1,1
SC368979,11,3,8,1,1,1,0,1,1
SC369296,8,4,4,0,1,1,0,1,1
SC369435,6,3,3,0,2,2,0,1,1
SC369602,5,2,3,0,2,2,0,0,0
SC369638,13,4,9,0,1,1,0,1,0
SC369647,11,4,7,0,1,1,0,1,1
SC369660,1,0,1,0,0,0,0,0,1
SC369867,3,1,2,1,2,2,0,0,1
SC369920,4,2,2,0,1,1,0,0,0
SC369981,19,2,17,0,0,0,0,0,1
SC370038,6,4,2,2,2,2,0,0,1
SC370081,4,4,0,0,1,1,0,0,0
SC370395,1,1,0,0,1,1,0,0,0
SC371228,6,6,0,0,3,1,2,1,1
SC371303,3,2,1,0,1,1,0,0,1
SC371327,17,2,15,0,1,1,0,1,1
SC371342,9,3,6,0,3,1,2,1,1
SC371377,3,2,1,0,2,2,0,0,0
SC371424,5,1,4,0,1,1,0,1,0
SC371732,3,0,3,0,0,0,0,0,1
SC371766,17,7,10,0,0,0,0,0,0
SC371916,8,5,3,0,1,1,0,1,1
SC371917,9,5,4,0,1,1,0,1,1
SC371918,8,5,3,0,1,1,0,1,1
SC372071,1,1,0,0,2,2,0,0,0
SC372199,35,14,21,0,0,0,0,0,1
SC372526,23,4,19,0,1,1,0,1,1
SC372837,17,4,13,1,1,1,0,1,1
SC373018,5,0,5,0,1,1,0,0,1
SC373086,5,1,4,0,0,0,0,0,0
SC373215,9,0,9,0,0,0,0,0,1
SC373332,5,2,3,0,1,1,0,0,0
SC373349,3,2,1,0,1,1,0,0,0
SC373389,4,1,3,0,2,1,1,1,1
SC373732,3,0,3,0,0,0,0,0,0
SC373801,4,2,2,0,1,1,0,0,0
SC373858,1,0,1,0,1,1,0,0,0
SC373907,2,0,2,0,0,0,0,0,0
SC373918,3,0,3,0,0,0,0,0,1
SC373921,7,0,7,0,1,1,0,0,1
SC373947,4,3,1,0,1,1,0,0,1
SC374255,15,6,9,0,0,0,0,0,0
SC374268,3,3,0,0,2,2,0,0,1
SC374486,4,4,0,0,0,0,0,0,0
SC374737,2,0,2,0,0,0,0,0,0
SC374789,3,2,1,0,1,1,0,0,1
SC374816,9,6,3,0,1,1,0,0,0
SC374873,5,0,5,0,0,0,0,0,1
SC374896,3,0,3,0,0,0,0,0,0
SC375022,2,1,1,0,1,1,0,0,0
SC375254,24,5,19,0,1,1,0,1,1
SC375277,11,0,11,0,1,1,0,1,1
SC375359,1,0,1,0,1,1,0,0,0
SC375395,6,4,2,4,1,1,0,0,0
SC375466,9,4,5,0,1,1,0,1,1
SC375774,2,2,0,0,1,1,0,0,1
SC375825,3,1,2,0,1,1,0,0,0
SC375856,32,9,23,0,0,0,0,0,0
SC375912,4,3,1,0,1,1,0,0,1
SC375940,6,2,4,0,1,1,0,0,0
SC375944,5,5,0,0,2,2,0,0,1
SC375957,5,0,5,0,0,0,0,0,1
SC375958,4,2,2,0,1,1,0,0,1
SC375961,4,3,1,0,2,2,0,0,1
SC375962,8,0,8,0,0,0,0,0,1
SC375963,12,0,12,0,2,1,1,2,1
SC376021,15,5,10,1,1,1,0,1,1
SC376269,6,3,3,0,1,1,0,0,1
SC376327,2,1,1,0,1,1,0,0,0
SC376707,32,5,27,0,1,0,1,0,1
SC376823,7,6,1,0,1,1,0,1,1
SC376824,4,0,4,0,0,0,0,0,1
SC376901,2,0,2,0,0,0,0,0,0
SC376945,5,0,5,0,0,0,0,0,1
SC377149,25,5,20,0,0,0,0,0,1
SC377176,4,0,4,0,0,0,0,0,0
SC377236,8,5,3,0,0,0,0,0,0
SC377377,30,8,22,0,0,0,0,0,0
SC377447,2,0,2,0,0,0,0,0,0
SC377654,2,1,1,0,1,1,0,0,0
SC377982,2,2,0,0,2,2,0,0,0
SC378037,2,2,0,0,2,2,0,0,0
SC378444,6,4,2,0,2,1,1,1,1
SC378650,3,2,1,0,2,2,0,0,0
SC378733,4,2,2,0,3,3,0,1,1
SC378968,5,0,5,0,0,0,0,0,1
SC378969,3,1,2,0,1,1,0,0,1
SC378970,3,1,2,0,1,1,0,0,1
SC379005,4,0,4,0,0,0,0,0,1
SC379141,10,7,3,0,0,0,0,0,0
SC379263,2,0,2,0,0,0,0,0,1
SC379264,2,1,1,0,1,1,0,0,1
SC379266,4,2,2,0,4,4,0,0,1
SC379584,4,2,2,0,3,1,2,1,1
SC379628,6,3,3,0,2,2,0,0,0
SC379713,2,1,1,0,1,1,0,0,0
SC379870,3,3,0,0,2,2,0,0,0
SC380133,9,0,9,0,0,0,0,0,0
SC380297,9,7,2,0,0,0,0,0,1
SC380533,7,5,2,0,0,0,0,0,1
SC380577,11,7,4,0,1,1,0,1,1
SC380596,3,3,0,0,1,1,0,0,1
SC380626,8,7,1,0,0,0,0,0,0
SC380708,11,4,7,1,1,1,0,1,0
SC381012,2,2,0,0,2,2,0,0,0
SC381034,4,2,2,0,1,1,0,0,0
SC381243,8,5,3,0,3,3,0,0,1
SC381446,3,3,0,0,2,2,0,0,0
SC381447,1,0,1,0,0,0,0,0,0
SC381553,3,0,3,1,0,0,0,0,1
SC381634,5,0,5,0,1,1,0,0,0
SC381737,30,5,25,0,0,0,0,0,1
SC382011,25,8,17,0,1,1,0,1,1
SC382314,3,3,0,0,2,2,0,0,0
SC382535,5,1,4,0,1,1,0,0,1
SC382573,8,5,3,0,1,1,0,1,1
SC382635,5,2,3,0,2,2,0,0,1
SC382636,3,1,2,0,2,2,0,0,1
SC382699,3,1,2,0,1,1,0,0,1
SC382702,3,1,2,0,1,1,0,0,1
SC382739,3,3,0,1,1,1,0,1,1
SC382883,5,1,4,0,1,1,0,0,0
SC382934,7,3,4,0,3,1,2,1,1
SC383178,3,2,1,0,1,1,0,0,0
SC383232,7,0,7,0,2,2,0,1,1
SC383233,9,4,5,0,1,1,0,0,1
SC383269,7,6,1,0,2,2,0,1,1
SC383455,18,5,13,1,1,1,0,1,1
SC383473,2,0,2,0,0,0,0,0,0
SC383500,13,2,11,0,1,1,0,1,1
SC383530,1,1,0,0,1,1,0,0,0
SC383673,2,0,2,0,0,0,0,0,0
SC383728,5,2,3,0,1,1,0,1,0
SC384458,2,0,2,0,0,0,0,0,0
SC384619,18,7,11,0,0,0,0,0,1
SC384652,3,2,1,0,1,1,0,0,0
SC384777,4,3,1,0,1,1,0,1,1
SC384884,3,0,3,0,0,0,0,0,0
SC385156,1,0,1,0,0,0,0,0,0
SC385506,3,0,3,0,1,1,0,1,1
SC385667,2,2,0,0,2,2,0,0,0
SC385905,4,2,2,0,1,1,0,1,1
SC385984,3,0,3,0,0,0,0,0,1
SC385985,3,0,3,0,0,0,0,0,1
SC386419,3,1,2,0,3,1,2,0,0
SC386506,5,3,2,0,1,1,0,0,0
SC386842,6,0,6,0,0,0,0,0,1
SC386922,18,9,9,0,0,0,0,0,1
SC386978,6,5,1,0,1,1,0,0,0
SC386987,3,1,2,0,1,1,0,0,0
SC387207,17,9,8,0,0,0,0,0,1
SC387208,12,7,5,0,0,0,0,0,0
SC387359,11,0,11,0,0,0,0,0,1
SC387374,14,3,11,0,2,1,1,1,1
SC387377,15,3,12,0,2,1,1,1,1
SC387575,7,4,3,1,3,3,0,1,1
SC387672,27,9,18,0,2,2,0,2,1
SC387740,12,2,10,0,3,1,2,1,1
SC387762,2,0,2,0,0,0,0,0,0
SC387903,13,4,9,0,0,0,0,0,1
SC387906,2,0,2,0,1,1,0,0,1
SC387944,18,12,6,0,1,1,0,0,0
SC387959,4,0,4,0,1,1,0,0,1
SC388092,4,2,2,1,1,1,0,1,1
SC388110,17,11,6,0,0,0,0,0,1
SC388204,4,0,4,0,1,1,0,0,1
SC388407,4,0,4,0,0,0,0,0,1
SC388413,1,0,1,0,0,0,0,0,0
SC388762,2,2,0,0,2,2,0,0,0
00650164,25,3,22,0,1,1,0,1,1
00650363,18,0,18,0,1,1,0,1,1
00650386,3,3,0,0,0,0,0,0,0
00650598,14,0,14,0,0,0,0,0,1
00650900,6,3,3,0,2,2,0,0,1
00650937,22,7,15,0,1,1,0,1,1
00650979,27,6,21,0,0,0,0,0,1
00651198,20,3,17,0,1,1,0,1,1
00651376,58,3,55,0,0,0,0,0,1
00651422,34,8,26,0,2,1,1,2,1
00651587,5,0,5,0,0,0,0,0,0
00651692,33,6,27,0,1,1,0,1,1
00652819,37,5,32,0,1,1,0,1,1
00652955,16,0,16,0,0,0,0,0,1
00653171,24,5,19,0,0,0,0,0,1
00653323,32,0,32,0,1,1,0,1,1
00653331,45,6,39,0,1,1,0,1,1
00653366,22,3,19,0,1,1,0,1,1
00653423,11,0,11,0,0,0,0,0,1
00653500,19,4,15,0,1,1,0,1,1
00653663,27,6,21,0,0,0,0,0,1
00654053,6,0,6,0,0,0,0,0,1
00654131,29,5,24,0,1,1,0,1,1
00654265,31,3,28,0,0,0,0,0,1
00654302,8,3,5,0,2,2,0,0,1
00654564,28,2,26,0,1,1,0,1,1
00654622,41,4,37,0,2,2,0,0,1
00655044,22,2,20,0,1,1,0,1,1
00655156,4,3,1,0,2,2,0,0,0
00655436,25,2,23,0,1,1,0,1,1
00655647,24,3,21,0,1,1,0,1,0
00655990,6,3,3,0,1,1,0,0,0
00656393,13,6,7,0,1,1,0,1,1
00657176,27,0,27,0,1,1,0,1,1
00657359,13,0,13,0,0,0,0,0,0
00658133,31,5,26,0,1,1,0,1,1
00658155,24,4,20,0,1,1,0,1,1
00658166,40,3,37,0,1,1,0,1,1
00658368,36,3,33,0,0,0,0,0,1
00658433,4,0,4,0,1,1,0,0,0
00658516,13,0,13,0,0,0,0,0,1
00658819,13,4,9,0,1,1,0,1,0
00658826,15,0,15,0,0,0,0,0,1
00658907,43,4,39,0,1,1,0,1,1
00658997,3,3,0,0,2,2,0,0,1
00659028,10,7,3,0,1,1,0,1,1
00660541,17,2,15,0,1,1,0,1,1
00661133,31,3,28,0,1,1,0,1,1
00661742,23,0,23,0,0,0,0,0,1
00661747,13,4,9,0,1,1,0,1,1
00662127,5,2,3,0,2,2,0,0,0
00662195,7,4,3,0,2,2,0,0,0
00662374,58,11,47,0,0,0,0,0,1
00662696,11,2,9,0,1,1,0,1,1
00662712,87,14,73,0,0,0,0,0,1
00663029,28,0,28,0,0,0,0,0,1
00663227,13,0,13,0,0,0,0,0,1
00663372,42,0,42,0,0,0,0,0,1
00664118,33,11,22,0,0,0,0,0,1
00664261,8,4,4,0,1,1,0,0,0
00664466,8,6,2,0,1,1,0,0,1
00664578,22,4,18,0,0,0,0,0,1
00664602,15,3,12,0,0,0,0,0,0
00664611,33,4,29,0,1,1,0,1,1
00664749,33,13,20,0,0,0,0,0,0
00664862,32,6,26,0,1,1,0,1,1
00665102,41,6,35,0,0,0,0,0,1
00665434,12,3,9,0,1,1,0,1,1
00665667,13,1,12,0,0,0,0,0,1
00666457,7,5,2,0,5,4,1,0,0
00666652,13,3,10,0,1,1,0,1,1
00667002,8,4,4,0,2,2,0,0,1
00667041,3,2,1,0,1,1,0,0,0
00667817,57,14,43,0,0,0,0,0,1
00667980,38,6,32,0,1,1,0,1,1
00668238,20,4,16,0,2,2,0,2,1
00668339,41,0,41,0,0,0,0,0,1
00668388,20,2,18,0,1,1,0,1,1
00668972,21,3,18,0,1,1,0,1,1
00668982,4,2,2,0,1,1,0,0,0
00669613,46,11,35,0,0,0,0,0,0
00669986,13,2,11,0,1,1,0,1,1
00670130,40,6,34,0,1,1,0,1,1
00670251,76,3,73,0,1,1,0,1,1
00671099,18,8,10,0,0,0,0,0,1
00671321,36,0,36,0,1,1,0,1,1
00671778,4,2,2,0,3,3,0,0,0
00672059,30,4,26,0,0,0,0,0,0
00672085,14,10,4,0,0,0,0,0,1
00672275,13,4,9,0,1,1,0,1,1
00672435,14,3,11,0,0,0,0,0,1
00672569,47,7,40,0,0,0,0,0,1
00672696,6,3,3,0,1,1,0,0,0
00672908,27,5,22,0,1,1,0,1,1
00672930,9,4,5,0,1,1,0,0,1
00672988,15,0,15,0,0,0,0,0,0
00673274,28,0,28,0,0,0,0,0,1
00673557,7,3,4,0,1,1,0,1,0
00673822,13,5,8,0,1,1,0,0,1
00674597,11,3,8,0,1,1,0,1,1
00674678,29,4,25,0,1,1,0,1,1
00674686,5,2,3,0,1,1,0,0,1
00674709,33,0,33,0,1,1,0,1,1
00674872,7,4,3,0,1,1,0,0,0
00675001,27,4,23,0,1,1,0,1,1
00675195,19,7,12,0,1,1,0,1,1
00675211,16,3,13,0,1,1,0,1,1
00675355,19,3,16,0,1,1,0,1,1
00675386,27,0,27,0,0,0,0,0,1
00675586,26,6,20,0,0,0,0,0,0
00676121,20,3,17,0,1,1,0,1,1
00676139,64,2,62,0,1,1,0,1,1
00676207,3,2,1,0,2,2,0,0,0
00676373,5,3,2,0,1,0,1,0,1
00677457,35,6,29,0,0,0,0,0,0
00677665,58,8,50,0,1,1,0,1,1
00677799,37,4,33,0,0,0,0,0,1
00677971,35,3,32,0,1,1,0,1,1
00678077,50,13,37,0,0,0,0,0,1
00678294,35,4,31,0,1,1,0,1,1
00678565,37,10,27,0,0,0,0,0,1
00678777,35,5,30,0,1,1,0,1,1
00678786,24,0,24,0,0,0,0,0,1
00679647,23,5,18,0,1,1,0,1,1
00679749,36,0,36,0,0,0,0,0,1
00679960,96,9,87,0,0,0,0,0,1
00680313,27,3,24,0,1,1,0,1,1
00680345,5,4,1,0,2,2,0,0,0
00680907,29,0,29,0,0,0,0,0,1
00680973,10,3,7,0,1,1,0,1,1
00681231,20,4,16,0,1,1,0,1,1
00681534,12,3,9,0,1,1,0,1,1
00681535,10,3,7,0,1,1,0,1,1
00681537,25,7,18,0,1,1,0,1,1
00681880,77,15,62,0,0,0,0,0,1
00683275,63,12,51,0,0,0,0,0,1
00683359,31,13,18,0,0,0,0,0,1
00683361,21,5,16,0,1,1,0,1,1
00683698,20,3,17,0,1,1,0,1,1
00683702,36,5,31,0,1,1,0,1,1
00683947,34,0,34,0,0,0,0,0,1
00683948,21,0,21,0,0,0,0,0,1
00684145,8,4,4,0,1,1,0,0,0
00684800,43,4,39,0,2,2,0,2,1
00685558,25,4,21,0,1,1,0,1,1
00685718,34,5,29,0,1,1,0,1,1
00685732,8,3,5,0,1,1,0,1,0
00686707,47,8,39,0,0,0,0,0,1
00687121,8,3,5,0,4,1,3,1,0
00687995,23,0,23,0,0,0,0,0,1
00688041,23,3,20,0,1,1,0,1,1
00688587,20,14,6,0,1,1,0,1,1
00688602,16,0,16,0,0,0,0,0,1
00688773,10,2,8,0,1,1,0,1,1
00688832,18,5,13,0,0,0,0,0,1
00689260,35,6,29,0,1,1,0,1,1
00689388,8,0,8,0,1,1,0,1,1
00689578,10,0,10,0,0,0,0,0,1
00689729,53,6,47,0,1,1,0,1,1
00690089,21,3,18,0,2,2,0,2,1
00690236,32,4,28,0,1,1,0,1,1
00690838,5,2,3,0,2,2,0,0,0
00691252,57,4,53,0,1,1,0,1,1
00691259,5,3,2,0,2,2,0,0,0
00691499,12,3,9,0,1,1,0,1,1
00691599,8,3,5,0,2,2,0,0,0
00692380,19,0,19,0,0,0,0,0,1
00692660,7,3,4,0,2,2,0,0,0
00692780,9,3,6,0,1,1,0,0,1
00692978,6,2,4,0,1,1,0,0,1
00693119,12,2,10,1,0,0,0,0,0
00693374,18,5,13,0,4,0,4,0,1
00693662,5,4,1,0,2,2,0,0,0
00694642,6,4,2,0,0,0,0,0,0
00694736,16,4,12,0,1,1,0,1,1
00694894,13,3,10,0,1,1,0,0,0
00695530,46,0,46,0,0,0,0,0,1
00696057,28,2,26,0,1,1,0,1,1
00696578,5,4,1,0,1,1,0,0,0
00696612,15,3,12,0,3,1,2,1,1
00696919,35,0,35,0,0,0,0,0,1
00697109,9,3,6,0,1,1,0,1,1
00697311,4,2,2,0,1,1,0,0,0
00697348,37,7,30,0,0,0,0,0,0
00697555,7,4,3,0,2,2,0,0,1
00697641,28,10,18,0,1,1,0,1,1
00697738,29,0,29,0,0,0,0,0,1
00697744,48,0,48,0,0,0,0,0,1
00698174,29,0,29,0,0,0,0,0,1
00698840,17,5,12,0,1,1,0,1,1
00698851,74,9,65,0,0,0,0,0,1
00699314,23,4,19,0,1,1,0,1,1
00699316,20,0,20,0,0,0,0,0,1
00699324,8,4,4,0,1,1,0,0,1
00699334,7,4,3,0,1,1,0,0,1
00699547,122,14,108,0,0,0,0,0,1
00699601,38,4,34,0,0,0,0,0,1
00699663,21,3,18,0,1,1,0,1,1
00700132,76,9,67,0,0,0,0,0,1
00700184,34,3,31,0,0,0,0,0,1
00700188,41,6,35,0,1,1,0,1,1
00700758,13,2,11,0,1,1,0,1,1
00700925,15,3,12,0,1,1,0,1,1
00700950,8,4,4,0,1,1,0,0,1
00701279,34,0,34,0,0,0,0,0,1
00701756,9,2,7,0,1,1,0,1,1
00701841,39,0,39,0,0,0,0,0,1
00702484,57,9,48,0,0,0,0,0,1
00702539,6,4,2,0,2,2,0,0,0
00702844,25,0,25,0,0,0,0,0,1
00702983,48,7,41,0,0,0,0,0,1
00703021,14,5,9,0,3,3,0,0,0
00703170,59,18,41,0,0,0,0,0,1
00703317,72,8,64,0,1,1,0,1,1
00703348,15,2,13,0,1,1,0,1,0
00703741,45,0,45,0,0,0,0,0,1
00703883,19,0,19,0,0,0,0,0,1
00703962,20,5,15,0,0,0,0,0,1
00704320,50,8,42,0,1,1,0,1,1
00704322,32,2,30,0,1,1,0,1,1
00705101,26,4,22,0,1,1,0,1,1
00705211,10,2,8,0,1,1,0,1,1
00705341,4,0,4,0,0,0,0,0,1
00705357,108,12,96,0,0,0,0,0,1
00705424,6,3,3,0,1,1,0,0,0
00705627,10,5,5,0,4,4,0,0,1
00705760,8,0,8,0,2,2,0,0,0
00706042,29,10,19,0,1,1,0,1,1
00706083,31,5,26,0,2,1,1,2,1
00706295,19,4,15,0,2,2,0,2,0
00706445,15,8,7,0,1,1,0,0,1
00706607,17,4,13,0,1,1,0,1,1
00706645,62,7,55,0,1,1,0,1,1
00706704,22,3,19,0,0,0,0,0,1
00706831,47,7,40,0,1,1,0,1,1
00707069,14,0,14,0,0,0,0,0,1
00707180,57,14,43,0,0,0,0,0,1
00707300,53,6,47,0,0,0,0,0,1
00707312,34,9,25,0,0,0,0,0,1
00707708,26,4,22,0,0,0,0,0,1
00707749,33,3,30,0,0,0,0,0,1
00707869,11,5,6,0,0,0,0,0,1
00708968,13,4,9,0,1,1,0,1,1
00709093,26,5,21,0,1,1,0,1,1
00709159,49,14,35,0,0,0,0,0,1
00709915,17,5,12,0,1,1,0,1,1
00709961,20,4,16,0,1,1,0,1,1
00710004,7,2,5,0,4,4,0,0,1
00710112,40,3,37,0,3,2,1,0,1
00710157,9,3,6,0,2,1,1,2,1
00710582,38,3,35,0,0,0,0,0,1
00710603,30,3,27,0,2,1,1,2,0
00710860,26,3,23,0,1,1,0,1,1
00711047,25,3,22,0,1,1,0,1,1
00711835,28,2,26,0,1,1,0,1,1
00711851,43,5,38,0,1,1,0,1,1
00711914,4,4,0,0,3,3,0,0,0
00712006,20,2,18,0,0,0,0,0,1
00712260,116,11,105,0,8,0,8,0,1
00712286,43,6,37,0,2,1,1,0,1
00712425,34,7,27,0,0,0,0,0,0
00712444,60,12,48,0,0,0,0,0,1
00712789,0,0,0,0,0,0,0,0,0
00713188,6,1,5,0,1,1,0,0,1
00713225,25,2,23,0,1,1,0,1,1
00713226,34,5,29,0,1,1,0,1,1
00713227,20,3,17,0,1,1,0,1,1
00713317,16,0,16,0,0,0,0,0,1
00713374,16,0,16,0,0,0,0,0,1
00713414,11,4,7,0,1,1,0,1,1
00714070,161,3,158,0,1,1,0,1,1
00714804,31,4,27,0,1,1,0,1,1
00715189,33,2,31,0,3,1,2,3,1
00715338,30,0,30,0,0,0,0,0,1
00715599,22,5,17,0,0,0,0,0,1
00716004,14,3,11,0,1,1,0,1,1
00716035,68,10,58,0,0,0,0,0,1
00716105,11,3,8,0,3,3,0,1,1
00716304,34,5,29,0,1,1,0,1,1
00716615,35,11,24,0,0,0,0,0,0
00716839,27,0,27,0,0,0,0,0,1
00716923,15,5,10,0,1,1,0,1,1
00717344,13,4,9,0,1,1,0,1,1
00717446,41,3,38,0,4,1,3,1,1
00718074,16,4,12,0,0,0,0,0,0
00718149,29,3,26,0,1,1,0,1,1
00718151,40,7,33,0,1,1,0,1,1
00718329,23,3,20,0,1,1,0,1,1
00718351,19,3,16,0,1,1,0,1,1
00718623,10,6,4,0,0,0,0,0,1
00718772,18,4,14,0,1,1,0,1,1
00718823,31,9,22,0,0,0,0,0,0
00718903,41,3,38,0,1,1,0,1,1
00719501,18,2,16,0,1,1,0,1,1
00719504,130,16,114,0,0,0,0,0,1
00719804,40,3,37,0,1,1,0,1,1
00719885,75,11,64,0,0,0,0,0,1
00720249,20,0,20,0,1,1,0,0,1
00720550,31,4,27,0,1,1,0,1,1
00720669,18,5,13,0,1,1,0,1,1
00720918,31,3,28,0,1,1,0,1,1
00720976,27,5,22,0,1,1,0,1,0
00720989,11,3,8,0,1,1,0,1,1
00721107,22,0,22,0,0,0,0,0,1
00722043,41,3,38,0,1,1,0,1,1
00722071,98,0,98,0,0,0,0,0,1
00722466,16,5,11,0,1,1,0,1,1
00722626,8,4,4,0,3,3,0,1,0
00722836,19,0,19,0,0,0,0,0,1
00723084,13,9,4,0,1,1,0,1,1
00723154,6,4,2,0,2,2,0,0,0
00723336,25,5,20,0,1,1,0,1,1
00723627,8,4,4,0,3,3,0,0,1
00724030,15,3,12,0,3,2,1,0,1
00724133,111,11,100,0,0,0,0,0,1
00724451,24,5,19,0,2,1,1,2,1
00724689,27,0,27,0,1,1,0,1,1
00724728,54,5,49,0,1,1,0,1,0
00724811,60,15,45,0,1,0,1,0,1
00724907,18,8,10,0,1,1,0,0,0
00724999,5,2,3,0,1,1,0,0,0
00725052,15,0,15,0,0,0,0,0,1
00725238,32,8,24,0,0,0,0,0,0
00725548,23,2,21,0,1,1,0,1,1
00726022,0,0,0,0,0,0,0,0,1
00726677,15,4,11,0,3,3,0,0,0
00726897,12,3,9,0,1,1,0,1,1
00727476,18,7,11,0,0,0,0,0,1
00727600,10,0,10,0,0,0,0,0,1
00727817,38,4,34,0,1,1,0,1,1
00728246,33,2,31,0,1,1,0,1,1
00728391,26,11,15,0,0,0,0,0,1
00728502,61,9,52,0,1,1,0,1,1
00729279,12,4,8,0,1,1,0,1,1
00729751,23,0,23,0,0,0,0,0,1
00730144,13,0,13,0,0,0,0,0,1
00730286,23,3,20,0,1,1,0,1,1
00730446,38,5,33,0,0,0,0,0,0
00730466,55,0,55,0,0,0,0,0,1
00730467,37,0,37,0,0,0,0,0,1
00730536,81,11,70,0,1,1,0,0,1
00730539,5,3,2,0,5,5,0,0,1
00730711,19,2,17,0,0,0,0,0,0
00731132,92,16,76,0,0,0,0,0,1
00731249,19,6,13,0,0,0,0,0,0
00731549,15,4,11,0,1,0,1,0,1
00732250,23,3,20,0,1,1,0,0,1
00732588,3,3,0,0,2,2,0,0,0
00732602,44,6,38,0,1,1,0,1,1
00732757,33,3,30,0,0,0,0,0,1
00732993,34,5,29,0,1,1,0,1,1
00733377,8,7,1,0,0,0,0,0,0
00733387,16,0,16,0,0,0,0,0,1
00733425,21,5,16,0,0,0,0,0,1
00733443,17,4,13,0,1,1,0,1,1
00733498,23,4,19,0,1,1,0,1,1
00733503,64,5,59,0,1,1,0,1,1
00734015,23,1,22,0,0,0,0,0,0
00734351,0,0,0,0,0,0,0,0,0
00734396,32,4,28,0,2,2,0,2,1
00734421,43,9,34,0,2,1,1,2,1
00735040,85,12,73,0,0,0,0,0,1
00735270,22,0,22,0,0,0,0,0,1
00735760,3,3,0,0,1,1,0,0,0
00735868,37,5,32,0,1,1,0,1,1
00736475,0,0,0,0,0,0,0,0,0
00736698,26,0,26,0,1,1,0,1,1
00736905,13,4,9,0,1,1,0,1,1
00737328,7,3,4,0,2,2,0,0,1
00737366,49,5,44,0,1,1,0,1,1
00737501,16,3,13,0,0,0,0,0,0
00737993,106,2,104,0,0,0,0,0,1
00738089,64,11,53,0,0,0,0,0,1
00738358,0,0,0,0,0,0,0,0,0
00738473,20,4,16,0,1,1,0,1,1
00738674,45,3,42,0,0,0,0,0,1
00738693,86,13,73,0,15,13,2,0,1
00739057,6,1,5,0,2,1,1,1,1
00739136,8,6,2,0,1,1,0,0,0
00739180,34,3,31,0,1,1,0,1,1
00739476,8,3,5,0,2,2,0,0,1
02274227,31,10,21,0,1,1,0,1,1
02274693,13,4,9,0,1,1,0,1,1
02274855,123,6,117,0,3,3,0,0,1
02274887,19,3,16,0,1,1,0,1,1
02274964,52,0,52,0,1,1,0,0,1
02275006,31,2,29,0,1,1,0,1,1
02275144,32,9,23,0,0,0,0,0,0
02275265,27,5,22,0,1,1,0,1,1
02275441,21,4,17,0,1,1,0,0,1
02275676,79,9,70,0,1,1,0,0,0
02275780,45,2,43,0,4,2,2,0,1
02276208,90,9,81,0,0,0,0,0,0
02276358,27,3,24,0,2,2,0,2,1
02276597,12,0,12,0,0,0,0,0,1
02276707,13,0,13,0,1,1,0,1,1
02276727,24,1,23,0,2,2,0,0,1
02276839,14,2,12,0,1,1,0,1,1
02276950,10,0,10,0,0,0,0,0,1
02277006,62,10,52,0,0,0,0,0,1
02277097,19,4,15,0,1,1,0,1,1
02277210,21,5,16,0,1,1,0,0,1
02277333,18,3,15,0,1,1,0,1,1
02277689,6,5,1,0,1,1,0,0,0
02277771,31,0,31,0,0,0,0,0,1
02278164,4,3,1,0,2,2,0,0,1
02278223,44,13,31,0,0,0,0,0,0
02278272,17,3,14,0,0,0,0,0,1
02278524,10,5,5,0,0,0,0,0,1
02278852,24,1,23,0,2,1,1,1,1
02278988,6,2,4,0,0,0,0,0,0
02279167,41,4,37,0,1,1,0,1,1
02279557,19,5,14,0,0,0,0,0,1
02279591,79,3,76,0,1,1,0,1,1
02279606,3,3,0,0,2,2,0,0,0
02280000,57,8,49,0,2,2,0,2,1
02280025,83,7,76,0,0,0,0,0,1
02280277,58,13,45,0,0,0,0,0,1
02280541,8,0,8,0,0,0,0,0,1
02280630,8,2,6,0,2,1,1,1,1
02280743,16,3,13,0,1,1,0,1,1
02280893,114,14,100,0,0,0,0,0,1
02280991,46,13,33,0,0,0,0,0,1
02281402,12,3,9,0,1,1,0,1,1
02281640,24,7,17,0,0,0,0,0,1
02282021,38,4,34,0,1,1,0,1,1
02282283,9,0,9,0,0,0,0,0,1
02282693,25,3,22,0,1,1,0,1,1
02282965,12,0,12,0,0,0,0,0,1
02283200,2,2,0,0,2,2,0,0,0
02283381,24,2,22,0,1,1,0,1,1
02283418,36,4,32,0,1,1,0,1,1
02283443,20,0,20,0,1,1,0,1,1
02283668,23,2,21,0,1,1,0,1,1
02283697,22,3,19,0,1,1,0,1,1
02283837,5,0,5,0,0,0,0,0,1
02283985,24,4,20,0,0,0,0,0,1
02284019,19,3,16,0,2,2,0,2,1
02284215,28,0,28,0,0,0,0,0,1
02284295,33,5,28,0,0,0,0,0,1
02284303,22,3,19,0,1,1,0,1,1
02284339,29,0,29,0,0,0,0,0,1
02284499,136,0,136,0,1,1,0,1,1
02285121,30,4,26,0,0,0,0,0,1
02285497,29,5,24,0,1,1,0,1,1
02285524,30,4,26,0,1,1,0,1,1
02285556,17,4,13,0,1,1,0,1,1
02285847,31,4,27,0,1,1,0,0,1
02285865,11,5,6,0,1,1,0,0,0
02286034,41,7,34,0,0,0,0,0,1
02286149,22,3,19,0,1,1,0,1,1
02286167,16,10,6,0,0,0,0,0,0
02286338,26,0,26,0,0,0,0,0,1
02287319,9,2,7,0,4,3,1,1,0
02287654,28,0,28,0,0,0,0,0,1
02287862,35,3,32,0,1,1,0,1,1
02288093,52,7,45,0,0,0,0,0,1
02288118,7,0,7,0,0,0,0,0,0
02288142,23,4,19,0,0,0,0,0,1
02288239,78,9,69,0,1,1,0,0,1
02288330,24,4,20,0,0,0,0,0,1
02288607,61,14,47,0,4,2,2,0,1
02289176,17,5,12,0,1,1,0,1,1
02289261,23,2,21,0,2,1,1,0,0
02289507,23,3,20,0,0,0,0,0,1
02289932,12,4,8,0,3,3,0,0,0
02290200,39,10,29,0,1,1,0,0,1
02290281,12,0,12,0,1,1,0,0,1
02290400,26,0,26,0,0,0,0,0,1
02290487,34,0,34,0,0,0,0,0,1
02290692,14,5,9,0,0,0,0,0,1
02290856,44,2,42,0,1,1,0,1,1
02291198,38,4,34,0,1,1,0,1,1
02291641,46,0,46,0,0,0,0,0,1
02291753,69,4,65,0,1,1,0,1,1
02291970,12,5,7,0,1,1,0,1,1
02292048,10,3,7,0,1,1,0,1,1
02292440,0,0,0,0,0,0,0,0,1
02292795,41,4,37,0,0,0,0,0,1
02293123,27,0,27,0,0,0,0,0,0
02293376,3,0,3,0,0,0,0,0,0
02293764,19,3,16,0,2,2,0,0,1
02293962,18,3,15,0,1,1,0,1,0
02294089,40,11,29,0,0,0,0,0,1
02294562,25,4,21,0,0,0,0,0,1
02294747,94,14,80,0,1,1,0,1,1
02294777,8,4,4,0,0,0,0,0,1
02294905,16,2,14,0,1,1,0,1,1
02294926,16,4,12,0,0,0,0,0,1
02294980,42,5,37,0,1,0,1,1,1
02295119,50,4,46,0,1,1,0,1,0
02295226,17,5,12,0,0,0,0,0,1
02295416,13,3,10,0,1,1,0,0,1
02295801,10,2,8,0,1,1,0,1,1
02295886,16,5,11,0,3,2,1,0,1
02295890,12,2,10,0,2,1,1,2,1
02295965,22,5,17,0,2,1,1,0,0
02296071,10,3,7,0,1,1,0,1,1
02296144,40,0,40,0,0,0,0,0,1
02296250,42,9,33,0,0,0,0,0,1
02296329,42,7,35,0,0,0,0,0,1
02296476,23,10,13,0,1,1,0,1,1
02296559,24,5,19,0,2,2,0,0,1
02296645,28,6,22,0,1,1,0,1,1
02297269,14,0,14,0,0,0,0,0,1
02297679,8,0,8,0,0,0,0,0,1
02298021,25,0,25,0,1,1,0,1,1
02298197,13,5,8,0,1,1,0,0,1
02298338,6,0,6,0,0,0,0,0,1
02298749,3,0,3,0,0,0,0,0,1
02299189,25,5,20,0,6,6,0,0,1
02299428,50,3,47,0,1,1,0,1,0
02299747,52,7,45,0,1,1,0,1,1
02299788,22,0,22,0,0,0,0,0,1
02299800,14,4,10,0,0,0,0,0,0
02299975,25,0,25,0,0,0,0,0,1
02300182,15,2,13,0,0,0,0,0,1
02300516,26,0,26,0,0,0,0,0,1
02300676,28,0,28,0,0,0,0,0,1
02300692,48,3,45,0,1,1,0,1,1
02300741,41,0,41,0,0,0,0,0,1
02300862,40,5,35,0,1,0,1,1,1
02300985,15,2,13,0,1,1,0,1,1
02301272,30,3,27,0,2,1,1,2,1
02301292,11,3,8,0,2,1,1,1,1
02301423,30,6,24,0,1,1,0,1,1
02301452,83,10,73,0,1,0,1,0,1
02301779,20,3,17,0,2,2,0,2,1
02301810,42,10,32,0,1,1,0,1,1
02302373,55,15,40,0,0,0,0,0,1
02303094,12,6,6,0,1,1,0,1,1
02303103,12,3,9,0,1,1,0,1,1
02303173,21,1,20,0,1,1,0,1,1
02303464,63,9,54,0,3,2,1,0,1
02303579,1,0,1,0,0,0,0,0,1
02303656,12,5,7,0,2,1,1,2,1
02303666,29,4,25,0,2,1,1,2,1
02303980,3,3,0,0,2,2,0,0,1
02304039,21,0,21,0,0,0,0,0,1
02304195,31,8,23,0,0,0,0,0,1
02304198,34,0,34,0,0,0,0,0,1
02304253,23,6,17,0,0,0,0,0,1
02304681,6,3,3,0,1,1,0,0,1
02304755,39,7,32,0,1,1,0,1,1
02304992,57,4,53,0,3,1,2,3,1
02305096,31,4,27,0,0,0,0,0,1
02305098,22,0,22,0,0,0,0,0,1
02305249,5,3,2,0,2,2,0,0,0
02306113,49,6,43,0,1,1,0,1,1
02306349,25,0,25,0,0,0,0,0,1
02306732,21,0,21,0,0,0,0,0,1
02306906,32,5,27,0,2,2,0,2,1
02306954,7,3,4,0,1,1,0,0,0
02307096,30,3,27,0,2,2,0,2,1
02307211,31,4,27,0,1,1,0,1,1
02307220,20,4,16,0,1,1,0,1,1
02307296,11,3,8,0,1,1,0,0,1
02307319,7,3,4,0,0,0,0,0,0
02307330,53,14,39,0,0,0,0,0,1
02307341,8,3,5,0,2,1,1,1,1
02307374,50,5,45,0,1,1,0,1,1
02307455,21,3,18,0,1,1,0,1,1
02307505,3,3,0,0,1,1,0,0,0
02307571,19,3,16,0,0,0,0,0,1
02308101,54,13,41,0,1,1,0,0,1
02308265,52,0,52,0,0,0,0,0,1
02308269,27,6,21,0,0,0,0,0,1
02308463,29,5,24,0,0,0,0,0,1
02309360,39,4,35,0,0,0,0,0,1
02309374,11,3,8,0,2,2,0,0,1
02309407,15,5,10,0,1,1,0,1,1
02310557,23,3,20,0,0,0,0,0,0
02310560,68,0,68,0,0,0,0,0,1
02310571,27,5,22,0,1,1,0,1,1
02310614,18,4,14,0,1,1,0,1,1
02310981,33,4,29,0,1,1,0,1,1
02311359,13,1,12,0,3,3,0,3,0
02311588,26,1,25,0,1,1,0,1,1
02311621,10,3,7,0,1,1,0,1,1
02311721,22,3,19,0,1,1,0,1,1
02311781,11,0,11,0,0,0,0,0,1
02311843,11,4,7,0,1,1,0,1,1
02311977,19,5,14,0,1,1,0,1,1
02312079,255,9,246,0,1,1,0,1,1
02312304,7,3,4,0,0,0,0,0,0
02312426,66,0,66,0,0,0,0,0,1
02312569,37,10,27,0,1,1,0,0,1
02313902,33,7,26,0,0,0,0,0,1
02314002,4,2,2,0,0,0,0,0,0
02314119,12,1,11,0,1,0,1,0,0
02314294,17,7,10,0,1,1,0,0,1
02314735,32,13,19,0,0,0,0,0,1
02314890,12,8,4,0,4,1,3,1,1
02315596,24,5,19,0,1,1,0,1,1
02316122,8,0,8,0,0,0,0,0,1
02316129,13,1,12,0,1,1,0,0,1
02316298,21,4,17,0,1,1,0,1,0
02316301,35,9,26,0,1,1,0,1,1
02316369,5,2,3,0,3,2,1,0,0
02316630,91,0,91,0,0,0,0,0,1
02316653,25,8,17,0,1,1,0,1,1
02316671,23,0,23,0,0,0,0,0,1
02316966,3,1,2,0,1,1,0,0,1
02316967,26,3,23,0,1,1,0,1,1
02317133,52,6,46,0,1,1,0,1,1
02317277,13,0,13,0,1,1,0,0,1
02317280,24,0,24,0,0,0,0,0,1
02317362,33,12,21,0,0,0,0,0,0
02317609,17,4,13,0,1,1,0,1,1
02317814,68,0,68,0,0,0,0,0,1
02318099,11,6,5,0,4,3,1,0,1
02318644,4,3,1,0,1,1,0,1,0
02318754,36,5,31,0,1,1,0,1,0
02318796,11,0,11,0,1,1,0,1,1
02318863,0,0,0,0,0,0,0,0,1
02318923,152,43,109,0,1,1,0,1,1
02318925,147,38,109,0,1,1,0,1,1
02319026,8,3,5,0,2,2,0,0,1
02319124,24,1,23,0,1,1,0,0,0
02319160,29,0,29,0,0,0,0,0,1
02319269,96,8,88,0,0,0,0,0,1
02319478,58,10,48,0,0,0,0,0,1
02319732,6,0,6,0,0,0,0,0,1
02319743,27,5,22,0,0,0,0,0,0
02319746,6,2,4,0,0,0,0,0,0
02320279,11,6,5,0,0,0,0,0,1
02320388,0,0,0,0,0,0,0,0,0
02320508,26,0,26,0,0,0,0,0,1
02320538,29,7,22,0,0,0,0,0,1
02320966,21,3,18,0,1,1,0,1,1
02321168,56,0,56,0,0,0,0,0,1
02321201,4,0,4,0,0,0,0,0,1
02321294,11,7,4,0,1,1,0,0,1
02321360,10,0,10,0,0,0,0,0,1
02321562,18,5,13,0,2,2,0,0,1
02321767,4,2,2,0,1,1,0,0,1
02321802,73,9,64,0,1,1,0,1,1
02321868,34,2,32,0,1,1,0,1,1
02321871,16,3,13,0,0,0,0,0,0
02322069,17,6,11,0,1,1,0,1,1
02322202,36,2,34,0,1,1,0,1,1
02322502,15,0,15,0,0,0,0,0,1
02322741,26,3,23,0,1,1,0,1,1
02322764,6,3,3,0,1,1,0,0,1
02322852,51,6,45,0,7,0,7,0,1
02322918,15,6,9,0,1,1,0,1,1
02322945,33,0,33,0,0,0,0,0,1
02323141,91,10,81,0,2,2,0,0,0
02323258,6,1,5,0,1,1,0,0,1
02323420,33,2,31,0,2,2,0,0,1
02323516,12,1,11,0,4,2,2,1,1
02323529,45,6,39,0,1,1,0,1,1
02323582,6,1,5,0,1,1,0,1,1
02323723,10,3,7,0,2,1,1,0,1
02324094,45,3,42,0,1,1,0,1,1
02324172,147,8,139,0,0,0,0,0,1
02324219,43,6,37,0,1,1,0,0,1
02324596,11,2,9,0,1,1,0,0,1
02324637,32,0,32,0,0,0,0,0,1
02324663,12,1,11,0,0,0,0,0,0
02324869,116,12,104,0,0,0,0,0,1
02324965,6,0,6,0,0,0,0,0,1
02325092,67,22,45,0,0,0,0,0,1
02325171,24,3,21,0,0,0,0,0,1
02325314,13,4,9,0,2,1,1,0,1
02325437,31,5,26,0,0,0,0,0,1
02325778,15,4,11,0,2,2,0,0,1
02325831,32,6,26,0,2,1,1,0,1
02325905,52,13,39,0,0,0,0,0,1
02325911,28,0,28,0,1,1,0,1,1
02325912,36,3,33,0,1,1,0,1,1
06770317,2,1,1,0,1,1,0,0,0
06770414,12,2,10,0,0,0,0,0,1
06770434,13,0,13,0,0,0,0,0,0
06770500,3,0,3,0,0,0,0,0,0
06770671,10,7,3,0,1,1,0,1,1
06771027,19,12,7,0,1,1,0,0,1
06771358,1,1,0,0,1,1,0,1,0
06771724,4,2,2,0,1,1,0,0,1
06771928,24,8,16,0,0,0,0,0,1
06771937,30,8,22,0,0,0,0,0,0
06771957,3,0,3,0,0,0,0,0,0
06771999,6,2,4,0,1,1,0,1,1
06772181,33,3,30,0,3,3,0,1,1
06772190,5,3,2,0,1,1,0,0,1
06772474,16,8,8,0,2,1,1,1,1
06772821,2,2,0,0,2,2,0,0,0
06773137,2,0,2,0,1,1,0,0,1
06773328,12,0,12,0,0,0,0,0,1
06773430,2,2,0,0,1,1,0,1,1
06773501,7,3,4,0,2,2,0,2,1
06773610,24,3,21,0,1,1,0,1,1
06773809,4,3,1,0,1,1,0,1,1
06773901,3,3,0,0,2,2,0,0,0
06774011,5,3,2,0,1,1,0,0,0
06774645,5,3,2,0,2,2,0,0,1
06774879,5,3,2,0,0,0,0,0,0
06775291,2,2,0,0,1,1,0,1,0
06775402,28,9,19,0,1,0,1,0,1
06775606,18,5,13,0,1,1,0,1,1
06775727,15,4,11,0,1,1,0,1,1
06775730,5,3,2,0,3,3,0,0,1
06776194,8,6,2,0,1,1,0,1,0
06776539,15,0,15,0,0,0,0,0,1
06776599,3,1,2,0,1,1,0,0,1
06776769,13,0,13,0,1,1,0,1,1
06776830,10,5,5,0,0,0,0,0,0
06776868,18,7,11,0,0,0,0,0,0
06777231,1,1,0,0,1,1,0,0,0
06777364,6,2,4,0,1,1,0,1,1
06777542,2,2,0,0,1,1,0,0,0
06777559,7,5,2,0,2,2,0,0,1
06777594,5,2,3,0,1,1,0,0,1
06777602,7,5,2,0,2,2,0,0,1
06777631,4,1,3,0,1,0,1,0,1
06777781,11,2,9,0,2,2,0,2,1
06777793,9,4,5,0,2,2,0,0,1
06777870,3,0,3,0,0,0,0,0,1
06777998,2,1,1,0,1,1,0,0,0
06778021,15,3,12,0,1,1,0,1,1
06778100,3,3,0,0,4,4,0,0,0
06778194,16,7,9,0,3,0,3,1,1
06778682,3,2,1,0,0,0,0,0,1
06778903,2,0,2,0,2,2,0,0,1
06778905,16,7,9,0,3,2,1,2,1
06779116,20,10,10,0,0,0,0,0,0
06779241,37,11,26,0,0,0,0,0,1
06779873,20,6,14,0,0,0,0,0,0
06780105,10,3,7,1,4,1,3,2,0
06780161,42,9,33,0,3,1,2,2,0
06780221,6,3,3,0,1,1,0,1,1
06780612,8,5,3,0,0,0,0,0,1
06780661,5,5,0,0,3,1,2,1,1
06781106,24,7,17,0,2,1,1,0,1
06781349,5,0,5,0,0,0,0,0,1
06781654,5,3,2,0,2,2,0,0,0
06782365,4,2,2,0,1,1,0,1,1
06782761,3,2,1,0,2,2,0,0,0
06782784,3,0,3,0,0,0,0,0,1
06783085,3,1,2,0,1,1,0,0,1
06783496,20,7,13,0,0,0,0,0,1
06783983,4,0,4,0,1,1,0,0,0
06784185,14,5,9,0,0,0,0,0,0
06784389,16,2,14,0,1,1,0,1,1
06784541,28,9,19,0,0,0,0,0,0
06784688,6,0,6,0,0,0,0,0,0
06784875,10,3,7,0,0,0,0,0,1
06784998,6,0,6,0,0,0,0,0,0
06785041,25,8,17,0,0,0,0,0,1
06785156,4,0,4,0,0,0,0,0,1
06785189,10,0,10,0,0,0,0,0,1
06785444,10,2,8,0,1,1,0,1,1
06785641,6,2,4,0,2,2,0,0,0
06785724,21,5,16,0,1,1,0,0,0
06786364,3,2,1,0,1,1,0,1,1
06786408,4,3,1,0,2,2,0,0,1
06786448,23,6,17,0,2,1,1,0,0
06786487,5,1,4,0,2,2,0,0,1
06786519,20,6,14,0,1,1,0,1,1
06786615,8,5,3,0,0,0,0,0,1
06786693,5,2,3,0,1,1,0,0,0
06786755,3,3,0,0,1,1,0,0,1
06786915,8,2,6,0,5,3,2,2,1
06787075,13,6,7,0,0,0,0,0,1
06787169,3,1,2,0,0,0,0,0,1
06787594,4,1,3,0,3,2,1,1,1
06787696,3,2,1,0,2,2,0,0,0
06787725,8,0,8,0,0,0,0,0,1
06787740,2,1,1,0,2,1,1,0,0
06787805,4,3,1,0,2,1,1,2,1
06788061,5,4,1,0,2,2,0,0,1
06788282,20,12,8,0,3,3,0,0,0
06788898,8,0,8,0,0,0,0,0,1
06788902,4,3,1,0,1,1,0,1,1
06788904,8,0,8,0,0,0,0,0,1
06788932,20,6,14,0,1,1,0,1,1
06788950,4,0,4,0,0,0,0,0,1
06788955,8,0,8,0,0,0,0,0,1
06788964,7,0,7,0,0,0,0,0,1
06788988,4,3,1,0,2,1,1,2,1
06788991,4,0,4,0,0,0,0,0,1
06789173,3,3,0,0,1,1,0,0,0
06789187,13,4,9,0,0,0,0,0,1
06789204,5,3,2,0,0,0,0,0,1
06789548,5,3,2,0,1,1,0,0,1
06789606,17,4,13,0,2,2,0,2,1
06789783,66,21,45,0,1,1,0,0,1
06790494,5,1,4,0,0,0,0,0,0
06790590,4,1,3,0,1,1,0,0,1
06790610,6,0,6,0,0,0,0,0,1
06790623,24,13,11,0,0,0,0,0,0
06790964,7,3,4,0,1,1,0,1,0
06791375,3,2,1,0,1,1,0,0,1
06791610,8,3,5,0,1,1,0,1,1
06791654,3,2,1,0,1,1,0,0,1
06791684,2,2,0,0,2,2,0,0,0
06791883,1,0,1,0,0,0,0,0,0
06791916,8,3,5,0,3,3,0,0,1
06791987,5,3,2,0,0,0,0,0,1
06792129,6,4,2,0,1,1,0,0,1
06792165,10,5,5,0,3,3,0,0,0
06792261,2,0,2,0,0,0,0,0,1
06792370,4,1,3,0,1,1,0,0,1
06792516,4,3,1,0,2,2,0,0,0
06792572,14,4,10,0,0,0,0,0,0
06792800,12,7,5,0,8,6,2,0,0
06792959,23,3,20,0,1,1,0,1,1
06793030,3,3,0,0,1,1,0,0,0
06793041,6,0,6,0,0,0,0,0,1
06793262,9,3,6,0,0,0,0,0,1
06793272,9,3,6,0,0,0,0,0,1
06793290,9,3,6,0,0,0,0,0,1
06793302,9,3,6,0,0,0,0,0,1
06793328,9,3,6,0,0,0,0,0,1
06793345,9,3,6,0,0,0,0,0,1
06793351,9,3,6,0,0,0,0,0,1
06793354,9,3,6,0,0,0,0,0,1
06793355,9,3,6,0,0,0,0,0,1
06793356,9,2,7,0,0,0,0,0,1
06793664,5,2,3,0,2,2,0,0,0
06793737,3,1,2,0,1,1,0,0,1
06793762,1,1,0,0,1,1,0,0,1
06793764,2,1,1,0,1,1,0,0,1
06793812,2,1,1,0,2,1,1,0,1
06793873,12,0,12,0,0,0,0,0,1
06793948,7,2,5,0,3,2,1,0,1
06794152,4,2,2,0,1,1,0,0,1
06794157,6,3,3,0,1,1,0,0,1
06794259,9,0,9,0,0,0,0,0,1
06794260,4,0,4,0,0,0,0,0,1
06794616,1,1,0,0,2,2,0,0,1
06794689,22,12,10,0,0,0,0,0,1
06794772,5,3,2,0,2,2,0,0,1
06794775,4,2,2,0,1,1,0,0,1
06794827,7,4,3,0,1,1,0,1,1
06795079,6,3,3,0,3,2,1,0,1
06795359,11,3,8,0,1,1,0,1,1
06795362,7,4,3,0,1,1,0,1,1
06795591,3,3,0,0,1,1,0,0,0
06796070,8,3,5,0,0,0,0,0,0
06796506,7,4,3,0,3,3,0,0,1
06796578,5,3,2,0,2,2,0,0,1
06796765,2,1,1,0,1,1,0,0,0
06797099,10,3,7,0,2,1,1,1,1
06797110,2,0,2,0,0,0,0,0,1
06797277,8,2,6,1,0,0,0,0,0
06797328,21,9,12,0,1,1,0,1,1
06797626,2,1,1,0,2,2,0,0,0
06797731,8,0,8,0,1,1,0,1,1
06797867,4,0,4,0,1,1,0,0,1
06798047,22,17,5,0,1,1,0,0,1
06798106,42,16,26,0,0,0,0,0,1
06798131,3,0,3,0,0,0,0,0,0
06799198,2,1,1,0,1,1,0,0,0
06799879,3,3,0,0,1,1,0,1,1
06799889,3,1,2,0,0,0,0,0,0
06800042,6,2,4,0,1,1,0,0,1
06800071,19,6,13,0,1,1,0,0,1
06800081,3,0,3,0,0,0,0,0,0
06800120,4,3,1,0,1,1,0,1,1
06800145,4,3,1,0,2,2,0,0,1
06800363,2,2,0,0,1,1,0,0,0
06800561,9,4,5,0,1,1,0,1,1
06800671,3,0,3,0,0,0,0,0,1
06800796,6,2,4,0,0,0,0,0,1
06800865,7,2,5,0,1,1,0,0,1
06800879,10,4,6,0,2,1,1,0,1
06801079,29,9,20,0,0,0,0,0,0
06801717,10,3,7,0,1,1,0,1,1
06801953,24,15,9,0,1,1,0,1,1
06802173,20,14,6,0,0,0,0,0,0
06802252,10,2,8,0,1,1,0,1,1
06802357,6,3,3,0,1,1,0,1,1
06802755,4,3,1,0,1,1,0,0,0
06802981,5,0,5,0,2,2,0,2,1
06803069,8,4,4,0,1,1,0,0,1
06803084,9,0,9,1,1,1,0,0,1
06803094,5,0,5,0,0,0,0,0,1
06803262,13,5,8,0,0,0,0,0,0
06803572,7,2,5,0,1,1,0,0,1
06803586,3,3,0,0,1,1,0,0,0
06804184,3,0,3,0,0,0,0,0,1
06804186,5,0,5,0,0,0,0,0,0
06804197,8,6,2,0,1,1,0,1,1
06804204,3,1,2,0,1,1,0,0,1
06804208,11,5,6,0,1,1,0,0,1
06804340,17,6,11,0,2,2,0,1,1
06804599,9,0,9,0,0,0,0,0,1
06804606,2,2,0,0,0,0,0,0,0
06805012,8,7,1,0,0,0,0,0,0
06805456,4,1,3,0,2,2,0,0,0
06805467,8,0,8,0,0,0,0,0,1
06806086,2,0,2,0,1,1,0,0,1
06806112,1,1,0,0,1,1,0,0,0
06806153,6,5,1,0,1,1,0,1,1
06806352,1,1,0,0,1,1,0,0,0
06806728,5,4,1,0,1,0,1,1,1
06806764,1,1,0,0,1,1,0,0,0
06807552,15,3,12,0,1,1,0,1,0
06807597,2,2,0,0,1,1,0,0,1
06808056,4,2,2,0,1,1,0,0,0
06808473,2,2,0,0,1,1,0,0,0
06808641,5,2,3,0,1,1,0,0,0
06808830,7,7,0,0,1,1,0,0,0
06808967,2,0,2,0,1,1,0,0,0
06809700,10,5,5,0,0,0,0,0,0
06809858,8,1,7,0,1,1,0,1,0
06810311,11,0,11,0,0,0,0,0,1
06810585,19,6,13,0,1,1,0,1,1
06810857,7,5,2,0,1,1,0,1,1
06811082,5,0,5,0,2,2,0,0,1
06811491,3,2,1,0,1,1,0,0,1
06811566,24,4,20,0,1,1,0,1,1
06811936,7,3,4,0,4,2,2,0,0
06811987,57,10,47,0,1,1,0,1,1
06811996,0,0,0,0,0,0,0,0,1
06812880,9,0,9,0,0,0,0,0,1
06813003,2,0,2,0,0,0,0,0,1
06813155,2,0,2,0,0,0,0,0,1
06813192,6,0,6,0,0,0,0,0,1
06813694,16,7,9,0,1,1,0,0,1
06813950,6,0,6,0,0,0,0,0,1
06814035,6,3,3,0,3,2,1,2,0
06814180,16,4,12,0,1,1,0,1,1
06814236,5,0,5,0,0,0,0,0,1
06814453,13,0,13,0,0,0,0,0,1
06815140,3,0,3,0,1,1,0,0,0
06815492,9,0,9,0,0,0,0,0,1
06815606,7,6,1,0,0,0,0,0,1
06816516,3,2,1,0,2,2,0,0,0
06816766,6,0,6,0,0,0,0,0,1
06817150,4,3,1,0,2,2,0,0,1
06817422,11,4,7,0,2,2,0,2,1
06817424,23,6,17,0,0,0,0,0,0
06817868,32,14,18,0,0,0,0,0,1
06817960,22,8,14,0,0,0,0,0,0
06818165,4,1,3,0,0,0,0,0,0
06818415,11,3,8,0,1,1,0,1,1
06818428,11,3,8,0,1,1,0,1,1
06818458,14,4,10,0,1,1,0,1,1
06818468,17,5,12,0,0,0,0,0,1
06818742,19,1,18,0,1,1,0,0,1
06818756,11,4,7,0,1,1,0,1,1
06818774,8,4,4,0,3,3,0,0,1
06818920,9,7,2,0,1,0,1,0,1
06819033,7,4,3,0,0,0,0,0,0
06819200,1,1,0,0,1,1,0,0,0
06819250,8,7,1,0,2,2,0,2,1
06819358,2,0,2,0,0,0,0,0,0
06819643,9,1,8,0,1,1,0,0,1
06819722,12,0,12,0,1,1,0,1,1
06819800,16,7,9,0,0,0,0,0,1
05286311,4,2,2,0,2,2,0,0,1
05286403,17,3,14,0,1,1,0,1,1
05286434,3,2,1,0,1,1,0,0,0
05286556,16,4,12,0,0,0,0,0,0
05286591,10,0,10,0,0,0,0,0,1
05286763,4,0,4,0,1,1,0,0,1
05287142,17,7,10,0,0,0,0,0,1
05287366,5,3,2,0,0,0,0,0,0
05287515,17,8,9,0,0,0,0,0,0
05287573,17,4,13,0,5,3,2,0,1
05287710,3,3,0,0,2,2,0,0,0
05288067,29,7,22,0,0,0,0,0,0
05288206,10,0,10,0,0,0,0,0,1
05288364,5,3,2,0,1,1,0,0,1
05288575,11,0,11,0,0,0,0,0,1
05288643,12,6,6,0,0,0,0,0,1
05288808,8,2,6,0,0,0,0,0,1
05288826,19,4,15,0,2,2,0,2,1
05288828,29,14,15,0,0,0,0,0,1
05289086,27,10,17,0,2,1,1,0,1
05289321,14,5,9,0,0,0,0,0,1
05289600,4,0,4,0,0,0,0,0,1
05289636,23,3,20,0,1,1,0,1,1
05289640,14,3,11,0,0,0,0,0,1
05289692,10,0,10,0,1,1,0,0,1
05290088,33,4,29,0,0,0,0,0,0
05290247,29,2,27,0,0,0,0,0,1
05290277,26,7,19,0,0,0,0,0,0
05290700,4,2,2,0,1,1,0,0,1
05290808,5,2,3,0,1,1,0,0,1
05291078,13,2,11,0,1,1,0,0,1
05291229,25,2,23,0,1,1,0,1,1
05291386,3,2,1,0,1,1,0,1,0
05291473,21,11,10,0,2,1,1,0,1
05291619,7,3,4,0,1,1,0,0,1
05291959,4,2,2,0,2,2,0,0,0
05292091,5,3,2,0,3,3,0,0,0
05292114,7,0,7,0,0,0,0,0,1
05292122,6,0,6,0,1,1,0,0,1
05292578,5,0,5,0,0,0,0,0,1
05292627,24,9,15,0,0,0,0,0,0
05293109,5,2,3,0,1,1,0,0,1
05293119,4,0,4,0,1,1,0,0,0
05293766,5,1,4,0,1,1,0,0,1
05293864,18,0,18,0,0,0,0,0,1
05293989,6,4,2,0,3,3,0,0,1
05294193,10,2,8,0,0,0,0,0,1
05294243,31,7,24,0,1,1,0,1,1
05294258,12,4,8,0,4,4,0,0,1
05294321,41,9,32,0,1,0,1,0,1
05294329,23,0,23,0,1,1,0,1,1
05294367,2,2,0,0,1,1,0,0,0
05294526,18,5,13,0,1,1,0,1,1
05294630,6,4,2,0,0,0,0,0,0
05294632,26,4,22,0,1,1,0,1,1
05294760,7,3,4,0,1,1,0,0,1
05294910,6,3,3,0,1,1,0,1,1
05295689,5,2,3,0,1,1,0,0,0
05295692,5,1,4,0,2,2,0,0,0
05297541,7,2,5,0,1,1,0,0,0
05297650,15,3,12,0,2,2,0,0,0
05297675,9,4,5,0,0,0,0,0,1
05298074,15,0,15,0,0,0,0,0,1
05298090,35,6,29,0,1,1,0,0,0
05298094,6,2,4,0,1,1,0,1,1
05298102,2,2,0,0,1,1,0,0,0
05298702,5,3,2,0,1,1,0,0,0
05298959,15,3,12,0,0,0,0,0,0
05299017,15,0,15,0,0,0,0,0,1
05299058,18,3,15,0,1,1,0,1,1
05299331,5,2,3,0,1,1,0,1,1
05299349,4,2,2,0,1,1,0,0,1
05300020,13,6,7,0,0,0,0,0,1
05300148,15,5,10,0,0,0,0,0,0
05300408,11,2,9,0,2,2,0,0,1
05300693,44,8,36,0,0,0,0,0,1
05300753,5,2,3,0,0,0,0,0,1
05300755,22,5,17,0,0,0,0,0,1
05300860,7,3,4,0,1,1,0,0,1
05300865,16,5,11,0,1,1,0,1,1
05300876,16,3,13,0,0,0,0,0,1
05300885,5,3,2,0,3,1,2,1,0
05301355,4,0,4,0,0,0,0,0,0
05301576,25,8,17,0,0,0,0,0,1
05301758,18,5,13,0,1,1,0,1,1
05301823,2,1,1,0,1,1,0,0,0
05301920,28,9,19,0,0,0,0,0,0
05302374,7,5,2,0,1,1,0,0,1
05302397,3,1,2,0,1,1,0,0,0
05302708,17,0,17,0,0,0,0,0,1
05302821,15,3,12,0,1,1,0,0,0
05302966,2,2,0,0,1,1,0,0,1
05303167,16,5,11,0,1,1,0,1,1
05303594,4,0,4,0,2,2,0,0,0
05303696,4,4,0,0,2,1,1,0,0
05303818,17,3,14,0,1,1,0,1,1
05303883,60,11,49,0,0,0,0,0,1
05304337,11,0,11,0,0,0,0,0,1
05304411,7,0,7,0,0,0,0,0,1
05304412,10,0,10,0,0,0,0,0,1
05305022,8,0,8,0,0,0,0,0,1
05305093,4,2,2,0,1,1,0,0,0
05305121,10,3,7,0,1,1,0,1,1
05305159,15,4,11,0,1,1,0,1,1
05305321,14,0,14,0,0,0,0,0,1
05305489,7,0,7,0,0,0,0,0,1
05305490,7,0,7,0,0,0,0,0,1
05306239,5,1,4,0,2,1,1,0,0
05306249,17,4,13,0,1,1,0,1,1
05306293,5,4,1,0,1,1,0,0,0
05306796,25,3,22,0,1,1,0,1,1
05306974,12,0,12,0,0,0,0,0,1
05307068,28,0,28,0,0,0,0,0,1
05307129,3,0,3,0,0,0,0,0,0
05307690,5,3,2,0,0,0,0,0,0
05307721,6,0,6,0,2,2,0,0,1
05307852,6,3,3,0,1,1,0,0,1
05307860,6,3,3,0,1,1,0,1,1
05307891,28,5,23,0,0,0,0,0,1
05307990,6,2,4,0,3,2,1,0,0
05308064,19,1,18,0,1,1,0,1,1
05308244,28,2,26,0,1,1,0,0,1
05308617,4,0,4,0,1,1,0,0,1
05308745,18,7,11,0,1,1,0,1,1
05308760,8,0,8,0,0,0,0,0,1
05309042,26,3,23,0,1,1,0,1,1
05309624,5,3,2,0,2,2,0,0,1
05310024,9,0,9,0,0,0,0,0,1
05310030,9,0,9,0,0,0,0,0,1
05310047,9,0,9,0,0,0,0,0,1
05310224,19,0,19,0,0,0,0,0,1
05310616,74,26,48,0,0,0,0,0,1
05310628,11,0,11,0,0,0,0,0,1
05310655,36,6,30,0,1,1,0,1,1
05310656,30,6,24,0,1,1,0,1,1
05310778,5,1,4,0,0,0,0,0,0
05310977,5,1,4,0,1,1,0,0,0
05310997,8,0,8,0,0,0,0,0,1
05311545,5,2,3,0,1,1,0,1,1
05311551,7,3,4,0,0,0,0,0,1
05311572,10,2,8,0,1,1,0,0,1
05311623,23,0,23,0,0,0,0,0,1
05311646,24,10,14,0,1,0,1,0,1
05311990,15,8,7,0,0,0,0,0,0
05312114,5,2,3,0,1,1,0,0,0
05312424,6,1,5,0,1,1,0,0,0
05312467,13,0,13,0,1,1,0,1,1
05312588,8,0,8,0,0,0,0,0,1
05312655,6,3,3,0,1,1,0,0,0
05312703,37,2,35,0,2,2,0,0,1
05312722,10,2,8,0,1,1,0,1,1
05312868,3,1,2,0,0,0,0,0,1
05312941,31,9,22,0,0,0,0,0,1
05312954,32,6,26,0,0,0,0,0,1
05313008,4,0,4,0,0,0,0,0,1
05313087,11,4,7,0,0,0,0,0,1
05313254,10,3,7,0,1,1,0,0,1
05313369,10,2,8,0,1,1,0,0,1
05313745,16,2,14,0,1,1,0,0,1
05313861,6,3,3,0,2,2,0,0,0
05314012,10,3,7,0,0,0,0,0,1
05314227,25,5,20,0,0,0,0,0,1
05314362,4,3,1,0,1,1,0,0,1
05314981,7,0,7,0,0,0,0,0,0
05315087,7,3,4,0,1,1,0,0,0
05315704,11,3,8,0,1,1,0,0,1
05315911,17,4,13,0,1,1,0,1,1
05316172,6,3,3,0,1,1,0,0,1
05316243,13,5,8,0,0,0,0,0,1
05316320,13,5,8,0,1,1,0,0,1
05316336,6,0,6,0,0,0,0,0,1
05316370,6,2,4,0,1,1,0,0,0
05316382,44,5,39,0,1,1,0,1,1
05316463,2,1,1,0,2,2,0,0,0
05316589,7,1,6,0,1,1,0,1,1
05316600,4,2,2,0,1,1,0,0,1
05316930,6,0,6,0,0,0,0,0,1
05317210,16,3,13,0,1,1,0,1,1
05317433,7,4,3,0,0,0,0,0,0
05317485,26,7,19,0,0,0,0,0,0
05317612,21,0,21,0,0,0,0,0,1
05317618,20,1,19,0,1,1,0,0,1
05317683,32,9,23,0,0,0,0,0,1
05317726,7,3,4,0,1,1,0,0,1
05318138,11,6,5,0,0,0,0,0,1
05318176,23,4,19,0,3,3,0,0,0
05318222,9,2,7,1,0,0,0,0,1
05318245,26,3,23,0,1,1,0,1,1
05318271,13,6,7,0,1,1,0,1,1
05318359,4,3,1,0,1,1,0,0,0
05318694,5,3,2,0,2,2,0,0,0
05319075,2,0,2,0,0,0,0,0,1
05319109,10,4,6,0,0,0,0,0,1
05319133,7,3,4,0,1,1,0,0,1
05319140,7,3,4,0,1,1,0,0,1
05319177,24,4,20,0,1,1,0,1,1
05319222,9,5,4,0,1,1,0,1,1
05319230,13,5,8,0,1,1,0,1,1
05319530,4,2,2,0,1,1,0,0,1
05319558,6,5,1,0,3,1,2,1,0
05319589,6,5,1,0,3,1,2,1,0
05319595,5,1,4,0,1,1,0,0,1
05319802,4,2,2,0,1,1,0,0,0
05319962,5,1,4,0,1,1,0,0,1
05320237,25,0,25,0,1,1,0,0,1
05320290,17,9,8,0,0,0,0,0,1
05320350,54,12,42,0,0,0,0,0,1
05320378,9,4,5,0,1,1,0,0,0
05320608,19,5,14,0,0,0,0,0,1
05320657,11,5,6,0,1,1,0,0,1
05320894,3,3,0,0,2,2,0,0,0
05321115,26,2,24,0,1,1,0,1,1
05321203,25,9,16,0,0,0,0,0,0
05321261,10,4,6,0,0,0,0,0,1
05321354,12,8,4,0,0,0,0,0,1
05321715,14,9,5,0,0,0,0,0,0
05321837,26,0,26,1,0,0,0,0,1
03339097,7,3,4,0,1,1,0,0,1
03339143,38,6,32,0,1,1,0,0,0
03339154,31,0,31,0,1,1,0,1,1
03339237,10,3,7,0,1,1,0,0,1
03339382,26,0,26,0,0,0,0,0,1
03339548,23,4,19,0,1,1,0,1,1
03339975,56,10,46,0,0,0,0,0,1
03340011,4,1,3,0,1,1,0,0,1
03340083,35,2,33,0,0,0,0,0,0
03340107,16,0,16,0,0,0,0,0,0
03340252,45,9,36,0,0,0,0,0,1
03340325,34,8,26,0,0,0,0,0,0
03340454,6,3,3,0,2,2,0,0,0
03340541,46,11,35,0,2,1,1,0,1
03340629,18,2,16,0,1,1,0,0,0
03340659,29,3,26,0,1,1,0,1,1
03340891,11,3,8,0,2,1,1,2,1
03341029,47,4,43,0,2,2,0,2,1
03341042,23,8,15,0,1,1,0,0,1
03341224,30,3,27,0,1,1,0,1,1
03341254,26,4,22,0,1,1,0,1,1
03341314,8,0,8,0,0,0,0,0,1
03341421,17,0,17,0,1,1,0,1,1
03341450,4,1,3,0,1,1,0,0,0
03341567,16,13,3,0,3,3,0,0,1
03341701,11,5,6,0,2,2,0,1,1
03341786,20,4,16,0,2,1,1,2,1
03341932,20,3,17,0,1,1,0,1,1
03341959,47,10,37,0,7,0,7,0,1
03341992,28,4,24,0,1,1,0,1,1
03342327,4,2,2,0,1,1,0,0,0
03342336,17,7,10,0,3,2,1,3,1
03342487,5,2,3,0,0,0,0,0,0
03342581,57,11,46,0,0,0,0,0,1
03342824,8,4,4,0,1,1,0,0,1
03342898,18,0,18,0,0,0,0,0,1
03342987,4,1,3,0,1,1,0,0,0
03343011,5,0,5,0,0,0,0,0,1
03343192,5,2,3,0,1,1,0,0,1
03343304,6,3,3,0,1,1,0,0,1
03343307,40,8,32,0,1,1,0,1,1
03343568,13,5,8,0,0,0,0,0,1
03343623,45,0,45,0,0,0,0,0,1
03343863,4,1,3,0,1,1,0,0,1
03343961,25,0,25,0,0,0,0,0,1
03344406,30,4,26,0,2,1,1,2,1
03344548,19,0,19,0,0,0,0,0,1
03344653,42,2,40,0,1,1,0,1,1
03344784,96,18,78,0,1,0,1,1,1
03344871,22,9,13,0,0,0,0,0,0
03345052,8,3,5,0,2,2,0,0,0
03345194,84,16,68,0,0,0,0,0,1
03345230,35,10,25,0,0,0,0,0,0
03345437,7,3,4,0,3,3,0,0,0
03345794,4,0,4,0,0,0,0,0,0
03346014,23,0,23,0,0,0,0,0,1
03346172,24,0,24,0,0,0,0,0,1
03346356,22,6,16,0,1,1,0,0,1
03346773,5,2,3,0,0,0,0,0,1
03346853,32,7,25,0,1,1,0,0,1
03346936,21,5,16,0,1,1,0,1,1
03347086,7,1,6,0,0,0,0,0,1
03347110,23,4,19,0,1,1,0,1,1
03347241,5,2,3,0,2,2,0,0,0
03347261,17,0,17,0,0,0,0,0,1
03347385,15,0,15,0,0,0,0,0,1
03347386,29,0,29,0,1,1,0,1,1
03347440,16,3,13,1,0,0,0,0,1
03347650,45,12,33,0,1,1,0,0,1
03347683,25,0,25,0,0,0,0,0,1
03347758,16,0,16,0,0,0,0,0,1
03347939,17,5,12,0,0,0,0,0,1
03347950,4,1,3,0,1,1,0,0,1
03348112,20,0,20,0,0,0,0,0,1
03348119,7,5,2,0,3,3,0,0,1
03348456,40,10,30,0,0,0,0,0,1
03348508,24,0,24,0,0,0,0,0,0
03348630,7,0,7,0,0,0,0,0,1
03349084,53,10,43,0,3,3,0,3,1
03349501,21,6,15,0,2,2,0,2,1
03349536,7,3,4,0,1,1,0,1,1
03350065,4,1,3,0,1,1,0,0,1
03350147,35,7,28,0,1,1,0,1,1
03350641,19,5,14,0,3,3,0,0,1
03350729,25,10,15,0,0,0,0,0,1
03351283,5,0,5,0,1,1,0,0,1
03351628,33,4,29,0,0,0,0,0,1
03351661,5,3,2,0,2,2,0,0,0
03351775,33,0,33,0,0,0,0,0,1
03351832,26,6,20,0,0,0,0,0,0
03352066,4,1,3,0,1,1,0,0,0
03352439,10,2,8,0,2,2,0,0,0
03352609,9,2,7,0,1,1,0,0,1
03352721,8,3,5,0,1,1,0,0,0
03353144,17,3,14,0,2,2,0,1,1
03353423,11,3,8,0,1,1,0,1,0
03353517,26,0,26,0,0,0,0,0,1
03353746,15,2,13,0,1,1,0,0,0
03353978,4,0,4,0,0,0,0,0,1
03354124,24,3,21,0,1,1,0,1,1
03354127,52,9,43,0,0,0,0,0,1
03355252,16,3,13,0,0,0,0,0,0
03355290,28,0,28,0,0,0,0,0,1
03355411,53,10,43,0,0,0,0,0,1
03355423,53,8,45,0,3,0,3,0,1
03355588,37,8,29,0,1,1,0,1,1
03355618,39,0,39,0,0,0,0,0,1
03355651,39,3,36,0,2,2,0,2,1
03355995,18,5,13,0,1,1,0,0,1
03356376,4,3,1,0,2,2,0,0,1
03356444,23,0,23,0,0,0,0,0,1
03356526,91,21,70,0,0,0,0,0,1
03356950,13,0,13,0,0,0,0,0,1
03357260,95,11,84,0,1,1,0,1,1
03357705,13,0,13,0,0,0,0,0,1
03358021,21,7,14,0,6,6,0,0,1
03358035,40,3,37,0,1,1,0,1,1
03358561,13,4,9,2,5,5,0,0,1
03358919,21,4,17,0,0,0,0,0,0
03359127,36,3,33,0,1,1,0,1,1
03359425,45,0,45,0,0,0,0,0,1
03359457,42,5,37,0,0,0,0,0,0
03359692,27,4,23,0,1,1,0,1,1
03359805,21,5,16,0,1,1,0,1,1
03360075,32,8,24,0,0,0,0,0,1
03360122,28,3,25,0,1,1,0,1,1
03360313,10,3,7,0,1,1,0,1,0
03360334,55,9,46,0,1,1,0,0,0
03360695,38,0,38,0,0,0,0,0,1
03360815,8,2,6,0,2,2,0,0,0
03360899,7,5,2,0,3,1,2,1,0
03361570,6,3,3,0,1,1,0,0,1
03361599,16,3,13,0,1,1,0,0,1
03361716,42,7,35,0,0,0,0,0,1
03362860,23,3,20,0,1,1,0,1,1
03362875,12,0,12,0,9,5,4,1,0
03363450,8,1,7,0,1,1,0,0,1
03363459,19,0,19,0,0,0,0,0,1
03363834,16,4,12,0,1,1,0,0,1
03363943,34,3,31,0,1,1,0,1,1
03364046,5,3,2,0,1,1,0,0,1
03364048,23,7,16,1,0,0,0,0,1
03364119,8,3,5,0,1,1,0,1,0
03364151,27,10,17,0,0,0,0,0,1
03364308,65,10,55,0,0,0,0,0,1
03364548,13,3,10,0,3,3,0,0,1
03365098,25,6,19,0,0,0,0,0,0
03365166,16,0,16,0,0,0,0,0,1
03365455,6,1,5,0,1,1,0,0,0
03365478,7,5,2,0,1,1,0,0,0
03365593,8,2,6,0,1,1,0,0,0
03365725,12,2,10,0,1,1,0,1,1
03365953,16,3,13,0,1,1,0,1,1
03366506,44,0,44,0,0,0,0,0,1
03366959,19,0,19,0,0,0,0,0,1
03367354,16,4,12,0,1,1,0,1,1
03367574,29,7,22,0,0,0,0,0,1
03367647,16,2,14,0,1,1,0,1,1
03367648,30,7,23,0,1,1,0,1,1
03368357,14,0,14,0,0,0,0,0,1
03368447,15,7,8,0,2,1,1,1,1
03368909,16,3,13,0,3,3,0,0,0
03368961,18,4,14,0,1,1,0,1,1
03369700,8,2,6,0,1,1,0,1,1
03369707,7,5,2,0,4,4,0,2,1
03369745,8,3,5,0,2,2,0,0,1
03369799,19,5,14,0,1,1,0,1,1
03369902,11,4,7,0,0,0,0,0,0
03370625,20,4,16,0,0,0,0,0,1
03370863,15,0,15,0,1,1,0,1,1
03371038,138,18,120,0,0,0,0,0,1
03371104,22,5,17,0,1,1,0,1,1
03371321,11,5,6,0,2,2,0,0,1
03371398,26,7,19,0,0,0,0,0,1
03371525,7,3,4,0,2,2,0,0,0
03371977,51,5,46,0,0,0,0,0,1
03372016,8,2,6,0,1,1,0,0,0
03372097,37,0,37,0,0,0,0,0,1
03372177,26,5,21,0,0,0,0,0,0
03372190,28,3,25,0,2,1,1,2,1
03372284,9,2,7,0,2,1,1,1,1
03372538,5,2,3,0,2,1,1,0,0
03372540,24,5,19,0,1,1,0,1,1
03372721,6,0,6,0,0,0,0,0,1
03372928,29,3,26,0,1,1,0,1,1
03373001,26,0,26,0,0,0,0,0,1
03373167,12,0,12,0,0,0,0,0,1
03373260,20,8,12,0,0,0,0,0,1
03373274,8,2,6,0,3,1,2,1,1
03373384,29,4,25,0,1,1,0,0,0
03373453,10,4,6,0,2,2,0,0,0
03373865,19,11,8,0,0,0,0,0,0
03374064,36,0,36,0,0,0,0,0,1
03374741,15,2,13,0,1,1,0,1,0
03374941,32,11,21,0,1,1,0,0,1
03375025,71,4,67,0,0,0,0,0,0
03375041,13,3,10,0,2,1,1,0,0
03375080,5,0,5,0,3,3,0,0,0
03375210,17,4,13,0,2,1,1,2,1
03375244,27,0,27,0,0,0,0,0,1
03375306,52,7,45,0,0,0,0,0,1
03375345,14,2,12,0,1,1,0,1,1
03375681,18,5,13,0,2,2,0,0,1
03375876,14,1,13,0,1,1,0,0,1
03375891,17,0,17,0,1,1,0,1,1
03375897,27,3,24,0,1,1,0,1,1
03375980,5,3,2,0,1,1,0,0,0
03376014,16,4,12,0,1,1,0,1,1
03376143,23,0,23,0,0,0,0,0,1
03376238,9,2,7,0,1,1,0,0,1
03376377,19,7,12,1,0,0,0,0,1
03376785,17,2,15,0,0,0,0,0,1
03376847,29,8,21,0,0,0,0,0,1
03377249,35,3,32,0,1,1,0,1,1
03377605,3,2,1,0,2,2,0,0,0
03377714,7,3,4,0,2,2,0,0,1
03377901,7,4,3,0,1,1,0,0,0
03377905,7,4,3,0,1,1,0,0,0
03377924,72,6,66,0,1,1,0,1,1
03377936,18,0,18,0,0,0,0,0,1
03377965,26,9,17,0,0,0,0,0,1
03378047,11,2,9,0,1,1,0,1,1
03378202,28,0,28,0,0,0,0,0,1
03378479,22,2,20,0,1,1,0,1,1
03378491,8,2,6,0,2,2,0,0,1
03378550,11,4,7,0,0,0,0,0,1
03378610,32,0,32,0,0,0,0,0,1
03378656,22,2,20,0,2,1,1,2,1
03378699,15,3,12,0,0,0,0,0,1
03378770,11,3,8,0,1,1,0,0,1
03379032,9,5,4,0,1,1,0,1,0
03379114,5,0,5,0,0,0,0,0,1
03379174,10,1,9,0,1,1,0,0,1
03379450,24,0,24,0,0,0,0,0,1
03379479,15,3,12,0,8,8,0,0,1
03379482,15,0,15,0,0,0,0,0,1
03379484,24,0,24,0,0,0,0,0,1
03379501,30,0,30,0,1,1,0,0,0
03379580,25,6,19,0,0,0,0,0,1
03379646,25,11,14,0,0,0,0,0,1
03379689,8,2,6,0,0,0,0,0,0
03380071,16,4,12,0,1,1,0,0,1
03380445,9,4,5,0,3,3,0,0,0
03380658,34,7,27,0,1,1,0,1,1
03381400,16,2,14,0,0,0,0,0,1
03381538,20,0,20,0,0,0,0,0,1
03381606,12,5,7,0,3,3,0,0,1
03381826,6,3,3,0,1,1,0,0,1
03382237,34,4,30,0,1,1,0,1,1
03382553,23,8,15,0,1,1,0,1,1
03383236,11,0,11,1,0,0,0,0,0
03383475,50,4,46,0,1,1,0,1,0
03383797,87,14,73,0,0,0,0,0,1
03383881,13,4,9,0,1,1,0,1,1
03384487,13,4,9,0,1,1,0,1,1
03384699,15,6,9,0,1,0,1,1,1
03384709,20,3,17,0,0,0,0,0,1
03384710,37,4,33,0,1,1,0,1,1
03384783,20,0,20,0,0,0,0,0,1
03385016,26,0,26,0,0,0,0,0,1
03385025,34,4,30,0,1,1,0,1,0
03385322,14,2,12,0,0,0,0,0,0
03385731,32,5,27,0,0,0,0,0,1
03385838,5,1,4,0,1,1,0,0,0
03386018,11,0,11,0,0,0,0,0,1
03386056,26,0,26,0,0,0,0,0,1
03386284,16,5,11,0,1,1,0,1,1
03386417,5,2,3,0,1,1,0,0,1
03386645,13,3,10,0,1,1,0,1,1
03386839,49,9,40,0,1,1,0,0,1
03386860,5,2,3,0,1,1,0,1,1
03386900,23,0,23,0,0,0,0,0,1
03386922,25,3,22,0,2,1,1,2,1
03386929,38,9,29,0,0,0,0,0,1
03386998,16,0,16,0,0,0,0,0,1
03387045,22,3,19,0,1,1,0,1,1
03387094,36,2,34,0,1,1,0,1,0
03387095,29,8,21,0,1,1,0,1,1
03387274,5,3,2,0,1,1,0,0,1
03387537,41,9,32,0,0,0,0,0,0
03387647,29,2,27,0,1,0,1,1,1
03387663,8,0,8,0,0,0,0,0,1
03387790,67,1,66,0,0,0,0,0,1
03387792,4,2,2,0,2,2,0,0,1
03387838,42,0,42,0,0,0,0,0,1
03387957,4,0,4,0,1,1,0,0,1
03387975,5,0,5,0,0,0,0,0,0
03388017,81,10,71,0,0,0,0,0,0
03388137,43,14,29,0,0,0,0,0,1
03388395,11,2,9,0,1,1,0,0,1
03388671,52,10,42,0,0,0,0,0,1
03388707,15,0,15,0,0,0,0,0,1
03389067,14,0,14,0,0,0,0,0,1
03389372,8,1,7,0,1,1,0,0,1
03389389,15,4,11,0,0,0,0,0,1
03389617,24,5,19,0,0,0,0,0,1
03389645,24,6,18,0,0,0,0,0,1
03389930,12,2,10,0,0,0,0,0,1
03389978,50,5,45,0,1,1,0,1,1
03390085,5,3,2,0,2,2,0,0,1
03390138,36,7,29,0,0,0,0,0,1
03390170,30,8,22,0,1,1,0,1,0
03390258,30,4,26,0,1,1,0,1,1
03390345,29,3,26,0,1,1,0,1,1
03390541,35,10,25,0,0,0,0,0,1
03390673,32,3,29,0,1,1,0,0,1
03390717,12,2,10,0,1,1,0,1,1
03390839,47,3,44,0,1,1,0,1,1
03390862,6,4,2,0,2,2,0,0,1
03390911,6,0,6,0,0,0,0,0,1
03390944,16,4,12,0,1,1,0,1,1
03391060,19,0,19,0,0,0,0,0,1
03391073,19,0,19,0,0,0,0,0,1
03391144,13,3,10,0,1,1,0,1,1
03391578,10,0,10,0,0,0,0,0,1
03391758,93,6,87,0,0,0,0,0,1
03391867,7,3,4,0,0,0,0,0,0
03392183,6,0,6,0,0,0,0,0,0
03392267,8,5,3,0,1,1,0,0,0
03392310,14,1,13,0,0,0,0,0,1
03392527,36,7,29,0,0,0,0,0,1
03392535,18,3,15,0,1,1,0,1,1
03392685,17,5,12,0,1,1,0,1,1
03393310,7,4,3,0,2,2,0,2,1
03393610,34,5,29,0,2,2,0,2,1
03394234,29,3,26,0,1,1,0,1,1
03394380,4,2,2,0,3,3,0,0,0
03394534,20,0,20,0,1,1,0,1,1
03394622,23,3,20,0,2,2,0,2,0
03394910,23,6,17,0,0,0,0,0,1
03394958,30,13,17,0,0,0,0,0,1
03394992,38,8,30,0,1,1,0,1,1
03395389,38,12,26,0,0,0,0,0,1
03395416,28,6,22,0,1,1,0,1,1
03395489,41,6,35,0,1,1,0,1,1
03395491,38,0,38,0,0,0,0,0,1
03395681,98,11,87,0,0,0,0,0,1
03395695,7,3,4,0,1,1,0,1,0
03395860,24,0,24,0,0,0,0,0,1
03396067,13,3,10,0,1,1,0,0,1
03396170,10,4,6,0,1,1,0,0,1
03396496,16,0,16,0,0,0,0,0,1
03396520,22,0,22,0,0,0,0,0,1
03396797,5,2,3,0,2,2,0,0,1
03396935,12,3,9,0,1,1,0,1,1
03396992,17,0,17,0,1,1,0,1,1
03397032,12,2,10,0,1,1,0,1,1
03397696,4,3,1,0,1,1,0,0,1
03397797,12,0,12,0,0,0,0,0,1
03397895,36,3,33,0,5,4,1,0,0
03397960,22,2,20,0,2,1,1,2,1
03398004,5,0,5,0,0,0,0,0,1
03398021,11,4,7,0,2,1,1,2,1
03398152,5,0,5,0,2,1,1,2,1
03398515,7,0,7,0,0,0,0,0,0
03398534,22,2,20,0,3,3,0,1,1
03398855,7,4,3,0,1,1,0,0,0
03399276,29,0,29,0,0,0,0,0,1
03399306,4,2,2,0,1,1,0,0,0
03399480,8,2,6,0,1,1,0,0,0
03399524,6,0,6,0,0,0,0,0,1
03399536,7,0,7,0,0,0,0,0,1
03399653,3,0,3,0,0,0,0,0,1
03399923,35,5,30,0,0,0,0,0,1
05764038,3,2,1,0,1,1,0,0,0
05764141,14,5,9,0,1,1,0,1,1
05764165,12,6,6,0,3,1,2,2,1
05764516,3,3,0,0,1,1,0,0,0
05764555,5,3,2,0,2,2,0,0,1
05764664,2,0,2,0,0,0,0,0,1
05764810,21,4,17,0,0,0,0,0,1
05764838,17,6,11,0,2,1,1,2,1
05764848,16,6,10,0,1,1,0,1,1
05764956,6,4,2,0,2,2,0,0,1
05765413,2,0,2,0,0,0,0,0,1
05765499,4,2,2,0,1,1,0,0,1
05765597,3,2,1,0,1,1,0,0,0
05765738,22,5,17,0,2,1,1,2,1
05765757,2,2,0,0,1,1,0,0,0
05765833,10,3,7,0,2,2,0,2,1
05765876,18,0,18,0,0,0,0,0,1
05765961,4,0,4,0,0,0,0,0,1
05765986,14,6,8,0,1,1,0,0,0
05766028,2,1,1,0,1,1,0,0,0
05766258,5,3,2,0,2,2,0,0,1
05766993,3,2,1,0,2,2,0,0,1
05767003,3,0,3,0,2,2,0,0,0
05768008,7,4,3,0,3,3,0,0,1
05768311,4,2,2,0,1,0,1,1,1
05768358,6,0,6,0,0,0,0,0,1
05768373,20,4,16,0,1,1,0,1,1
05768401,4,0,4,0,0,0,0,0,0
05768446,4,2,2,0,1,1,0,0,0
05768459,2,2,0,0,1,1,0,0,1
05768654,9,3,6,0,0,0,0,0,1
05768822,4,0,4,0,0,0,0,0,1
05768823,3,0,3,0,0,0,0,0,1
05768914,18,6,12,0,0,0,0,0,1
05768994,8,5,3,0,1,1,0,1,1
05769142,18,8,10,0,0,0,0,0,1
05769472,12,6,6,0,1,1,0,0,0
05769525,28,0,28,0,1,1,0,1,1
05769539,6,2,4,0,2,2,0,0,0
05769604,19,0,19,0,0,0,0,0,1
05769615,2,1,1,0,2,2,0,0,0
05769622,7,3,4,0,1,1,0,0,0
05769844,8,2,6,0,1,1,0,0,1
05770270,16,0,16,0,0,0,0,0,1
05770311,4,2,2,0,1,1,0,0,1
05770898,4,2,2,0,2,2,0,0,0
05770953,3,2,1,0,1,1,0,0,1
05771039,3,1,2,0,1,1,0,0,1
05771283,9,2,7,0,1,1,0,1,0
05771327,3,0,3,0,0,0,0,0,1
05771493,3,2,1,0,1,1,0,0,0
05772181,4,2,2,0,1,1,0,0,1
05772223,3,1,2,0,1,1,0,0,1
05772287,4,3,1,0,1,1,0,0,1
05772297,9,0,9,0,0,0,0,0,1
05772965,5,3,2,0,2,2,0,0,0
05772999,39,9,30,0,0,0,0,0,1
05773174,5,1,4,0,1,1,0,0,0
05773238,5,3,2,0,2,2,0,0,1
05774175,21,4,17,0,1,1,0,1,1
05774879,4,2,2,0,1,1,0,0,1
05775046,3,3,0,0,1,1,0,0,1
05775190,4,3,1,0,2,2,0,0,1
05775464,4,3,1,0,2,2,0,0,1
05775955,12,0,12,0,0,0,0,0,1
05776211,14,0,14,0,2,0,2,2,0
05776300,22,0,22,0,0,0,0,0,1
05776368,5,2,3,0,1,1,0,0,1
05776675,6,0,6,0,0,0,0,0,1
05777017,6,4,2,0,1,1,0,1,0
05777067,20,5,15,0,1,1,0,1,1
05777204,8,3,5,0,0,0,0,0,0
05777438,9,0,9,0,0,0,0,0,1
05777728,43,9,34,0,1,1,0,1,1
05777772,6,3,3,0,4,4,0,1,1
05778052,11,5,6,0,5,4,1,0,0
05778147,2,2,0,0,1,1,0,1,1
05778204,5,0,5,0,1,1,0,1,0
05778207,5,3,2,0,2,1,1,2,0
05778231,22,0,22,0,1,1,0,1,1
05778362,4,2,2,0,1,1,0,0,1
05778493,6,0,6,0,0,0,0,0,1
05778768,19,0,19,0,1,1,0,0,1
05778832,15,8,7,0,1,1,0,0,1
05779059,11,3,8,0,1,1,0,1,1
05779226,7,2,5,0,1,1,0,1,1
05779334,6,0,6,0,0,0,0,0,1
05779997,7,5,2,0,1,1,0,1,1
05780094,4,2,2,0,1,1,0,0,0
05780181,7,1,6,0,2,1,1,0,1
05780353,2,2,0,0,1,1,0,0,0
05780587,3,2,1,0,1,1,0,0,0
05780883,4,1,3,0,1,1,0,0,1
05781011,18,0,18,0,1,1,0,1,1
05781320,5,2,3,0,1,1,0,0,1
05781496,9,4,5,0,1,1,0,1,1
05782682,4,1,3,0,1,1,0,0,1
05783175,2,2,0,0,1,1,0,0,1
05783452,9,3,6,0,1,1,0,1,1
05783850,4,2,2,0,1,1,0,0,0
05783924,2,1,1,0,1,1,0,0,1
05784012,6,2,4,0,1,1,0,0,0
05784041,3,3,0,0,4,4,0,0,0
05784087,5,3,2,0,1,1,0,0,1
05784772,2,2,0,0,1,1,0,0,0
05786104,3,1,2,0,1,1,0,0,0
05787179,6,3,3,0,2,2,0,0,1
05787426,4,1,3,1,2,1,1,0,0
05787439,16,5,11,0,2,1,1,2,1
05787554,9,3,6,0,0,0,0,0,0
05787855,5,0,5,0,0,0,0,0,0
05788427,5,0,5,0,1,1,0,0,0
05788465,7,2,5,0,1,1,0,1,1
05788622,5,2,3,0,1,1,0,1,0
05788626,5,2,3,0,1,1,0,1,0
05788648,5,2,3,0,1,1,0,1,0
05789411,4,2,2,0,2,2,0,0,0
05790132,3,3,0,0,2,2,0,0,0
05790256,4,2,2,0,1,1,0,1,1
05790312,3,3,0,0,2,2,0,0,0
05790343,9,3,6,0,1,1,0,0,1
05790394,6,0,6,0,0,0,0,0,1
05790471,9,5,4,0,1,1,0,1,1
05790506,6,3,3,0,2,2,0,0,1
05791377,5,3,2,0,2,2,0,0,1
05791450,4,0,4,0,0,0,0,0,1
05791589,9,3,6,0,1,1,0,1,1
05791612,9,0,9,0,0,0,0,0,1
05792123,17,2,15,0,2,1,1,2,1
05792192,4,1,3,0,1,1,0,0,1
05792278,4,1,3,0,1,1,0,0,1
05792362,6,4,2,0,0,0,0,0,1
05792400,4,1,3,0,1,1,0,0,1
05792500,8,3,5,0,3,1,2,2,1
05792692,6,4,2,0,3,3,0,0,0
05792977,2,1,1,0,2,2,0,0,0
05793063,5,3,2,0,1,1,0,0,1
05794246,3,2,1,0,2,2,0,0,1
05794281,17,9,8,0,0,0,0,0,1
05794494,12,2,10,0,1,1,0,1,1
05794909,8,2,6,0,0,0,0,0,1
05795115,3,0,3,0,0,0,0,0,1
05795193,6,0,6,0,0,0,0,0,1
05795248,5,0,5,0,2,2,0,0,0
05796154,4,2,2,0,1,1,0,0,1
05796173,3,0,3,0,0,0,0,0,1
05796180,3,1,2,0,1,1,0,0,1
05796357,4,1,3,0,1,1,0,0,1
05796766,25,4,21,0,1,1,0,1,1
05797367,6,3,3,0,2,2,0,0,0
05797411,6,0,6,0,0,0,0,0,0
05797448,6,1,5,0,2,1,1,0,0
05797584,6,3,3,0,1,1,0,1,1
05797585,6,3,3,0,1,1,0,1,1
05797623,7,3,4,0,2,2,0,0,1
05797743,12,3,9,0,0,0,0,0,1
05797774,39,8,31,0,1,1,0,1,1
05797779,36,9,27,0,1,1,0,1,1
05797818,10,5,5,0,0,0,0,0,0
05797852,5,0,5,0,0,0,0,0,1
05797953,3,1,2,0,1,1,0,0,1
05797992,3,3,0,0,1,1,0,1,0
05798208,9,0,9,0,0,0,0,0,0
05798225,17,5,12,0,1,1,0,1,1
05798860,2,2,0,0,1,1,0,0,0
05799080,10,4,6,0,0,0,0,0,1
05799215,18,0,18,0,1,1,0,1,1
05799601,3,0,3,0,2,2,0,0,1
05799659,5,3,2,0,2,2,0,0,0
05799782,6,3,3,0,1,1,0,1,1
05800210,4,1,3,0,1,1,0,1,0
05800435,5,4,1,0,3,3,0,0,1
05800768,16,2,14,0,1,1,0,1,1
05800771,4,2,2,0,2,2,0,0,0
05801082,15,0,15,0,0,0,0,0,1
05801407,29,8,21,0,0,0,0,0,1
05801433,17,2,15,0,0,0,0,0,1
05801467,17,2,15,0,1,1,0,1,1
05801655,6,1,5,0,1,1,0,0,1
05802093,7,5,2,0,4,4,0,1,1
05802101,9,2,7,0,1,1,0,0,1
05802246,17,6,11,0,0,0,0,0,1
05802437,5,0,5,0,1,1,0,0,0
05802661,15,4,11,0,1,1,0,1,1
05802963,14,3,11,0,1,1,0,1,1
05803075,2,0,2,0,0,0,0,0,1
05803939,12,2,10,0,0,0,0,0,1
05803985,4,2,2,0,1,1,0,0,1
05804264,4,0,4,0,0,0,0,0,1
05804288,6,3,3,0,0,0,0,0,1
05804397,26,2,24,0,2,1,1,2,1
05805010,7,4,3,0,0,0,0,0,0
05805069,14,3,11,0,0,0,0,0,1
05805276,3,0,3,0,1,1,0,0,0
05805327,6,3,3,0,1,1,0,0,0
05805541,6,2,4,0,2,2,0,0,0
05805640,5,3,2,0,2,2,0,0,1
05805789,8,3,5,0,3,1,2,1,1
05805820,13,5,8,0,3,3,0,0,1
05806409,4,3,1,0,1,1,0,0,1
05806761,12,4,8,0,0,0,0,0,1
05806904,4,0,4,0,1,1,0,0,1
05806941,9,2,7,0,0,0,0,0,0
05806943,6,0,6,0,0,0,0,0,1
05807220,3,1,2,0,1,1,0,0,0
05807296,6,0,6,0,0,0,0,0,1
05807499,12,5,7,0,1,1,0,1,1
05807690,13,3,10,0,1,1,0,1,1
05807776,4,3,1,0,3,3,0,1,0
05808040,27,3,24,0,4,2,2,0,1
05808051,4,2,2,0,1,1,0,0,1
05808375,8,1,7,0,1,1,0,0,0
05808563,2,2,0,0,1,1,0,0,0
05808791,9,1,8,0,1,1,0,1,1
05809399,21,8,13,0,1,1,0,1,1
05809432,9,5,4,0,1,1,0,1,1
05809569,5,3,2,0,1,1,0,0,1
05809683,6,3,3,0,1,1,0,0,0
05809949,9,5,4,0,1,1,0,1,1
05810043,14,3,11,0,1,1,0,1,1
05810661,11,3,8,0,1,1,0,1,1
05810921,9,3,6,0,2,2,0,0,0
05811253,6,0,6,0,1,1,0,0,1
05811355,12,2,10,0,1,1,0,1,1
05811364,21,5,16,0,1,1,0,1,1
05811374,12,2,10,0,1,1,0,1,1
05811376,7,1,6,0,1,1,0,1,1
05811470,7,3,4,0,0,0,0,0,1
05811471,4,0,4,0,0,0,0,0,1
05811755,3,1,2,0,1,1,0,0,0
05811807,5,1,4,0,1,1,0,0,1
05811851,7,3,4,0,1,1,0,1,0
05811865,4,2,2,0,1,1,0,0,0
05812162,3,0,3,0,0,0,0,0,1
05812177,6,0,6,0,0,0,0,0,1
05812195,3,2,1,0,1,1,0,0,0
05812287,9,2,7,0,0,0,0,0,1
05812600,4,1,3,0,1,1,0,0,1
05812725,7,4,3,0,0,0,0,0,1
05812951,10,5,5,0,2,2,0,1,1
05812953,12,5,7,0,2,2,0,2,1
05812954,11,2,9,0,0,0,0,0,1
05813129,2,0,2,0,1,1,0,0,0
05813190,3,0,3,0,0,0,0,0,1
05813566,2,2,0,0,1,1,0,0,0
05813575,10,3,7,0,1,1,0,0,1
05813603,8,3,5,0,1,1,0,1,1
05813853,13,6,7,0,0,0,0,0,1
05814032,29,10,19,0,0,0,0,0,0
05814047,12,5,7,0,0,0,0,0,1
05814156,5,3,2,0,2,2,0,0,0
05814316,13,4,9,0,4,4,0,0,0
05814349,4,3,1,0,2,2,0,0,1
05814426,4,0,4,0,0,0,0,0,1
05814480,4,1,3,0,1,1,0,0,0
05814487,12,2,10,0,0,0,0,0,1
05814584,25,4,21,0,1,1,0,1,1
05814586,18,5,13,0,1,1,0,1,1
05814686,41,16,25,0,0,0,0,0,1
05814704,5,0,5,0,0,0,0,0,1
05814872,6,0,6,0,0,0,0,0,1
05814962,7,3,4,0,2,1,1,0,0
05815637,4,0,4,0,0,0,0,0,1
05815806,37,5,32,0,2,1,1,2,1
05815868,3,3,0,0,2,2,0,0,0
05815942,9,0,9,0,1,1,0,1,1
05816335,7,3,4,0,1,1,0,0,1
05816565,16,9,7,0,7,7,0,0,1
05817045,19,4,15,0,1,1,0,1,1
05817235,4,3,1,0,2,2,0,0,0
05817558,8,3,5,0,1,1,0,0,0
05818196,6,3,3,0,1,1,0,0,1
05818267,7,4,3,0,2,2,0,0,1
05818308,5,2,3,0,1,1,0,0,1
05818369,3,3,0,0,0,0,0,0,0
05818448,5,2,3,0,2,2,0,0,0
05818571,4,2,2,0,1,1,0,0,0
05818607,5,3,2,0,2,2,0,0,1
05819052,13,5,8,0,0,0,0,0,0
05819097,6,4,2,0,1,1,0,0,0
05819202,10,7,3,0,1,1,0,0,1
05819233,2,2,0,0,1,1,0,0,0
05819273,12,7,5,0,6,6,0,0,0
05819388,28,7,21,0,1,1,0,0,1
05819470,6,2,4,0,1,1,0,0,1
05819475,10,2,8,0,1,1,0,0,1
05819525,9,1,8,0,1,1,0,1,1
05819580,15,1,14,0,2,1,1,2,1
05819705,5,0,5,0,1,1,0,0,1
05819791,52,9,43,0,0,0,0,0,0
05819852,12,4,8,0,2,2,0,0,1
05820636,10,7,3,0,1,1,0,1,1
05820897,7,0,7,0,0,0,0,0,1
05820910,5,2,3,0,1,1,0,0,1
05821054,3,3,0,0,2,2,0,0,1
05821073,2,2,0,0,1,1,0,0,1
05821406,3,0,3,0,0,0,0,0,1
05821585,16,5,11,0,1,1,0,0,1
05821594,5,2,3,0,1,1,0,0,0
05821633,3,2,1,0,1,1,0,0,1
05821987,20,4,16,0,2,2,0,2,1
05822082,4,2,2,0,2,1,1,0,0
05822343,4,3,1,0,1,1,0,0,1
05822489,14,3,11,0,2,1,1,2,1
05822581,32,8,24,0,0,0,0,0,0
05822622,3,2,1,0,1,1,0,0,1
05822773,4,0,4,0,0,0,0,0,1
05822818,32,9,23,0,0,0,0,0,0
05822854,6,3,3,0,1,1,0,0,1
05822975,8,0,8,0,0,0,0,0,1
05822983,6,2,4,0,1,1,0,0,0
05823102,2,2,0,0,1,1,0,0,1
05823194,16,8,8,0,0,0,0,0,1
05823283,3,0,3,0,0,0,0,0,1
05823413,51,16,35,0,0,0,0,0,1
05823583,11,0,11,0,0,0,0,0,1
05823597,8,4,4,0,2,2,0,0,0
05823763,20,4,16,0,0,0,0,0,1
09090223,6,2,4,0,4,1,3,4,1
09090276,15,9,6,0,1,1,0,1,1
09090448,6,2,4,0,2,1,1,2,1
09090452,6,2,4,0,1,1,0,1,1
09090458,8,2,6,0,1,1,0,1,1
09090502,8,2,6,0,1,1,0,1,1
09090594,1,1,0,0,1,1,0,0,0
09091180,1,1,0,0,1,1,0,0,0
09091890,5,3,2,0,0,0,0,0,1
09091944,18,6,12,0,1,1,0,1,1
09092061,6,0,6,0,0,0,0,0,1
09092077,2,1,1,0,2,1,1,0,0
09092128,6,0,6,0,0,0,0,0,1
09092149,12,9,3,0,2,2,0,0,1
09092227,2,2,0,0,0,0,0,0,0
09093009,6,5,1,0,0,0,0,0,1
09093037,1,1,0,0,1,1,0,0,1
09093331,15,11,4,0,0,0,0,0,1
09093512,1,0,1,0,0,0,0,0,0
09093942,2,2,0,0,2,2,0,0,1
09094260,3,3,0,0,1,1,0,1,1
09094311,1,0,1,0,1,1,0,0,0
09094389,5,5,0,0,0,0,0,0,1
09094680,6,0,6,0,1,1,0,1,1
09094820,2,2,0,0,2,2,0,0,1
09094829,1,1,0,0,1,1,0,0,0
09095146,1,1,0,0,1,1,0,0,0
09095367,1,0,1,0,1,1,0,0,0
09095511,2,2,0,0,1,1,0,1,1
09095773,2,2,0,0,2,2,0,0,0
09095978,1,1,0,0,1,1,0,0,0
09095991,1,0,1,0,0,0,0,0,0
09095995,3,0,3,0,0,0,0,0,0
09096155,7,4,3,0,0,0,0,0,1
09096485,1,1,0,0,2,2,0,0,0
09096998,4,0,4,0,0,0,0,0,1
09097566,1,1,0,0,1,1,0,0,0
09097919,3,1,2,0,3,2,1,1,1
09098251,4,4,0,0,2,2,0,0,0
09098358,1,0,1,0,0,0,0,0,0
09098445,7,3,4,0,3,1,2,2,1
09098472,1,0,1,0,0,0,0,0,1
09099533,2,2,0,0,1,1,0,0,0
09099708,3,3,0,0,1,1,0,1,1
09099972,2,2,0,0,2,2,0,0,0
09100148,5,0,5,0,1,1,0,0,1
09100159,2,2,0,0,1,1,0,0,0
09100180,2,0,2,0,0,0,0,0,1
09100319,2,0,2,0,0,0,0,0,0
09100325,2,0,2,0,0,0,0,0,0
09100501,14,6,8,1,1,1,0,1,1
09100833,5,5,0,0,1,1,0,1,1
09100835,8,2,6,0,0,0,0,0,1
09100870,3,0,3,0,1,1,0,0,1
09100883,7,3,4,0,0,0,0,0,1
09100905,1,1,0,0,1,1,0,0,0
09100954,5,4,1,0,0,0,0,0,1
09101743,1,0,1,0,0,0,0,0,0
09101981,2,0,2,0,1,1,0,0,0
09102015,11,7,4,0,2,1,1,1,1
09102435,5,2,3,0,0,0,0,0,1
09102436,5,2,3,0,0,0,0,0,1
09102480,13,5,8,0,1,1,0,1,1
09102509,3,2,1,0,2,2,0,0,1
09102558,13,9,4,0,2,1,1,0,1
09103050,3,3,0,0,3,3,0,0,1
09103165,6,3,3,0,2,1,1,2,1
09103286,6,3,3,0,2,1,1,2,1
09103491,2,1,1,0,1,1,0,0,0
09103585,2,2,0,0,2,2,0,0,0
09103667,1,1,0,0,1,1,0,0,0
09104001,1,0,1,0,0,0,0,0,0
09104211,1,1,0,0,1,1,0,0,0
09104263,1,1,0,0,1,1,0,0,0
09104414,3,3,0,0,1,1,0,0,1
09104491,20,14,6,0,1,1,0,0,1
09104672,3,0,3,1,0,0,0,0,1
09104814,2,2,0,0,1,1,0,0,0
09104821,5,3,2,0,1,1,0,0,0
09105139,2,2,0,0,1,1,0,0,0
09105373,5,4,1,0,0,0,0,0,1
09105486,2,2,0,0,2,2,0,0,0
09105666,2,2,0,0,2,2,0,0,0
09105948,2,1,1,0,1,1,0,0,1
09106000,6,6,0,0,2,2,0,2,1
09106062,1,1,0,0,1,1,0,0,0
09106115,1,1,0,0,1,1,0,0,0
09106343,1,1,0,0,1,1,0,0,0
09106540,4,4,0,0,2,2,0,0,1
09106604,10,8,2,0,3,3,0,0,1
09107277,2,0,2,0,1,1,0,0,1
09107369,4,2,2,0,1,1,0,0,1
09107894,1,1,0,0,1,1,0,1,0
09108354,1,1,0,0,1,1,0,0,0
09108519,5,3,2,0,4,4,0,2,1
09108533,2,2,0,0,1,1,0,0,0
09108987,2,0,2,0,1,1,0,0,1
09109364,2,2,0,0,1,1,0,1,1
09110798,2,0,2,0,1,1,0,0,0
09111449,25,12,13,0,1,1,0,0,1
09111698,10,1,9,0,3,1,2,0,0
09111783,10,1,9,0,6,1,5,0,0
09112085,2,0,2,0,0,0,0,0,1
09112135,1,1,0,0,1,1,0,0,0
09112245,2,0,2,0,0,0,0,0,0
09112348,4,0,4,0,0,0,0,0,1
09112366,5,0,5,0,0,0,0,0,1
09112415,6,2,4,0,1,1,0,1,1
09112800,1,0,1,0,0,0,0,0,0
09113029,1,1,0,0,1,1,0,0,0
09113046,2,2,0,0,1,1,0,0,1
09113696,1,1,0,0,2,2,0,1,0
09113787,5,4,1,0,3,2,1,0,1
09113819,2,2,0,0,1,1,0,0,0
09114167,1,1,0,0,1,1,0,0,0
09114258,9,1,8,0,5,1,4,0,0
09114684,3,3,0,0,1,1,0,0,0
09114888,14,5,9,0,6,2,4,4,1
09114957,2,2,0,0,1,1,0,0,1
09115085,1,1,0,0,1,1,0,0,0
09115170,2,2,0,0,3,3,0,1,1
09115222,10,6,4,0,1,1,0,0,1
09115553,4,2,2,0,2,1,1,2,0
09115861,1,1,0,0,1,1,0,0,0
09116502,5,3,2,0,2,2,0,0,1
09116596,2,0,2,0,0,0,0,0,0
09116683,2,1,1,0,1,1,0,0,1
09116938,2,2,0,0,2,2,0,0,1
09117243,13,6,7,0,3,3,0,3,1
09117256,1,1,0,0,2,2,0,0,0
09117961,12,5,7,0,2,2,0,2,0
09118770,16,10,6,0,5,4,1,0,1
09118860,1,0,1,0,0,0,0,0,0
09118912,3,3,0,0,3,3,0,1,1
09119069,2,1,1,0,2,2,0,0,0
09119229,1,0,1,0,0,0,0,0,0
09121158,3,3,0,0,2,2,0,0,1
09121352,19,10,9,0,2,2,0,2,1
09121572,23,10,13,0,1,1,0,1,1
09121616,4,4,0,0,4,4,0,0,0
09122058,2,0,2,0,1,1,0,0,0
09122076,2,0,2,0,1,1,0,0,0
09122123,4,4,0,0,3,3,0,0,0
09122208,2,0,2,0,1,1,0,0,0
09122589,1,1,0,0,1,1,0,1,0
09123030,3,1,2,0,1,1,0,0,0
09123347,2,0,2,0,1,1,0,0,0
09123355,2,0,2,0,1,1,0,0,0
09123359,2,0,2,0,1,1,0,0,0
09123386,2,0,2,0,1,1,0,0,0
09123466,4,2,2,0,1,1,0,0,0
09123563,4,0,4,0,1,1,0,0,0
09123578,2,0,2,0,1,1,0,0,0
09123615,7,0,7,0,0,0,0,0,1
09123713,9,5,4,0,1,1,0,0,1
09123811,9,2,7,0,7,1,6,4,1
09124006,4,2,2,0,2,2,0,0,0
09124176,1,0,1,0,0,0,0,0,0
09124758,2,2,0,0,1,1,0,0,0
09125322,3,2,1,0,2,2,0,0,0
09125376,2,0,2,0,1,1,0,0,0
09125426,6,5,1,0,1,1,0,1,1
09125441,7,0,7,0,0,0,0,0,1
09125474,2,0,2,0,1,1,0,0,0
09125522,2,0,2,0,1,1,0,0,0
09125542,4,3,1,0,3,3,0,0,0
09125898,1,1,0,0,2,2,0,0,0
09125901,3,2,1,0,2,2,0,0,0
09125965,2,2,0,0,2,2,0,0,0
09126010,13,10,3,0,0,0,0,0,0
09126455,2,2,0,0,2,2,0,0,1
09126513,1,1,0,0,1,1,0,0,0
09126900,1,1,0,0,1,1,0,0,1
09127240,1,1,0,0,1,1,0,0,0
09127390,4,3,1,0,1,1,0,1,1
09127436,7,5,2,0,1,1,0,1,1
09127524,4,4,0,0,0,0,0,0,1
09127721,1,1,0,0,1,1,0,0,0
09127749,6,0,6,0,4,1,3,1,0
09127759,5,2,3,0,3,3,0,1,0
09128004,4,3,1,0,1,1,0,0,1
09128201,5,2,3,0,3,3,0,1,0
09128258,5,2,3,0,3,3,0,1,0
09128554,1,0,1,0,1,1,0,0,0
09129276,2,0,2,0,0,0,0,0,0
09129871,1,0,1,0,1,1,0,0,0
09129982,2,0,2,0,1,1,0,0,0
09130241,2,1,1,0,2,2,0,0,1
09130256,7,4,3,0,1,1,0,1,1
09130381,7,6,1,0,0,0,0,0,0
09130543,2,0,2,0,0,0,0,0,1
09130872,2,1,1,0,1,1,0,0,1
09131035,2,2,0,0,0,0,0,0,0
09131462,2,2,0,0,2,2,0,0,1
09131766,3,2,1,0,1,1,0,1,0
09131811,2,1,1,0,1,1,0,0,0
09131927,1,1,0,0,1,1,0,0,1
09131932,2,0,2,0,0,0,0,0,1
09132182,3,0,3,0,0,0,0,0,0
09132197,2,0,2,1,0,0,0,0,1
09132285,2,1,1,0,2,1,1,0,0
09132565,3,1,2,0,1,1,0,0,0
09132788,2,1,1,0,1,1,0,0,0
09132799,5,0,5,0,2,1,1,0,0
09132892,5,1,4,0,3,1,2,0,0
09133329,1,0,1,0,0,0,0,0,0
09133376,1,1,0,0,1,1,0,0,0
09133434,7,4,3,0,1,1,0,0,1
09134529,6,0,6,0,0,0,0,0,1
09134997,17,8,9,0,1,1,0,1,1
09135131,10,2,8,0,1,1,0,1,1
09135247,3,0,3,0,3,3,0,1,1
09136178,2,2,0,0,1,1,0,0,0
09136241,4,2,2,0,1,1,0,0,0
09136349,4,2,2,0,1,1,0,1,1
09136408,7,3,4,0,2,2,0,0,0
09136426,2,0,2,0,2,2,0,0,1
09136445,24,13,11,0,0,0,0,0,1
09136556,22,10,12,0,0,0,0,0,0
09136562,2,0,2,0,0,0,0,0,1
09136616,8,1,7,0,2,1,1,0,0
09136682,3,2,1,0,1,1,0,0,1
09136791,9,1,8,0,3,1,2,0,0
09137257,3,3,0,0,2,2,0,0,0
09137361,2,2,0,0,2,2,0,1,0
09137387,7,7,0,0,4,2,2,2,1
09137413,5,1,4,0,3,1,2,0,0
09137525,10,1,9,0,4,1,3,0,0
09137766,4,3,1,0,4,3,1,0,0
09137938,3,0,3,0,2,2,0,0,0
09137960,1,1,0,0,1,1,0,0,0
09138004,6,3,3,0,0,0,0,0,0
09138181,3,2,1,0,1,1,0,1,0
09138209,2,2,0,0,2,2,0,0,0
09138475,1,0,1,0,1,1,0,0,1
09138849,4,1,3,0,1,1,0,0,1
09138890,1,1,0,0,1,1,0,0,0
09138930,14,8,6,0,0,0,0,0,1
09138979,8,1,7,0,5,1,4,0,0
09139224,8,1,7,0,3,1,2,0,0
09139394,4,2,2,0,2,2,0,0,0
09140467,1,1,0,0,2,2,0,0,0
09140632,4,4,0,0,2,2,0,0,1
09141136,2,2,0,0,1,1,0,0,1
09141973,1,1,0,0,1,1,0,0,0
09142567,3,2,1,0,1,1,0,0,1
09142724,10,6,4,0,2,2,0,0,1
09142792,2,0,2,0,0,0,0,0,1
09142869,3,2,1,0,1,1,0,0,0
09143049,2,0,2,0,1,1,0,0,1
09143387,1,0,1,0,1,1,0,0,1
09143445,3,1,2,0,1,1,0,0,0
09143532,2,2,0,0,1,1,0,0,1
09143585,1,1,0,0,1,1,0,0,0
09143601,16,1,15,0,6,1,5,0,0
09143718,3,2,1,0,1,1,0,0,0
09144647,14,8,6,0,2,1,1,2,1
09144761,2,1,1,0,2,1,1,0,0
09144802,3,3,0,0,0,0,0,0,0
09144988,2,0,2,0,0,0,0,0,1
09145056,2,2,0,0,2,2,0,0,0
09145229,2,2,0,0,2,2,0,0,0
09145239,1,1,0,0,1,1,0,0,0
09145297,2,2,0,0,2,2,0,0,0
09145336,4,0,4,0,0,0,0,0,1
09145482,1,1,0,0,2,2,0,0,0
09145527,1,0,1,0,1,1,0,0,0
09145635,1,1,0,0,1,1,0,0,0
09145738,6,3,3,0,3,1,2,1,1
09145939,3,3,0,0,2,2,0,0,0
09146125,4,1,3,0,1,1,0,0,1
09146323,3,0,3,0,0,0,0,0,1
09146452,1,1,0,0,1,1,0,0,0
09146865,1,1,0,0,1,1,0,0,0
09147059,11,6,5,0,0,0,0,0,0
09147156,3,2,1,0,2,2,0,0,0
09147268,8,0,8,0,3,1,2,0,0
09147297,2,0,2,0,0,0,0,0,0
09147387,3,2,1,0,1,1,0,0,0
09147870,3,3,0,0,1,1,0,0,0
09147951,3,0,3,0,0,0,0,0,0
09148081,3,3,0,0,3,3,0,0,0
09148134,6,5,1,0,1,1,0,1,1
09148310,4,4,0,0,1,1,0,0,1
09148399,1,1,0,0,1,1,0,0,0
09148747,3,1,2,0,1,1,0,0,1
09148896,2,0,2,0,2,2,0,0,0
09148904,3,1,2,0,1,1,0,0,1
09149004,5,5,0,0,1,1,0,1,1
09149177,1,1,0,0,1,1,0,0,0
09149419,1,0,1,0,0,0,0,0,0
09150035,5,4,1,0,1,1,0,0,0
09150715,21,9,12,0,0,0,0,0,0
09150752,2,1,1,0,2,1,1,0,0
09150859,2,2,0,0,1,1,0,0,1
09151051,22,3,19,0,0,0,0,0,1
09151056,1,1,0,0,1,1,0,0,0
09151816,1,1,0,0,1,1,0,0,0
09152074,2,1,1,0,1,1,0,0,0
09152652,3,3,0,0,2,2,0,0,0
09153785,4,3,1,0,2,2,0,1,0
09154350,4,1,3,0,1,1,0,0,0
09154420,2,0,2,0,1,1,0,1,1
09154707,4,4,0,0,1,1,0,0,0
09154843,1,1,0,0,1,1,0,0,0
09154850,22,4,18,0,1,1,0,1,1
09154929,6,5,1,0,0,0,0,0,0
09155074,1,1,0,0,1,1,0,0,0
09155112,34,16,18,0,0,0,0,0,1
09155226,3,0,3,0,2,2,0,0,0
09155669,2,0,2,0,0,0,0,0,0
09155970,17,3,14,0,1,1,0,1,1
09155980,17,3,14,0,1,1,0,1,1
09156393,23,14,9,0,0,0,0,0,1
09156590,4,0,4,0,0,0,0,0,1
09156760,2,1,1,0,2,1,1,0,0
09156982,2,2,0,0,2,2,0,0,1
09157039,4,4,0,0,2,2,0,0,0
09157216,3,1,2,0,2,1,1,0,0
09157234,5,1,4,0,1,1,0,0,0
09157307,2,2,0,0,3,3,0,1,0
09157851,2,2,0,0,2,2,0,0,1
09157892,22,4,18,0,1,1,0,1,1
09158229,1,1,0,0,1,1,0,0,1
09158397,4,3,1,0,0,0,0,0,0
09158492,2,0,2,0,1,1,0,0,0
09158586,8,6,2,0,0,0,0,0,1
09159397,3,3,0,0,2,2,0,0,0
09159507,1,1,0,0,2,2,0,2,0
09160126,9,3,6,0,1,1,0,1,1
09160650,2,2,0,0,2,2,0,0,0
09161046,1,1,0,0,2,2,0,0,0
09161117,3,2,1,0,2,2,0,0,0
09161172,2,0,2,0,0,0,0,0,0
09161859,4,3,1,0,1,1,0,1,1
09162507,7,5,2,0,3,1,2,1,1
09162767,7,3,4,0,1,1,0,1,1
09162879,2,2,0,0,3,1,2,1,1
09163577,10,3,7,0,1,1,0,1,1
09163676,4,0,4,0,1,1,0,0,0
09164117,2,2,0,0,1,1,0,0,0
09164128,2,1,1,0,2,1,1,0,0
09164146,6,5,1,0,1,1,0,1,1
09164322,6,0,6,0,2,1,1,2,1
09164378,6,3,3,0,2,1,1,2,1
09164504,2,1,1,0,2,2,0,1,0
09164619,6,4,2,0,3,1,2,1,1
09164759,2,0,2,0,0,0,0,0,1
09165169,1,1,0,0,1,1,0,0,0
09165174,1,0,1,0,0,0,0,0,0
09165220,9,4,5,0,1,1,0,1,1
09165649,1,1,0,0,1,1,0,0,0
09166030,5,5,0,0,2,2,0,0,1
09166756,2,0,2,0,2,2,0,1,1
09166782,8,6,2,0,1,1,0,0,1
09166829,2,1,1,0,2,1,1,2,1
09167362,2,2,0,0,2,2,0,0,0
09168993,7,3,4,0,3,1,2,1,1
09169441,1,1,0,0,0,0,0,0,1
09169583,4,4,0,0,1,1,0,0,1
09169881,1,0,1,0,0,0,0,0,0
02995487,14,5,9,0,2,2,0,0,1
02995531,44,4,40,0,1,1,0,1,1
02995545,8,2,6,0,1,1,0,0,0
02995748,16,4,12,0,1,1,0,0,1
02995811,55,6,49,0,0,0,0,0,1
02995859,44,3,41,0,0,0,0,0,1
02996018,5,0,5,0,0,0,0,0,1
02996104,76,5,71,0,1,1,0,1,1
02996181,20,2,18,0,1,1,0,1,1
02996482,9,2,7,0,1,1,0,0,1
02996620,25,0,25,0,0,0,0,0,1
02996991,4,2,2,0,2,2,0,0,1
02997013,11,3,8,0,2,2,0,0,1
02997067,28,6,22,0,0,0,0,0,1
02997371,25,6,19,0,1,1,0,1,1
02997500,25,2,23,0,1,1,0,1,1
02997682,22,0,22,0,0,0,0,0,1
02997845,25,6,19,0,1,1,0,1,1
02997883,56,9,47,0,0,0,0,0,1
02997884,7,0,7,0,0,0,0,0,1
02997941,29,4,25,0,1,1,0,1,1
02997981,17,3,14,0,4,1,3,1,0
02998017,17,7,10,0,1,1,0,0,1
02998217,68,4,64,0,1,1,0,1,1
02998223,12,4,8,1,2,0,2,2,1
02998337,13,2,11,0,1,1,0,1,1
02998440,31,0,31,0,0,0,0,0,1
02998539,13,2,11,0,1,1,0,0,1
02998558,21,3,18,0,1,1,0,1,1
02998594,53,7,46,0,2,2,0,2,1
02998595,49,10,39,0,3,1,2,1,1
02998648,55,4,51,0,1,1,0,1,1
02998677,11,2,9,0,2,1,1,1,1
02998803,36,4,32,0,2,1,1,2,1
02998831,15,4,11,0,2,2,0,1,0
02998937,19,5,14,0,0,0,0,0,1
02998938,7,2,5,0,1,1,0,0,1
02999055,83,9,74,0,0,0,0,0,1
02999282,13,3,10,0,0,0,0,0,1
02999396,23,3,20,0,1,1,0,1,1
02999408,25,4,21,0,1,1,0,1,0
02999760,21,1,20,0,1,1,0,1,1
02999946,10,0,10,0,0,0,0,0,1
02999960,34,4,30,0,1,1,0,1,1
03000049,37,11,26,0,0,0,0,0,1
03000118,13,5,8,0,1,1,0,0,1
03000262,5,3,2,0,3,2,1,0,0
03000322,16,4,12,0,0,0,0,0,0
03000727,16,0,16,0,1,1,0,1,1
03001101,19,9,10,0,0,0,0,0,1
03001280,23,5,18,0,1,1,0,0,1
03001328,7,0,7,0,0,0,0,0,1
03001459,13,3,10,0,1,1,0,0,1
03001560,28,4,24,0,0,0,0,0,1
03001770,22,2,20,0,0,0,0,0,1
03001965,6,2,4,0,1,1,0,0,0
03002007,19,3,16,1,1,1,0,1,1
03002060,7,2,5,0,2,2,0,0,1
03002073,21,3,18,0,1,1,0,1,1
03002114,47,0,47,0,0,0,0,0,1
03002128,25,4,21,0,1,1,0,1,1
03002174,20,2,18,0,1,1,0,1,1
03002186,14,0,14,0,0,0,0,0,1
03002190,0,0,0,0,0,0,0,0,1
03002199,14,0,14,0,0,0,0,0,1
03002306,9,2,7,0,2,2,0,0,1
03002336,9,3,6,0,2,2,0,0,0
03002557,12,3,9,0,1,1,0,1,1
03002592,35,0,35,0,0,0,0,0,1
03002594,5,3,2,0,2,2,0,0,1
03002689,17,3,14,0,1,1,0,1,1
03002772,18,3,15,0,1,1,0,1,0
03002784,17,0,17,0,0,0,0,0,1
03003212,24,0,24,0,0,0,0,0,1
03003338,30,5,25,0,0,0,0,0,1
03003429,46,6,40,0,0,0,0,0,1
03003533,32,0,32,0,0,0,0,0,1
03003537,5,3,2,0,2,2,0,0,1
03003539,4,1,3,0,1,1,0,1,1
03003612,9,4,5,0,1,1,0,1,1
03003797,21,0,21,0,0,0,0,0,1
03003852,6,0,6,0,0,0,0,0,1
03003900,23,5,18,0,0,0,0,0,1
03004156,19,5,14,0,4,4,0,0,1
03004175,6,1,5,0,1,1,0,0,1
03004377,55,10,45,0,0,0,0,0,1
03004438,4,2,2,0,1,1,0,0,1
03004769,34,3,31,0,1,1,0,1,1
03004959,39,8,31,0,1,1,0,1,1
03005111,9,4,5,0,1,1,0,0,0
03005185,4,2,2,0,1,1,0,0,0
03005200,10,7,3,0,2,2,0,0,1
03005233,14,2,12,0,2,1,1,1,0
03005366,10,3,7,0,3,2,1,0,1
03005520,63,13,50,0,1,1,0,0,1
03005581,11,0,11,0,0,0,0,0,1
03005603,42,6,36,0,0,0,0,0,1
03005621,3,2,1,0,1,1,0,0,0
03005720,14,3,11,0,1,1,0,1,1
03005721,22,4,18,0,0,0,0,0,1
03005774,40,4,36,0,1,1,0,1,1
03005933,67,15,52,0,0,0,0,0,1
03006066,17,6,11,0,0,0,0,0,1
03006074,5,3,2,0,2,2,0,0,1
03006203,22,3,19,0,2,2,0,0,1
03006237,5,1,4,0,1,1,0,0,1
03006529,27,6,21,0,1,1,0,1,1
03006563,38,3,35,0,1,1,0,1,1
03006571,34,1,33,0,1,1,0,1,1
03006668,11,3,8,0,2,2,0,0,1
03006948,43,0,43,0,0,0,0,0,1
03007373,6,3,3,0,0,0,0,0,1
03007386,6,3,3,0,1,1,0,0,1
03007422,16,0,16,0,0,0,0,0,1
03007485,12,2,10,0,1,1,0,1,1
03007536,30,1,29,0,1,1,0,1,1
03007662,56,9,47,0,0,0,0,0,1
03007934,45,2,43,0,1,1,0,1,1
03007935,45,2,43,0,1,1,0,1,1
03007938,40,2,38,0,1,1,0,1,1
03007943,33,2,31,0,1,1,0,1,1
03007944,49,2,47,0,1,1,0,1,1
03008394,6,4,2,0,1,1,0,1,1
03008538,14,0,14,0,0,0,0,0,1
03008745,12,5,7,0,0,0,0,0,1
03008820,45,0,45,0,0,0,0,0,1
03008942,14,4,10,0,0,0,0,0,1
03008953,6,3,3,0,2,2,0,0,1
03008968,32,3,29,0,1,1,0,1,1
03008985,14,4,10,0,1,1,0,1,1
03008987,20,0,20,0,1,1,0,1,1
03009023,10,5,5,0,1,1,0,1,1
03009111,10,2,8,0,0,0,0,0,1
03009141,44,6,38,0,0,0,0,0,0
03009426,44,5,39,0,1,1,0,1,1
03009441,11,0,11,0,0,0,0,0,0
03009473,10,3,7,0,3,3,0,1,0
03009598,21,2,19,0,1,1,0,0,1
03009972,68,7,61,0,4,3,1,3,1
03009992,20,0,20,0,0,0,0,0,1
03010091,21,4,17,0,0,0,0,0,1
03010219,3,0,3,0,0,0,0,0,1
03010228,49,10,39,0,0,0,0,0,1
03010321,45,3,42,0,1,1,0,1,1
03010460,21,1,20,0,1,1,0,1,0
03010919,45,3,42,0,1,1,0,1,1
03011024,4,0,4,0,0,0,0,0,1
03011029,57,2,55,0,1,1,0,1,1
03011053,71,10,61,0,1,1,0,0,1
03011075,7,0,7,0,0,0,0,0,1
03011193,65,4,61,0,1,1,0,1,1
03011737,60,11,49,0,13,10,3,0,1
03011753,39,0,39,0,0,0,0,0,1
03011768,20,5,15,0,0,0,0,0,1
03011784,37,4,33,0,1,1,0,1,1
03012087,8,3,5,0,0,0,0,0,0
03012216,16,0,16,0,0,0,0,0,1
03012218,33,5,28,0,1,1,0,1,1
03012293,19,3,16,0,2,1,1,2,1
03012315,10,2,8,0,1,1,0,0,1
03012351,54,14,40,0,0,0,0,0,1
03012622,19,2,17,0,1,1,0,1,1
03012624,15,0,15,0,0,0,0,0,1
03012758,22,4,18,0,0,0,0,0,1
03013036,45,0,45,0,0,0,0,0,1
03013136,11,0,11,0,0,0,0,0,1
03013232,39,3,36,0,1,1,0,1,1
03013260,8,1,7,0,0,0,0,0,0
03013301,17,4,13,0,6,6,0,0,1
03013406,24,3,21,0,1,1,0,1,1
03013493,79,0,79,0,0,0,0,0,1
03013518,10,2,8,0,1,1,0,0,0
03013570,4,2,2,0,2,2,0,0,1
03013578,10,0,10,0,1,1,0,1,1
03013581,5,1,4,0,1,1,0,0,1
03013585,8,4,4,0,1,1,0,0,1
03013591,5,0,5,0,2,2,0,0,1
03013746,8,2,6,0,1,1,0,1,1
03014046,5,2,3,0,2,2,0,0,1
03014351,25,3,22,0,0,0,0,0,0
03014389,9,5,4,0,2,2,0,0,1
03014422,18,4,14,0,0,0,0,0,0
03014594,12,4,8,0,1,1,0,0,0
03014889,22,3,19,0,2,1,1,2,1
03015012,101,13,88,0,1,1,0,0,1
03015175,13,4,9,0,1,1,0,1,1
03015215,18,2,16,0,1,1,0,1,1
03015434,13,3,10,0,1,1,0,1,1
03015439,21,5,16,0,1,1,0,0,1
03015817,12,0,12,0,0,0,0,0,1
03015880,6,2,4,0,0,0,0,0,1
03016120,9,2,7,0,2,2,0,0,1
03016409,28,3,25,0,1,1,0,1,1
03016445,9,1,8,0,1,1,0,0,1
03016796,26,9,17,0,0,0,0,0,1
03016827,6,3,3,0,2,2,0,0,0
03016875,10,2,8,0,2,2,0,1,0
03016902,15,0,15,0,0,0,0,0,1
03017046,26,0,26,0,0,0,0,0,1
03017258,30,5,25,0,2,1,1,1,1
03017341,4,0,4,0,0,0,0,0,1
03017402,10,2,8,0,1,1,0,0,1
03017503,15,3,12,0,2,2,0,0,1
03017758,4,2,2,0,0,0,0,0,0
03017841,28,14,14,0,2,1,1,2,0
03017958,48,3,45,0,1,1,0,1,1
03018113,5,3,2,0,2,2,0,0,1
03018519,30,5,25,0,1,1,0,1,1
03019029,14,1,13,0,1,1,0,1,1
03019081,43,10,33,0,0,0,0,0,1
03019096,17,5,12,0,0,0,0,0,1
03019108,13,6,7,0,0,0,0,0,1
03019187,9,3,6,0,1,1,0,0,1
03019190,4,0,4,0,1,1,0,0,0
03019293,100,0,100,0,0,0,0,0,1
03019355,21,0,21,0,0,0,0,0,1
03019717,13,3,10,0,0,0,0,0,1
03019773,29,0,29,0,1,1,0,1,1
03019859,5,3,2,0,2,2,0,0,1
SC200076,38,0,38,0,1,1,0,1,1
SC200185,5,3,2,0,3,3,0,0,0
SC200212,32,4,28,0,1,1,0,1,1
SC200213,5,3,2,0,1,1,0,0,0
SC200368,7,0,7,0,0,0,0,0,0
SC200403,18,2,16,0,1,1,0,1,1
SC200436,5,0,5,0,0,0,0,0,1
SC200513,13,2,11,0,1,1,0,1,1
SC200596,12,4,8,0,1,1,0,1,1
SC200700,5,0,5,0,0,0,0,0,0
SC200777,89,39,50,1,0,0,0,0,1
SC200827,52,11,41,1,0,0,0,0,1
SC200884,5,3,2,0,1,1,0,0,1
SC200887,29,3,26,0,2,1,1,2,1
SC200911,19,3,16,0,1,1,0,0,1
SC200914,11,3,8,0,1,1,0,1,1
SC200916,19,4,15,0,1,1,0,1,1
SC201063,25,0,25,0,1,1,0,1,1
SC201105,8,7,1,0,1,1,0,1,1
SC201246,6,0,6,0,1,1,0,0,1
SC201265,5,3,2,0,0,0,0,0,0
SC201378,14,3,11,0,0,0,0,0,1
SC201401,60,11,49,0,0,0,0,0,1
SC201416,13,5,8,0,1,1,0,1,1
SC201581,7,4,3,0,2,2,0,0,1
SC201645,27,10,17,0,5,1,4,0,0
SC201649,7,5,2,0,1,1,0,1,1
SC201651,9,3,6,0,0,0,0,0,1
SC201947,18,5,13,0,1,1,0,0,0
SC201982,5,1,4,0,2,1,1,0,0
SC202026,8,0,8,0,1,1,0,1,1
SC202088,11,3,8,0,2,2,0,0,1
SC202089,4,3,1,0,2,2,0,0,1
SC202102,28,8,20,0,1,1,0,1,1
SC202142,8,0,8,0,0,0,0,0,0
SC202170,18,4,14,0,1,1,0,1,1
SC202258,13,4,9,0,1,1,0,0,1
SC202264,29,2,27,0,0,0,0,0,1
SC202394,20,2,18,0,1,1,0,1,1
SC202445,52,5,47,0,0,0,0,0,0
SC202454,10,0,10,0,0,0,0,0,0
SC202791,47,7,40,0,0,0,0,0,1
SC202909,20,3,17,1,0,0,0,0,1
SC203062,7,0,7,0,0,0,0,0,1
SC203138,4,0,4,0,0,0,0,0,1
SC203174,8,0,8,0,0,0,0,0,1
SC203223,15,5,10,0,0,0,0,0,0
SC203416,15,3,12,0,2,2,0,0,1
SC203613,47,5,42,0,0,0,0,0,1
SC203624,22,0,22,0,0,0,0,0,1
SC203728,5,3,2,0,1,1,0,0,1
SC203732,13,0,13,0,0,0,0,0,1
SC203750,34,24,10,0,1,1,0,1,1
SC203853,12,3,9,0,3,2,1,0,1
SC204326,9,0,9,0,1,1,0,0,1
SC204327,10,0,10,0,1,1,0,1,1
SC204555,35,3,32,0,0,0,0,0,0
SC204564,6,2,4,0,1,1,0,1,0
SC204637,7,5,2,0,1,1,0,0,0
SC204757,26,3,23,0,1,1,0,1,1
SC204956,12,3,9,0,3,2,1,0,1
SC205004,52,9,43,0,0,0,0,0,0
SC205070,10,2,8,0,1,1,0,0,1
SC205206,21,0,21,0,0,0,0,0,1
SC205318,10,1,9,0,1,1,0,1,1
SC205426,17,2,15,0,1,1,0,1,1
SC205475,20,0,20,0,0,0,0,0,1
SC205538,4,2,2,0,1,1,0,1,1
SC205657,11,5,6,0,1,1,0,0,0
SC205786,6,4,2,0,2,2,0,0,0
SC206005,27,0,27,1,0,0,0,0,1
SC206116,21,0,21,0,0,0,0,0,1
SC206158,23,0,23,0,0,0,0,0,1
SC206283,9,2,7,0,1,1,0,0,1
SC206477,5,0,5,0,0,0,0,0,1
SC206683,18,3,15,0,1,1,0,1,1
SC206844,33,2,31,0,1,1,0,0,1
SC206936,16,0,16,0,0,0,0,0,1
SC206994,23,5,18,0,1,1,0,0,1
SC207126,31,6,25,0,1,1,0,1,0
SC207266,7,3,4,0,1,1,0,1,1
SC207268,14,0,14,0,0,0,0,0,1
SC207274,33,5,28,0,0,0,0,0,1
SC207309,12,0,12,0,0,0,0,0,1
SC207312,22,0,22,0,0,0,0,0,1
SC207313,7,0,7,0,0,0,0,0,1
SC207315,16,7,9,0,1,1,0,1,1
SC207316,5,2,3,0,1,1,0,0,1
SC207391,33,11,22,0,0,0,0,0,1
SC207497,5,2,3,1,2,2,0,0,1
SC207756,23,0,23,0,0,0,0,0,1
SC207810,5,0,5,0,1,1,0,0,1
SC207825,5,3,2,0,1,1,0,0,0
SC207862,6,5,1,0,1,1,0,0,1
SC207926,27,6,21,0,0,0,0,0,0
SC207937,6,3,3,0,2,2,0,0,0
SC207989,24,7,17,0,0,0,0,0,1
SC208030,14,0,14,0,0,0,0,0,1
SC208201,7,5,2,0,1,1,0,0,1
SC208241,20,10,10,0,0,0,0,0,0
SC208319,6,0,6,0,0,0,0,0,1
SC208512,4,2,2,0,1,1,0,0,0
SC208635,21,2,19,0,2,1,1,2,1
SC208806,21,0,21,1,1,1,0,1,1
SC208831,33,6,27,0,2,1,1,0,0
SC208837,9,1,8,0,1,1,0,0,1
SC208840,31,0,31,0,3,3,0,3,1
SC208934,32,3,29,0,2,2,0,2,1
SC208965,11,6,5,0,0,0,0,0,0
SC209016,7,3,4,0,2,2,0,0,0
SC209017,11,5,6,0,1,1,0,1,1
SC209090,21,0,21,0,1,1,0,1,1
SC209106,40,12,28,0,0,0,0,0,0
SC209111,8,1,7,0,1,1,0,0,0
SC209148,47,0,47,1,1,1,0,1,1
SC209180,16,0,16,0,0,0,0,0,1
SC209203,11,4,7,0,1,1,0,1,1
SC209205,13,0,13,0,1,1,0,1,1
SC209206,18,6,12,0,0,0,0,0,1
SC209297,11,0,11,0,0,0,0,0,1
SC209393,13,4,9,1,3,2,1,0,1
SC209837,11,1,10,0,3,1,2,0,1
SC209936,19,5,14,0,0,0,0,0,1
SC210035,21,3,18,0,1,1,0,1,1
SC210146,15,0,15,0,1,1,0,1,0
SC210229,14,7,7,0,1,1,0,0,1
SC210231,14,6,8,1,1,1,0,1,1
SC210263,28,15,13,0,1,1,0,1,1
SC210264,36,20,16,0,1,1,0,1,1
SC210282,18,0,18,0,0,0,0,0,1
SC210361,42,5,37,0,2,1,1,2,1
SC210423,24,0,24,1,0,0,0,0,1
SC210525,11,5,6,0,1,1,0,1,1
SC210599,13,0,13,0,0,0,0,0,1
SC210686,19,4,15,0,1,1,0,1,1
SC210712,10,3,7,0,1,1,0,1,1
SC210822,50,10,40,0,0,0,0,0,0
SC211082,5,2,3,0,0,0,0,0,0
SC211181,20,0,20,0,0,0,0,0,1
SC211185,9,4,5,0,1,1,0,1,1
SC211214,22,2,20,0,1,1,0,1,1
SC211318,5,3,2,0,2,2,0,0,0
SC211429,39,7,32,0,0,0,0,0,1
SC211524,28,3,25,0,2,1,1,2,1
SC211594,25,3,22,0,3,1,2,3,1
SC211701,10,2,8,0,3,1,2,1,1
SC211971,18,0,18,0,0,0,0,0,1
SC212146,0,0,0,0,0,0,0,0,1
SC212159,27,4,23,0,1,1,0,1,1
SC212253,10,4,6,0,1,1,0,1,1
SC212334,42,7,35,0,2,1,1,0,1
SC212396,8,0,8,0,0,0,0,0,1
SC212431,10,0,10,0,0,0,0,0,1
SC212532,8,5,3,0,3,3,0,0,1
SC212590,8,2,6,0,2,2,0,2,1
SC212591,8,2,6,0,2,2,0,2,1
SC212595,17,3,14,0,1,1,0,1,1
SC212718,10,0,10,0,1,1,0,1,0
SC212855,14,3,11,0,1,1,0,1,1
SC212906,7,0,7,0,0,0,0,0,1
SC213006,7,0,7,0,1,1,0,0,0
SC213049,15,5,10,0,3,1,2,1,1
SC213050,37,14,23,0,0,0,0,0,1
SC213155,20,2,18,0,1,1,0,1,1
SC213191,4,0,4,0,0,0,0,0,1
SC213269,7,0,7,0,0,0,0,0,1
SC213282,17,4,13,0,5,2,3,2,0
SC213295,7,0,7,0,0,0,0,0,1
SC213374,38,4,34,0,1,1,0,1,1
SC213376,38,4,34,0,1,1,0,1,1
SC213377,38,4,34,0,1,1,0,1,1
SC213381,7,2,5,1,1,1,0,1,1
SC213572,6,3,3,0,1,1,0,0,1
SC213606,6,0,6,1,1,1,0,0,1
SC213607,6,0,6,1,1,1,0,0,1
SC213640,17,6,11,1,1,1,0,1,1
SC213726,12,0,12,0,0,0,0,0,1
SC213984,6,4,2,0,1,1,0,0,1
SC213985,7,4,3,0,1,1,0,0,1
SC214001,4,2,2,0,1,1,0,0,0
SC214185,6,0,6,0,0,0,0,0,1
SC214199,4,2,2,0,1,1,0,0,0
SC214204,14,4,10,0,2,2,0,2,1
SC214269,35,8,27,0,0,0,0,0,0
SC214374,4,0,4,0,0,0,0,0,1
SC214415,13,4,9,0,1,1,0,1,1
SC214482,7,2,5,0,1,1,0,0,1
SC214564,119,22,97,0,0,0,0,0,1
SC214606,4,3,1,0,1,1,0,0,1
SC214681,43,7,36,1,0,0,0,0,1
SC214719,32,4,28,0,0,0,0,0,0
SC214791,50,8,42,0,0,0,0,0,0
SC214809,8,4,4,0,1,1,0,1,1
SC214816,7,4,3,0,4,4,0,0,1
SC214851,26,3,23,0,5,5,0,2,1
SC214859,9,6,3,0,2,2,0,1,1
SC214892,25,2,23,0,2,1,1,2,1
SC214915,58,0,58,0,0,0,0,0,1
SC214919,7,0,7,1,0,0,0,0,1
SC214930,8,0,8,0,0,0,0,0,1
SC215035,12,4,8,0,1,1,0,1,1
SC215097,22,0,22,0,1,1,0,1,1
SC215165,18,0,18,0,0,0,0,0,1
SC215476,6,2,4,0,2,2,0,0,0
SC215719,8,2,6,0,2,1,1,0,0
SC215744,9,4,5,0,1,1,0,0,0
SC215951,7,0,7,0,0,0,0,0,1
SC216001,8,3,5,0,1,1,0,0,0
SC216097,11,5,6,0,2,2,0,0,0
SC216180,11,3,8,0,1,1,0,1,0
SC216290,20,3,17,0,1,1,0,1,1
SC216395,7,2,5,0,1,1,0,0,0
SC216556,9,3,6,0,3,3,0,3,0
SC216638,24,6,18,0,0,0,0,0,1
SC216691,7,1,6,1,2,2,0,0,1
SC216821,2,2,0,0,0,0,0,0,1
SC216881,11,0,11,0,1,1,0,1,1
SC216955,11,0,11,0,1,1,0,1,1
SC216956,7,0,7,0,0,0,0,0,1
SC216992,23,6,17,0,1,1,0,1,1
SC217020,26,5,21,1,1,1,0,1,1
SC217093,33,6,27,0,1,1,0,1,1
SC217115,12,0,12,0,0,0,0,0,1
SC217150,7,3,4,0,1,1,0,0,0
SC217231,17,2,15,0,1,1,0,1,1
SC217265,28,7,21,0,1,1,0,1,1
SC217314,6,0,6,0,2,2,0,0,1
SC217367,38,6,32,0,0,0,0,0,1
SC217836,12,5,7,0,0,0,0,0,1
SC217931,31,5,26,0,1,0,1,0,0
SC217976,21,3,18,0,1,1,0,1,1
SC218026,68,12,56,0,1,0,1,0,1
SC218085,18,0,18,0,1,1,0,0,0
SC218588,3,2,1,0,1,1,0,0,1
SC218691,6,0,6,0,0,0,0,0,0
SC218749,13,4,9,0,1,1,0,1,1
SC218813,78,13,65,0,1,1,0,1,1
SC219011,13,3,10,0,2,2,0,0,1
SC219163,4,2,2,0,1,1,0,0,0
SC219233,10,3,7,1,1,1,0,0,1
SC219284,33,3,30,0,1,1,0,1,1
SC219319,43,6,37,0,0,0,0,0,1
SC219347,4,3,1,0,2,2,0,0,0
SC219483,15,3,12,0,2,1,1,1,1
SC219538,6,3,3,0,2,2,0,0,1
SC219601,32,9,23,0,0,0,0,0,1
SC219714,12,3,9,0,1,1,0,0,1
SC219765,23,0,23,1,0,0,0,0,1
SC219892,8,0,8,0,1,1,0,1,1
SC220213,34,8,26,0,0,0,0,0,1
SC220221,19,2,17,0,1,1,0,1,1
SC220297,81,13,68,0,0,0,0,0,1
SC220330,10,0,10,0,0,0,0,0,1
SC220379,10,0,10,0,0,0,0,0,1
SC220469,6,2,4,0,0,0,0,0,1
SC220711,10,1,9,0,1,1,0,0,1
SC220736,18,0,18,0,0,0,0,0,1
SC220804,2,0,2,0,0,0,0,0,1
SC220836,7,0,7,1,0,0,0,0,1
SC220907,9,3,6,0,2,2,0,0,1
SC220916,9,0,9,0,2,2,0,0,1
SC220929,6,3,3,0,1,1,0,0,1
SC220986,13,4,9,0,2,2,0,2,1
SC220987,8,4,4,0,2,1,1,0,1
SC220988,9,3,6,0,2,2,0,0,1
SC221013,7,0,7,0,0,0,0,0,1
SC221071,51,10,41,0,0,0,0,0,0
SC221093,8,4,4,0,2,1,1,0,1
SC221191,8,2,6,1,4,3,1,1,1
SC221240,4,2,2,1,1,1,0,0,1
SC221290,24,4,20,0,2,1,1,2,1
SC221428,23,8,15,0,0,0,0,0,1
SC221470,13,0,13,0,0,0,0,0,1
SC221592,18,0,18,1,1,1,0,1,1
SC221668,8,5,3,0,1,1,0,0,0
SC221813,11,7,4,0,0,0,0,0,0
SC221874,22,3,19,0,2,2,0,2,1
SC221954,35,5,30,0,1,1,0,1,1
SC222092,9,3,6,0,2,2,0,0,1
SC222126,6,4,2,0,2,2,0,0,0
SC222231,16,4,12,0,1,1,0,1,1
SC222304,6,4,2,0,1,1,0,0,1
SC222309,10,3,7,0,1,1,0,0,1
SC222439,32,13,19,0,0,0,0,0,1
SC222523,17,8,9,0,1,1,0,0,0
SC222542,2,2,0,0,1,1,0,0,1
SC222585,12,7,5,0,1,1,0,0,0
SC222904,14,3,11,0,0,0,0,0,1
SC223000,8,5,3,0,1,1,0,1,1
SC223015,15,2,13,0,1,1,0,1,1
SC223049,14,0,14,0,1,1,0,1,1
SC223101,14,0,14,0,1,1,0,1,1
SC223172,9,5,4,0,1,1,0,0,1
SC223286,6,0,6,0,0,0,0,0,1
SC223296,14,4,10,0,0,0,0,0,1
SC223302,45,12,33,0,0,0,0,0,1
SC223352,13,2,11,0,1,1,0,1,1
SC223362,14,6,8,0,1,1,0,1,1
SC223363,14,6,8,0,1,1,0,1,1
SC223616,7,2,5,0,1,1,0,0,1
SC223621,9,2,7,0,1,1,0,0,0
SC223801,22,8,14,0,2,2,0,2,0
SC224009,16,6,10,0,1,1,0,1,0
SC224070,15,6,9,0,0,0,0,0,0
SC224157,4,4,0,0,2,2,0,0,1
SC224158,4,4,0,0,2,2,0,0,1
SC224189,11,3,8,0,2,2,0,0,1
SC224193,5,2,3,0,0,0,0,0,1
SC224296,11,2,9,0,1,1,0,1,0
SC224403,16,2,14,0,1,1,0,1,1
SC224404,25,5,20,0,1,1,0,1,1
SC224459,9,2,7,0,2,2,0,0,1
SC224638,6,2,4,0,1,1,0,0,0
SC224718,27,7,20,0,0,0,0,0,0
02368235,39,4,35,0,1,1,0,1,1
02368530,33,1,32,0,3,1,2,0,1
02368728,26,3,23,0,1,1,0,1,1
02368763,39,0,39,0,0,0,0,0,1
02368966,15,0,15,0,0,0,0,0,1
02368991,7,2,5,0,1,1,0,1,0
02369239,58,23,35,0,0,0,0,0,1
02369251,6,5,1,0,2,2,0,0,1
02369679,37,5,32,0,1,1,0,1,1
02369719,36,11,25,0,0,0,0,0,1
02369721,27,0,27,0,0,0,0,0,1
02369824,37,3,34,0,2,1,1,2,1
02369828,98,0,98,0,0,0,0,0,1
02369965,42,4,38,0,1,1,0,1,1
02370089,33,0,33,0,1,1,0,1,1
02370374,10,5,5,0,0,0,0,0,1
02370509,30,0,30,0,0,0,0,0,1
02370591,13,3,10,0,2,2,0,0,1
02370592,51,3,48,0,0,0,0,0,1
02370612,39,3,36,0,0,0,0,0,1
02370868,62,11,51,0,0,0,0,0,1
02370894,25,4,21,0,1,1,0,1,1
02371112,16,4,12,0,1,1,0,0,1
02371452,22,5,17,0,1,1,0,0,0
02372056,13,3,10,0,3,3,0,1,1
02372114,21,0,21,0,0,0,0,0,1
02372255,22,3,19,0,1,1,0,1,1
02372311,36,3,33,0,1,1,0,1,1
02372439,48,7,41,0,1,1,0,1,1
02372487,34,3,31,0,1,1,0,1,1
02372592,20,0,20,0,1,1,0,1,1
02372619,4,1,3,0,1,1,0,0,1
02372740,53,22,31,0,0,0,0,0,1
02372789,51,4,47,0,1,1,0,1,1
02373160,9,3,6,0,1,1,0,0,1
02373389,13,3,10,0,1,1,0,1,1
02373490,18,3,15,0,1,1,0,1,1
02373630,83,8,75,0,0,0,0,0,1
02374117,22,0,22,0,0,0,0,0,1
02374322,2,0,2,0,0,0,0,0,1
02374570,73,0,73,0,0,0,0,0,1
02374985,19,4,15,0,3,3,0,0,1
02375067,7,3,4,0,1,1,0,0,1
02375077,41,8,33,0,3,3,0,1,1
02375426,34,0,34,0,0,0,0,0,1
02375859,25,0,25,0,0,0,0,0,1
02375865,37,4,33,0,1,1,0,1,1
02375927,6,4,2,0,2,2,0,0,1
02375962,16,3,13,0,0,0,0,0,1
02375963,44,0,44,0,1,1,0,1,1
02376257,9,4,5,0,0,0,0,0,0
02376427,5,3,2,0,2,2,0,0,1
02376684,62,9,53,0,1,1,0,1,1
02376698,20,3,17,0,0,0,0,0,1
02376828,17,0,17,0,0,0,0,0,1
02376959,37,4,33,0,1,1,0,1,1
02376963,21,5,16,0,1,1,0,1,1
02377225,9,2,7,0,1,1,0,0,0
02377581,2,2,0,0,1,1,0,0,0
02378070,24,5,19,0,1,1,0,0,1
02378072,10,2,8,0,1,1,0,0,0
02378467,19,6,13,0,1,1,0,0,1
02378784,18,4,14,0,0,0,0,0,0
02379259,3,0,3,0,0,0,0,0,1
02379280,41,16,25,0,0,0,0,0,1
02379479,56,9,47,0,1,1,0,1,1
02379610,7,3,4,0,1,1,0,0,0
02379795,6,0,6,0,0,0,0,0,1
02379800,56,0,56,0,1,1,0,1,1
02379804,55,3,52,0,1,1,0,1,1
02380110,30,3,27,0,1,1,0,1,1
02380446,0,0,0,0,0,0,0,0,1
02380564,171,13,158,0,0,0,0,0,1
02380675,50,6,44,0,0,0,0,0,1
02381492,3,0,3,0,0,0,0,0,1
02381543,30,2,28,0,1,1,0,1,1
02381718,38,7,31,0,0,0,0,0,1
02381891,39,7,32,0,0,0,0,0,1
02382187,15,0,15,0,0,0,0,0,1
02382808,31,4,27,0,1,1,0,1,1
02382822,46,28,18,0,0,0,0,0,1
02382824,47,28,19,0,0,0,0,0,1
02382855,0,0,0,0,0,0,0,0,1
02382941,14,0,14,0,1,1,0,1,1
02383031,24,2,22,0,1,1,0,1,1
02383045,35,10,25,0,11,10,1,0,0
02383574,25,0,25,0,0,0,0,0,1
02383590,25,3,22,0,1,1,0,1,1
02383683,22,7,15,0,0,0,0,0,1
02383863,41,6,35,0,0,0,0,0,1
02383959,40,10,30,0,0,0,0,0,1
02384039,6,2,4,0,0,0,0,0,1
02385160,18,5,13,0,0,0,0,0,1
02385197,34,5,29,0,1,1,0,1,1
02385277,27,4,23,0,2,1,1,2,1
02385322,21,4,17,0,1,1,0,1,1
02385383,11,2,9,0,5,4,1,0,1
02385734,17,2,15,0,1,1,0,1,1
02385818,29,3,26,0,1,1,0,1,1
02385991,23,6,17,0,1,1,0,0,1
02386168,16,2,14,0,1,1,0,1,1
02386220,55,6,49,0,1,1,0,1,1
02386409,22,0,22,0,0,0,0,0,1
02386528,39,1,38,0,0,0,0,0,1
02386579,33,15,18,0,0,0,0,0,1
02387141,47,3,44,0,1,1,0,1,1
02387340,22,5,17,0,4,1,3,1,1
02387490,5,0,5,0,1,1,0,0,1
02387531,31,6,25,0,1,1,0,1,1
02387681,18,8,10,0,1,1,0,1,1
02387713,51,3,48,0,1,1,0,1,1
02387786,20,0,20,0,0,0,0,0,1
02387949,23,2,21,0,1,1,0,1,1
02388324,22,4,18,0,0,0,0,0,0
02388620,53,16,37,0,1,1,0,1,1
02388655,34,0,34,0,1,1,0,1,1
02388701,15,8,7,0,0,0,0,0,1
02388740,31,5,26,0,1,1,0,1,0
02388852,18,3,15,0,0,0,0,0,1
02389055,14,3,11,0,1,1,0,1,1
02389761,16,0,16,0,0,0,0,0,1
02389907,79,14,65,0,0,0,0,0,1
02390160,10,2,8,0,1,1,0,1,1
02390516,11,0,11,0,0,0,0,0,1
02390548,8,3,5,0,4,4,0,1,1
02390884,16,3,13,0,0,0,0,0,1
02390929,9,4,5,0,2,2,0,0,1
02390948,9,3,6,0,1,0,1,0,1
02391355,18,0,18,0,0,0,0,0,1
02391367,55,5,50,0,0,0,0,0,0
02391543,81,6,75,0,0,0,0,0,1
02391624,6,2,4,0,2,2,0,0,1
02391638,8,4,4,0,1,1,0,1,0
02392550,39,4,35,0,1,1,0,1,1
02392756,6,1,5,0,2,1,1,0,1
02392854,34,0,34,0,1,1,0,1,1
02393078,33,3,30,0,1,1,0,1,1
02393175,42,10,32,0,0,0,0,0,1
02393366,25,2,23,0,0,0,0,0,1
02393527,21,3,18,0,1,1,0,1,1
02394244,40,8,32,0,1,1,0,0,1
02394254,14,2,12,0,1,1,0,0,1
02394738,19,3,16,0,1,1,0,1,1
02395416,62,6,56,0,2,2,0,2,1
02395485,10,0,10,0,0,0,0,0,1
02396008,23,0,23,0,0,0,0,0,1
02396114,41,9,32,0,1,1,0,1,1
02396184,26,3,23,0,1,1,0,1,1
02396496,13,0,13,0,1,1,0,1,1
02396943,20,3,17,0,1,1,0,0,1
02397134,111,23,88,0,0,0,0,0,0
02397322,18,8,10,0,1,1,0,0,0
02397373,66,16,50,0,0,0,0,0,1
02397594,11,3,8,0,0,0,0,0,0
02397775,23,4,19,0,1,1,0,1,1
02398410,33,3,30,0,2,1,1,0,1
02398515,63,7,56,0,1,1,0,0,1
02398586,51,11,40,0,0,0,0,0,1
02398979,112,5,107,0,1,1,0,1,1
02398992,14,1,13,0,1,1,0,1,1
02399820,5,4,1,0,2,2,0,0,1
02400085,27,4,23,0,1,1,0,1,1
02400377,5,0,5,0,1,1,0,0,1
02400509,57,8,49,0,0,0,0,0,1
02400519,29,6,23,0,1,1,0,1,1
02400555,9,1,8,0,1,1,0,0,1
02400909,37,0,37,0,0,0,0,0,1
02400917,8,3,5,0,0,0,0,0,1
02400947,11,5,6,0,0,0,0,0,1
02400969,60,11,49,0,0,0,0,0,1
02400977,8,0,8,0,0,0,0,0,1
02401034,64,10,54,0,4,4,0,4,1
02401046,33,6,27,0,2,2,0,2,1
02401055,40,6,34,0,1,1,0,1,1
02401068,54,12,42,0,0,0,0,0,1
02401107,22,2,20,0,0,0,0,0,1
02401261,3,3,0,0,1,1,0,0,0
02401575,19,4,15,0,1,1,0,1,1
02401712,16,0,16,0,0,0,0,0,1
02402312,7,2,5,0,1,0,1,0,1
02402491,11,2,9,0,1,1,0,0,1
02402805,105,11,94,0,0,0,0,0,1
02402927,33,0,33,0,0,0,0,0,1
02403333,195,21,174,0,0,0,0,0,1
02403588,18,2,16,0,1,1,0,1,1
02403711,19,0,19,0,0,0,0,0,1
02403771,24,0,24,0,0,0,0,0,1
02403779,23,0,23,0,0,0,0,0,1
02403986,12,3,9,0,0,0,0,0,0
02404052,20,3,17,0,1,1,0,0,1
02404350,44,6,38,0,1,1,0,1,1
02404351,36,0,36,0,1,1,0,1,1
02404792,7,2,5,0,1,1,0,0,1
02404920,8,0,8,0,1,1,0,1,1
02405030,14,3,11,0,1,1,0,1,1
02405166,22,2,20,0,1,1,0,1,1
02405306,22,2,20,0,1,1,0,1,1
02405307,24,2,22,0,1,1,0,1,1
02405490,33,3,30,0,3,2,1,3,1
02405523,20,5,15,0,1,1,0,0,1
02405546,18,3,15,0,1,1,0,1,1
02405739,4,2,2,0,1,1,0,0,0
02405764,5,3,2,0,2,2,0,0,0
02405903,15,4,11,0,6,6,0,5,1
02406054,35,3,32,0,1,1,0,1,1
02406236,11,2,9,0,1,1,0,0,1
02406298,18,0,18,0,0,0,0,0,1
02407078,12,0,12,0,3,2,1,0,0
02407250,21,5,16,0,0,0,0,0,1
02407613,17,2,15,0,1,1,0,1,1
02407769,17,0,17,0,0,0,0,0,1
02407799,42,4,38,0,1,1,0,1,1
02407924,51,3,48,0,1,1,0,1,1
02407940,38,0,38,0,0,0,0,0,1
02408386,46,0,46,0,0,0,0,0,1
02408422,0,0,0,0,0,0,0,0,0
02408646,23,3,20,0,1,1,0,1,1
02408840,6,2,4,0,1,1,0,0,0
02408948,4,3,1,0,3,3,0,1,1
02409015,25,2,23,0,0,0,0,0,1
02409699,6,2,4,0,1,1,0,0,0
02409902,70,9,61,0,0,0,0,0,1
02410197,25,3,22,0,9,4,5,1,1
02410244,27,2,25,0,1,1,0,0,1
02410479,35,3,32,0,0,0,0,0,1
02410626,66,14,52,0,1,1,0,1,1
02410798,12,0,12,0,0,0,0,0,1
02410810,41,3,38,0,1,1,0,1,1
02410817,43,0,43,0,0,0,0,0,1
02410818,33,4,29,0,1,1,0,1,1
02411055,49,15,34,0,0,0,0,0,1
02411065,13,1,12,0,1,1,0,0,1
02411202,5,2,3,0,1,1,0,0,1
02411699,7,2,5,0,1,1,0,0,0
02411786,103,11,92,0,0,0,0,0,1
02411791,43,7,36,0,0,0,0,0,1
02412046,35,8,27,0,0,0,0,0,1
02412105,10,8,2,0,2,2,0,0,0
02412299,81,12,69,0,9,4,5,0,1
02412572,7,0,7,0,0,0,0,0,1
02412609,16,4,12,0,1,1,0,1,0
02412647,27,2,25,0,0,0,0,0,1
02412962,63,0,63,0,0,0,0,0,1
02413137,28,5,23,0,1,1,0,1,1
02413321,57,4,53,0,1,1,0,1,1
02413547,44,10,34,0,0,0,0,0,1
02413697,5,3,2,0,2,2,0,0,1
02413714,35,6,29,0,0,0,0,0,1
02413730,1,0,1,0,0,0,0,0,1
02414033,12,3,9,0,1,1,0,1,1
02414212,75,6,69,0,1,1,0,1,1
02414283,51,9,42,0,1,1,0,1,1
02414292,22,4,18,0,3,2,1,0,1
02414298,8,3,5,0,0,0,0,0,1
02414308,13,3,10,0,2,2,0,0,0
02414443,14,3,11,0,1,1,0,1,1
02414459,14,3,11,0,1,1,0,1,1
02414472,31,5,26,0,0,0,0,0,1
02414480,29,0,29,0,1,1,0,1,1
02414649,2,2,0,0,1,1,0,0,1
02414699,53,13,40,0,0,0,0,0,1
02414704,10,6,4,0,2,2,0,0,1
02414884,21,2,19,0,1,1,0,0,0
02414997,32,5,27,0,1,1,0,1,1
02415070,9,0,9,0,0,0,0,0,1
02415211,26,7,19,0,0,0,0,0,1
02415283,5,0,5,0,0,0,0,0,1
02415387,15,4,11,0,1,1,0,1,1
02415597,25,0,25,0,0,0,0,0,1
02415637,18,2,16,0,0,0,0,0,1
02415684,16,0,16,0,0,0,0,0,1
02415777,3,1,2,0,1,1,0,0,0
02415826,22,3,19,0,1,1,0,1,1
02415956,12,0,12,0,2,2,0,2,1
02416082,22,3,19,0,1,1,0,1,1
02416242,262,27,235,0,0,0,0,0,1
02416818,0,0,0,0,0,0,0,0,1
02416904,25,5,20,0,1,1,0,1,1
02417014,29,3,26,0,1,1,0,1,1
02417119,31,4,27,0,0,0,0,0,1
02417385,17,2,15,0,2,1,1,0,0
02417647,5,3,2,0,2,2,0,0,0
02418209,18,3,15,0,1,1,0,0,0
02418670,19,6,13,0,0,0,0,0,0
02418844,15,3,12,0,1,1,0,1,1
02418965,30,4,26,0,1,1,0,1,1
02419098,3,3,0,0,2,2,0,0,1
02419432,38,3,35,0,0,0,0,0,1
02419491,28,0,28,0,0,0,0,0,1
08330057,22,13,9,0,0,0,0,0,1
08330162,12,9,3,0,0,0,0,0,1
08330611,2,2,0,0,2,2,0,0,0
08330634,5,2,3,0,2,2,0,0,1
08330731,3,3,0,0,1,1,0,1,0
08330875,3,0,3,0,2,2,0,0,0
08331397,4,3,1,0,1,1,0,0,1
08331440,4,0,4,0,0,0,0,0,1
08331556,5,4,1,0,1,1,0,1,1
08331837,16,5,11,0,1,1,0,1,1
08331870,16,5,11,0,1,1,0,1,1
08331918,9,0,9,0,1,1,0,1,1
08331920,3,2,1,0,1,1,0,0,0
08332200,2,1,1,0,1,1,0,0,0
08332793,2,2,0,0,3,3,0,0,0
08333128,3,0,3,0,0,0,0,0,1
08333148,2,1,1,0,2,1,1,0,0
08333185,2,2,0,0,1,1,0,0,0
08333462,2,2,0,0,0,0,0,0,0
08333464,7,4,3,0,2,0,2,2,1
08334023,26,14,12,0,0,0,0,0,1
08334182,1,1,0,0,1,1,0,0,0
08334284,3,1,2,0,1,1,0,0,0
08334627,10,4,6,0,0,0,0,0,0
08334736,2,1,1,0,1,1,0,0,0
08334743,20,11,9,0,0,0,0,0,1
08334798,14,4,10,0,0,0,0,0,0
08334906,4,3,1,0,1,1,0,0,1
08334960,11,10,1,0,1,1,0,0,1
08335008,4,4,0,0,2,2,0,0,1
08335167,2,2,0,0,2,2,0,0,0
08335307,2,2,0,0,2,2,0,0,0
08335412,2,2,0,0,2,2,0,0,1
08335543,2,1,1,0,1,1,0,0,1
08335726,12,4,8,0,1,1,0,1,1
08335734,2,0,2,0,0,0,0,0,0
08336170,1,1,0,0,1,1,0,0,1
08336173,26,10,16,0,0,0,0,0,0
08336197,3,2,1,0,1,1,0,0,1
08336279,2,0,2,0,0,0,0,0,0
08336356,3,2,1,0,1,1,0,0,0
08336375,1,1,0,0,1,1,0,0,0
08336516,4,3,1,0,3,2,1,0,0
08336545,2,1,1,0,1,1,0,0,0
08336774,2,2,0,0,1,1,0,0,0
08336902,2,0,2,0,0,0,0,0,1
08337023,3,0,3,0,0,0,0,0,1
08337433,1,0,1,0,0,0,0,0,0
08337483,2,2,0,0,1,1,0,0,0
08338106,2,2,0,0,1,1,0,0,0
08338562,2,0,2,0,0,0,0,0,0
08338585,9,0,9,0,1,1,0,0,1
08338746,2,0,2,0,1,1,0,1,1
08338820,3,3,0,0,1,1,0,0,0
08338967,4,4,0,0,3,2,1,0,1
08338976,4,4,0,0,3,3,0,0,1
08338990,4,4,0,0,1,1,0,0,0
08339155,2,1,1,0,1,1,0,0,0
08339379,7,6,1,0,0,0,0,0,0
08339700,1,1,0,0,1,1,0,1,0
08339761,5,0,5,0,2,2,0,0,1
08339878,24,6,18,0,3,2,1,0,1
08340090,20,10,10,0,0,0,0,0,1
08340943,1,0,1,0,1,1,0,0,0
08341226,14,7,7,0,2,2,0,0,0
08342169,9,4,5,0,0,0,0,0,1
08342552,2,0,2,0,0,0,0,0,1
08342655,5,5,0,0,1,1,0,0,1
08343538,2,1,1,0,1,1,0,0,0
08343828,4,0,4,0,0,0,0,0,1
08345177,1,1,0,0,1,1,0,0,1
08346019,10,3,7,0,1,1,0,1,0
08346406,5,4,1,0,1,1,0,0,1
08346842,4,3,1,1,1,1,0,0,0
08347210,1,0,1,0,1,1,0,0,0
08347261,5,3,2,0,1,1,0,1,1
08347668,2,0,2,0,0,0,0,0,1
08348098,2,0,2,0,0,0,0,0,0
08349379,2,0,2,0,1,1,0,0,0
08349593,1,1,0,0,1,1,0,0,1
08349638,5,3,2,0,2,2,0,2,1
08349970,1,0,1,0,0,0,0,0,0
08350628,3,2,1,0,1,1,0,0,1
08351191,20,4,16,0,1,1,0,1,1
08351391,3,3,0,0,2,2,0,0,1
08351666,5,2,3,0,2,2,0,0,1
08351960,14,4,10,0,1,1,0,1,1
08352052,5,2,3,0,0,0,0,0,0
08352060,2,2,0,0,2,2,0,0,0
08352444,13,0,13,1,1,1,0,0,0
08352523,1,1,0,0,1,1,0,0,0
08353025,2,0,2,0,1,1,0,0,1
08353048,5,0,5,0,0,0,0,0,0
08353749,1,1,0,0,0,0,0,0,0
08353765,2,2,0,0,2,2,0,0,0
08353993,5,0,5,0,0,0,0,0,0
08354847,8,3,5,0,1,1,0,1,1
08355422,4,2,2,0,2,2,0,0,1
08355539,17,3,14,0,0,0,0,0,1
08355806,2,1,1,0,1,1,0,0,0
08355909,5,1,4,0,0,0,0,0,0
08356293,3,0,3,0,1,1,0,0,1
08356550,3,0,3,0,0,0,0,0,1
08356706,41,16,25,0,0,0,0,0,0
08357105,2,2,0,0,1,1,0,0,1
08357422,2,2,0,0,2,2,0,0,0
08357697,4,4,0,0,2,2,0,0,1
08357799,1,0,1,0,0,0,0,0,1
08358047,1,0,1,0,1,1,0,0,0
08359040,6,5,1,0,0,0,0,0,0
08359073,1,1,0,0,1,1,0,0,0
08359113,21,5,16,0,0,0,0,0,1
08359339,1,0,1,0,0,0,0,0,0
08359705,14,9,5,0,1,1,0,0,0
08359812,2,0,2,0,1,1,0,0,0
08359889,21,7,14,0,3,0,3,0,1
08359989,13,9,4,0,0,0,0,0,1
08360076,3,3,0,0,1,1,0,0,1
08360915,32,15,17,0,0,0,0,0,1
08361655,8,3,5,0,1,1,0,0,1
08362347,7,1,6,0,3,1,2,0,1
08362391,3,0,3,0,1,1,0,1,1
08362598,18,12,6,0,0,0,0,0,1
08362867,2,2,0,0,1,1,0,0,0
08362956,1,1,0,0,1,1,0,1,1
08363016,27,9,18,0,13,8,5,0,1
08363068,1,1,0,0,1,1,0,1,1
08364253,4,3,1,0,1,1,0,0,1
08364254,3,0,3,0,0,0,0,0,1
08364663,5,2,3,0,2,2,0,0,0
08364786,1,1,0,0,2,2,0,0,0
08365274,2,2,0,0,1,1,0,0,0
08365506,2,0,2,0,1,1,0,0,0
08365637,2,0,2,0,0,0,0,0,1
08365878,2,0,2,0,0,0,0,0,1
08365973,6,4,2,0,5,3,2,0,0
08366029,13,12,1,0,0,0,0,0,1
08366038,3,0,3,0,0,0,0,0,1
08366041,7,3,4,0,1,1,0,0,1
08366427,1,1,0,0,1,1,0,0,0
08366557,2,2,0,0,1,1,0,0,0
08366681,2,2,0,0,2,2,0,0,1
08366788,1,0,1,0,0,0,0,0,1
08367081,3,3,0,0,2,2,0,0,1
08367867,14,4,10,0,1,1,0,1,1
08368233,1,1,0,0,2,2,0,0,0
08368317,1,1,0,0,1,1,0,0,0
08368341,1,1,0,0,1,1,0,0,0
08368437,8,7,1,0,0,0,0,0,1
08368640,2,2,0,0,1,1,0,0,0
08368769,1,0,1,0,0,0,0,0,1
08369008,5,4,1,0,1,1,0,1,0
08369331,4,2,2,0,2,2,0,0,0
08369977,2,0,2,0,1,1,0,0,0
08370047,2,2,0,0,1,1,0,0,0
08370399,22,0,22,0,0,0,0,0,1
08370423,1,1,0,0,1,1,0,0,0
08370622,7,1,6,0,1,1,0,1,1
08370766,6,3,3,0,1,1,0,1,1
08370902,2,1,1,0,1,1,0,0,0
08371016,1,0,1,0,0,0,0,0,0
08371113,9,1,8,0,1,1,0,1,0
08371130,4,0,4,0,0,0,0,0,1
08371198,3,0,3,0,0,0,0,0,1
08371944,4,4,0,0,3,3,0,0,0
08372184,3,0,3,0,0,0,0,0,1
08372228,15,3,12,0,2,1,1,2,1
08372327,5,2,3,0,3,2,1,0,0
08372779,4,3,1,0,1,1,0,1,1
08373408,5,2,3,0,1,1,0,1,1
08373440,2,2,0,0,1,1,0,1,0
08374172,2,0,2,0,0,0,0,0,0
08374250,6,3,3,0,0,0,0,0,0
08374283,9,8,1,0,0,0,0,0,1
08374352,21,6,15,0,2,1,1,2,1
08374570,8,0,8,0,1,1,0,1,1
08374655,15,6,9,0,1,1,0,1,1
08374714,4,2,2,0,1,1,0,0,1
08375453,2,2,0,0,1,1,0,0,0
08375599,5,3,2,0,2,1,1,0,1
08375655,3,2,1,0,3,3,0,0,0
08375918,2,1,1,0,2,1,1,0,0
08376361,3,2,1,0,2,1,1,0,0
08376381,10,6,4,0,1,1,0,1,1
08377340,3,2,1,0,2,2,0,0,0
08377494,23,0,23,0,0,0,0,0,1
08378172,3,2,1,0,1,1,0,0,0
08379362,1,0,1,0,0,0,0,0,1
08379496,1,1,0,0,1,1,0,0,0
08379687,5,4,1,0,1,1,0,1,1
08379841,1,1,0,0,1,1,0,0,0
08380017,1,1,0,0,1,1,0,0,0
08380062,2,0,2,0,0,0,0,0,1
08380557,2,1,1,0,2,2,0,0,0
08380611,1,1,0,0,1,1,0,0,1
08381013,2,2,0,0,2,2,0,0,0
08381300,9,4,5,1,1,1,0,1,1
08381392,2,2,0,0,1,1,0,0,0
08381599,5,0,5,0,0,0,0,0,1
08381835,1,1,0,0,1,1,0,0,0
08382010,6,2,4,0,1,1,0,0,0
08382179,13,9,4,0,0,0,0,0,1
08382409,3,1,2,0,1,1,0,0,0
08382795,2,1,1,0,1,1,0,0,0
08383049,5,0,5,0,0,0,0,0,1
08383281,4,0,4,0,0,0,0,0,0
08383471,1,0,1,0,0,0,0,0,0
08383499,2,2,0,0,1,1,0,1,0
08383568,3,3,0,0,1,1,0,0,1
08383620,1,1,0,0,1,1,0,0,1
08384125,20,14,6,0,0,0,0,0,1
08384134,2,1,1,0,0,0,0,0,1
08384169,5,4,1,0,0,0,0,0,0
08384386,2,0,2,0,1,1,0,0,1
08384590,2,0,2,0,1,1,0,0,0
08384723,15,7,8,0,10,9,1,0,1
08384783,1,0,1,0,0,0,0,0,1
08385190,4,2,2,0,1,1,0,0,1
08385527,3,1,2,0,1,1,0,1,1
08385534,2,0,2,0,0,0,0,0,1
08385640,7,3,4,0,0,0,0,0,0
08386622,1,1,0,0,2,2,0,0,0
08387042,6,6,0,0,2,2,0,0,1
08387265,11,2,9,0,0,0,0,0,1
08387357,2,0,2,0,0,0,0,0,1
08387405,1,1,0,0,2,2,0,0,0
08387616,3,0,3,0,0,0,0,0,0
08387837,9,6,3,0,1,1,0,1,1
08387957,3,3,0,0,3,3,0,0,1
08388118,18,10,8,0,3,3,0,3,1
08388119,1,1,0,0,1,1,0,0,0
08388197,7,5,2,0,2,2,0,0,1
08388945,1,0,1,0,1,1,0,0,0
08389092,1,0,1,0,0,0,0,0,0
08389118,20,8,12,0,2,1,1,0,0
08389326,2,1,1,0,1,1,0,0,0
08389495,2,2,0,0,1,1,0,0,0
08389890,2,1,1,0,1,1,0,0,1
08389945,1,0,1,0,0,0,0,0,1
08390003,4,3,1,0,1,1,0,0,0
08390044,1,0,1,0,0,0,0,0,1
08390750,1,1,0,0,1,1,0,0,1
08390995,5,3,2,0,1,1,0,0,1
08391032,5,0,5,0,3,3,0,0,1
08391210,14,8,6,0,0,0,0,0,0
08392167,1,1,0,0,1,1,0,0,0
08392713,9,2,7,0,1,1,0,0,0
08392771,1,0,1,0,0,0,0,0,0
08392938,3,1,2,0,1,1,0,0,0
08393301,3,3,0,0,1,1,0,1,0
08393552,4,4,0,0,2,2,0,0,0
08393683,2,0,2,0,0,0,0,0,1
08393780,3,0,3,0,1,1,0,0,1
08394114,3,2,1,0,1,1,0,0,0
08394782,1,1,0,0,2,2,0,0,0
08395104,5,3,2,0,0,0,0,0,1
08395289,3,2,1,0,4,2,2,0,1
08395296,21,10,11,0,1,1,0,1,1
08395345,1,0,1,0,1,1,0,0,0
08395657,1,0,1,0,0,0,0,0,0
08395925,3,0,3,0,1,1,0,0,1
08396817,3,1,2,0,1,1,0,0,0
08397102,4,0,4,0,0,0,0,0,0
08397106,4,4,0,0,2,2,0,0,0
08397816,4,3,1,0,3,2,1,0,0
08397898,3,0,3,0,0,0,0,0,0
08398077,4,4,0,0,2,2,0,1,1
08398246,2,0,2,0,0,0,0,0,0
08398544,5,4,1,0,2,2,0,1,1
08398703,2,2,0,0,1,1,0,0,0
08398865,2,1,1,0,1,1,0,0,0
08399381,1,1,0,0,1,1,0,0,0
08399454,2,2,0,0,2,2,0,0,0
08399899,7,2,5,0,1,1,0,1,1
08399940,8,3,5,0,5,3,2,0,0
08400066,2,2,0,0,2,2,0,0,0
08400389,1,1,0,0,1,1,0,0,1
08400453,5,5,0,0,1,1,0,1,1
08400456,3,2,1,0,1,1,0,0,0
08400703,6,3,3,0,1,1,0,1,1
08400725,3,3,0,0,2,2,0,0,0
08401078,1,1,0,0,1,1,0,0,1
08401447,1,1,0,0,1,1,0,0,0
08401483,2,2,0,0,2,2,0,0,0
08401726,6,0,6,0,1,1,0,1,1
08401887,22,0,22,0,0,0,0,0,0
08401925,4,3,1,0,1,1,0,0,0
08402166,12,10,2,0,0,0,0,0,0
08402413,7,2,5,0,2,1,1,0,1
08403099,6,0,6,0,0,0,0,0,1
08403342,2,1,1,0,1,1,0,0,0
08404129,1,1,0,0,1,1,0,0,0
08404165,1,1,0,0,1,1,0,0,0
08404285,2,2,0,0,2,1,1,1,0
08404561,1,1,0,0,1,1,0,0,0
08404719,2,2,0,0,2,2,0,2,1
08405214,2,2,0,0,1,1,0,0,1
08405458,2,2,0,0,1,1,0,0,1
08405479,2,1,1,0,2,2,0,0,1
08405514,1,0,1,0,0,0,0,0,1
08405548,7,0,7,0,0,0,0,0,1
08405629,3,2,1,0,1,1,0,1,1
08405783,2,1,1,0,1,1,0,0,0
08405786,14,4,10,0,1,1,0,1,1
08405840,14,4,10,0,1,1,0,1,1
08405885,14,4,10,0,1,1,0,1,1
08406148,4,3,1,0,2,2,0,1,0
08406149,23,10,13,0,0,0,0,0,0
08406156,3,0,3,0,0,0,0,0,1
08406187,2,1,1,0,1,1,0,0,0
08406289,1,1,0,0,1,1,0,0,1
08406303,2,0,2,0,1,1,0,0,0
08407119,4,2,2,0,2,2,0,0,0
08407458,6,3,3,0,2,1,1,2,1
08407961,24,5,19,0,0,0,0,0,0
08408021,7,0,7,0,0,0,0,0,1
08408211,19,7,12,0,0,0,0,0,1
08408338,5,3,2,0,0,0,0,0,1
08408637,3,3,0,0,2,1,1,0,0
08409289,21,9,12,0,0,0,0,0,0
08409361,14,8,6,0,0,0,0,0,1
08409391,1,1,0,0,1,1,0,0,0
08409517,2,1,1,0,1,1,0,0,0
08409621,4,4,0,0,2,2,0,0,1
08409650,11,3,8,0,1,1,0,1,1
08409765,6,2,4,0,1,1,0,0,1
08409810,1,0,1,0,0,0,0,0,0
03120147,19,10,9,0,2,2,0,0,1
03120328,22,5,17,0,1,1,0,0,1
03120443,60,10,50,0,0,0,0,0,1
03120593,15,8,7,0,0,0,0,0,1
03120716,30,6,24,0,1,1,0,1,1
03120768,8,0,8,0,0,0,0,0,1
03120930,20,5,15,0,1,1,0,1,1
03120977,7,3,4,0,1,1,0,0,1
03120999,40,4,36,0,1,1,0,1,1
03121110,29,3,26,0,1,1,0,1,1
03121229,35,0,35,0,0,0,0,0,1
03121594,43,4,39,0,0,0,0,0,1
03121679,32,12,20,0,0,0,0,0,1
03121688,50,3,47,0,0,0,0,0,1
03121690,16,2,14,0,0,0,0,0,0
03121772,19,0,19,0,0,0,0,0,1
03121862,16,5,11,0,2,2,0,0,1
03121985,8,0,8,0,1,1,0,0,0
03122085,76,2,74,0,1,1,0,1,1
03122495,51,13,38,0,1,1,0,1,1
03122827,7,0,7,0,0,0,0,0,1
03123160,22,0,22,0,0,0,0,0,1
03123290,16,4,12,0,1,1,0,1,1
03123349,22,3,19,0,1,1,0,1,1
03123464,14,3,11,0,1,1,0,0,1
03123470,14,3,11,0,1,1,0,0,1
03123544,19,3,16,0,0,0,0,0,1
03123555,5,1,4,0,1,1,0,0,0
03123592,51,8,43,0,1,1,0,0,1
03123764,14,0,14,0,0,0,0,0,1
03123961,8,4,4,0,1,1,0,0,1
03124410,34,10,24,0,1,0,1,1,1
03124566,19,7,12,0,1,1,0,0,1
03124651,29,2,27,0,1,1,0,1,1
03124721,14,8,6,0,1,1,0,1,1
03124785,27,5,22,0,1,1,0,1,1
03124788,33,2,31,0,1,1,0,1,1
03125176,7,3,4,0,1,1,0,0,1
03125198,19,0,19,0,0,0,0,0,1
03125316,8,4,4,0,1,1,0,0,1
03125492,12,4,8,0,1,1,0,0,1
03125686,38,6,32,0,0,0,0,0,0
03125802,13,5,8,0,2,2,0,2,1
03125913,23,9,14,0,0,0,0,0,1
03126017,10,1,9,0,1,1,0,0,1
03126031,28,1,27,0,0,0,0,0,1
03126168,35,4,31,0,1,1,0,1,1
03126301,17,3,14,0,1,1,0,1,1
03126311,10,3,7,0,4,2,2,0,1
03126488,11,0,11,0,0,0,0,0,1
03126711,15,3,12,0,1,1,0,1,1
03126815,7,0,7,0,1,1,0,1,0
03127123,3,3,0,0,2,2,0,0,0
03127226,40,12,28,0,0,0,0,0,1
03127415,7,2,5,0,2,2,0,0,1
03127843,21,3,18,0,3,3,0,0,1
03128187,14,3,11,0,3,1,2,1,0
03128229,4,2,2,0,1,1,0,0,1
03128328,6,2,4,0,2,1,1,1,1
03128485,7,0,7,0,0,0,0,0,1
03128558,35,8,27,0,0,0,0,0,1
03128694,49,15,34,0,0,0,0,0,0
03128830,9,0,9,0,0,0,0,0,1
03128842,11,0,11,0,0,0,0,0,1
03129297,15,2,13,0,1,0,1,0,1
03129327,24,0,24,0,0,0,0,0,1
03129533,16,4,12,0,5,4,1,0,0
03129592,25,3,22,0,2,1,1,2,1
03129594,27,3,24,0,2,1,1,1,1
03129950,25,6,19,0,2,2,0,2,1
03129955,4,2,2,0,1,1,0,0,0
03130127,12,4,8,0,1,1,0,1,1
03130188,13,4,9,0,1,1,0,1,1
03130238,30,0,30,0,0,0,0,0,1
03130433,15,7,8,0,0,0,0,0,1
03130876,53,12,41,0,0,0,0,0,1
03130909,3,0,3,0,2,2,0,0,1
03131273,29,8,21,0,1,1,0,1,1
03131278,6,3,3,0,1,1,0,1,1
03131485,30,2,28,0,1,1,0,1,1
03131624,27,4,23,0,1,1,0,1,1
03131750,0,0,0,0,0,0,0,0,0
03131810,13,0,13,0,0,0,0,0,1
03132110,45,4,41,0,1,1,0,1,1
03132165,20,0,20,0,1,1,0,1,1
03132202,23,0,23,0,0,0,0,0,1
03132257,18,4,14,0,1,1,0,1,1
03132259,7,2,5,0,1,1,0,0,1
03132432,43,0,43,0,1,1,0,1,1
03132487,60,3,57,0,0,0,0,0,1
03132671,5,1,4,0,1,1,0,0,0
03132944,67,6,61,0,0,0,0,0,1
03133029,8,2,6,0,2,1,1,0,1
03133130,15,0,15,0,0,0,0,0,1
03133226,61,10,51,0,1,1,0,1,1
03133249,7,1,6,0,1,1,0,0,0
03133310,18,0,18,0,0,0,0,0,1
03133472,16,0,16,0,0,0,0,0,1
03133599,42,5,37,0,0,0,0,0,1
03133815,13,2,11,0,1,1,0,1,1
03133845,21,0,21,0,1,1,0,1,1
03133858,11,1,10,0,2,2,0,0,0
03133863,18,2,16,0,1,1,0,1,1
03133879,4,2,2,0,1,0,1,0,0
03133919,6,2,4,0,2,2,0,0,0
03134026,10,2,8,0,0,0,0,0,1
03134175,36,3,33,0,1,1,0,1,1
03134290,33,3,30,0,1,1,0,1,1
03134383,18,3,15,0,1,1,0,1,1
03134462,8,4,4,0,1,1,0,0,1
03134540,42,2,40,0,2,1,1,2,1
03135001,23,0,23,0,0,0,0,0,1
03135090,5,2,3,0,1,1,0,0,0
03135100,36,0,36,0,0,0,0,0,1
03135106,40,0,40,0,0,0,0,0,1
03135129,23,5,18,0,2,2,0,1,1
03135205,35,8,27,0,0,0,0,0,1
03135472,25,3,22,0,0,0,0,0,1
03135512,20,0,20,0,1,1,0,1,1
03135522,35,2,33,0,1,1,0,1,1
03135528,36,3,33,0,0,0,0,0,1
03135543,36,3,33,0,1,1,0,1,1
03135558,6,2,4,0,1,1,0,0,1
03135565,5,0,5,0,2,2,0,0,1
03135882,27,4,23,0,1,1,0,1,1
03135945,31,4,27,0,11,2,9,0,1
03136055,23,3,20,0,0,0,0,0,1
03136090,27,2,25,0,1,1,0,1,1
03136223,34,0,34,0,0,0,0,0,1
03136293,37,3,34,0,1,1,0,1,1
03136611,6,2,4,0,1,1,0,0,0
03136695,13,2,11,0,0,0,0,0,0
03136977,11,0,11,0,1,1,0,1,1
03137001,24,0,24,0,0,0,0,0,1
03137028,13,0,13,0,1,1,0,1,1
03137094,10,4,6,0,1,1,0,1,1
03137395,18,7,11,0,1,1,0,1,1
03137449,42,4,38,0,1,1,0,1,1
03137494,13,2,11,0,1,1,0,1,1
03137515,24,6,18,0,1,1,0,1,1
03137571,18,5,13,0,1,1,0,1,1
03137720,66,7,59,0,0,0,0,0,1
03137730,26,0,26,0,1,1,0,0,1
03137740,18,0,18,0,0,0,0,0,1
03138087,18,3,15,0,0,0,0,0,1
03138274,35,5,30,0,3,1,2,0,0
03138390,42,4,38,0,1,1,0,1,1
03138443,23,0,23,0,0,0,0,0,1
03138509,9,4,5,0,2,2,0,0,1
03138574,8,2,6,0,1,1,0,1,1
03138683,50,15,35,0,0,0,0,0,1
03138736,4,2,2,0,2,2,0,0,1
03138868,25,0,25,0,1,1,0,1,1
03138870,14,3,11,0,1,1,0,1,1
03138881,22,3,19,0,0,0,0,0,1
03138896,29,4,25,0,2,2,0,2,0
03138920,13,4,9,0,2,2,0,0,1
03139019,28,5,23,0,0,0,0,0,1
03139024,9,1,8,0,1,1,0,0,1
03139400,23,4,19,0,1,1,0,1,1
03139474,6,2,4,0,2,2,0,0,0
03139685,27,7,20,0,6,6,0,0,1
03139715,19,3,16,0,1,1,0,1,1
03139876,20,8,12,0,5,1,4,1,0
03139917,26,3,23,0,1,1,0,1,1
03139948,26,3,23,0,1,1,0,1,1
03140076,48,5,43,0,6,3,3,0,1
03140204,34,5,29,0,0,0,0,0,1
03140258,21,4,17,0,1,1,0,1,1
03140273,45,4,41,0,1,1,0,1,1
03140291,22,2,20,0,1,1,0,1,1
03140430,13,3,10,0,1,1,0,0,1
03140596,38,3,35,0,1,1,0,1,1
03140646,12,0,12,0,0,0,0,0,0
03140769,55,10,45,0,0,0,0,0,1
03140878,36,3,33,0,1,1,0,0,1
03141073,19,7,12,0,0,0,0,0,1
03141599,7,2,5,0,1,1,0,0,1
03141667,28,3,25,0,1,1,0,1,1
03141679,33,3,30,0,1,1,0,1,1
03141707,16,4,12,0,1,1,0,1,1
03141709,13,2,11,0,0,0,0,0,1
03142133,27,8,19,1,0,0,0,0,1
03142214,33,3,30,0,1,1,0,1,1
03142604,25,6,19,0,5,5,0,0,0
03142608,7,0,7,0,0,0,0,0,1
03142642,35,2,33,0,0,0,0,0,1
03142715,16,3,13,0,1,1,0,0,1
03142762,30,7,23,0,0,0,0,0,1
03143004,23,3,20,0,1,0,1,0,0
03143125,26,0,26,0,0,0,0,0,0
03143355,22,5,17,0,0,0,0,0,0
03143673,43,10,33,0,0,0,0,0,0
03143692,11,1,10,0,3,1,2,2,1
03144016,25,4,21,0,1,0,1,1,1
03144035,7,3,4,0,1,1,0,0,1
03144066,67,7,60,0,1,1,0,1,1
03144067,27,4,23,0,1,1,0,1,1
03144199,65,9,56,0,1,1,0,1,1
03144234,12,1,11,0,0,0,0,0,1
03144465,30,4,26,0,1,1,0,1,1
03145014,9,0,9,0,0,0,0,0,0
03145216,28,6,22,0,1,1,0,1,1
03145283,4,2,2,0,1,1,0,0,1
03145609,15,0,15,0,1,1,0,1,1
03145691,39,4,35,0,1,1,0,1,1
03145704,29,6,23,0,1,1,0,1,1
03145846,21,0,21,0,1,1,0,1,1
03145848,21,3,18,0,1,1,0,1,1
03146114,16,7,9,0,2,1,1,1,1
03146280,19,5,14,0,1,1,0,1,1
03146736,26,5,21,0,1,1,0,1,1
03146770,49,11,38,0,0,0,0,0,1
03147000,5,1,4,0,1,1,0,0,0
03147122,12,3,9,0,3,3,0,0,1
03147164,51,9,42,0,2,2,0,2,1
03147490,17,1,16,0,1,1,0,1,1
03147725,5,3,2,0,2,2,0,0,1
03147851,70,0,70,0,0,0,0,0,1
03147927,28,2,26,0,1,1,0,1,1
03147949,56,5,51,0,1,1,0,1,1
03148073,9,2,7,0,2,2,0,0,0
03148085,6,3,3,0,2,2,0,0,1
03148086,33,3,30,0,1,1,0,1,1
03148118,30,4,26,0,1,1,0,1,1
03148311,17,3,14,0,4,4,0,0,1
03148352,12,3,9,0,1,1,0,1,1
03148432,30,3,27,0,1,1,0,1,1
03148588,12,3,9,0,1,1,0,0,0
03148926,6,4,2,0,2,2,0,0,1
03148949,14,0,14,0,0,0,0,0,1
03149336,5,3,2,0,1,1,0,1,0
03149760,49,15,34,0,0,0,0,0,1
03149785,32,4,28,0,1,1,0,1,0
03150113,9,3,6,0,1,1,0,0,0
03150205,6,0,6,0,1,1,0,0,1
03150227,11,2,9,0,0,0,0,0,1
03150316,8,0,8,0,0,0,0,0,0
03150348,13,1,12,0,1,1,0,1,1
03150522,14,1,13,0,1,1,0,0,1
03150680,21,0,21,0,1,1,0,1,1
03150771,32,3,29,0,1,1,0,1,1
03150813,5,3,2,0,1,1,0,0,0
03150875,187,14,173,0,0,0,0,0,1
03150876,13,5,8,0,0,0,0,0,1
03151011,6,3,3,0,1,1,0,1,1
03151270,15,2,13,0,1,1,0,1,1
03151334,53,2,51,0,1,1,0,1,1
03151878,54,6,48,0,10,5,5,0,0
03152115,23,3,20,0,1,1,0,1,1
03152137,6,4,2,0,1,1,0,0,0
03152455,5,3,2,0,1,1,0,0,0
03152569,31,0,31,0,2,1,1,2,1
03152606,33,4,29,0,0,0,0,0,1
03152636,27,0,27,0,0,0,0,0,1
03152721,11,5,6,0,0,0,0,0,0
03152730,23,2,21,0,1,1,0,1,1
03152823,11,5,6,0,0,0,0,0,0
03152835,11,5,6,0,0,0,0,0,0
03152986,28,6,22,0,0,0,0,0,1
03153131,11,5,6,0,0,0,0,0,0
03153279,8,0,8,0,1,0,1,0,1
03153384,14,5,9,0,0,0,0,0,1
03153391,55,2,53,0,1,1,0,1,1
03153398,13,0,13,0,1,1,0,1,1
03153490,37,3,34,0,1,1,0,1,1
03153494,35,0,35,0,1,1,0,1,1
03153646,4,2,2,0,1,1,0,0,1
03153895,44,11,33,0,0,0,0,0,1
03154038,17,0,17,0,0,0,0,0,1
03154125,22,0,22,0,0,0,0,0,1
03154765,19,0,19,0,0,0,0,0,1
03155192,9,1,8,0,5,2,3,0,1
03155211,18,4,14,0,1,1,0,1,1
03155367,16,5,11,0,1,1,0,0,1
03155620,81,10,71,0,1,1,0,1,1
03155652,15,5,10,0,1,1,0,1,1
03155839,6,0,6,0,0,0,0,0,1
03156028,9,5,4,0,1,1,0,1,0
03156159,56,5,51,0,1,1,0,1,1
03156479,21,3,18,0,1,1,0,1,1
03156599,7,3,4,0,2,2,0,0,1
03156676,20,7,13,0,0,0,0,0,1
03156792,24,0,24,0,1,1,0,1,1
03156893,9,3,6,0,1,1,0,0,1
03156927,8,3,5,0,1,1,0,1,0
03157061,6,1,5,0,1,1,0,0,0
03157076,21,8,13,0,1,1,0,0,1
03157153,6,3,3,0,2,2,0,0,1
03157171,24,10,14,0,0,0,0,0,1
03157276,4,2,2,0,1,1,0,0,1
03157535,5,2,3,0,1,1,0,0,1
03157625,53,10,43,0,2,2,0,2,1
03157634,70,9,61,0,1,1,0,1,1
03157646,60,6,54,0,0,0,0,0,1
03157685,7,3,4,0,2,1,1,2,1
03157759,18,3,15,0,2,2,0,2,1
03157760,30,5,25,0,2,2,0,1,1
03157930,5,3,2,0,3,2,1,0,1
03157977,26,0,26,0,0,0,0,0,1
03158105,22,5,17,0,1,1,0,1,1
03158106,28,4,24,0,1,1,0,1,1
03158108,28,0,28,0,0,0,0,0,1
03158254,5,2,3,0,1,1,0,0,0
03158306,16,6,10,0,0,0,0,0,1
03158788,8,2,6,0,0,0,0,0,1
03158846,13,2,11,0,1,1,0,1,1
03158868,7,3,4,0,1,1,0,0,0
03159029,46,10,36,0,3,2,1,0,1
03159256,13,0,13,0,0,0,0,0,1
03159306,16,0,16,0,0,0,0,0,1
03159446,6,3,3,0,2,2,0,0,0
03160188,7,2,5,0,2,2,0,0,0
03160344,20,5,15,0,0,0,0,0,1
03160526,51,13,38,0,0,0,0,0,1
03160563,5,3,2,0,1,1,0,0,1
03160586,16,0,16,0,0,0,0,0,1
03160831,7,1,6,0,1,1,0,1,1
03160854,5,3,2,0,2,2,0,0,1
03160902,22,4,18,0,1,1,0,0,1
03161085,28,2,26,0,2,2,0,2,1
03161219,30,2,28,0,1,1,0,1,1
03161225,24,2,22,0,1,1,0,1,1
03161354,44,8,36,0,1,1,0,0,0
03161448,7,3,4,0,2,2,0,0,1
03161651,6,3,3,0,2,2,0,0,1
03161821,40,6,34,0,1,1,0,1,1
03161850,11,2,9,0,1,1,0,0,1
03161906,5,0,5,0,0,0,0,0,1
03162046,29,2,27,0,4,1,3,4,1
03162063,3,1,2,0,1,1,0,0,1
03162289,33,2,31,0,1,1,0,1,1
03162429,29,13,16,0,0,0,0,0,1
03162439,16,3,13,0,1,1,0,1,1
03162540,39,0,39,0,0,0,0,0,1
03162555,29,4,25,0,0,0,0,0,1
03162829,28,8,20,0,1,1,0,1,1
03162873,61,11,50,0,1,1,0,0,1
03162882,18,0,18,0,0,0,0,0,1
03162897,40,5,35,0,1,1,0,1,1
03163027,22,3,19,0,0,0,0,0,1
03163028,8,2,6,0,1,1,0,0,1
03163051,19,4,15,0,1,1,0,1,1
03163069,21,0,21,0,0,0,0,0,1
03163167,9,2,7,0,0,0,0,0,1
03163187,99,15,84,0,0,0,0,0,1
03163230,36,5,31,0,1,1,0,1,1
03163233,14,6,8,0,0,0,0,0,1
03163624,22,9,13,0,0,0,0,0,1
03163638,8,3,5,0,1,1,0,0,1
03163754,64,8,56,0,0,0,0,0,1
03164247,22,7,15,0,5,5,0,0,1
03164365,15,7,8,0,1,1,0,1,1
03164431,36,11,25,0,0,0,0,0,1
03164472,7,3,4,0,0,0,0,0,1
03164540,20,0,20,0,0,0,0,0,1
03164889,5,3,2,0,2,2,0,0,1
03164990,4,1,3,0,1,1,0,0,1
03165122,30,0,30,0,0,0,0,0,1
03165130,20,8,12,0,0,0,0,0,0
03165147,37,3,34,0,1,1,0,1,1
03165181,7,0,7,0,0,0,0,0,1
03165591,29,4,25,0,0,0,0,0,1
03165755,3,3,0,0,2,2,0,0,1
03165762,19,7,12,0,7,7,0,0,1
03165788,6,2,4,0,1,1,0,0,1
03165809,16,7,9,0,0,0,0,0,1
03165836,30,10,20,0,0,0,0,0,1
03166339,60,13,47,0,0,0,0,0,1
03166361,140,9,131,0,0,0,0,0,1
03166376,21,4,17,0,3,3,0,0,1
03166592,11,0,11,0,0,0,0,0,1
03166614,12,0,12,0,0,0,0,0,1
03166701,34,8,26,0,2,1,1,2,1
03166785,7,4,3,0,1,1,0,1,1
03167262,7,2,5,0,3,3,0,1,0
03167477,15,4,11,0,0,0,0,0,1
03167586,45,0,45,0,1,1,0,1,1
03167622,48,5,43,0,1,1,0,1,1
03167637,7,4,3,0,1,1,0,1,1
03168082,31,9,22,0,1,1,0,1,1
03168108,30,14,16,0,0,0,0,0,1
03168139,10,0,10,0,0,0,0,0,1
03168401,8,4,4,0,2,2,0,0,1
03168611,29,3,26,0,2,2,0,2,1
03168873,9,3,6,0,4,3,1,0,0
03168893,6,2,4,0,1,1,0,0,0
03168918,31,0,31,0,3,2,1,1,1
03169278,40,0,40,0,1,1,0,1,1
03169281,40,11,29,0,1,1,0,1,1
03169284,24,3,21,0,1,1,0,1,1
03169368,19,0,19,0,0,0,0,0,1
03169411,20,4,16,0,1,1,0,1,1
03169422,31,4,27,0,1,1,0,1,1
03169474,16,5,11,0,1,1,0,1,1
03169578,16,2,14,0,6,2,4,0,0
03169600,53,12,41,0,1,0,1,1,1
03169665,50,9,41,0,0,0,0,0,1
03169833,29,3,26,0,1,1,0,1,1
SC389077,9,0,9,0,2,1,1,0,0
SC389092,6,3,3,1,1,1,0,1,1
SC389127,1,1,0,0,1,1,0,0,0
SC389327,3,1,2,0,1,1,0,0,0
SC389404,10,5,5,0,0,0,0,0,0
SC389810,4,0,4,0,0,0,0,0,1
SC390019,6,3,3,0,1,1,0,0,1
SC390021,6,2,4,0,1,1,0,0,1
SC390206,4,2,2,0,2,1,1,0,1
SC390210,17,4,13,0,1,1,0,1,1
SC390229,4,3,1,0,2,0,2,0,1
SC390534,2,2,0,0,2,2,0,0,0
SC390582,3,2,1,0,2,2,0,0,0
SC390621,12,0,12,0,0,0,0,0,0
SC390655,2,2,0,0,2,2,0,0,0
SC390698,26,14,12,0,14,12,2,0,0
SC390699,4,0,4,0,0,0,0,0,1
SC390736,2,2,0,0,2,2,0,0,1
SC390738,2,2,0,0,2,2,0,0,1
SC391048,3,0,3,0,0,0,0,0,1
SC391158,5,0,5,0,0,0,0,0,1
SC391385,4,0,4,0,0,0,0,0,0
SC391468,9,0,9,0,0,0,0,0,0
SC391580,14,3,11,0,1,0,1,0,0
SC391905,7,6,1,0,1,1,0,1,1
SC392285,13,4,9,0,1,1,0,1,1
SC392291,13,5,8,0,2,2,0,2,1
SC392332,4,1,3,0,1,1,0,0,0
SC392386,10,7,3,0,0,0,0,0,0
SC392560,5,3,2,0,2,2,0,0,0
SC392759,8,0,8,0,1,1,0,1,1
SC392873,2,2,0,0,0,0,0,0,0
SC392928,4,1,3,0,4,4,0,0,0
SC393096,8,2,6,0,1,1,0,1,1
SC393097,8,0,8,0,0,0,0,0,1
SC393098,8,4,4,0,3,1,2,3,1
SC393275,7,2,5,0,1,1,0,0,0
SC393430,4,3,1,0,0,0,0,0,0
SC393459,5,2,3,1,1,1,0,1,1
SC393460,5,2,3,1,1,1,0,1,1
SC393589,9,0,9,0,0,0,0,0,0
SC393645,7,4,3,0,2,2,0,0,0
SC393648,4,2,2,0,1,1,0,0,0
SC393671,2,2,0,0,2,2,0,0,0
SC393873,5,0,5,0,1,1,0,0,1
SC393967,5,5,0,0,0,0,0,0,0
SC394126,3,0,3,0,0,0,0,0,1
SC394162,2,1,1,0,1,1,0,0,0
SC394169,3,3,0,0,2,2,0,0,0
SC394203,3,0,3,0,0,0,0,0,0
SC394389,1,0,1,0,0,0,0,0,0
SC394519,13,4,9,0,1,1,0,1,1
SC394595,1,1,0,0,1,1,0,0,0
SC394614,3,2,1,0,2,2,0,0,1
SC394622,3,3,0,0,1,1,0,1,0
SC394656,3,2,1,0,2,2,0,0,0
SC394684,1,1,0,0,1,1,0,0,0
SC394689,7,4,3,0,1,1,0,1,1
SC394690,7,4,3,0,1,1,0,1,1
SC394691,7,4,3,0,1,1,0,1,1
SC394695,3,3,0,0,3,3,0,0,1
SC394719,1,1,0,0,1,1,0,0,1
SC394794,5,0,5,0,1,1,0,0,0
SC395007,5,2,3,0,4,2,2,0,0
SC395082,13,5,8,0,0,0,0,0,0
SC395262,4,2,2,0,3,1,2,1,0
SC395396,6,4,2,0,3,0,3,0,1
SC395537,20,6,14,0,1,1,0,1,0
SC395600,12,5,7,0,1,1,0,0,0
SC395671,5,4,1,0,1,1,0,0,1
SC395787,4,2,2,0,1,1,0,1,1
SC395835,3,1,2,0,1,1,0,0,0
SC395892,5,4,1,0,3,3,0,0,1
SC395896,4,0,4,0,0,0,0,0,1
SC395973,2,1,1,0,1,1,0,0,0
SC395976,12,3,9,0,1,1,0,1,1
SC395977,19,3,16,0,1,1,0,1,1
SC396230,7,0,7,0,0,0,0,0,1
SC396516,3,2,1,0,1,1,0,0,1
SC396838,23,8,15,0,5,0,5,0,0
SC396877,6,5,1,0,2,2,0,1,1
SC397096,8,0,8,0,0,0,0,0,1
SC397174,2,2,0,0,1,1,0,0,0
SC397231,3,1,2,0,1,1,0,0,0
SC397449,7,4,3,1,2,2,0,0,1
SC397450,7,4,3,0,1,1,0,1,1
SC397527,2,1,1,0,1,1,0,0,1
SC397528,2,1,1,0,1,1,0,0,1
SC397530,1,0,1,0,0,0,0,0,1
SC397653,2,0,2,0,0,0,0,0,0
SC397710,2,0,2,0,1,1,0,0,0
SC397857,7,2,5,0,2,2,0,1,1
SC397950,23,10,13,0,0,0,0,0,0
SC398038,19,5,14,0,0,0,0,0,1
SC398044,20,13,7,0,14,12,2,0,0
SC398119,3,0,3,0,0,0,0,0,1
SC398293,6,3,3,0,1,0,1,1,1
SC398497,1,1,0,0,1,1,0,0,0
SC398548,5,3,2,0,2,2,0,0,0
SC398596,6,0,6,0,0,0,0,0,1
SC398607,6,0,6,0,0,0,0,0,1
SC398820,2,2,0,0,1,1,0,0,0
SC399121,6,0,6,0,0,0,0,0,0
SC399312,5,0,5,0,0,0,0,0,1
SC399354,12,2,10,0,1,1,0,1,1
SC399384,5,0,5,0,0,0,0,0,1
SC399582,13,8,5,0,0,0,0,0,1
SC399592,10,5,5,0,1,1,0,0,1
SC399763,6,5,1,0,0,0,0,0,0
SC399844,3,0,3,0,0,0,0,0,0
SC399862,1,0,1,0,0,0,0,0,0
SC399876,13,4,9,0,0,0,0,0,0
SC399970,2,1,1,0,1,1,0,0,0
SC399996,1,0,1,0,0,0,0,0,0
SC400171,1,1,0,0,1,1,0,0,0
SC400328,11,7,4,0,3,0,3,0,0
SC400364,2,0,2,0,0,0,0,0,0
SC400459,20,4,16,1,2,1,1,2,1
SC400486,2,0,2,0,0,0,0,0,1
SC400520,3,0,3,0,0,0,0,0,1
SC400657,35,11,24,0,1,1,0,1,0
SC400658,13,7,6,0,1,1,0,1,0
SC400714,9,6,3,0,1,1,0,0,1
SC400763,1,0,1,0,0,0,0,0,0
SC400790,2,2,0,0,1,1,0,0,0
SC400895,7,3,4,0,3,3,0,0,0
SC401121,14,8,6,0,0,0,0,0,0
SC401603,10,4,6,0,1,1,0,1,1
SC401635,2,0,2,0,0,0,0,0,1
SC401717,3,3,0,0,2,2,0,0,1
SC401843,7,2,5,0,1,1,0,1,1
SC401907,2,1,1,0,1,1,0,0,1
SC402041,2,0,2,0,0,0,0,0,0
SC402171,16,8,8,0,0,0,0,0,0
SC402242,2,2,0,0,2,2,0,0,0
SC402272,5,0,5,0,0,0,0,0,0
SC402300,1,1,0,0,1,1,0,0,0
SC402353,4,2,2,0,2,2,0,2,1
SC402378,4,0,4,0,0,0,0,0,1
SC402380,4,0,4,0,0,0,0,0,1
SC402586,9,4,5,0,1,1,0,1,1
SC402662,3,3,0,0,1,1,0,0,0
SC402708,6,3,3,0,2,1,1,1,1
SC402773,21,12,9,0,0,0,0,0,0
SC402787,2,2,0,0,1,1,0,0,0
SC402837,11,4,7,0,2,1,1,1,1
SC403283,4,0,4,0,1,1,0,0,0
SC403483,4,2,2,0,2,2,0,0,1
SC403946,9,4,5,0,1,1,0,1,1
SC404303,2,2,0,0,2,1,1,0,0
SC404362,13,0,13,0,1,1,0,1,1
SC404533,4,4,0,0,1,1,0,0,1
SC404540,2,0,2,0,2,1,1,0,1
SC404621,2,2,0,0,2,2,0,0,1
SC404678,1,1,0,0,1,1,0,0,1
SC405094,6,0,6,0,0,0,0,0,0
SC405177,1,1,0,0,1,1,0,0,1
SC405253,3,0,3,0,0,0,0,0,0
SC405298,2,2,0,0,1,1,0,0,0
SC405562,3,2,1,0,1,1,0,0,0
SC405964,14,8,6,0,0,0,0,0,1
SC405993,1,1,0,0,1,1,0,0,0
SC405995,8,6,2,0,0,0,0,0,0
SC406125,5,0,5,0,1,1,0,1,1
SC406191,5,0,5,0,0,0,0,0,1
SC406349,6,0,6,1,0,0,0,0,1
SC406352,12,6,6,0,0,0,0,0,0
SC406353,4,2,2,0,1,1,0,0,0
SC406447,10,0,10,0,0,0,0,0,1
SC406515,7,0,7,0,0,0,0,0,1
SC406603,2,2,0,0,2,2,0,0,0
SC406671,4,2,2,0,2,2,0,0,1
SC406704,4,2,2,0,2,2,0,0,1
SC406941,4,0,4,0,0,0,0,0,0
SC407233,21,11,10,0,0,0,0,0,1
SC407442,5,3,2,0,1,1,0,0,1
SC407510,6,3,3,0,2,1,1,1,1
SC407533,5,2,3,0,1,1,0,1,1
SC407876,8,5,3,0,1,1,0,1,1
SC408011,2,2,0,0,2,2,0,0,1
SC408188,12,4,8,0,1,1,0,1,1
SC408238,12,9,3,0,1,1,0,0,0
SC408525,1,1,0,0,1,1,0,0,0
SC408551,2,2,0,0,2,2,0,0,0
SC408586,3,2,1,0,1,1,0,0,0
SC408711,2,2,0,0,2,2,0,0,0
SC408886,2,0,2,0,0,0,0,0,0
SC409027,3,3,0,0,2,2,0,0,0
SC409186,4,1,3,0,1,1,0,0,0
SC409322,3,3,0,0,2,2,0,0,0
SC409380,3,1,2,0,1,1,0,0,0
SC409431,9,2,7,0,2,2,0,2,1
SC409656,3,2,1,0,2,1,1,1,1
SC409733,1,0,1,0,0,0,0,0,1
SC409777,9,4,5,0,1,1,0,1,1
SC410008,1,0,1,0,0,0,0,0,0
SC410134,1,0,1,0,0,0,0,0,0
SC410297,21,8,13,0,0,0,0,0,0
SC410426,1,0,1,0,1,1,0,0,0
SC410573,18,0,18,0,0,0,0,0,0
SC410626,3,0,3,0,0,0,0,0,0
SC410676,4,1,3,0,1,1,0,0,0
SC410732,2,2,0,0,1,1,0,0,0
SC410904,4,2,2,0,0,0,0,0,0
SC410915,4,2,2,0,1,1,0,0,0
SC410956,1,0,1,0,1,1,0,0,0
SC411036,17,6,11,0,0,0,0,0,0
SC411174,2,0,2,0,0,0,0,0,0
SC411251,1,0,1,0,0,0,0,0,1
SC411667,28,11,17,0,0,0,0,0,1
SC411831,5,0,5,0,0,0,0,0,1
SC411872,3,3,0,0,2,2,0,0,1
SC412275,33,10,23,0,0,0,0,0,0
SC412350,2,0,2,0,0,0,0,0,0
SC412355,4,2,2,0,2,2,0,2,1
SC412487,1,1,0,0,1,1,0,1,1
SC412524,3,1,2,0,1,1,0,0,0
SC412605,5,3,2,0,1,1,0,0,1
SC412641,1,1,0,0,1,1,0,0,0
SC412662,3,0,3,0,0,0,0,0,1
SC413001,3,2,1,0,0,0,0,0,0
SC413235,2,1,1,0,1,0,1,0,0
SC413268,5,3,2,0,1,1,0,0,1
SC413288,5,2,3,0,3,2,1,0,0
SC413327,2,1,1,0,1,1,0,0,0
SC413329,2,2,0,0,1,1,0,0,0
SC413390,10,6,4,0,1,1,0,1,1
SC413448,1,1,0,0,1,1,0,0,1
SC413518,5,1,4,0,1,1,0,0,0
SC413620,33,14,19,0,0,0,0,0,0
SC413672,8,3,5,0,1,1,0,1,1
01649155,23,0,23,0,0,0,0,0,1
01649615,7,2,5,0,2,2,0,0,0
01650215,22,0,22,0,1,1,0,1,1
01650657,8,2,6,0,1,1,0,0,1
01650840,25,0,25,0,0,0,0,0,1
01650846,26,4,22,0,1,1,0,1,1
01651257,9,5,4,0,1,1,0,0,0
01652047,15,0,15,0,0,0,0,0,1
01652213,21,5,16,0,1,1,0,0,1
01653116,77,12,65,0,0,0,0,0,1
01653166,17,3,14,0,1,1,0,1,1
01653185,15,0,15,0,0,0,0,0,1
01653331,42,8,34,0,1,1,0,1,1
01653359,16,3,13,0,0,0,0,0,0
01653519,37,3,34,0,1,1,0,1,1
01654125,6,4,2,0,1,1,0,0,0
01654194,21,0,21,0,0,0,0,0,1
01654220,10,0,10,0,1,1,0,1,1
01654806,44,9,35,0,0,0,0,0,1
01654989,13,1,12,0,1,0,1,0,0
01655467,64,8,56,0,0,0,0,0,1
01655888,41,0,41,0,0,0,0,0,1
01656023,13,2,11,0,1,1,0,1,1
01656361,50,4,46,0,1,1,0,1,1
01656516,54,10,44,0,0,0,0,0,1
01656728,8,2,6,0,2,1,1,0,1
01656838,38,0,38,0,0,0,0,0,1
01657022,6,2,4,0,2,2,0,0,0
01657163,16,5,11,0,1,1,0,0,0
01657318,23,5,18,0,1,1,0,1,1
01657550,6,1,5,0,1,1,0,0,0
01657562,5,4,1,0,3,3,0,0,0
01657657,17,4,13,0,1,1,0,1,1
01657717,43,17,26,0,0,0,0,0,1
01658371,32,2,30,0,2,2,0,2,0
01658599,85,0,85,0,0,0,0,0,1
01658691,7,2,5,0,0,0,0,0,0
01658699,26,4,22,0,0,0,0,0,1
01658859,96,11,85,0,2,0,2,0,1
01659028,12,0,12,0,0,0,0,0,0
01659209,37,3,34,0,1,1,0,1,1
01659504,15,0,15,0,1,1,0,1,1
01659643,5,4,1,0,1,1,0,0,1
01659656,63,5,58,0,0,0,0,0,1
01660078,37,3,34,0,1,1,0,1,1
01660249,17,3,14,0,1,0,1,0,1
01660784,48,9,39,0,1,1,0,1,1
01660786,29,0,29,0,0,0,0,0,1
01661136,5,3,2,0,5,5,0,2,1
01661173,5,1,4,0,1,1,0,0,0
01661244,7,5,2,0,2,2,0,0,1
01661686,31,17,14,0,1,1,0,1,1
01662208,49,9,40,0,0,0,0,0,0
01662228,21,5,16,0,1,1,0,0,0
01662284,33,2,31,0,1,1,0,1,1
01662332,5,2,3,0,4,2,2,0,0
01662393,4,3,1,0,1,1,0,0,1
01662682,25,4,21,0,2,1,1,2,1
01663694,49,4,45,0,0,0,0,0,1
01664296,19,4,15,0,5,4,1,1,1
01664812,58,11,47,0,0,0,0,0,1
01665074,13,5,8,0,4,4,0,0,1
01665292,6,4,2,0,2,2,0,1,0
01665648,37,4,33,0,1,1,0,1,1
01666333,40,4,36,0,1,1,0,1,1
01666751,100,8,92,0,0,0,0,0,1
01666896,21,2,19,0,1,1,0,1,1
01667171,22,1,21,0,0,0,0,0,1
01667196,21,2,19,0,1,1,0,1,1
01668014,15,0,15,0,0,0,0,0,1
01668015,8,0,8,0,0,0,0,0,1
01668204,25,0,25,0,0,0,0,0,1
01668371,9,4,5,0,0,0,0,0,0
01668457,41,6,35,0,1,1,0,1,1
01668726,8,4,4,0,3,1,2,2,0
01668892,3,3,0,0,0,0,0,0,0
01669057,50,5,45,0,1,1,0,1,1
01669296,6,2,4,0,1,1,0,1,0
01669515,17,4,13,0,6,6,0,0,1
01669693,17,0,17,0,0,0,0,0,1
01669776,4,4,0,0,1,1,0,0,1
01669978,3,2,1,0,2,2,0,0,1
01670395,4,2,2,0,1,1,0,0,0
01671114,33,4,29,0,1,1,0,1,1
01671240,5,2,3,0,2,2,0,0,0
01671347,49,14,35,0,1,1,0,0,1
01671355,25,6,19,0,1,1,0,1,1
01671730,31,0,31,0,0,0,0,0,1
01672274,23,3,20,0,1,1,0,1,1
01672983,15,2,13,0,1,1,0,0,0
01672991,58,13,45,0,0,0,0,0,1
01673012,12,2,10,0,3,2,1,0,1
01673325,22,7,15,0,0,0,0,0,1
01673457,0,0,0,0,0,0,0,0,0
01673650,24,2,22,0,0,0,0,0,1
01673720,46,13,33,0,0,0,0,0,1
01673907,30,3,27,0,1,1,0,1,1
01674688,1,1,0,0,0,0,0,0,1
01674774,16,4,12,0,0,0,0,0,1
01674944,25,3,22,0,1,1,0,0,1
01675071,26,0,26,0,1,1,0,1,1
01675552,60,14,46,0,0,0,0,0,1
01675557,13,4,9,0,0,0,0,0,1
01675656,34,3,31,0,3,3,0,1,1
01675679,18,5,13,0,0,0,0,0,1
01675735,7,0,7,0,1,1,0,0,1
01675893,7,4,3,0,3,3,0,0,0
01676618,93,14,79,0,4,3,1,0,1
01676689,29,3,26,0,1,1,0,1,1
01677155,26,10,16,0,0,0,0,0,0
01677389,21,3,18,0,1,1,0,1,1
01677787,46,18,28,0,1,1,0,1,1
01678876,13,2,11,0,2,1,1,1,1
01679043,22,2,20,0,1,1,0,1,1
01679046,46,3,43,0,1,1,0,1,1
01679166,19,2,17,0,0,0,0,0,0
01679183,5,2,3,0,3,3,0,0,1
01679424,61,4,57,0,1,1,0,1,1
01679488,41,3,38,0,1,1,0,1,1
01679530,18,3,15,0,1,1,0,1,1
01679789,4,3,1,0,2,1,1,0,1
01679912,34,3,31,0,1,1,0,1,1
01679975,16,4,12,0,1,1,0,1,1
01679995,3,3,0,0,1,1,0,0,1
01680115,17,3,14,0,1,1,0,1,1
01680796,22,5,17,0,1,1,0,0,1
01681046,10,4,6,0,4,3,1,2,1
01681278,72,10,62,0,0,0,0,0,1
01682107,15,2,13,0,1,1,0,1,1
01682230,5,5,0,0,2,2,0,0,0
01682540,27,3,24,0,0,0,0,0,1
01682771,8,2,6,0,1,1,0,1,1
01683075,14,1,13,0,0,0,0,0,1
01683477,27,0,27,0,0,0,0,0,1
01683840,30,4,26,0,1,0,1,1,1
01683936,10,2,8,0,1,1,0,0,1
01684483,45,7,38,0,0,0,0,0,1
01684525,25,0,25,0,1,1,0,1,1
01684544,4,1,3,0,1,1,0,0,0
01684636,13,0,13,0,0,0,0,0,1
01685094,23,4,19,0,1,1,0,1,1
01686116,20,4,16,0,1,1,0,1,1
01686164,92,8,84,0,0,0,0,0,1
01686341,5,3,2,0,1,1,0,0,0
01686716,23,0,23,0,0,0,0,0,1
01687154,8,0,8,0,0,0,0,0,1
01687173,13,5,8,0,4,4,0,1,1
01687590,52,5,47,0,1,1,0,1,1
01687626,31,0,31,0,0,0,0,0,1
01687652,31,0,31,0,1,1,0,1,1
01687872,6,4,2,0,2,2,0,0,0
01688036,118,38,80,0,0,0,0,0,1
01688065,31,5,26,0,5,4,1,0,1
01688075,73,7,66,0,1,1,0,1,1
01688410,118,38,80,0,0,0,0,0,1
01688879,11,0,11,0,0,0,0,0,1
01688958,10,3,7,0,1,1,0,0,1
01689098,23,0,23,0,0,0,0,0,1
01689416,40,0,40,0,1,1,0,1,1
01689619,65,10,55,0,1,1,0,0,1
01689995,41,0,41,0,1,1,0,1,1
01690003,18,2,16,0,1,1,0,1,1
01690026,73,11,62,0,2,2,0,2,1
01690525,26,4,22,0,0,0,0,0,1
01690565,36,11,25,0,1,1,0,0,1
01690572,24,4,20,0,1,1,0,1,1
01690725,35,0,35,0,0,0,0,0,1
01690758,15,5,10,0,1,1,0,1,1
01690781,30,2,28,0,1,1,0,1,1
01690871,46,13,33,0,0,0,0,0,1
01690936,24,0,24,0,1,1,0,1,1
01690975,18,0,18,0,0,0,0,0,1
01690987,16,0,16,0,0,0,0,0,1
01691431,58,5,53,0,1,1,0,1,1
01691472,59,5,54,0,1,1,0,1,1
01691818,21,5,16,0,0,0,0,0,1
01691901,23,3,20,0,1,1,0,1,1
01692341,56,13,43,0,0,0,0,0,1
01692351,19,5,14,0,1,1,0,1,1
01692482,13,4,9,0,0,0,0,0,0
01692928,61,9,52,0,0,0,0,0,1
01693088,20,4,16,0,1,1,0,1,1
01693108,34,5,29,0,1,1,0,1,1
01693212,21,4,17,0,0,0,0,0,1
01693309,8,2,6,0,3,3,0,0,1
01693426,11,3,8,0,0,0,0,0,1
01693490,13,4,9,0,2,2,0,0,1
01694712,56,9,47,0,0,0,0,0,1
01694836,28,3,25,0,3,1,2,2,1
01695085,22,5,17,0,0,0,0,0,1
01695426,13,0,13,0,0,0,0,0,1
01695813,18,6,12,0,1,1,0,1,1
01696150,88,15,73,0,0,0,0,0,1
01696899,12,6,6,0,2,2,0,1,0
01696917,20,3,17,0,1,1,0,1,1
01697096,11,5,6,0,1,1,0,0,0
01697158,10,4,6,0,5,1,4,1,1
01697225,16,0,16,0,0,0,0,0,1
01697431,14,3,11,0,0,0,0,0,1
01697461,107,13,94,0,0,0,0,0,1
01697756,47,10,37,0,0,0,0,0,1
01698056,20,2,18,0,0,0,0,0,0
01698137,10,5,5,0,0,0,0,0,1
01698349,51,11,40,0,0,0,0,0,1
01698399,41,14,27,0,0,0,0,0,1
01698409,43,11,32,0,1,1,0,1,1
01698889,6,2,4,0,1,1,0,1,1
01698962,5,3,2,0,1,1,0,1,1
01699246,24,3,21,0,1,1,0,1,1
01699296,14,0,14,0,0,0,0,0,1
01699383,9,5,4,0,2,2,0,0,1
01699434,13,2,11,0,1,1,0,1,1
01699514,19,3,16,0,1,1,0,1,1
01699784,86,11,75,0,1,1,0,1,1
01699916,7,3,4,0,1,1,0,1,1
01701035,28,4,24,0,3,1,2,0,0
01701276,4,2,2,0,2,2,0,0,0
01701605,16,4,12,0,1,1,0,1,1
01701634,11,6,5,0,1,1,0,0,1
01701757,4,3,1,0,2,2,0,0,1
01701924,80,3,77,0,0,0,0,0,1
01702378,43,4,39,0,1,1,0,1,1
01702419,5,4,1,0,2,2,0,0,0
01702426,59,11,48,0,0,0,0,0,1
01702448,17,3,14,0,1,1,0,0,1
01702727,5,5,0,0,2,2,0,0,1
01702816,75,6,69,0,0,0,0,0,1
01703066,0,0,0,0,0,0,0,0,0
01704111,36,3,33,0,1,1,0,1,1
01704270,10,4,6,0,0,0,0,0,0
01704776,36,4,32,0,0,0,0,0,0
01704931,5,4,1,0,2,2,0,0,0
01705419,21,3,18,0,0,0,0,0,0
01705520,15,5,10,0,2,1,1,0,1
01705689,28,2,26,0,1,1,0,1,0
01705868,27,4,23,0,1,1,0,0,1
01705930,38,13,25,0,0,0,0,0,0
01706358,28,6,22,0,1,1,0,0,0
01706540,20,6,14,0,0,0,0,0,1
01706670,4,2,2,0,3,2,1,0,0
01707341,35,5,30,0,1,1,0,1,1
01707442,25,3,22,0,1,1,0,1,1
01707502,9,3,6,0,1,1,0,1,0
01707581,9,5,4,0,1,1,0,0,0
01708119,4,0,4,0,1,1,0,0,1
01708850,19,6,13,0,1,1,0,1,1
01709017,20,3,17,0,1,1,0,1,1
01709310,6,0,6,0,0,0,0,0,1
01709436,29,3,26,0,1,1,0,0,1
01709532,8,5,3,0,0,0,0,0,0
01709638,14,3,11,0,1,1,0,0,1
01710313,103,10,93,0,2,1,1,0,1
01710447,31,6,25,0,0,0,0,0,1
01710669,52,7,45,0,0,0,0,0,1
01710671,15,4,11,0,1,1,0,1,1
01710695,59,16,43,0,2,0,2,0,1
01710702,5,2,3,0,1,1,0,0,1
01710736,38,9,29,0,1,1,0,1,1
01711118,37,6,31,0,1,1,0,1,1
01711151,13,5,8,0,3,3,0,1,1
01711189,9,0,9,0,0,0,0,0,1
01712157,35,0,35,0,0,0,0,0,1
01712247,15,0,15,0,0,0,0,0,1
01712307,57,4,53,0,1,1,0,1,1
01712782,10,3,7,0,1,1,0,1,1
01712914,19,4,15,0,0,0,0,0,1
01713006,6,2,4,0,1,1,0,0,1
01713124,97,9,88,0,0,0,0,0,1
01713396,13,4,9,0,4,3,1,0,1
01713578,39,4,35,0,1,1,0,1,0
01713927,38,5,33,0,1,1,0,1,1
01713997,70,10,60,0,0,0,0,0,1
01714446,30,3,27,0,1,1,0,1,1
01714796,15,4,11,0,3,3,0,0,1
01714937,63,12,51,0,0,0,0,0,1
01715389,6,0,6,0,1,1,0,0,1
01715768,22,4,18,0,1,1,0,1,1
01716035,33,4,29,0,0,0,0,0,1
01716654,3,2,1,0,2,2,0,0,1
01716719,23,8,15,0,1,1,0,0,1
01717239,84,15,69,0,1,1,0,1,1
01717446,2,2,0,0,0,0,0,0,0
01717639,61,0,61,0,0,0,0,0,1
01718016,12,5,7,0,1,1,0,0,1
01718369,16,5,11,0,0,0,0,0,1
01718430,7,3,4,0,2,2,0,1,1
01719128,30,8,22,0,0,0,0,0,1
01719314,9,1,8,0,3,1,2,2,1
01719649,38,10,28,0,1,1,0,1,1
01719860,15,5,10,0,3,3,0,0,1
OC329090,2,2,0,0,1,1,0,0,0
OC329250,4,2,2,0,1,1,0,0,1
OC329392,137,57,80,0,1,1,0,1,1
OC329609,10,3,7,0,1,1,0,0,1
OC329653,14,6,8,0,0,0,0,0,1
OC329754,18,0,18,0,0,0,0,0,1
OC329879,6,2,4,0,1,1,0,0,1
OC330011,4,3,1,0,3,3,0,0,1
OC330252,460,204,256,0,0,0,0,0,1
OC330347,25,22,3,0,1,1,0,1,1
OC330377,4,0,4,0,0,0,0,0,1
OC330384,20,0,20,0,2,2,0,2,1
OC330567,4,4,0,0,1,1,0,0,1
OC330580,27,0,27,1,0,0,0,0,1
OC330614,35,9,26,0,0,0,0,0,1
OC330889,5,2,3,0,2,1,1,0,1
OC330925,2,2,0,0,2,2,0,0,0
OC331086,14,5,9,0,2,2,0,0,1
OC331125,27,16,11,0,0,0,0,0,1
OC331458,8,4,4,0,0,0,0,0,1
OC331564,5,3,2,0,2,2,0,0,0
OC331671,7,3,4,0,0,0,0,0,0
OC331830,4,0,4,0,0,0,0,0,1
OC331918,2,2,0,2,0,0,0,0,1
OC332045,36,14,22,1,1,1,0,1,0
OC332087,4,0,4,0,0,0,0,0,1
OC332103,3,3,0,0,3,3,0,0,1
OC332129,10,3,7,0,3,3,0,0,1
OC332293,2,2,0,0,1,1,0,0,1
OC332526,17,0,17,0,0,0,0,0,1
OC332563,5,0,5,0,2,2,0,0,1
OC332605,53,31,22,0,0,0,0,0,1
OC332730,3,0,3,0,0,0,0,0,0
OC332883,4,0,4,0,0,0,0,0,0
OC333073,9,2,7,2,2,1,1,0,1
OC333278,6,3,3,0,3,2,1,0,1
OC333282,5,2,3,0,0,0,0,0,1
OC333433,19,9,10,0,0,0,0,0,1
OC333537,4,2,2,0,2,2,0,2,0
OC333653,678,398,280,0,0,0,0,0,1
OC333709,65,46,19,0,1,1,0,1,1
OC333791,8,0,8,8,0,0,0,0,1
OC334031,203,2,201,0,1,1,0,1,1
OC334289,34,13,21,0,0,0,0,0,1
OC334313,22,14,8,0,0,0,0,0,1
OC334323,302,288,14,0,4,2,2,4,1
OC334326,2,0,2,0,0,0,0,0,1
OC334333,9,3,6,0,1,1,0,0,0
OC334334,126,83,43,0,0,0,0,0,1
OC334398,68,2,66,0,5,1,4,1,1
OC334406,148,90,58,0,0,0,0,0,1
OC334430,4,0,4,0,0,0,0,0,1
OC334522,92,71,21,0,0,0,0,0,1
OC334647,5,0,5,0,0,0,0,0,1
OC334653,7,0,7,6,1,1,0,1,1
OC334677,6,2,4,6,1,1,0,0,1
OC334789,558,289,269,0,0,0,0,0,1
OC334809,4,0,4,0,3,3,0,0,1
OC334874,55,22,33,1,2,2,0,0,1
OC335029,14,14,0,0,0,0,0,0,1
OC335051,83,0,83,0,0,0,0,0,1
OC335387,7,0,7,5,0,0,0,0,1
OC335427,3,3,0,0,2,2,0,0,0
OC335451,14,0,14,0,0,0,0,0,1
OC335506,67,44,23,0,0,0,0,0,1
OC335840,33,24,9,0,0,0,0,0,0
OC335884,4,2,2,0,1,1,0,0,0
OC335981,25,0,25,0,0,0,0,0,1
OC336049,7,6,1,0,0,0,0,0,0
OC336077,66,42,24,0,0,0,0,0,1
OC336183,13,9,4,0,0,0,0,0,0
OC336385,6,0,6,4,0,0,0,0,1
OC336518,4,2,2,0,2,2,0,0,0
OC336590,4,0,4,0,0,0,0,0,1
OC336756,3,3,0,0,3,3,0,0,1
OC336943,2,0,2,0,0,0,0,0,1
OC336965,3,3,0,0,0,0,0,0,0
OC337118,5,0,5,1,0,0,0,0,1
OC337203,3,0,3,0,1,1,0,0,1
OC337226,4,2,2,0,2,2,0,0,0
OC337378,177,0,177,0,0,0,0,0,1
OC337726,6,0,6,2,0,0,0,0,0
OC337755,4,2,2,0,2,2,0,0,0
OC338112,17,4,13,0,3,2,1,0,1
OC338118,6,3,3,1,1,1,0,0,1
OC338183,63,5,58,0,0,0,0,0,1
OC338426,76,25,51,0,0,0,0,0,1
OC338681,3,0,3,0,1,1,0,0,1
OC338824,10,10,0,0,0,0,0,0,1
OC338907,2,0,2,0,0,0,0,0,1
OC339018,19,14,5,3,1,1,0,1,1
OC339048,4,0,4,0,1,1,0,0,0
OC339069,5,0,5,0,0,0,0,0,1
OC339088,5,5,0,0,4,4,0,0,1
OC339121,17,4,13,0,1,1,0,1,1
OC339122,5,2,3,0,1,1,0,0,1
OC339129,233,231,2,0,1,1,0,1,1
OC339137,5,3,2,4,1,1,0,1,1
OC339408,14,4,10,2,3,2,1,0,1
OC339470,46,32,14,0,0,0,0,0,1
OC339786,2,2,0,0,1,1,0,0,0
OC339819,2,0,2,0,0,0,0,0,1
OC339863,5,0,5,0,0,0,0,0,1
OC339900,6,0,6,0,0,0,0,0,1
OC339999,4,2,2,0,2,2,0,0,0
OC340127,4,0,4,0,0,0,0,0,0
OC340160,6,5,1,0,1,1,0,0,1
OC340239,5,2,3,0,3,1,2,0,0
OC340361,55,25,30,0,0,0,0,0,1
OC340425,27,2,25,1,1,1,0,1,1
OC340779,17,8,9,0,0,0,0,0,1
OC341044,2,0,2,0,0,0,0,0,1
OC341223,130,127,3,0,0,0,0,0,1
OC341404,5,4,1,0,4,4,0,0,1
OC341489,9,5,4,0,1,1,0,1,1
OC341717,3,3,0,0,2,1,1,1,0
OC341786,69,32,37,0,0,0,0,0,1
OC342007,124,0,124,0,0,0,0,0,1
OC342063,6,4,2,0,4,4,0,0,0
OC342174,63,0,63,0,0,0,0,0,1
OC342304,6,5,1,1,1,1,0,0,0
OC342384,4,2,2,2,0,0,0,0,1
OC342432,131,75,56,0,10,8,2,0,1
OC342504,4,2,2,0,1,1,0,0,1
OC342889,10,5,5,0,0,0,0,0,0
OC343267,26,11,15,0,6,3,3,1,1
OC343301,3,3,0,0,1,1,0,0,0
OC343448,2,2,0,0,2,2,0,0,1
OC343458,5,2,3,0,1,1,0,0,1
OC343478,24,2,22,0,2,2,0,2,1
OC343522,18,0,18,0,0,0,0,0,1
OC343563,7,3,4,6,1,1,0,1,1
OC343640,2,2,0,0,2,2,0,2,0
OC343815,51,45,6,0,0,0,0,0,1
OC343897,417,244,173,0,0,0,0,0,1
OC343916,10,7,3,0,0,0,0,0,1
OC344013,14,0,14,0,0,0,0,0,1
OC344173,15,2,13,0,2,2,0,2,1
OC344192,5,0,5,0,2,2,0,0,0
OC344209,9,2,7,0,1,1,0,1,1
OC344239,3,2,1,0,3,2,1,0,1
OC344243,4,2,2,2,0,0,0,0,1
OC344414,4,0,4,2,0,0,0,0,1
OC344553,80,51,29,0,0,0,0,0,1
OC344600,33,24,9,0,0,0,0,0,1
OC344627,6,2,4,0,2,2,0,0,1
OC344774,6,0,6,0,0,0,0,0,1
OC345220,9,5,4,0,1,1,0,0,1
OC345232,8,5,3,0,0,0,0,0,0
OC345380,8,3,5,0,1,1,0,0,1
OC345423,3,0,3,0,3,3,0,0,1
OC345558,3,3,0,0,3,3,0,0,0
OC345619,212,0,212,0,0,0,0,0,1
OC345662,2,0,2,0,2,2,0,1,1
OC345670,3,3,0,0,3,3,0,0,1
OC345717,5,0,5,0,0,0,0,0,1
OC345738,8,2,6,0,1,1,0,1,1
OC345751,4,2,2,2,0,0,0,0,1
OC346028,88,0,88,0,0,0,0,0,1
OC346126,4,2,2,0,1,1,0,0,0
OC346618,7,4,3,0,3,3,0,0,1
OC346638,22,2,20,0,2,2,0,2,1
OC346720,2,2,0,0,1,1,0,0,0
OC346767,6,0,6,0,0,0,0,0,1
OC346990,5,0,5,0,0,0,0,0,1
OC347034,28,22,6,0,2,2,0,0,1
OC347121,2,2,0,0,1,1,0,0,1
OC347127,2,0,2,0,2,2,0,0,0
OC347341,8,3,5,0,4,1,3,1,1
OC347430,9,2,7,0,2,2,0,0,0
OC347463,3,3,0,0,3,3,0,0,1
OC347559,5,2,3,3,0,0,0,0,0
OC347572,5,2,3,0,2,2,0,0,0
OC347578,2,2,0,0,2,2,0,0,1
OC347590,8,3,5,0,3,3,0,1,1
OC347897,2,2,0,0,3,3,0,0,0
OC348242,3,3,0,0,1,1,0,0,1
OC348443,4,4,0,0,5,5,0,1,1
OC348591,3,2,1,0,1,0,1,0,1
OC348736,20,0,20,0,1,1,0,0,1
OC348774,7,2,5,0,4,4,0,0,0
OC348965,32,23,9,0,0,0,0,0,1
OC348976,7,0,7,0,0,0,0,0,1
OC349012,25,12,13,0,0,0,0,0,1
OC349036,6,3,3,0,2,2,0,0,1
OC349306,4,0,4,0,0,0,0,0,1
OC349547,13,7,6,0,0,0,0,0,1
OC349617,32,29,3,1,0,0,0,0,1
OC349663,6,0,6,6,1,1,0,0,1
OC349671,5,3,2,0,0,0,0,0,1
OC349808,13,0,13,0,0,0,0,0,1
OC349822,4,0,4,0,1,1,0,0,1
OC349884,3,3,0,0,2,2,0,0,1
OC349914,2,2,0,0,2,2,0,0,0
OC350252,10,10,0,0,0,0,0,0,0
OC350716,8,6,2,0,3,3,0,0,1
OC350881,2,0,2,0,1,1,0,0,1
OC350920,5,0,5,0,0,0,0,0,1
OC351001,2,2,0,0,1,1,0,0,1
OC351102,60,53,7,0,0,0,0,0,1
OC351304,15,0,15,0,1,1,0,0,1
OC351442,2,2,0,0,0,0,0,0,0
OC351506,125,121,4,0,2,2,0,2,1
OC351574,12,5,7,0,1,1,0,0,0
OC351726,3,2,1,0,2,2,0,0,0
OC351752,4,0,4,0,0,0,0,0,1
OC351914,6,0,6,6,0,0,0,0,1
OC352041,81,60,21,0,0,0,0,0,1
OC352072,23,2,21,0,2,2,0,2,1
OC352078,5,2,3,0,1,1,0,0,0
OC352355,6,0,6,0,0,0,0,0,1
OC352463,54,41,13,0,1,1,0,1,1
OC352586,37,0,37,1,0,0,0,0,1
OC352742,3,3,0,0,0,0,0,0,1
OC353072,4,3,1,0,3,3,0,1,1
OC353077,3,0,3,0,0,0,0,0,1
OC353203,3,0,3,0,1,1,0,0,1
OC353248,2,0,2,0,0,0,0,0,1
OC353282,2,2,0,0,2,2,0,0,1
OC353475,11,11,0,0,0,0,0,0,0
OC353478,10,10,0,0,0,0,0,0,0
OC353480,16,13,3,0,0,0,0,0,0
OC353539,9,8,1,0,0,0,0,0,0
OC353588,113,0,113,0,2,2,0,0,1
OC353669,12,12,0,0,0,0,0,0,0
OC353714,3,2,1,0,2,2,0,0,1
OC353779,7,5,2,0,1,1,0,1,1
OC353953,5,3,2,0,0,0,0,0,1
OC354037,7,0,7,0,0,0,0,0,1
OC354054,2,2,0,1,3,3,0,0,0
OC354140,6,5,1,0,0,0,0,0,1
OC354187,7,6,1,0,1,1,0,0,1
OC354226,121,75,46,0,1,1,0,1,1
OC354275,15,0,15,0,0,0,0,0,1
OC354356,14,13,1,0,2,2,0,0,1
OC354703,4,0,4,4,0,0,0,0,1
OC354754,2,2,0,0,1,1,0,0,1
OC354848,6,3,3,0,4,3,1,0,1
OC355031,2,2,0,0,2,2,0,0,0
OC355051,133,11,122,0,17,11,6,2,1
OC355196,9,7,2,0,1,1,0,1,1
OC355216,3,3,0,0,2,2,0,0,1
OC355225,20,14,6,0,0,0,0,0,1
OC355231,6,0,6,0,0,0,0,0,0
OC355365,24,16,8,0,4,2,2,4,1
OC355582,11,11,0,0,0,0,0,0,1
OC355617,2,2,0,0,2,2,0,0,1
OC355641,45,40,5,0,1,1,0,1,1
OC355694,2,2,0,0,2,2,0,0,0
OC355800,9,2,7,0,3,2,1,0,1
OC355851,2,0,2,0,0,0,0,0,1
OC355869,4,3,1,0,1,1,0,0,1
OC355886,2,2,0,0,2,2,0,0,1
OC355935,9,2,7,0,3,2,1,0,1
02682106,26,0,26,0,1,1,0,1,1
02682185,30,2,28,0,1,1,0,1,1
02682207,24,0,24,0,1,1,0,1,1
02682211,26,7,19,0,1,1,0,1,1
02682306,46,0,46,0,0,0,0,0,1
02682316,49,0,49,0,0,0,0,0,1
02682322,44,0,44,0,0,0,0,0,1
02682370,13,2,11,0,2,2,0,1,1
02682464,20,2,18,0,1,1,0,1,1
02682493,19,4,15,0,2,1,1,1,1
02682696,26,0,26,0,1,1,0,1,1
02682768,32,5,27,0,1,1,0,1,1
02682786,5,3,2,0,2,1,1,0,1
02682793,15,0,15,0,0,0,0,0,1
02682865,14,3,11,0,0,0,0,0,1
02682887,11,0,11,0,0,0,0,0,1
02682984,11,0,11,0,0,0,0,0,1
02683331,13,3,10,0,1,1,0,1,1
02684004,11,2,9,0,1,1,0,0,1
02684008,24,0,24,0,0,0,0,0,1
02684045,9,4,5,0,2,2,0,0,1
02684234,34,8,26,0,1,1,0,0,0
02684378,16,3,13,0,1,1,0,1,1
02684596,43,0,43,1,0,0,0,0,1
02684628,11,2,9,0,3,3,0,1,1
02685100,7,2,5,0,1,1,0,0,0
02685210,16,1,15,0,1,1,0,0,1
02685302,23,0,23,0,1,1,0,1,1
02685309,23,0,23,0,1,1,0,1,1
02685660,14,0,14,0,0,0,0,0,1
02685674,20,5,15,0,0,0,0,0,0
02685704,7,3,4,0,1,1,0,0,1
02685707,27,3,24,0,1,1,0,1,1
02685737,12,2,10,0,1,1,0,1,1
02685888,5,0,5,0,1,1,0,1,1
02685981,32,0,32,0,0,0,0,0,1
02686473,19,3,16,0,0,0,0,0,0
02686703,9,3,6,0,0,0,0,0,1
02686778,29,8,21,0,1,1,0,0,1
02686796,26,0,26,0,0,0,0,0,1
02686884,5,0,5,0,0,0,0,0,0
02687110,6,2,4,0,1,1,0,0,0
02687137,37,3,34,0,2,1,1,0,1
02687168,26,7,19,0,1,1,0,0,1
02687360,10,0,10,0,1,1,0,1,0
02687511,7,0,7,0,0,0,0,0,1
02687523,19,3,16,0,1,1,0,0,1
02687933,33,6,27,0,0,0,0,0,1
02687939,7,2,5,0,2,2,0,0,1
02688007,31,0,31,0,1,1,0,1,1
02688108,48,9,39,0,1,1,0,1,1
02688169,5,0,5,0,0,0,0,0,1
02688377,31,7,24,0,1,1,0,0,0
02688394,39,1,38,0,2,2,0,1,1
02688399,38,3,35,0,1,1,0,1,1
02688514,43,5,38,0,0,0,0,0,1
02688597,11,3,8,0,1,1,0,1,1
02688742,38,5,33,0,0,0,0,0,1
02688814,38,3,35,0,1,1,0,1,1
02689134,29,9,20,0,1,1,0,1,1
02689453,28,3,25,0,0,0,0,0,1
02689836,28,5,23,0,2,2,0,2,1
02690018,23,3,20,0,2,1,1,2,1
02690028,12,0,12,0,0,0,0,0,1
02690161,8,2,6,0,2,2,0,0,0
02690259,16,3,13,0,0,0,0,0,1
02690319,9,3,6,0,1,1,0,1,1
02690347,18,1,17,0,1,1,0,0,1
02690459,21,2,19,0,1,1,0,1,1
02690562,25,3,22,0,1,1,0,1,1
02690792,39,4,35,0,0,0,0,0,0
02691102,25,3,22,0,1,1,0,1,1
02691122,13,2,11,0,1,1,0,1,1
02691127,31,8,23,0,0,0,0,0,0
02691430,13,0,13,0,1,1,0,1,0
02691452,29,4,25,0,0,0,0,0,1
02691456,45,0,45,0,1,1,0,1,1
02691508,10,1,9,0,1,1,0,0,1
02691516,28,2,26,0,1,1,0,1,1
02691601,28,0,28,0,0,0,0,0,1
02691636,20,0,20,0,0,0,0,0,1
02691706,16,3,13,0,1,1,0,0,1
02691718,17,4,13,0,0,0,0,0,0
02691750,19,4,15,0,0,0,0,0,1
02691752,19,5,14,0,0,0,0,0,1
02691753,15,2,13,0,0,0,0,0,1
02691818,29,2,27,0,1,1,0,1,1
02691858,17,0,17,0,0,0,0,0,1
02692155,10,4,6,0,3,3,0,0,1
02692254,4,2,2,0,1,1,0,0,1
02692890,43,0,43,0,1,1,0,1,1
02693051,9,4,5,0,1,1,0,1,0
02693175,11,2,9,0,1,1,0,1,1
02693180,30,0,30,0,0,0,0,0,1
02693396,17,3,14,0,0,0,0,0,1
02693471,21,0,21,0,0,0,0,0,1
02693490,23,4,19,0,1,1,0,1,1
02693725,71,3,68,0,1,1,0,1,1
02693774,27,5,22,0,0,0,0,0,1
02693778,33,8,25,0,0,0,0,0,1
02693876,32,2,30,0,1,1,0,1,1
02694171,44,0,44,0,0,0,0,0,1
02694718,42,10,32,0,1,1,0,1,1
02695131,17,3,14,0,1,1,0,0,1
02695296,34,4,30,0,1,1,0,1,1
02695558,11,4,7,0,1,1,0,1,1
02695596,51,2,49,0,0,0,0,0,1
02695601,13,3,10,0,1,1,0,1,1
02695836,8,3,5,0,2,2,0,0,0
02695896,11,4,7,0,1,1,0,0,0
02696223,9,3,6,0,1,1,0,0,1
02696252,25,0,25,0,0,0,0,0,1
02696296,11,4,7,0,1,1,0,0,1
02696326,18,2,16,0,1,1,0,1,1
02696736,13,4,9,0,0,0,0,0,1
02697232,7,3,4,0,2,2,0,0,0
02697436,89,6,83,0,0,0,0,0,1
02697861,13,4,9,0,1,1,0,0,1
02698100,62,6,56,0,0,0,0,0,1
02698195,18,2,16,1,1,1,0,1,0
02698223,8,2,6,0,1,1,0,0,1
02698282,87,17,70,0,0,0,0,0,0
02698321,47,12,35,0,0,0,0,0,1
02698380,50,11,39,0,1,1,0,1,1
02698638,42,7,35,0,0,0,0,0,1
02698671,43,3,40,0,1,1,0,1,1
02698759,41,2,39,0,1,1,0,1,1
02698919,72,7,65,0,0,0,0,0,1
02699171,7,1,6,0,1,1,0,0,1
02699219,56,3,53,0,1,1,0,1,1
02699264,46,7,39,0,1,1,0,1,1
02699283,60,9,51,0,0,0,0,0,0
02699428,6,2,4,0,2,1,1,0,0
02699637,25,5,20,0,1,1,0,1,1
02699651,19,4,15,0,0,0,0,0,1
02699705,19,7,12,0,1,1,0,0,1
02699839,70,8,62,0,0,0,0,0,1
02699902,48,10,38,0,0,0,0,0,1
02700052,17,6,11,0,2,1,1,2,0
02700093,26,7,19,0,1,1,0,1,1
02700408,22,2,20,0,1,1,0,1,1
02700424,79,9,70,0,0,0,0,0,1
02700516,59,15,44,0,0,0,0,0,1
02700613,24,4,20,0,0,0,0,0,0
02700769,64,5,59,0,1,1,0,1,1
02700778,57,6,51,0,0,0,0,0,1
02700788,21,0,21,0,1,1,0,1,1
02701079,22,3,19,0,0,0,0,0,0
02701171,4,2,2,0,2,2,0,0,1
02701429,24,7,17,0,0,0,0,0,1
02701475,7,3,4,0,1,1,0,1,1
02701516,25,0,25,0,0,0,0,0,1
02701557,11,3,8,0,2,2,0,0,1
02701569,23,6,17,0,1,1,0,0,0
02701742,16,4,12,0,4,1,3,2,1
02701923,28,8,20,0,2,1,1,0,1
02702189,9,2,7,0,1,1,0,1,1
02702429,16,4,12,0,1,1,0,0,1
02702612,79,13,66,0,0,0,0,0,1
02702653,152,9,143,0,1,1,0,0,1
02702795,20,4,16,0,1,1,0,0,1
02702797,19,2,17,0,0,0,0,0,1
02702992,15,4,11,0,1,1,0,0,0
02703013,23,5,18,0,4,4,0,0,1
02703063,71,10,61,0,0,0,0,0,0
02703128,42,0,42,0,0,0,0,0,1
02703244,20,3,17,0,2,1,1,2,1
02703399,30,12,18,0,0,0,0,0,1
02703466,21,2,19,0,1,1,0,0,0
02703517,16,2,14,0,1,1,0,1,1
02703566,6,0,6,0,1,1,0,0,1
02703829,5,4,1,0,3,3,0,0,0
02703856,14,2,12,0,1,1,0,1,1
02703869,33,5,28,0,1,1,0,1,1
02703926,16,0,16,0,0,0,0,0,1
02704647,6,2,4,0,1,1,0,1,0
02704700,14,3,11,0,1,1,0,1,1
02705172,52,10,42,0,0,0,0,0,1
02705354,33,0,33,0,0,0,0,0,1
02705556,33,6,27,0,1,1,0,1,1
02705558,9,3,6,0,1,1,0,0,1
02705798,15,4,11,0,1,1,0,0,1
02705821,11,3,8,0,1,1,0,0,1
02706045,43,4,39,0,2,1,1,2,1
02706178,13,4,9,0,4,4,0,1,1
02706196,9,2,7,0,1,1,0,1,1
02706273,8,3,5,0,1,1,0,0,1
02706370,10,0,10,0,0,0,0,0,1
02706450,15,3,12,0,2,2,0,2,1
02706584,33,4,29,0,0,0,0,0,1
02706861,15,4,11,0,1,1,0,1,1
02706865,15,2,13,0,0,0,0,0,0
02706969,31,2,29,0,2,2,0,2,1
02707095,23,3,20,0,0,0,0,0,1
02707096,36,4,32,0,0,0,0,0,0
02707110,26,4,22,0,0,0,0,0,0
02707298,14,2,12,0,1,1,0,0,0
02707328,27,1,26,0,1,1,0,0,1
02707376,14,5,9,0,1,1,0,1,0
02707791,6,2,4,0,1,1,0,0,1
02707792,27,1,26,0,0,0,0,0,1
02707797,28,3,25,0,1,1,0,1,1
02707944,13,3,10,0,1,1,0,1,1
02707949,19,3,16,0,1,1,0,1,1
02707998,32,3,29,0,0,0,0,0,1
02708030,42,9,33,0,0,0,0,0,1
02708129,39,0,39,0,0,0,0,0,1
02708130,36,2,34,0,1,1,0,1,1
02708158,17,3,14,0,0,0,0,0,1
02708273,13,0,13,0,0,0,0,0,0
02708334,63,11,52,0,0,0,0,0,0
02708690,28,2,26,0,2,1,1,2,1
02708693,24,0,24,0,0,0,0,0,1
02708725,11,0,11,0,0,0,0,0,1
02709001,15,6,9,0,2,2,0,0,1
02709148,16,3,13,0,2,2,0,0,1
02709302,78,8,70,0,0,0,0,0,1
02709324,101,7,94,0,0,0,0,0,1
02709399,5,2,3,0,1,1,0,0,1
02709621,34,5,29,0,1,1,0,1,1
02709932,14,4,10,0,1,1,0,1,1
02710541,10,2,8,0,0,0,0,0,1
02710557,12,0,12,0,0,0,0,0,0
02710654,43,3,40,0,1,1,0,1,1
02710768,14,0,14,0,0,0,0,0,1
02710846,39,6,33,0,1,1,0,1,1
02710955,1,0,1,0,0,0,0,0,1
02711000,45,7,38,0,0,0,0,0,1
02711006,90,13,77,0,3,1,2,3,1
02711801,10,0,10,0,0,0,0,0,0
02712350,77,7,70,0,0,0,0,0,1
02712443,33,5,28,0,2,1,1,2,1
02712492,3,0,3,0,0,0,0,0,1
02713318,35,8,27,0,2,1,1,2,1
02713373,19,3,16,0,1,1,0,1,1
02713501,8,0,8,0,0,0,0,0,1
02713513,33,6,27,0,2,1,1,2,1
02713536,34,9,25,0,6,4,2,1,1
02713749,37,3,34,0,1,1,0,1,1
02713806,52,6,46,0,0,0,0,0,1
02714146,8,2,6,0,1,1,0,1,1
02714181,47,4,43,0,0,0,0,0,1
02714217,60,10,50,0,0,0,0,0,0
02714547,7,3,4,0,2,2,0,0,1
02714750,88,7,81,0,0,0,0,0,0
02714759,13,3,10,0,2,2,0,2,1
02714911,28,0,28,0,0,0,0,0,1
02715103,28,0,28,0,1,1,0,1,1
02715255,0,0,0,0,0,0,0,0,1
02715286,14,2,12,0,3,2,1,0,1
02715989,8,3,5,0,2,2,0,0,0
02716424,31,3,28,0,1,1,0,1,1
02716476,53,8,45,0,1,1,0,1,0
02716482,9,0,9,0,0,0,0,0,0
02716917,16,4,12,0,2,2,0,0,0
02717127,11,2,9,0,1,1,0,1,1
02717340,9,1,8,0,1,1,0,0,0
02717400,26,2,24,0,1,1,0,1,1
02717692,73,11,62,0,0,0,0,0,1
02717838,14,4,10,0,3,1,2,1,1
02717897,10,3,7,0,1,1,0,1,0
02718035,15,3,12,0,0,0,0,0,1
02718442,58,6,52,0,0,0,0,0,0
02718443,13,3,10,0,0,0,0,0,1
02718458,15,4,11,0,0,0,0,0,1
02719010,11,0,11,0,1,1,0,1,1
02719047,49,7,42,0,0,0,0,0,0
02719242,45,5,40,0,1,1,0,1,1
02719326,11,0,11,0,1,1,0,1,1
02719382,25,2,23,0,0,0,0,0,1
02719456,88,10,78,0,0,0,0,0,1
02719478,42,0,42,0,1,1,0,1,1
02719480,42,4,38,0,1,1,0,1,1
02719699,17,4,13,0,0,0,0,0,1
02719828,8,3,5,0,2,2,0,0,1
02720295,38,9,29,0,2,2,0,2,1
02720382,39,3,36,0,0,0,0,0,0
02720446,18,3,15,0,1,1,0,1,0
02720630,55,14,41,0,0,0,0,0,1
02720748,57,0,57,0,0,0,0,0,1
02720809,58,4,54,0,1,1,0,1,1
02720823,17,4,13,0,1,1,0,1,1
02720881,11,6,5,0,1,1,0,0,1
02721009,15,5,10,0,1,1,0,0,0
02721508,23,0,23,0,1,1,0,1,1
02721621,43,5,38,0,0,0,0,0,1
02721642,37,4,33,0,1,1,0,1,1
02721712,23,0,23,0,0,0,0,0,1
02721765,38,24,14,0,3,2,1,0,1
02722280,18,0,18,0,0,0,0,0,1
02722282,16,2,14,0,0,0,0,0,1
02722285,26,0,26,0,0,0,0,0,1
02722343,47,4,43,0,1,1,0,1,1
02722346,19,5,14,0,0,0,0,0,0
02722384,18,3,15,0,0,0,0,0,0
02722518,0,0,0,0,0,0,0,0,1
02722646,23,5,18,0,0,0,0,0,1
02722749,18,5,13,0,0,0,0,0,0
02722754,81,8,73,0,0,0,0,0,1
02722812,10,3,7,0,0,0,0,0,1
02722984,27,5,22,0,1,1,0,1,1
02722985,29,0,29,0,0,0,0,0,1
02723173,24,0,24,0,0,0,0,0,1
02723178,8,3,5,0,2,2,0,0,1
02723259,21,0,21,0,0,0,0,0,1
02723354,22,4,18,0,1,1,0,1,1
02723420,41,8,33,0,1,1,0,1,1
02723470,13,4,9,0,0,0,0,0,1
02723472,61,11,50,0,1,1,0,1,1
02723527,47,0,47,0,0,0,0,0,1
02723534,57,12,45,0,0,0,0,0,1
02723621,23,3,20,0,1,1,0,1,0
02723797,14,3,11,0,3,3,0,3,1
02723982,9,4,5,0,2,2,0,1,1
02724503,20,0,20,0,0,0,0,0,1
02724838,14,0,14,0,0,0,0,0,1
02725147,21,0,21,0,0,0,0,0,1
02725272,8,2,6,0,2,2,0,1,1
02725709,32,4,28,0,1,1,0,1,0
02725792,15,0,15,0,0,0,0,0,1
02725830,42,4,38,0,1,1,0,1,1
02726030,118,12,106,0,0,0,0,0,1
02726164,71,11,60,0,2,2,0,2,1
02726170,29,3,26,0,1,1,0,1,1
02726408,13,0,13,0,0,0,0,0,1
02727249,20,0,20,0,0,0,0,0,1
02727262,9,4,5,0,0,0,0,0,0
02727310,5,1,4,0,3,2,1,0,0
02727383,57,5,52,0,1,0,1,1,1
02727421,13,2,11,0,1,1,0,1,1
02727514,125,13,112,0,0,0,0,0,1
02727547,17,2,15,0,1,1,0,1,1
02727560,29,3,26,0,1,1,0,1,1
02727561,22,3,19,0,1,1,0,1,1
02727815,12,3,9,0,1,1,0,1,0
02727939,24,4,20,0,1,1,0,1,1
02728021,38,10,28,0,1,1,0,1,1
02728455,29,6,23,0,2,2,0,2,1
02728491,12,4,8,0,0,0,0,0,1
02728563,36,8,28,0,3,3,0,3,0
02728593,48,9,39,0,15,9,6,0,1
02728601,14,0,14,0,0,0,0,0,1
02728849,19,2,17,0,3,3,0,0,0
02728867,23,3,20,0,1,1,0,1,1
02728920,21,3,18,0,1,1,0,1,1
02728922,19,3,16,0,1,1,0,1,1
02728994,14,1,13,0,3,1,2,1,1
02729260,50,6,44,0,2,1,1,2,1
02729513,31,3,28,0,1,1,0,1,1
02729688,13,5,8,0,2,1,1,2,0
02730427,45,4,41,0,1,1,0,1,1
02730503,7,1,6,0,1,1,0,0,1
02730611,133,14,119,0,0,0,0,0,0
02730618,64,14,50,0,0,0,0,0,1
02731014,15,0,15,0,0,0,0,0,1
02731197,21,4,17,0,3,3,0,1,1
02731948,10,1,9,0,1,1,0,0,1
02732244,89,6,83,0,0,0,0,0,1
02732245,56,9,47,0,0,0,0,0,1
02732254,5,2,3,0,3,2,1,0,1
02732441,37,0,37,0,0,0,0,0,1
02732747,8,0,8,0,0,0,0,0,1
02732784,9,4,5,0,2,2,0,0,1
02733039,21,0,21,0,0,0,0,0,1
02733070,29,3,26,0,1,1,0,1,1
02733119,41,4,37,0,1,1,0,1,1
02733136,79,11,68,0,0,0,0,0,1
02733559,13,5,8,0,1,1,0,1,1
02733595,33,5,28,0,1,1,0,1,1
02733701,33,0,33,0,0,0,0,0,1
02733787,12,3,9,0,1,1,0,1,0
02733932,46,10,36,0,0,0,0,0,1
02734125,28,7,21,0,0,0,0,0,0
02734611,3,3,0,0,1,1,0,0,0
02734652,64,6,58,0,0,0,0,0,1
02734658,7,0,7,0,0,0,0,0,1
02734677,30,3,27,0,1,1,0,1,1
02734722,54,0,54,0,0,0,0,0,1
02734730,18,3,15,0,0,0,0,0,1
02734789,16,3,13,0,1,1,0,1,1
02734927,10,4,6,0,1,1,0,1,0
02734955,22,3,19,0,0,0,0,0,1
02735226,9,0,9,0,0,0,0,0,1
02735431,24,5,19,0,1,1,0,0,1
02735633,91,9,82,0,0,0,0,0,0
02735825,19,0,19,0,0,0,0,0,1
02735861,19,0,19,0,0,0,0,0,1
02736127,27,3,24,0,1,1,0,1,1
02736925,12,4,8,0,1,1,0,1,1
02737370,39,4,35,0,1,1,0,1,1
02737396,51,7,44,0,1,1,0,1,1
02737458,13,5,8,0,1,1,0,0,1
02737706,16,3,13,0,1,1,0,0,1
02737866,8,3,5,0,1,1,0,0,0
02737974,24,7,17,0,1,1,0,1,1
02738000,33,0,33,0,0,0,0,0,1
02738034,12,2,10,0,1,1,0,1,1
02738210,19,2,17,0,1,1,0,1,1
02738413,76,5,71,0,1,1,0,0,0
02738761,16,1,15,0,2,1,1,1,1
02739107,5,3,2,0,0,0,0,0,0
02739471,18,4,14,0,4,3,1,0,1
02739563,35,5,30,0,1,1,0,1,1
06120395,12,2,10,0,1,1,0,1,1
06120444,18,4,14,0,1,1,0,1,1
06120751,6,3,3,0,2,2,0,0,1
06121539,23,4,19,0,1,1,0,1,1
06122534,13,0,13,0,3,3,0,1,1
06122711,15,3,12,0,1,1,0,1,1
06124302,15,0,15,0,0,0,0,0,1
06124685,3,0,3,0,1,1,0,0,1
06124779,41,10,31,0,1,1,0,0,1
06124783,21,3,18,0,1,1,0,1,1
06124828,40,17,23,0,0,0,0,0,1
06124923,11,0,11,0,1,1,0,1,1
06124960,14,3,11,0,2,2,0,2,1
06124979,4,3,1,0,1,1,0,0,0
06125274,17,11,6,0,0,0,0,0,1
06125504,4,2,2,0,1,1,0,1,1
06125615,22,2,20,0,2,2,0,2,1
06125726,8,0,8,0,0,0,0,0,0
06125830,7,0,7,0,1,1,0,0,0
06125927,32,13,19,0,0,0,0,0,1
06126480,8,1,7,0,2,2,0,0,0
06126670,6,1,5,0,2,1,1,0,0
06126855,8,0,8,0,1,1,0,0,1
06126900,8,4,4,0,1,1,0,0,1
06127199,3,2,1,0,2,2,0,0,0
06127293,4,2,2,0,1,1,0,1,0
06127353,4,0,4,0,0,0,0,0,1
06127361,7,3,4,0,0,0,0,0,0
06127421,3,3,0,0,2,2,0,0,0
06127433,4,2,2,0,2,2,0,0,0
06127529,3,0,3,0,0,0,0,0,1
06128149,3,3,0,0,2,2,0,0,0
06128774,2,2,0,0,1,1,0,0,0
06129852,13,3,10,0,1,1,0,1,0
06129936,31,18,13,0,0,0,0,0,1
06130181,15,2,13,0,1,1,0,1,1
06130205,6,2,4,0,0,0,0,0,0
06130476,4,0,4,0,0,0,0,0,1
06130530,13,0,13,0,0,0,0,0,1
06130932,13,1,12,0,1,1,0,1,1
06130943,13,1,12,0,1,1,0,1,1
06131084,14,5,9,0,1,1,0,0,1
06131380,8,2,6,0,2,2,0,0,1
06131579,9,2,7,0,1,1,0,1,1
06131647,2,2,0,0,1,1,0,0,0
06132297,14,4,10,0,0,0,0,0,1
06132425,39,0,39,0,1,1,0,1,1
06132562,16,6,10,0,2,2,0,2,1
06132783,5,0,5,0,2,2,0,0,0
06133168,16,0,16,0,0,0,0,0,1
06133397,13,2,11,0,2,2,0,0,1
06133495,4,0,4,0,0,0,0,0,1
06133901,7,0,7,0,0,0,0,0,1
06133937,7,0,7,0,0,0,0,0,1
06133979,38,7,31,0,0,0,0,0,1
06134203,4,3,1,0,1,1,0,1,1
06134256,4,4,0,0,1,1,0,1,0
06134500,4,2,2,0,1,1,0,0,0
06134823,59,9,50,0,0,0,0,0,1
06134948,17,2,15,0,0,0,0,0,0
06134957,8,0,8,0,2,2,0,0,1
06135492,2,2,0,0,1,1,0,0,0
06135534,8,5,3,0,1,1,0,1,1
06135586,17,4,13,0,1,1,0,1,1
06135639,19,4,15,0,0,0,0,0,1
06135683,3,3,0,0,2,2,0,0,1
06135692,5,0,5,0,0,0,0,0,0
06135832,8,0,8,0,4,4,0,0,0
06135889,5,0,5,0,0,0,0,0,1
06135904,20,7,13,0,0,0,0,0,1
06135939,7,3,4,0,1,1,0,1,1
06135971,10,5,5,0,5,0,5,0,1
06136032,16,3,13,0,0,0,0,0,1
06136043,33,9,24,0,0,0,0,0,1
06136174,4,0,4,0,0,0,0,0,1
06136498,3,3,0,0,1,1,0,0,0
06136521,9,2,7,0,4,3,1,1,1
06137039,6,3,3,0,3,3,0,0,1
06137198,4,1,3,0,1,1,0,0,1
06137221,6,0,6,0,0,0,0,0,0
06137288,5,0,5,0,0,0,0,0,1
06138214,16,4,12,0,0,0,0,0,1
06138264,4,2,2,0,1,1,0,0,0
06138337,11,0,11,0,0,0,0,0,1
06138360,11,6,5,0,1,1,0,1,1
06138551,4,3,1,0,1,1,0,0,0
06138577,6,6,0,0,1,1,0,1,1
06138618,5,0,5,0,1,1,0,1,1
06138640,5,0,5,0,0,0,0,0,1
06139077,18,6,12,0,1,1,0,1,1
06139121,22,5,17,0,1,1,0,0,1
06139132,10,1,9,0,1,1,0,1,1
06139244,7,3,4,0,1,1,0,0,1
06140223,5,0,5,0,0,0,0,0,0
06140568,9,3,6,0,1,1,0,1,1
06140742,5,2,3,0,1,1,0,0,1
06140882,7,2,5,0,2,1,1,0,0
06141036,3,0,3,0,0,0,0,0,1
06141077,18,3,15,0,1,1,0,1,1
06141156,4,1,3,0,1,1,0,0,0
06141518,3,3,0,0,2,2,0,0,1
06141603,23,8,15,0,0,0,0,0,1
06141698,5,2,3,0,3,3,0,0,0
06141708,3,0,3,0,0,0,0,0,1
06141973,43,14,29,0,0,0,0,0,1
06142007,42,15,27,0,0,0,0,0,1
06142617,3,3,0,0,1,1,0,0,0
06143426,2,2,0,0,1,1,0,0,1
06143649,14,4,10,0,1,1,0,1,1
06144430,6,0,6,0,1,1,0,0,1
06144813,20,0,20,0,0,0,0,0,0
06144857,6,4,2,0,0,0,0,0,1
06145147,19,2,17,0,3,1,2,3,1
06145280,3,1,2,0,1,1,0,0,1
06145342,8,0,8,0,1,1,0,0,1
06147104,8,3,5,0,1,1,0,1,1
06147572,20,10,10,0,0,0,0,0,1
06148029,39,8,31,0,1,1,0,1,1
06149589,4,2,2,0,2,2,0,0,0
06149607,10,1,9,0,1,1,0,0,0
06149825,9,0,9,0,0,0,0,0,1
06150067,14,2,12,0,1,1,0,0,0
06150106,6,0,6,0,0,0,0,0,1
06150174,16,0,16,0,0,0,0,0,1
06150438,5,0,5,0,0,0,0,0,1
06151247,4,2,2,0,1,1,0,0,1
06153577,10,5,5,0,1,1,0,1,0
06153771,10,0,10,0,0,0,0,0,1
06154034,7,3,4,0,1,1,0,1,1
06154186,4,1,3,0,3,1,2,1,0
06155287,4,2,2,0,2,2,0,0,0
06155726,4,2,2,0,1,1,0,0,1
06156274,9,3,6,0,2,2,0,0,0
06156553,15,5,10,0,1,1,0,1,1
06156661,18,3,15,1,1,1,0,1,1
06157074,5,0,5,0,0,0,0,0,1
06158015,5,2,3,0,0,0,0,0,1
06158066,2,1,1,0,1,1,0,0,0
06158076,11,6,5,0,0,0,0,0,1
06158085,10,0,10,0,0,0,0,0,1
06158097,2,2,0,0,1,1,0,0,0
06158790,15,3,12,0,1,1,0,1,1
06159017,18,3,15,1,1,1,0,1,1
06159302,6,2,4,0,2,2,0,1,1
06159670,5,4,1,0,2,2,0,0,1
06160934,5,0,5,0,2,2,0,0,0
06161101,24,7,17,0,1,1,0,1,1
06161443,5,3,2,0,1,1,0,1,0
06161828,4,2,2,0,1,1,0,0,1
06162462,12,0,12,0,1,1,0,1,1
06163147,8,3,5,0,1,1,0,1,1
06163501,4,2,2,0,2,2,0,0,0
06163579,10,4,6,0,1,1,0,0,1
06163673,10,1,9,0,3,2,1,3,1
06163728,18,2,16,0,1,1,0,1,1
06163846,5,2,3,0,4,1,3,1,0
06163890,3,2,1,0,1,1,0,0,0
06163893,10,5,5,0,3,2,1,0,0
06164128,12,4,8,0,1,1,0,1,1
06164788,29,7,22,0,1,1,0,1,1
06165540,17,7,10,0,0,0,0,0,1
06165859,19,7,12,0,1,1,0,1,1
06166023,6,0,6,0,0,0,0,0,1
06166047,6,2,4,0,2,1,1,1,1
06166068,11,6,5,0,1,1,0,0,1
06166092,15,4,11,0,0,0,0,0,0
06166109,7,1,6,0,2,1,1,1,1
06166349,5,0,5,0,0,0,0,0,1
06166397,13,6,7,1,0,0,0,0,1
06166544,3,0,3,0,0,0,0,0,1
06166785,10,2,8,0,1,1,0,1,1
06166786,8,3,5,0,0,0,0,0,0
06166872,7,4,3,0,1,1,0,0,1
06166899,5,3,2,0,3,3,0,0,1
06166968,13,4,9,0,0,0,0,0,0
06167204,6,0,6,0,1,1,0,0,0
06167537,3,2,1,0,1,1,0,0,1
06167580,5,3,2,0,1,1,0,0,1
06167585,3,0,3,0,1,1,0,0,1
06167793,10,0,10,0,0,0,0,0,1
06167797,10,0,10,0,0,0,0,0,1
06167839,4,2,2,0,1,1,0,0,0
06167928,13,4,9,0,2,2,0,2,1
06167991,13,0,13,0,0,0,0,0,1
06168151,7,2,5,0,0,0,0,0,1
06168333,7,2,5,0,1,1,0,0,1
06169591,8,0,8,0,0,0,0,0,1
06169712,8,4,4,0,3,3,0,0,0
06169738,15,3,12,0,1,1,0,1,1
06169938,20,4,16,0,2,2,0,2,1
06170096,5,0,5,0,0,0,0,0,1
06170277,4,0,4,0,0,0,0,0,1
06170611,32,7,25,0,1,1,0,1,1
06170884,3,3,0,0,2,2,0,0,0
06171056,2,2,0,0,1,1,0,0,0
06172154,6,0,6,0,0,0,0,0,1
06172239,27,6,21,0,0,0,0,0,1
06172534,23,3,20,0,0,0,0,0,1
06172724,2,2,0,0,1,1,0,0,1
06172876,3,1,2,0,1,1,0,0,0
06172930,2,1,1,0,1,1,0,0,1
06173021,2,0,2,0,0,0,0,0,0
06173090,5,1,4,0,2,2,0,0,0
06173344,35,16,19,0,1,1,0,0,1
06175954,13,2,11,0,0,0,0,0,1
06176697,5,0,5,0,0,0,0,0,1
06176778,8,0,8,0,0,0,0,0,1
06176780,8,0,8,0,0,0,0,0,1
06176876,4,4,0,0,3,3,0,0,0
06177143,2,0,2,0,1,1,0,0,0
06178578,6,0,6,0,0,0,0,0,1
06178729,16,5,11,0,1,1,0,0,0
06179061,12,3,9,0,3,1,2,1,0
06179375,7,0,7,0,0,0,0,0,1
06179972,14,0,14,0,1,1,0,1,1
06180177,8,4,4,0,1,1,0,1,1
06180720,4,2,2,0,2,2,0,0,0
06181070,4,1,3,0,1,1,0,0,1
06181286,4,4,0,0,3,3,0,0,0
06181313,7,2,5,0,2,1,1,0,1
06181912,18,1,17,0,1,1,0,1,1
06182106,18,4,14,0,3,3,0,3,1
06182748,31,6,25,0,1,1,0,0,1
06182923,5,3,2,0,2,2,0,0,1
06182982,37,8,29,0,0,0,0,0,0
06183315,4,0,4,0,0,0,0,0,1
06183910,6,3,3,0,0,0,0,0,1
06184084,10,5,5,0,0,0,0,0,1
06184455,7,5,2,0,0,0,0,0,0
06184603,6,4,2,0,2,2,0,0,0
06184771,18,5,13,0,1,1,0,1,1
06184929,10,4,6,0,0,0,0,0,0
06185898,5,3,2,0,1,1,0,1,1
06186090,3,0,3,0,1,1,0,0,0
06186766,3,0,3,0,0,0,0,0,0
06187598,12,4,8,0,1,1,0,1,1
06187654,2,2,0,0,2,2,0,0,0
06187783,5,3,2,0,2,2,0,0,1
06188085,5,3,2,0,1,1,0,1,0
06188580,3,0,3,0,0,0,0,0,1
06188662,4,0,4,0,0,0,0,0,1
06188668,5,3,2,0,1,1,0,0,1
06188983,10,5,5,0,5,5,0,1,1
06188985,9,5,4,0,5,5,0,1,1
06189455,11,3,8,0,1,1,0,1,1
06189958,3,0,3,0,0,0,0,0,1
06190079,4,0,4,0,0,0,0,0,1
06190267,14,0,14,0,0,0,0,0,1
06190306,27,9,18,0,0,0,0,0,1
06190393,27,9,18,0,0,0,0,0,1
06190528,10,0,10,0,0,0,0,0,1
06191044,5,3,2,0,2,2,0,0,0
06191512,4,2,2,0,1,1,0,1,0
06191598,9,4,5,0,1,1,0,0,0
06191720,3,0,3,0,1,1,0,1,1
06192005,4,0,4,0,0,0,0,0,1
06192136,7,2,5,0,2,2,0,0,1
06192161,5,2,3,0,1,1,0,0,0
06192226,6,0,6,0,0,0,0,0,1
06192479,5,0,5,0,0,0,0,0,1
06192615,23,9,14,0,0,0,0,0,0
06192832,2,1,1,0,1,1,0,0,1
06193621,5,0,5,0,0,0,0,0,1
06194070,25,5,20,0,0,0,0,0,0
06194411,12,6,6,0,0,0,0,0,0
06194826,8,4,4,0,1,1,0,1,1
06194953,3,3,0,0,2,2,0,0,1
06195438,7,4,3,0,1,1,0,1,1
06195648,9,0,9,0,0,0,0,0,1
06195779,16,3,13,0,1,1,0,1,1
06195812,14,6,8,0,1,1,0,1,1
06195816,38,15,23,0,1,1,0,0,1
06195985,34,12,22,0,15,11,4,0,1
06196036,6,0,6,0,4,4,0,0,0
06196200,10,5,5,0,0,0,0,0,1
06197518,2,0,2,0,0,0,0,0,1
06197703,13,2,11,0,4,3,1,2,1
06197727,9,1,8,0,3,3,0,1,1
06197739,3,1,2,0,1,1,0,0,0
06198255,14,1,13,0,0,0,0,0,1
06198281,15,1,14,0,1,1,0,1,1
06198327,15,0,15,0,0,0,0,0,1
06198378,15,0,15,0,0,0,0,0,1
06198400,15,0,15,0,0,0,0,0,1
06198404,16,0,16,0,1,1,0,1,1
06198447,20,4,16,0,0,0,0,0,1
06198627,3,1,2,0,2,2,0,0,0
06198944,8,2,6,0,2,1,1,1,0
06198959,7,0,7,0,2,2,0,0,1
06198978,6,3,3,0,1,1,0,0,1
06199118,5,2,3,0,1,1,0,0,0
06199510,13,5,8,0,1,1,0,1,1
06200060,8,0,8,0,0,0,0,0,1
06200498,4,3,1,0,2,2,0,0,0
06200511,3,1,2,0,1,1,0,0,0
06201205,5,0,5,0,0,0,0,0,1
06201249,5,3,2,0,2,2,0,0,1
06201255,11,5,6,0,0,0,0,0,1
06201302,9,3,6,0,0,0,0,0,1
06201407,3,1,2,0,1,1,0,0,0
06201419,5,2,3,0,0,0,0,0,1
06201541,8,4,4,0,1,1,0,0,1
06201543,4,2,2,0,1,1,0,0,1
06201659,16,0,16,0,0,0,0,0,1
06201896,17,5,12,0,4,1,3,2,1
06202340,25,6,19,0,0,0,0,0,0
06202777,3,0,3,0,0,0,0,0,0
06202969,37,13,24,0,1,1,0,1,1
06203324,12,0,12,0,0,0,0,0,1
06203380,14,6,8,0,0,0,0,0,0
06203503,3,2,1,0,1,1,0,0,0
06203534,5,2,3,0,2,2,0,0,1
06204109,11,0,11,0,0,0,0,0,1
06204129,22,7,15,0,23,13,10,0,1
06204572,6,3,3,0,1,1,0,1,1
06204592,8,4,4,0,2,2,0,2,1
06204618,5,3,2,0,2,2,0,2,1
06204642,5,3,2,0,3,3,0,3,1
06204683,4,0,4,0,0,0,0,0,1
06205388,7,4,3,0,3,3,0,3,1
06205397,3,1,2,0,1,1,0,0,0
06205458,27,6,21,0,1,0,1,0,1
06205552,29,11,18,0,0,0,0,0,1
06205779,7,2,5,0,0,0,0,0,0
06205795,17,4,13,0,2,2,0,2,1
06205815,7,0,7,0,0,0,0,0,1
06205874,5,0,5,0,0,0,0,0,1
06206644,22,5,17,0,3,2,1,0,1
06206655,9,0,9,0,0,0,0,0,1
06206967,5,1,4,0,1,1,0,1,1
06207067,17,2,15,0,1,1,0,0,1
06207095,5,1,4,0,2,1,1,0,1
06207416,7,2,5,0,0,0,0,0,0
06207544,28,4,24,0,1,1,0,1,1
06207595,5,3,2,0,1,1,0,0,1
06208560,7,4,3,0,2,2,0,0,1
06208888,7,4,3,0,5,3,2,0,1
06209386,21,9,12,0,0,0,0,0,1
06209458,15,4,11,0,2,2,0,2,1
06209507,2,2,0,0,1,1,0,0,0
06209607,6,0,6,0,0,0,0,0,1
06210062,3,1,2,0,1,1,0,0,0
06210225,5,0,5,0,0,0,0,0,1
06210272,15,5,10,1,1,1,0,1,1
06210273,3,0,3,0,0,0,0,0,1
06210283,27,8,19,0,0,0,0,0,1
06210309,3,0,3,0,0,0,0,0,1
06210578,18,10,8,0,1,1,0,0,0
06210773,5,1,4,0,2,2,0,1,1
06210939,6,2,4,0,3,2,1,0,1
06211124,5,0,5,0,0,0,0,0,1
06211313,5,3,2,0,1,1,0,0,0
06211858,9,2,7,0,1,1,0,0,1
06211865,6,0,6,0,2,2,0,0,1
06212156,18,7,11,0,0,0,0,0,0
06212580,2,1,1,0,1,1,0,0,0
06212648,2,1,1,0,1,1,0,0,0
06212715,5,0,5,0,0,0,0,0,1
06212760,3,0,3,0,0,0,0,0,1
06212771,26,14,12,0,0,0,0,0,1
06212781,6,4,2,0,3,3,0,0,1
06212870,4,2,2,0,2,2,0,0,1
06212873,4,0,4,0,0,0,0,0,1
06213591,3,0,3,0,0,0,0,0,0
06213709,7,3,4,0,0,0,0,0,1
06213962,11,4,7,0,2,2,0,0,1
06214127,6,4,2,0,0,0,0,0,1
06214446,2,2,0,0,1,1,0,0,0
06215825,4,2,2,0,1,1,0,0,0
06216087,9,0,9,0,0,0,0,0,1
06216096,9,0,9,0,0,0,0,0,1
06216137,16,4,12,0,0,0,0,0,0
06216262,12,0,12,0,0,0,0,0,1
06216389,4,1,3,0,1,1,0,0,0
06216413,2,0,2,0,0,0,0,0,1
06216905,24,4,20,0,1,1,0,1,1
06216942,4,2,2,0,2,2,0,0,1
06217492,3,2,1,0,0,0,0,0,1
06217620,8,5,3,0,1,1,0,0,1
06218148,9,2,7,0,1,1,0,0,1
06218310,5,2,3,0,1,1,0,0,1
06218667,16,6,10,0,0,0,0,0,1
06218984,19,4,15,0,2,2,0,2,1
06219100,2,2,0,0,1,1,0,0,0
06219291,6,2,4,0,3,2,1,0,1
06219614,4,0,4,0,0,0,0,0,1
06219619,4,2,2,0,1,1,0,0,1
06219625,9,6,3,0,1,1,0,1,1
06219717,2,2,0,0,1,1,0,0,0
06219830,4,2,2,0,0,0,0,0,1
06219884,22,10,12,0,1,1,0,1,1
11979061,3,3,0,0,2,2,0,0,1
11979064,1,1,0,0,1,1,0,0,0
11979095,1,1,0,0,1,1,0,0,0
11979164,1,1,0,0,1,1,0,0,0
11979505,2,2,0,0,2,2,0,0,0
11979623,1,1,0,0,1,1,0,0,0
11979847,2,1,1,0,2,1,1,0,0
11979887,1,1,0,0,1,1,0,0,0
11979915,1,1,0,0,1,1,0,0,0
11979939,1,1,0,0,1,1,0,0,0
11980270,1,1,0,0,1,1,0,0,0
11981191,1,1,0,0,1,1,0,0,0
11981429,2,2,0,0,2,2,0,0,0
11981443,1,1,0,0,1,1,0,0,0
11981528,1,1,0,0,1,1,0,0,0
11981578,1,1,0,0,1,1,0,0,0
11981638,1,1,0,0,1,1,0,0,0
11982875,2,2,0,0,1,1,0,0,0
11983056,2,2,0,0,2,2,0,0,0
11983115,2,2,0,0,2,2,0,0,0
11983159,2,2,0,0,1,1,0,1,0
11983953,2,2,0,0,2,2,0,0,0
11984100,5,5,0,0,0,0,0,0,0
11984417,1,1,0,0,1,1,0,0,0
11984507,1,1,0,0,1,1,0,0,0
11984756,1,1,0,0,1,1,0,0,0
11985685,2,2,0,0,1,1,0,0,0
11985794,1,1,0,0,1,1,0,0,0
11986621,1,1,0,0,1,1,0,0,0
11987987,3,3,0,0,1,1,0,1,1
11988039,3,3,0,0,1,1,0,1,1
11988053,3,3,0,0,1,1,0,1,1
11988704,1,1,0,0,1,1,0,0,0
11989641,3,3,0,0,3,3,0,0,0
11990206,1,1,0,0,1,1,0,0,0
11990507,2,1,1,0,0,0,0,0,0
11990675,5,5,0,0,1,1,0,0,0
11990904,2,2,0,0,2,2,0,0,1
11991205,1,1,0,0,1,1,0,0,0
11991728,1,1,0,0,1,1,0,0,0
11991807,1,1,0,0,1,1,0,0,0
11991929,2,2,0,0,1,1,0,0,1
11992536,4,4,0,1,1,1,0,1,1
11993481,1,1,0,0,1,1,0,0,0
11993484,1,1,0,0,1,1,0,0,0
11993992,6,6,0,0,0,0,0,0,0
11994115,1,1,0,0,1,1,0,0,0
11994320,1,1,0,0,1,1,0,0,1
11994409,2,2,0,0,1,1,0,0,0
11995470,1,1,0,0,1,1,0,0,0
11995481,1,1,0,0,1,1,0,0,0
11995669,1,1,0,0,1,1,0,0,0
11995681,1,1,0,0,1,1,0,0,0
11996217,1,1,0,0,1,1,0,0,0
11996502,2,2,0,0,2,2,0,0,0
11996561,2,2,0,0,0,0,0,0,0
11996661,1,1,0,0,1,1,0,0,0
11996677,3,3,0,0,1,1,0,1,0
11997484,1,1,0,0,1,1,0,0,0
11997596,1,1,0,0,1,1,0,0,0
11997729,1,1,0,0,1,1,0,0,0
11998416,1,1,0,0,1,1,0,0,0
11998429,3,3,0,0,2,2,0,0,0
11998837,1,1,0,0,1,1,0,0,0
11999010,1,1,0,0,1,1,0,0,0
11999067,1,1,0,0,1,1,0,0,0
11999160,2,2,0,0,1,1,0,1,0
12000128,2,2,0,0,2,2,0,0,0
12000506,2,2,0,0,1,1,0,1,1
12000686,1,1,0,0,1,1,0,0,1
12001613,3,3,0,0,0,0,0,0,0
12001687,2,2,0,0,2,2,0,0,0
12001707,3,3,0,0,1,1,0,1,0
12001711,2,2,0,0,1,1,0,1,1
12002014,2,2,0,0,2,2,0,0,0
12002069,7,7,0,0,7,7,0,0,1
12002501,1,1,0,0,1,1,0,0,0
12003192,1,1,0,0,1,1,0,0,0
12004008,1,1,0,0,1,1,0,0,0
12004123,2,2,0,0,1,1,0,0,0
12004430,1,1,0,0,1,1,0,0,1
12004706,1,1,0,0,1,1,0,0,0
12004740,3,3,0,0,1,1,0,1,0
12005376,2,2,0,0,2,2,0,0,0
12005662,1,1,0,0,1,1,0,0,0
12006063,4,4,0,0,1,1,0,0,0
12006132,2,2,0,0,3,3,0,0,0
12006347,1,1,0,0,1,1,0,0,0
12006595,2,2,0,0,1,1,0,0,0
12006631,1,1,0,0,1,1,0,0,0
12006980,2,2,0,0,2,2,0,0,1
12007205,1,1,0,0,1,1,0,0,0
12007589,1,1,0,0,1,1,0,0,0
12008536,2,2,0,0,1,1,0,1,1
12008548,2,2,0,0,1,1,0,1,1
12008984,1,1,0,0,1,1,0,1,0
12009077,1,1,0,0,1,1,0,0,0
12009420,1,1,0,0,1,1,0,0,0
12009902,1,1,0,0,1,1,0,0,0
12009986,3,3,0,0,1,1,0,1,0
12010136,1,1,0,0,1,1,0,0,0
12010286,1,1,0,0,1,1,0,0,0
12010568,1,1,0,0,1,1,0,0,0
12011573,2,2,0,0,2,2,0,0,0
12011875,1,1,0,0,1,1,0,0,0
12012502,1,1,0,0,1,1,0,0,0
12012994,2,2,0,0,2,2,0,0,0
12013156,2,2,0,0,1,1,0,0,0
12013423,1,1,0,0,1,1,0,0,0
12013655,1,1,0,0,1,1,0,0,0
12013686,1,1,0,0,1,1,0,0,0
12014042,1,1,0,0,1,1,0,0,0
12014501,2,2,0,0,2,2,0,0,0
12014608,2,2,0,0,2,2,0,0,0
12014883,4,4,0,0,0,0,0,0,0
12015046,2,2,0,0,1,1,0,0,0
12015083,5,5,0,0,2,2,0,0,1
12015327,1,1,0,0,1,1,0,0,0
12015439,2,2,0,0,0,0,0,0,0
12016741,1,1,0,0,1,1,0,0,1
12017360,2,2,0,0,1,1,0,1,1
12017366,1,1,0,0,1,1,0,0,0
12017421,3,3,0,0,1,1,0,1,1
12017696,1,1,0,0,1,1,0,0,0
12019298,2,2,0,0,2,2,0,0,0
12019605,1,1,0,0,1,1,0,0,0
12019687,1,1,0,0,1,1,0,0,0
12020237,9,9,0,0,0,0,0,0,0
12020481,3,3,0,0,3,3,0,0,0
12021098,1,1,0,0,0,0,0,0,0
12021276,1,1,0,0,1,1,0,0,0
12021667,1,1,0,0,1,1,0,1,0
12022415,2,2,0,0,2,2,0,0,0
12022780,2,2,0,0,2,2,0,0,0
12023241,2,2,0,0,2,2,0,0,0
12023330,2,2,0,0,2,2,0,0,0
12023394,1,1,0,0,1,1,0,0,0
12023402,2,2,0,0,1,1,0,0,0
12024080,3,3,0,0,2,2,0,0,0
12024096,1,1,0,0,1,1,0,0,0
12026219,2,2,0,0,2,2,0,0,0
12026572,1,1,0,0,1,1,0,0,0
12026834,1,1,0,0,1,1,0,0,0
12027039,1,1,0,0,1,1,0,0,0
12027515,1,1,0,0,1,1,0,0,0
AC001105,0,0,0,0,0,0,0,0,0
AC001134,0,0,0,0,0,0,0,0,0
AC001137,0,0,0,0,0,0,0,0,0
AC001146,0,0,0,0,0,0,0,0,0
AC001157,0,0,0,0,0,0,0,0,0
BR000031,0,0,0,0,0,0,0,0,0
BR002238,0,0,0,0,0,0,0,0,0
BR003203,0,0,0,0,0,0,0,0,0
BR004475,0,0,0,0,0,0,0,0,0
BR005036,0,0,0,0,0,0,0,0,0
BR005136,0,0,0,0,0,0,0,0,0
BR007635,0,0,0,0,0,0,0,0,0
BR008039,0,0,0,0,0,0,0,0,0
BR008146,0,0,0,0,0,0,0,0,0
BR008383,0,0,0,0,0,0,0,0,0
BR008575,0,0,0,0,0,0,0,0,0
BR008912,0,0,0,0,0,0,0,0,0
BR009305,0,0,0,0,0,0,0,0,0
BR009388,0,0,0,0,0,0,0,0,0
BR009549,0,0,0,0,0,0,0,0,0
BR009550,0,0,0,0,0,0,0,0,0
BR010000,0,0,0,0,0,0,0,0,0
BR010778,0,0,0,0,0,0,0,0,0
BR010964,0,0,0,0,0,0,0,0,0
BR011937,0,0,0,0,0,0,0,0,0
BR011974,0,0,0,0,0,0,0,0,0
BR012204,0,0,0,0,0,0,0,0,0
BR012383,0,0,0,0,0,0,0,0,0
BR012928,0,0,0,0,0,0,0,0,0
BR012948,0,0,0,0,0,0,0,0,0
BR012950,0,0,0,0,0,0,0,0,0
BR012974,0,0,0,0,0,0,0,0,0
BR012979,0,0,0,0,0,0,0,0,0
BR012980,0,0,0,0,0,0,0,0,0
BR013011,0,0,0,0,0,0,0,0,0
BR014871,0,0,0,0,0,0,0,0,0
BR015127,0,0,0,0,0,0,0,0,0
BR015180,0,0,0,0,0,0,0,0,0
BR015262,0,0,0,0,0,0,0,0,0
BR016752,0,0,0,0,0,0,0,0,0
BR016778,0,0,0,0,0,0,0,0,0
BR016862,0,0,0,0,0,0,0,0,0
BR018186,0,0,0,0,0,0,0,0,0
BR018265,0,0,0,0,0,0,0,0,0
BR018267,0,0,0,0,0,0,0,0,0
BR019113,0,0,0,0,0,0,0,0,0
BR019722,0,0,0,0,0,0,0,0,0
BR019791,0,0,0,0,0,0,0,0,0
CE000025,0,0,0,0,0,0,0,0,0
CE000033,0,0,0,0,0,0,0,0,0
CE000042,0,0,0,0,0,0,0,0,0
CE000049,0,0,0,0,0,0,0,0,0
CE000098,0,0,0,0,0,0,0,0,0
CE000107,0,0,0,0,0,0,0,0,0
CE000125,0,0,0,0,0,0,0,0,0
CE000154,0,0,0,0,0,0,0,0,0
CE000164,0,0,0,0,0,0,0,0,0
CE000169,0,0,0,0,0,0,0,0,0
CE000178,0,0,0,0,0,0,0,0,0
CE000237,0,0,0,0,0,0,0,0,0
CE000244,0,0,0,0,0,0,0,0,0
CE000267,0,0,0,0,0,0,0,0,0
CE000276,0,0,0,0,0,0,0,0,0
CE000337,0,0,0,0,0,0,0,0,0
CE000400,0,0,0,0,0,0,0,0,0
CE000416,0,0,0,0,0,0,0,0,0
CE000448,0,0,0,0,0,0,0,0,0
CE000466,0,0,0,0,0,0,0,0,0
CS003001,0,0,0,0,0,0,0,0,0
CS003002,0,0,0,0,0,0,0,0,0
CS003010,0,0,0,0,0,0,0,0,0
CS003026,0,0,0,0,0,0,0,0,0
CS003029,0,0,0,0,0,0,0,0,0
CS003035,0,0,0,0,0,0,0,0,0
CS003062,0,0,0,0,0,0,0,0,0
CS003064,0,0,0,0,0,0,0,0,0
CS003067,0,0,0,0,0,0,0,0,0
CS003073,0,0,0,0,0,0,0,0,0
CS003082,0,0,0,0,0,0,0,0,0
CS003097,0,0,0,0,0,0,0,0,0
CS003099,0,0,0,0,0,0,0,0,0
CS003117,0,0,0,0,0,0,0,0,0
CS003119,0,0,0,0,0,0,0,0,0
CS003120,0,0,0,0,0,0,0,0,0
CS003146,0,0,0,0,0,0,0,0,0
CS003177,0,0,0,0,0,0,0,0,0
CS003190,0,0,0,0,0,0,0,0,0
CS003205,0,0,0,0,0,0,0,0,0
CS003216,0,0,0,0,0,0,0,0,0
CS003223,0,0,0,0,0,0,0,0,0
CS003231,0,0,0,0,0,0,0,0,0
CS003233,0,0,0,0,0,0,0,0,0
CS003255,0,0,0,0,0,0,0,0,0
CS003266,0,0,0,0,0,0,0,0,0
CS003271,0,0,0,0,0,0,0,0,0
CS003272,0,0,0,0,0,0,0,0,0
CS003278,0,0,0,0,0,0,0,0,0
CS003282,0,0,0,0,0,0,0,0,0
CS003304,0,0,0,0,0,0,0,0,0
CS003313,0,0,0,0,0,0,0,0,0
CS003316,0,0,0,0,0,0,0,0,0
CS003334,0,0,0,0,0,0,0,0,0
CS003344,0,0,0,0,0,0,0,0,0
CS003348,0,0,0,0,0,0,0,0,0
CS003349,0,0,0,0,0,0,0,0,0
CS003365,0,0,0,0,0,0,0,0,0
CS003375,0,0,0,0,0,0,0,0,0
CS003392,0,0,0,0,0,0,0,0,0
CS003402,0,0,0,0,0,0,0,0,0
CS003407,0,0,0,0,0,0,0,0,0
CS003437,0,0,0,0,0,0,0,0,0
CS003442,0,0,0,0,0,0,0,0,0
CS003452,0,0,0,0,0,0,0,0,0
CS003456,0,0,0,0,0,0,0,0,0
CS003458,0,0,0,0,0,0,0,0,0
CS003474,0,0,0,0,0,0,0,0,0
CS003477,0,0,0,0,0,0,0,0,0
CS003485,0,0,0,0,0,0,0,0,0
CS003514,0,0,0,0,0,0,0,0,0
CS003542,0,0,0,0,0,0,0,0,0
CS003562,0,0,0,0,0,0,0,0,0
CS003566,0,0,0,0,0,0,0,0,0
CS003590,0,0,0,0,0,0,0,0,0
CS003596,0,0,0,0,0,0,0,0,0
CS003597,0,0,0,0,0,0,0,0,0
CS003598,0,0,0,0,0,0,0,0,0
CS003604,0,0,0,0,0,0,0,0,0
CS003633,0,0,0,0,0,0,0,0,0
CS003643,0,0,0,0,0,0,0,0,0
CS003645,0,0,0,0,0,0,0,0,0
CS003659,0,0,0,0,0,0,0,0,0
CS003667,0,0,0,0,0,0,0,0,0
CS003668,0,0,0,0,0,0,0,0,0
CS003674,0,0,0,0,0,0,0,0,0
CS003687,0,0,0,0,0,0,0,0,0
CS003699,0,0,0,0,0,0,0,0,0
CS003718,0,0,0,0,0,0,0,0,0
CS003737,0,0,0,0,0,0,0,0,0
CS003752,0,0,0,0,0,0,0,0,0
CS003780,0,0,0,0,0,0,0,0,0
CS003816,0,0,0,0,0,0,0,0,0
CS003845,0,0,0,0,0,0,0,0,0
CS003852,0,0,0,0,0,0,0,0,0
CS003859,0,0,0,0,0,0,0,0,0
CS003860,0,0,0,0,0,0,0,0,0
CS003861,0,0,0,0,0,0,0,0,0
CS003872,0,0,0,0,0,0,0,0,0
CS003877,0,0,0,0,0,0,0,0,0
CS003937,0,0,0,0,0,0,0,0,0
CS003947,0,0,0,0,0,0,0,0,0
CS003949,0,0,0,0,0,0,0,0,0
CS003962,0,0,0,0,0,0,0,0,0
CS003966,0,0,0,0,0,0,0,0,0
CS003982,0,0,0,0,0,0,0,0,0
CS004002,0,0,0,0,0,0,0,0,0
CS004010,0,0,0,0,0,0,0,0,0
CS004011,0,0,0,0,0,0,0,0,0
CS004024,0,0,0,0,0,0,0,0,0
CS004027,0,0,0,0,0,0,0,0,0
FC000011,72,15,57,0,0,0,0,0,1
FC000298,65,17,48,0,0,0,0,0,1
FC000365,61,16,45,0,0,0,0,0,1
FC002451,20,20,0,0,0,0,0,0,1
FC003748,42,18,24,0,0,0,0,0,1
FC003950,64,13,51,0,0,0,0,0,1
FC004891,99,13,86,0,0,0,0,0,1
FC005059,37,16,21,0,0,0,0,0,1
FC005586,44,1,43,0,0,0,0,0,1
FC007776,15,0,15,0,0,0,0,0,1
FC009467,7,7,0,0,0,0,0,0,0
FC010020,37,0,37,0,0,0,0,0,1
FC010036,56,12,44,0,0,0,0,0,1
FC010256,18,6,12,0,0,0,0,0,1
FC010559,43,5,38,0,0,0,0,0,1
FC010617,126,18,108,0,0,0,0,0,1
FC010666,10,0,10,0,0,0,0,0,1
FC011130,41,5,36,0,0,0,0,0,1
FC011257,20,4,16,0,0,0,0,0,1
FC011299,11,0,11,0,0,0,0,0,1
FC011396,3,3,0,0,0,0,0,0,0
FC011723,16,0,16,0,0,0,0,0,1
FC011727,15,6,9,0,0,0,0,0,1
FC012245,9,4,5,0,0,0,0,0,1
FC012246,11,4,7,0,0,0,0,0,1
FC012400,8,2,6,0,0,0,0,0,1
FC013069,17,14,3,0,0,0,0,0,1
FC013519,8,8,0,0,0,0,0,0,0
FC013727,9,0,9,0,0,0,0,0,1
FC014055,4,4,0,0,0,0,0,0,0
FC014415,3,3,0,0,0,0,0,0,0
FC014598,45,0,45,0,0,0,0,0,1
FC014611,109,0,109,0,0,0,0,0,1
FC015201,38,5,33,1,0,0,0,0,1
FC015234,19,0,19,0,0,0,0,0,1
FC015558,4,0,4,0,0,0,0,0,1
FC015650,4,1,3,0,0,0,0,0,1
FC015811,9,0,9,0,0,0,0,0,1
FC015868,10,10,0,0,0,0,0,0,1
FC016009,47,13,34,0,0,0,0,0,1
FC016329,12,4,8,0,0,0,0,0,1
FC016500,5,0,5,0,0,0,0,0,1
FC016594,10,0,10,0,0,0,0,0,1
FC016957,5,5,0,0,0,0,0,0,1
FC017057,10,5,5,0,0,0,0,0,0
FC017117,55,12,43,0,0,0,0,0,1
FC017124,24,4,20,0,0,0,0,0,1
FC017421,21,0,21,0,0,0,0,0,1
FC017612,17,4,13,0,0,0,0,0,1
FC017793,10,5,5,0,0,0,0,0,1
FC018124,26,0,26,0,0,0,0,0,1
FC018207,24,0,24,0,0,0,0,0,1
FC018645,30,4,26,0,0,0,0,0,1
FC018866,21,6,15,0,0,0,0,0,1
FC018908,10,6,4,0,0,0,0,0,0
FC019036,2,2,0,0,0,0,0,0,0
FC019099,25,3,22,1,0,0,0,0,1
FC019216,2,2,0,0,0,0,0,0,1
FC019412,25,0,25,0,0,0,0,0,1
FC019485,23,4,19,0,0,0,0,0,1
FC019554,11,3,8,0,0,0,0,0,1
FC019556,11,3,8,0,0,0,0,0,1
FC019567,11,3,8,0,0,0,0,0,1
FC019591,11,3,8,0,0,0,0,0,1
FC019600,9,4,5,0,0,0,0,0,1
FC019633,11,3,8,0,0,0,0,0,0
FC019756,7,0,7,0,0,0,0,0,1
FC019777,10,3,7,0,0,0,0,0,0
FC019783,8,4,4,0,0,0,0,0,0
FC019797,10,3,7,0,0,0,0,0,0
FC019816,8,3,5,0,0,0,0,0,0
FC019917,10,3,7,0,0,0,0,0,0
FC019951,39,3,36,0,0,0,0,0,1
FC019957,9,5,4,0,0,0,0,0,1
FC020051,4,4,0,0,0,0,0,0,1
FC020152,25,4,21,0,0,0,0,0,1
FC020569,5,2,3,0,0,0,0,0,1
FC020642,30,10,20,0,0,0,0,0,1
FC020689,14,0,14,0,0,0,0,0,1
FC021021,12,0,12,0,0,0,0,0,1
FC021022,12,0,12,0,0,0,0,0,1
FC021074,3,3,0,0,0,0,0,0,0
FC021101,9,3,6,0,0,0,0,0,1
FC021105,40,0,40,0,0,0,0,0,1
FC021437,7,0,7,0,0,0,0,0,1
FC021495,11,3,8,0,0,0,0,0,1
FC021570,11,4,7,0,0,0,0,0,1
FC021571,11,4,7,0,0,0,0,0,1
FC021700,47,5,42,0,0,0,0,0,1
FC021730,16,0,16,0,0,0,0,0,1
FC021846,9,0,9,0,0,0,0,0,1
FC021864,28,9,19,0,0,0,0,0,1
FC021891,4,4,0,0,0,0,0,0,0
FC021994,13,0,13,0,0,0,0,0,1
FC022008,4,4,0,0,0,0,0,0,0
FC022143,15,0,15,0,0,0,0,0,0
FC022335,6,2,4,0,0,0,0,0,1
FC022337,4,0,4,0,0,0,0,0,1
FC022973,5,0,5,0,0,0,0,0,1
FC023055,17,0,17,0,0,0,0,0,1
FC023131,11,3,8,0,0,0,0,0,1
FC023222,16,4,12,0,0,0,0,0,1
FC023246,15,3,12,0,0,0,0,0,1
FC023557,9,0,9,0,0,0,0,0,1
FC023558,7,0,7,0,0,0,0,0,1
FC023846,15,2,13,0,0,0,0,0,1
FC023847,14,1,13,0,0,0,0,0,1
FC023961,5,0,5,0,0,0,0,0,1
FC024113,14,0,14,0,0,0,0,0,1
FC024177,18,0,18,0,0,0,0,0,1
FC024178,18,0,18,0,0,0,0,0,1
FC024293,11,3,8,0,0,0,0,0,1
FC024345,12,0,12,0,0,0,0,0,1
FC024436,8,2,6,0,0,0,0,0,1
FC024446,3,1,2,0,0,0,0,0,1
FC024447,11,3,8,0,0,0,0,0,1
FC024458,18,4,14,0,0,0,0,0,1
FC024459,19,4,15,0,0,0,0,0,1
FC024469,0,0,0,0,0,0,0,0,1
FC024515,12,0,12,0,0,0,0,0,1
FC024767,13,2,11,0,0,0,0,0,1
FC024817,16,5,11,0,0,0,0,0,1
FC024818,16,5,11,0,0,0,0,0,1
FC024819,16,5,11,0,0,0,0,0,1
FC024871,8,0,8,0,0,0,0,0,1
FC024874,5,2,3,0,0,0,0,0,1
FC025110,9,0,9,0,0,0,0,0,1
FC025176,17,4,13,1,0,0,0,0,1
FC025245,11,5,6,0,0,0,0,0,1
FC025279,9,0,9,0,0,0,0,0,0
FC025566,3,0,3,0,0,0,0,0,1
FC025589,9,3,6,0,0,0,0,0,1
FC025591,7,0,7,0,0,0,0,0,1
FC025605,16,4,12,0,0,0,0,0,1
FC025634,7,2,5,0,0,0,0,0,1
FC025635,9,2,7,0,0,0,0,0,1
FC025679,6,0,6,0,0,0,0,0,1
FC025700,87,14,73,0,0,0,0,0,1
FC025808,16,4,12,1,0,0,0,0,1
FC025861,8,0,8,0,0,0,0,0,1
FC025862,8,0,8,0,0,0,0,0,1
FC025898,2,1,1,0,0,0,0,0,0
FC026160,3,3,0,0,0,0,0,0,1
FC026254,14,5,9,0,0,0,0,0,1
FC026519,5,0,5,0,0,0,0,0,1
FC026581,6,0,6,0,0,0,0,0,1
FC026682,5,0,5,0,0,0,0,0,1
FC026860,18,4,14,0,0,0,0,0,1
FC026864,5,0,5,0,0,0,0,0,1
FC026865,5,0,5,0,0,0,0,0,1
FC026866,5,0,5,0,0,0,0,0,1
SC513090,1,1,0,0,1,1,0,0,0
SC513326,1,1,0,0,1,1,0,0,0
SC513436,4,4,0,0,1,1,0,0,0
SC513633,5,2,3,0,1,1,0,0,1
SC513701,1,0,1,0,1,1,0,0,1
SC513792,1,1,0,0,2,2,0,0,0
SC513914,2,2,0,0,2,2,0,0,0
SC513938,1,0,1,0,0,0,0,0,0
SC513955,1,0,1,0,0,0,0,0,0
SC513979,7,5,2,1,2,2,0,1,1
SC514037,1,1,0,0,0,0,0,0,0
SC514076,3,2,1,0,2,1,1,0,0
SC514201,2,0,2,0,0,0,0,0,1
SC514326,1,0,1,0,0,0,0,0,1
SC514678,1,0,1,0,0,0,0,0,0
SC514737,1,0,1,0,1,1,0,0,0
SC514819,1,1,0,0,1,1,0,0,0
SC514934,1,1,0,0,1,1,0,0,0
SC514988,2,1,1,0,1,1,0,0,0
SC515059,2,2,0,0,1,1,0,0,0
SC515093,1,1,0,0,1,1,0,0,0
SC515116,8,6,2,0,5,5,0,0,1
SC515472,2,2,0,0,2,2,0,0,0
SC515554,1,1,0,0,1,1,0,0,0
SC515694,2,1,1,0,1,1,0,0,0
SC515698,4,4,0,0,2,1,1,1,1
SC515702,1,1,0,0,1,1,0,0,0
SC516358,1,1,0,0,1,1,0,0,0
SC516464,2,0,2,0,1,1,0,0,0
SC516488,2,0,2,0,0,0,0,0,0
SC516913,2,2,0,0,2,2,0,0,0
SC517288,2,2,0,0,1,1,0,0,0
SC517339,1,1,0,0,1,1,0,1,0
SC517350,1,1,0,0,2,1,1,0,0
SC517396,1,0,1,0,1,1,0,0,0
SC517772,1,0,1,0,1,1,0,0,0
SC518242,1,1,0,0,1,1,0,0,0
SC518625,2,1,1,0,2,1,1,0,0
SC518643,2,2,0,0,2,2,0,0,1
SC518761,1,0,1,0,0,0,0,0,0
SC518939,1,0,1,0,0,0,0,0,0
SC519013,1,1,0,0,1,1,0,0,0
SC519021,1,1,0,0,1,1,0,0,0
SC519076,3,3,0,0,1,1,0,0,1
SC519144,4,0,4,0,1,1,0,0,0
SC519202,3,0,3,0,1,0,1,0,0
SC519210,2,0,2,0,1,1,0,0,0
SC519349,2,2,0,0,1,1,0,0,0
SC519434,4,0,4,0,3,3,0,0,0
SC519907,1,1,0,0,1,1,0,0,0
SC519982,1,1,0,0,1,1,0,0,0
SC520020,3,3,0,0,2,2,0,0,0
SC520112,3,3,0,0,2,2,0,0,0
SC520383,6,5,1,0,1,1,0,1,1
SC520429,2,2,0,0,2,2,0,2,1
SC520770,1,0,1,0,1,1,0,0,0
SC520801,2,0,2,0,2,2,0,0,1
SC520816,1,1,0,0,1,1,0,0,0
SC520883,5,0,5,0,1,1,0,1,0
SC521153,6,3,3,1,1,1,0,1,0
SC521188,1,1,0,0,0,0,0,0,0
SC521270,6,3,3,1,1,1,0,1,0
SC521276,1,1,0,0,1,1,0,1,0
SC521565,2,2,0,0,1,1,0,0,0
SC521636,1,0,1,0,1,1,0,0,0
SC521679,6,4,2,0,0,0,0,0,1
SC521682,3,0,3,0,1,1,0,0,0
SC521830,4,3,1,0,2,2,0,0,1
SC522070,1,1,0,0,1,1,0,0,0
SC522242,7,6,1,0,4,3,1,0,1
SC522272,3,3,0,0,3,3,0,0,0
SC522583,3,2,1,0,3,3,0,1,1
SC522712,2,1,1,0,2,1,1,0,1
SC522719,2,1,1,0,2,1,1,1,1
SC522767,2,0,2,0,0,0,0,0,0
SC522785,4,3,1,0,2,1,1,1,1
SC522831,11,7,4,0,0,0,0,0,0
SC523007,2,2,0,0,0,0,0,0,0
SC523283,2,2,0,0,2,2,0,0,1
SC523341,14,9,5,0,0,0,0,0,0
SC523574,2,2,0,0,1,1,0,0,0
SC523672,1,0,1,0,1,1,0,0,0
SC523809,3,2,1,0,2,2,0,0,0
SC523818,3,3,0,0,1,1,0,0,0
SC523936,3,3,0,0,2,2,0,0,0
SC523966,2,2,0,0,0,0,0,0,0
SC524008,1,1,0,0,1,1,0,0,0
SC524086,4,3,1,0,3,3,0,1,0
SC524122,3,3,0,0,2,2,0,0,0
SC524806,3,0,3,0,1,1,0,0,0
SC524981,6,6,0,0,1,1,0,0,0
SC525012,4,1,3,0,2,2,0,0,0
SC525084,10,8,2,0,0,0,0,0,0
SC525242,14,10,4,0,0,0,0,0,0
SC525513,4,4,0,0,1,1,0,1,1
SC525544,2,2,0,0,2,2,0,0,0
SC525726,2,2,0,0,1,1,0,0,0
SC525851,2,1,1,0,1,1,0,0,0
SC525948,6,4,2,0,0,0,0,0,0
SC525961,2,2,0,0,2,2,0,0,0
SC525982,1,1,0,0,1,1,0,0,1
SC526187,3,0,3,0,1,1,0,0,0
SC526265,1,1,0,0,1,1,0,0,0
SC526321,4,1,3,0,1,1,0,0,0
SC526387,1,0,1,0,0,0,0,0,0
SC526681,1,1,0,0,1,1,0,0,0
SC526986,2,1,1,0,2,1,1,0,0
SC527069,1,1,0,0,1,1,0,0,0
SC527459,2,2,0,0,2,2,0,0,0
SC527465,2,0,2,0,0,0,0,0,0
SC527474,2,0,2,0,3,2,1,0,0
SC527639,4,4,0,0,0,0,0,0,1
SC528053,1,1,0,0,1,1,0,0,0
SC528131,3,3,0,0,2,2,0,0,0
SC528200,1,1,0,0,1,1,0,0,0
SC528261,1,1,0,0,1,1,0,0,0
SC528522,3,0,3,0,1,1,0,0,1
SC528612,11,9,2,0,0,0,0,0,0
SC528756,1,1,0,0,1,1,0,0,0
SC528781,4,4,0,0,1,1,0,0,1
SC529255,1,1,0,0,1,1,0,0,0
SC529309,1,0,1,0,0,0,0,0,0
SC529374,2,2,0,0,1,1,0,0,0
SC529375,2,0,2,0,1,1,0,0,0
SC529495,2,2,0,0,2,2,0,0,0
SC529524,3,2,1,0,2,2,0,0,1
SC529612,1,0,1,0,1,1,0,0,0
SC529898,3,0,3,0,0,0,0,0,0
SC530080,2,2,0,0,2,2,0,0,0
SC530473,2,2,0,0,1,1,0,0,0
SC530534,3,3,0,0,3,3,0,0,1
SC530678,6,2,4,0,4,1,3,0,0
SC530700,2,2,0,0,2,2,0,0,0
SC530718,2,0,2,0,0,0,0,0,0
SC530852,2,2,0,0,2,2,0,0,1
SC530980,3,2,1,0,1,1,0,1,0
SC530988,1,1,0,0,2,2,0,0,0
SC531126,1,1,0,0,1,1,0,0,0
SC531290,2,2,0,0,2,2,0,0,0
SC531320,3,0,3,0,0,0,0,0,0
SC531331,1,1,0,0,1,1,0,0,0
SC531379,4,4,0,0,2,2,0,0,0
SC531385,17,9,8,0,0,0,0,0,0
SC531402,1,0,1,0,0,0,0,0,0
SC531454,1,0,1,0,0,0,0,0,1
SC531606,1,1,0,0,1,1,0,0,0
SC531696,3,2,1,0,2,2,0,0,0
SC532098,2,2,0,0,1,1,0,0,0
SC532200,4,4,0,0,3,3,0,0,1
SC532304,3,0,3,0,0,0,0,0,1
SC532518,5,2,3,0,1,1,0,1,0
SC532676,2,2,0,0,2,2,0,0,0
SC533110,2,0,2,0,1,1,0,0,1
SC533169,2,2,0,0,1,1,0,0,0
SC533192,2,0,2,0,0,0,0,0,1
SC533257,2,1,1,0,1,1,0,0,0
SC533338,1,1,0,0,0,0,0,0,0
SC533564,1,1,0,0,1,1,0,0,0
SC533614,2,2,0,0,4,4,0,0,1
SC533685,1,1,0,0,1,1,0,0,0
SC533786,1,1,0,0,0,0,0,0,0
SC533886,14,11,3,0,0,0,0,0,0
SC534018,1,1,0,0,1,1,0,0,0
SC534299,1,1,0,0,1,1,0,0,0
SC534609,2,2,0,0,2,2,0,0,0
SC534827,1,1,0,0,1,1,0,0,0
SC534840,1,1,0,0,1,1,0,0,0
SC535036,1,1,0,0,1,1,0,0,0
SC535054,1,0,1,0,0,0,0,0,0
SC535077,2,1,1,0,3,1,2,1,0
SC535126,2,2,0,0,2,2,0,0,0
SC535413,3,0,3,0,2,2,0,0,1
SC536073,1,0,1,0,0,0,0,0,0
SC536415,3,3,0,0,1,1,0,0,0
SC536664,2,1,1,0,2,1,1,0,0
SC536670,2,1,1,0,2,1,1,0,0
SC536768,3,3,0,0,2,2,0,0,1
SC536931,4,2,2,0,2,2,0,0,0
SC536935,2,1,1,0,1,1,0,0,1
SC536937,1,0,1,0,0,0,0,0,1
SC536975,3,2,1,0,1,1,0,0,1
SC537035,1,0,1,0,1,1,0,0,0
SC537597,1,0,1,0,1,1,0,0,0
SC537670,1,1,0,0,1,1,0,0,0
SC537674,1,1,0,0,1,1,0,0,0
SC537675,1,1,0,0,1,1,0,0,0
SC537678,2,2,0,0,2,2,0,0,0
SC537939,1,1,0,0,1,1,0,0,0
SC537959,1,1,0,0,1,1,0,0,0
SC538370,3,2,1,0,2,2,0,1,1
SC538528,2,2,0,0,1,1,0,0,0
SC538529,1,1,0,0,1,1,0,0,0
SC538540,4,4,0,0,1,1,0,0,0
SC538580,2,2,0,0,2,2,0,0,0
SC538729,2,2,0,0,1,1,0,0,0
SC538888,2,1,1,0,1,1,0,0,0
SC538909,10,6,4,0,0,0,0,0,0
SC539055,2,0,2,0,2,2,0,0,0
SC539105,1,0,1,0,0,0,0,0,1
SC539284,1,1,0,0,1,1,0,0,0
SC539876,5,2,3,0,4,2,2,0,0
SC540171,1,1,0,0,1,1,0,1,0
SC540331,1,0,1,0,1,1,0,0,0
SC540405,1,0,1,0,1,1,0,0,0
SC540655,2,2,0,0,2,2,0,0,0
SC540846,2,0,2,0,1,0,1,0,0
SC541152,3,3,0,0,1,1,0,0,0
SC541464,1,1,0,0,0,0,0,0,0
SC541634,1,1,0,0,1,1,0,0,1
SC541925,8,8,0,0,0,0,0,0,0
SC542402,3,1,2,0,1,0,1,0,0
SC542843,14,10,4,0,0,0,0,0,0
SC542881,3,3,0,0,2,2,0,0,1
SC542967,1,1,0,0,0,0,0,0,0
SC543001,4,0,4,0,0,0,0,0,0
SC543101,1,0,1,0,1,1,0,0,0
SC543140,1,0,1,0,1,1,0,0,0
SC543197,1,1,0,0,1,1,0,0,0
SC543272,2,2,0,0,1,1,0,0,0
SC543372,8,4,4,0,3,0,3,0,0
SC543470,7,4,3,0,3,1,2,1,0
SC543595,3,2,1,0,2,2,0,0,0
SC543655,3,3,0,0,1,1,0,1,0
SC543681,3,3,0,0,1,1,0,1,0
SC543910,2,2,0,0,1,1,0,0,0
SC544097,5,2,3,0,3,1,2,1,1
SC544114,3,3,0,0,2,2,0,0,0
SC544542,2,2,0,0,2,2,0,0,0
SC544689,2,1,1,0,1,1,0,0,0
SC544948,1,0,1,0,1,1,0,0,1
SC545198,1,1,0,0,1,1,0,0,0
SC545271,2,2,0,0,2,2,0,0,0
SC545331,1,1,0,0,1,1,0,0,0
SC545389,4,4,0,0,0,0,0,0,0
SC545543,3,3,0,0,1,1,0,0,1
SC545788,1,1,0,0,1,1,0,0,0
SC545791,5,0,5,0,1,0,1,0,0
SC545895,2,1,1,0,3,2,1,1,0
SC546068,6,4,2,0,5,2,3,4,1
SC546217,1,1,0,0,1,1,0,0,0
SC546223,2,2,0,0,1,1,0,0,1
SC546322,4,4,0,0,0,0,0,0,1
SC546564,7,7,0,0,1,1,0,0,1
SC546572,1,0,1,0,1,0,1,0,0
SC546594,2,2,0,0,1,1,0,1,1
SC546618,6,4,2,0,1,1,0,1,1
SC546719,3,3,0,1,1,1,0,1,1
SC546762,5,3,2,0,5,3,2,2,1
SC546966,1,0,1,0,1,1,0,0,0
SC547008,2,0,2,0,1,1,0,1,1
SC547009,2,0,2,0,1,1,0,1,1
SC547010,2,0,2,0,1,1,0,1,1
SC547071,7,4,3,0,3,2,1,1,1
SC547318,2,2,0,0,1,1,0,0,0
SC547441,8,4,4,0,1,1,0,0,1
SC547499,2,2,0,0,1,1,0,0,0
SC547510,2,1,1,0,2,1,1,0,0
SC547970,4,4,0,0,2,2,0,0,0
SC548014,2,2,0,0,1,1,0,0,1
SC548023,4,3,1,0,0,0,0,0,0
SC548464,1,0,1,0,1,1,0,0,0
SC548682,1,1,0,0,1,1,0,0,0
SC548716,2,2,0,0,2,2,0,0,0
SC548806,1,0,1,0,1,1,0,0,0
SC549024,10,7,3,0,0,0,0,0,0
SC549144,1,1,0,0,1,1,0,0,0
SC549340,2,2,0,0,1,1,0,0,0
SC549405,2,0,2,0,1,1,0,0,0
SC549628,1,1,0,0,1,1,0,0,0
SC549676,5,3,2,0,3,2,1,2,1
SC549861,2,0,2,0,1,1,0,0,0
SC549911,8,8,0,0,2,1,1,1,1
SC549979,1,1,0,0,1,1,0,0,0
SC413980,14,3,11,1,1,1,0,1,1
SC413998,4,3,1,0,1,1,0,1,1
SC414239,8,6,2,0,1,1,0,0,0
SC414258,1,0,1,0,0,0,0,0,0
SC414274,2,2,0,0,2,2,0,0,1
SC414329,5,0,5,0,0,0,0,0,1
SC414528,2,0,2,0,0,0,0,0,1
SC414776,3,1,2,0,2,2,0,0,0
SC414845,2,0,2,0,0,0,0,0,0
SC415053,3,2,1,0,1,1,0,0,1
SC415849,6,3,3,0,1,0,1,0,1
SC416246,1,1,0,0,0,0,0,0,0
SC416345,1,1,0,0,1,1,0,0,0
SC416394,9,0,9,0,0,0,0,0,1
SC417202,8,3,5,0,2,2,0,0,1
SC417227,2,0,2,0,2,2,0,0,0
SC417310,1,0,1,0,0,0,0,0,0
SC417428,2,0,2,0,0,0,0,0,1
SC417637,8,4,4,1,1,1,0,1,1
SC417641,12,0,12,0,0,0,0,0,1
SC417669,3,3,0,0,2,2,0,0,0
SC417703,2,1,1,0,1,1,0,0,1
SC417888,9,2,7,2,2,1,1,1,0
SC418160,20,8,12,0,1,1,0,1,0
SC418393,4,0,4,0,0,0,0,0,1
SC418395,4,2,2,0,1,1,0,0,0
SC418522,7,0,7,0,0,0,0,0,1
SC418783,1,1,0,0,1,1,0,0,0
SC418838,13,5,8,0,1,1,0,1,1
SC418969,1,0,1,0,0,0,0,0,1
SC419377,5,3,2,0,1,1,0,1,0
SC419421,9,0,9,0,1,1,0,1,1
SC419562,4,0,4,0,1,1,0,1,1
SC419593,1,1,0,0,1,1,0,0,0
SC419663,10,7,3,0,0,0,0,0,1
SC419728,4,1,3,0,2,1,1,1,1
SC419852,20,8,12,0,2,2,0,0,0
SC419871,1,0,1,0,0,0,0,0,0
SC420127,6,1,5,0,4,1,3,1,1
SC420393,26,11,15,0,0,0,0,0,0
SC420459,4,3,1,0,2,2,0,0,0
SC420531,6,3,3,0,1,1,0,0,1
SC420608,3,3,0,0,1,1,0,0,1
SC420663,4,0,4,0,0,0,0,0,0
SC420719,2,2,0,0,2,2,0,0,0
SC420722,2,2,0,0,2,2,0,0,1
SC420803,9,4,5,0,3,3,0,0,0
SC420857,2,2,0,0,1,1,0,0,0
SC421056,4,2,2,0,2,2,0,0,1
SC421072,10,7,3,0,1,1,0,1,1
SC421652,3,2,1,0,1,1,0,0,0
SC421749,5,0,5,0,0,0,0,0,1
SC421764,14,11,3,0,0,0,0,0,0
SC421804,1,0,1,0,0,0,0,0,0
SC421841,6,3,3,0,3,3,0,0,1
SC421935,4,3,1,0,2,2,0,0,1
SC422051,5,2,3,0,1,1,0,0,0
SC422180,2,2,0,0,1,1,0,0,0
SC422365,5,2,3,0,2,2,0,0,0
SC422611,1,0,1,0,1,1,0,0,1
SC422707,3,1,2,0,3,1,2,0,0
SC422708,2,0,2,0,0,0,0,0,1
SC422871,1,1,0,0,1,1,0,0,0
SC422878,3,0,3,0,0,0,0,0,1
SC422966,5,4,1,0,0,0,0,0,1
SC423125,4,0,4,0,0,0,0,0,1
SC423161,1,0,1,0,0,0,0,0,0
SC423292,3,3,0,0,2,2,0,0,0
SC423330,3,3,0,0,2,2,0,0,0
SC423551,2,0,2,0,2,2,0,0,1
SC423575,4,3,1,0,1,1,0,0,1
SC423813,2,2,0,0,2,2,0,0,0
SC423927,5,0,5,0,0,0,0,0,1
SC423965,2,1,1,0,0,0,0,0,0
SC423969,8,6,2,0,1,1,0,1,1
SC424008,1,0,1,0,1,1,0,0,0
SC424066,3,3,0,0,2,2,0,0,1
SC424177,2,2,0,0,2,2,0,0,0
SC424227,1,1,0,0,1,1,0,0,0
SC424232,4,2,2,0,1,1,0,1,1
SC424282,2,0,2,0,0,0,0,0,1
SC425069,2,2,0,0,1,1,0,0,0
SC425241,3,0,3,0,0,0,0,0,1
SC425281,9,0,9,0,0,0,0,0,1
SC425339,1,1,0,0,1,1,0,0,0
SC425404,2,1,1,0,2,2,0,0,0
SC425419,11,4,7,1,1,1,0,1,0
SC425560,3,1,2,0,1,1,0,0,0
SC425799,1,0,1,0,0,0,0,0,0
SC425808,36,10,26,0,0,0,0,0,1
SC425938,3,0,3,0,0,0,0,0,1
SC426144,2,2,0,0,1,1,0,0,0
SC426172,3,0,3,0,0,0,0,0,0
SC426291,1,0,1,0,1,1,0,0,1
SC426525,12,9,3,0,1,1,0,1,1
SC426667,8,5,3,0,0,0,0,0,1
SC426789,1,1,0,0,1,1,0,0,0
SC426815,6,4,2,0,1,1,0,0,0
SC427011,13,0,13,0,0,0,0,0,0
SC427013,6,2,4,0,0,0,0,0,0
SC427156,12,2,10,0,1,1,0,1,1
SC427253,3,2,1,0,2,2,0,0,1
SC427340,1,0,1,0,0,0,0,0,0
SC427401,3,3,0,0,2,2,0,0,1
SC427583,5,3,2,0,1,1,0,1,1
SC427652,12,4,8,1,2,2,0,0,1
SC427653,3,0,3,0,0,0,0,0,0
SC427879,48,11,37,0,0,0,0,0,0
SC427906,2,0,2,0,1,1,0,0,0
SC428029,1,0,1,0,0,0,0,0,0
SC428031,4,2,2,0,2,2,0,0,1
SC428034,3,0,3,0,0,0,0,0,1
SC428036,1,1,0,0,1,1,0,0,0
SC428080,7,0,7,0,0,0,0,0,1
SC428085,5,0,5,0,4,1,3,2,1
SC428112,3,3,0,0,2,2,0,0,1
SC428206,11,3,8,0,5,1,4,5,1
SC428382,4,1,3,0,1,1,0,0,1
SC428384,3,3,0,0,2,1,1,0,0
SC428478,6,5,1,0,1,1,0,1,1
SC428588,4,0,4,0,1,1,0,0,1
SC428623,1,0,1,0,0,0,0,0,0
SC428628,1,0,1,0,0,0,0,0,1
SC428676,1,1,0,0,1,1,0,0,0
SC429039,2,0,2,0,2,1,1,2,0
SC429355,2,0,2,0,0,0,0,0,0
SC429394,1,1,0,0,1,1,0,0,0
SC429507,2,0,2,0,0,0,0,0,0
SC429595,1,1,0,0,1,1,0,0,1
SC429705,6,0,6,0,0,0,0,0,1
SC429763,5,0,5,0,0,0,0,0,1
SC429898,2,2,0,0,1,1,0,0,0
SC429941,3,1,2,0,1,1,0,0,0
SC430077,1,1,0,0,1,1,0,0,0
SC430118,7,4,3,0,1,1,0,1,1
SC430241,2,0,2,0,0,0,0,0,1
SC430512,11,6,5,1,1,1,0,0,1
SC430556,2,1,1,0,1,1,0,0,0
SC430766,5,2,3,0,1,0,1,1,1
SC430847,12,2,10,0,1,1,0,0,1
SC430893,1,1,0,0,1,1,0,0,1
SC430922,2,2,0,0,2,2,0,0,1
SC431138,5,3,2,0,4,4,0,0,1
SC431161,4,0,4,0,1,1,0,1,1
SC431397,2,0,2,0,0,0,0,0,1
SC431469,5,1,4,0,2,1,1,0,1
SC431485,11,5,6,0,2,1,1,2,1
SC431522,1,0,1,0,0,0,0,0,0
SC431541,2,0,2,0,0,0,0,0,1
SC431557,6,4,2,0,2,1,1,1,1
SC431779,1,0,1,0,0,0,0,0,1
SC431870,1,1,0,0,2,2,0,0,0
SC431906,1,1,0,0,1,1,0,0,0
SC431989,2,2,0,0,1,1,0,0,1
SC432099,1,0,1,0,0,0,0,0,0
SC432119,12,6,6,0,0,0,0,0,0
SC432209,2,0,2,0,0,0,0,0,1
SC432216,2,2,0,0,2,2,0,0,0
SC432605,2,2,0,0,1,1,0,0,0
SC432748,2,2,0,0,1,1,0,0,1
SC432755,3,3,0,0,2,2,0,0,1
SC432787,3,3,0,0,1,1,0,0,0
SC432912,3,0,3,0,0,0,0,0,0
SC433110,3,3,0,0,1,1,0,0,1
SC433164,1,1,0,0,1,1,0,0,0
SC433176,11,4,7,0,1,1,0,1,1
SC433439,1,0,1,0,0,0,0,0,0
SC433625,7,3,4,0,1,1,0,1,0
SC433842,2,2,0,0,1,1,0,0,0
SC433844,5,3,2,0,1,1,0,1,1
SC433845,6,4,2,0,1,1,0,1,1
SC433857,31,9,22,0,0,0,0,0,0
SC433949,2,0,2,0,0,0,0,0,1
SC433950,2,0,2,0,0,0,0,0,1
SC433952,2,0,2,0,0,0,0,0,1
SC434246,10,4,6,0,0,0,0,0,1
SC434350,2,2,0,0,2,2,0,0,0
SC434756,28,9,19,0,1,1,0,0,1
SC434794,3,3,0,0,1,1,0,0,1
SC434990,5,0,5,0,2,2,0,0,1
SC435128,2,2,0,0,2,2,0,0,0
SC435274,28,10,18,0,0,0,0,0,0
SC435506,5,0,5,0,0,0,0,0,1
SC435553,3,0,3,0,0,0,0,0,1
SC435579,1,1,0,0,2,2,0,0,0
SC435687,3,0,3,0,0,0,0,0,1
SC435949,1,0,1,0,0,0,0,0,0
SC436187,2,0,2,0,0,0,0,0,0
SC436334,1,1,0,0,1,1,0,0,1
SC436491,2,2,0,0,2,2,0,0,0
SC436779,2,1,1,0,1,1,0,0,0
SC436827,10,4,6,1,1,1,0,1,1
SC437055,3,2,1,0,1,1,0,0,0
SC437105,1,0,1,0,0,0,0,0,0
SC437333,11,2,9,0,1,1,0,1,1
SC437346,11,2,9,0,9,1,8,1,1
SC437540,5,2,3,0,1,1,0,0,1
SC437641,7,2,5,0,1,1,0,1,0
SC437955,2,2,0,0,1,1,0,0,1
SC437967,2,2,0,0,1,1,0,1,0
SC438035,2,0,2,0,1,1,0,1,0
SC438125,1,1,0,0,1,1,0,0,1
SC438148,3,0,3,0,0,0,0,0,1
SC438149,4,0,4,0,0,0,0,0,1
SC438150,3,0,3,0,0,0,0,0,1
SC438168,1,0,1,0,1,1,0,0,0
SC438195,19,6,13,0,0,0,0,0,1
SC438223,10,5,5,0,1,1,0,0,1
SC438225,14,6,8,0,1,1,0,1,1
SC438313,3,0,3,0,0,0,0,0,1
SC438595,9,0,9,0,0,0,0,0,0
SC438711,2,0,2,0,0,0,0,0,0
SC438863,2,2,0,0,2,2,0,0,0
SC438886,10,6,4,0,0,0,0,0,1
SC438972,2,2,0,0,2,2,0,0,0
SC439109,2,2,0,0,2,2,0,0,0
SC439204,1,1,0,0,1,1,0,0,0
SC439231,11,2,9,0,1,1,0,1,1
SC439430,4,2,2,0,2,1,1,0,1
SC439603,11,3,8,0,1,1,0,0,0
SC439627,2,0,2,0,0,0,0,0,1
SC439900,2,1,1,0,2,2,0,0,0
SC439976,6,0,6,0,0,0,0,0,1
09720182,10,1,9,0,5,1,4,0,0
09720235,13,7,6,0,1,1,0,1,1
09720523,6,1,5,0,2,1,1,0,0
09720557,3,0,3,0,1,1,0,1,1
09720590,1,1,0,0,1,1,0,0,0
09720758,6,3,3,0,1,1,0,1,1
09720899,2,2,0,0,2,2,0,0,0
09721163,1,0,1,0,1,1,0,0,0
09721260,3,2,1,0,1,1,0,0,0
09721912,4,3,1,0,1,1,0,0,0
09722902,8,0,8,0,0,0,0,0,1
09723299,2,2,0,0,2,2,0,0,0
09723437,2,0,2,0,2,2,0,0,1
09723783,7,5,2,0,1,1,0,1,1
09723820,2,2,0,0,2,2,0,0,0
09724156,2,0,2,0,2,2,0,0,0
09724294,3,0,3,0,1,1,0,0,1
09724853,3,0,3,0,0,0,0,0,1
09725003,7,3,4,0,2,1,1,2,1
09725240,1,1,0,0,1,1,0,0,0
09725560,7,4,3,0,1,1,0,1,1
09725563,8,4,4,0,1,1,0,1,1
09725642,4,4,0,0,1,1,0,1,1
09726606,5,2,3,0,0,0,0,0,0
09726612,1,1,0,0,1,1,0,0,0
09726852,8,1,7,0,5,1,4,0,0
09726879,4,1,3,0,2,1,1,0,0
09727051,3,3,0,0,1,1,0,0,0
09727234,1,1,0,0,1,1,0,0,0
09727301,10,1,9,0,5,1,4,0,0
09727477,2,2,0,0,2,2,0,0,0
09728352,5,4,1,0,1,1,0,1,1
09728547,10,3,7,0,1,1,0,1,1
09728614,12,8,4,0,5,4,1,0,1
09728708,3,2,1,0,2,1,1,0,1
09728750,4,2,2,0,2,2,0,0,1
09728765,1,0,1,0,1,1,0,0,0
09729218,6,4,2,0,2,2,0,0,1
09729815,1,0,1,0,1,1,0,0,1
09730615,1,1,0,0,1,1,0,0,0
09730704,1,1,0,0,0,0,0,0,0
09730860,1,1,0,0,1,1,0,0,0
09730948,2,2,0,0,2,2,0,0,1
09731994,1,1,0,0,1,1,0,0,0
09732210,17,11,6,0,0,0,0,0,1
09732324,11,9,2,0,0,0,0,0,0
09732367,8,7,1,0,0,0,0,0,0
09732439,16,7,9,0,2,1,1,0,1
09732495,2,2,0,0,1,1,0,0,1
09732644,2,2,0,0,1,1,0,0,0
09733231,3,0,3,0,2,2,0,0,0
09733479,2,0,2,0,1,1,0,0,1
09733703,6,6,0,0,0,0,0,0,1
09734068,2,2,0,0,2,2,0,0,1
09734231,4,4,0,0,1,1,0,0,1
09734488,4,2,2,0,2,1,1,0,0
09734578,3,3,0,0,2,2,0,0,0
09734698,7,5,2,0,0,0,0,0,0
09735004,4,3,1,0,2,2,0,0,0
09735057,1,1,0,0,1,1,0,0,0
09735068,7,6,1,0,0,0,0,0,0
09735235,3,2,1,0,2,2,0,0,0
09735340,6,5,1,0,1,1,0,0,0
09735357,3,1,2,0,3,1,2,0,0
09735528,1,1,0,0,1,1,0,0,0
09735896,2,0,2,0,0,0,0,0,1
09736134,5,5,0,0,1,1,0,0,1
09737004,1,0,1,0,1,1,0,0,0
09737065,2,1,1,0,0,0,0,0,0
09737463,1,1,0,0,1,1,0,0,0
09737712,1,1,0,0,1,1,0,0,1
09738135,5,3,2,0,4,2,2,0,1
09738511,11,3,8,0,3,1,2,1,1
09739450,4,2,2,0,2,2,0,0,1
09739607,7,0,7,0,2,1,1,2,1
09739719,1,1,0,0,1,1,0,0,0
09739893,8,2,6,0,1,1,0,1,1
09740029,13,3,10,0,1,1,0,1,1
09740073,7,2,5,0,2,1,1,2,1
09740322,20,9,11,0,2,1,1,2,1
09740498,5,4,1,0,1,1,0,1,0
09740550,1,1,0,0,1,1,0,0,0
09740664,14,3,11,0,1,1,0,1,1
09740754,3,0,3,0,0,0,0,0,0
09740763,6,6,0,0,2,2,0,0,1
09740986,2,2,0,0,2,2,0,0,0
09741110,2,2,0,0,2,2,0,0,1
09741214,9,0,9,0,2,2,0,2,1
09741888,1,1,0,0,1,1,0,0,0
09741928,10,6,4,0,2,2,0,1,1
09741951,2,2,0,0,2,2,0,0,0
09742278,2,2,0,0,1,1,0,0,1
09742540,13,9,4,0,13,9,4,0,0
09742555,3,3,0,0,1,1,0,1,1
09742580,1,1,0,0,1,1,0,0,0
09742902,7,5,2,0,6,2,4,2,1
09743047,6,3,3,0,1,1,0,1,1
09743406,7,3,4,0,1,1,0,1,1
09743459,1,1,0,0,1,1,0,0,0
09743513,6,3,3,0,0,0,0,0,0
09743746,2,1,1,0,1,1,0,0,1
09743796,1,1,0,0,1,1,0,0,1
09743797,6,2,4,0,0,0,0,0,1
09743833,5,2,3,0,1,1,0,0,1
09743895,1,1,0,0,1,1,0,0,0
09744207,4,4,0,0,2,2,0,0,1
09744354,3,3,0,0,1,1,0,1,0
09744409,14,8,6,0,0,0,0,0,1
09744499,2,1,1,0,1,1,0,0,0
09744505,3,3,0,0,2,2,0,0,1
09744541,4,3,1,0,0,0,0,0,0
09744826,2,2,0,0,2,2,0,0,0
09744830,1,0,1,0,1,1,0,0,0
09744905,2,1,1,0,2,1,1,0,0
09744971,1,1,0,0,1,1,0,0,0
09745212,2,1,1,0,2,2,0,0,1
09745282,10,4,6,0,1,0,1,1,0
09745294,1,1,0,0,1,1,0,0,0
09745346,1,1,0,0,1,1,0,0,0
09745569,1,1,0,0,1,1,0,0,1
09745670,11,6,5,0,1,1,0,0,0
09745740,2,2,0,0,2,2,0,0,1
09745805,1,1,0,0,1,1,0,0,0
09746035,2,1,1,0,1,1,0,0,0
09746748,3,3,0,0,3,3,0,0,0
09747033,3,1,2,0,2,1,1,0,0
09747371,2,1,1,0,1,1,0,0,0
09747515,5,4,1,0,4,4,0,0,0
09748002,1,1,0,0,1,1,0,0,0
09748604,1,0,1,0,0,0,0,0,1
09749251,2,2,0,0,2,2,0,0,0
09749513,7,1,6,0,1,1,0,1,1
09749615,8,1,7,0,1,1,0,1,1
09749678,4,0,4,0,0,0,0,0,1
09750587,3,2,1,0,1,1,0,1,1
09750832,4,3,1,0,2,1,1,2,1
09750890,17,16,1,0,0,0,0,0,0
09750946,9,6,3,0,0,0,0,0,1
09751151,4,0,4,0,0,0,0,0,0
09751326,5,3,2,0,1,1,0,1,1
09751345,5,4,1,0,0,0,0,0,0
09751395,1,1,0,0,1,1,0,0,0
09751521,1,1,0,0,1,1,0,0,0
09751644,7,6,1,0,1,1,0,1,1
09751671,2,2,0,0,2,2,0,0,0
09751720,7,6,1,0,1,1,0,1,1
09751875,8,0,8,0,1,1,0,1,1
09751889,6,0,6,0,2,1,1,2,1
09752013,2,1,1,0,1,1,0,0,0
09752273,6,3,3,0,2,1,1,2,1
09752302,4,4,0,0,1,0,1,0,0
09752452,19,10,9,0,0,0,0,0,1
09752499,1,1,0,0,1,1,0,0,0
09752717,3,0,3,0,3,3,0,0,1
09754098,1,1,0,0,1,1,0,0,0
09754554,1,1,0,0,1,1,0,0,0
09754752,8,3,5,0,2,2,0,0,0
09755311,2,0,2,0,0,0,0,0,0
09755529,2,1,1,0,2,1,1,0,0
09757399,1,1,0,0,1,1,0,0,0
09757456,1,1,0,0,1,1,0,0,0
09757470,1,1,0,0,1,1,0,0,0
09757652,3,3,0,0,3,2,1,1,1
09757696,3,2,1,0,1,1,0,0,1
09757729,2,2,0,0,1,1,0,0,0
09757740,1,1,0,0,1,1,0,0,0
09757868,1,1,0,0,1,1,0,0,0
09757960,1,1,0,0,2,2,0,0,0
09758309,7,4,3,0,0,0,0,0,1
09758793,9,7,2,0,1,1,0,1,1
09758964,1,1,0,0,1,1,0,0,1
09759029,1,1,0,0,2,1,1,0,0
09759126,9,0,9,0,4,4,0,1,0
09760010,6,5,1,0,0,0,0,0,0
09760192,1,1,0,0,1,1,0,0,0
09760296,2,2,0,0,2,2,0,0,0
09760807,6,2,4,0,2,2,0,0,1
09760850,14,8,6,0,0,0,0,0,1
09760951,2,2,0,0,2,2,0,0,0
09761005,24,14,10,0,0,0,0,0,0
09761115,4,4,0,0,1,1,0,0,1
09761415,3,3,0,0,1,1,0,0,1
09761603,4,4,0,0,0,0,0,0,1
09761646,12,8,4,0,0,0,0,0,1
09761671,6,3,3,0,0,0,0,0,1
09762041,7,0,7,0,0,0,0,0,1
09762160,2,1,1,0,1,1,0,0,0
09762574,3,0,3,0,0,0,0,0,1
09762854,2,0,2,0,2,1,1,0,1
09763160,3,0,3,0,0,0,0,0,1
09763403,2,2,0,0,2,1,1,1,1
09764024,2,2,0,0,2,2,0,0,1
09764161,7,4,3,0,0,0,0,0,0
09764164,1,1,0,0,1,1,0,0,0
09764538,3,0,3,0,3,3,0,0,0
09764553,4,3,1,0,1,1,0,1,1
09764840,1,1,0,0,1,1,0,0,0
09764869,1,0,1,0,0,0,0,0,0
09764969,1,1,0,0,1,1,0,0,0
09765350,1,1,0,0,1,1,0,0,0
09765515,7,5,2,0,2,1,1,0,1
09765525,6,4,2,0,1,1,0,1,1
09766859,1,1,0,0,1,1,0,0,0
09766887,3,0,3,0,0,0,0,0,1
09767343,1,1,0,0,3,2,1,2,0
09767583,1,1,0,0,1,1,0,0,0
09768505,1,1,0,0,2,2,0,0,0
09768573,1,0,1,0,1,1,0,0,1
09768780,1,0,1,0,0,0,0,0,0
09769075,2,0,2,0,1,1,0,0,0
09769423,4,4,0,0,3,3,0,0,0
09769455,6,2,4,0,1,1,0,0,0
09769779,10,6,4,0,1,1,0,1,1
05480069,5,2,3,0,1,1,0,0,0
05480115,2,2,0,0,1,1,0,0,0
05480338,5,1,4,0,1,1,0,0,1
05480340,35,4,31,0,1,1,0,1,1
05480367,5,0,5,0,0,0,0,0,0
05480730,6,4,2,0,1,1,0,0,1
05481374,8,3,5,0,1,1,0,0,1
05481377,10,1,9,0,0,0,0,0,1
05481386,10,0,10,0,0,0,0,0,1
05481495,9,2,7,0,0,0,0,0,1
05481900,4,2,2,0,1,1,0,0,0
05482383,6,1,5,0,1,1,0,0,1
05482421,6,3,3,0,0,0,0,0,1
05482646,14,0,14,0,0,0,0,0,1
05483058,9,3,6,0,1,1,0,1,1
05483060,9,3,6,0,2,1,1,1,1
05483375,6,3,3,0,1,1,0,1,1
05483483,3,0,3,0,0,0,0,0,1
05483806,11,4,7,0,1,1,0,1,1
05483950,23,10,13,0,0,0,0,0,1
05484062,4,0,4,0,1,1,0,0,1
05484125,97,11,86,0,0,0,0,0,0
05484221,9,0,9,0,0,0,0,0,1
05484760,4,3,1,0,1,1,0,0,1
05484988,5,4,1,0,3,3,0,0,0
05484990,4,3,1,0,4,2,2,1,0
05485219,3,3,0,0,2,2,0,0,1
05485349,30,10,20,0,0,0,0,0,0
05485651,29,4,25,1,0,0,0,0,0
05485678,28,6,22,0,1,1,0,1,1
05485879,3,2,1,0,1,1,0,0,1
05485932,22,7,15,0,0,0,0,0,0
05485961,29,10,19,0,1,1,0,1,0
05486114,6,0,6,0,0,0,0,0,1
05486638,20,5,15,0,1,1,0,1,1
05486645,7,0,7,0,0,0,0,0,1
05486647,16,0,16,0,0,0,0,0,1
05486671,7,0,7,0,0,0,0,0,1
05486992,4,0,4,0,1,1,0,0,0
05487505,6,3,3,0,2,2,0,0,0
05488651,18,8,10,0,1,1,0,1,1
05489010,3,2,1,0,1,1,0,0,0
05489355,7,0,7,0,0,0,0,0,1
05489727,2,2,0,0,1,1,0,1,0
05489767,27,6,21,0,1,1,0,1,1
05489775,31,2,29,0,0,0,0,0,1
05490074,4,0,4,0,1,1,0,0,1
05490114,7,2,5,0,3,3,0,0,0
05490129,3,2,1,0,2,2,0,0,1
05490182,6,0,6,0,0,0,0,0,1
05490276,0,0,0,0,0,0,0,0,1
05490390,10,0,10,0,0,0,0,0,1
05490420,18,1,17,0,0,0,0,0,0
05490737,10,0,10,0,0,0,0,0,1
05490738,6,3,3,0,1,1,0,0,1
05491198,32,0,32,0,1,1,0,1,1
05491200,34,0,34,0,1,1,0,1,1
05491588,25,8,17,0,0,0,0,0,1
05491604,8,5,3,0,3,3,0,0,1
05491635,30,4,26,0,3,2,1,1,1
05491668,30,4,26,0,3,2,1,1,1
05492468,6,2,4,0,1,1,0,0,0
05492628,3,0,3,0,0,0,0,0,1
05492673,29,4,25,0,3,2,1,1,1
05492674,28,4,24,0,3,2,1,1,1
05492798,4,2,2,0,2,2,0,0,0
05493152,4,0,4,0,0,0,0,0,0
05493384,78,19,59,0,3,2,1,0,1
05493387,19,2,17,0,1,1,0,1,1
05493800,5,3,2,0,1,1,0,0,0
05493819,22,3,19,0,0,0,0,0,0
05494031,5,2,3,0,2,1,1,0,1
05494070,4,2,2,0,2,2,0,0,0
05494083,5,3,2,0,2,2,0,0,0
05494336,6,0,6,0,0,0,0,0,1
05494740,5,3,2,0,2,2,0,0,0
05494748,16,0,16,0,0,0,0,0,1
05494795,9,0,9,0,0,0,0,0,1
05494867,10,0,10,0,0,0,0,0,1
05495096,10,6,4,0,0,0,0,0,1
05495293,33,3,30,0,2,1,1,2,1
05495731,13,8,5,0,1,0,1,0,1
05496466,23,5,18,0,1,1,0,1,1
05496468,23,5,18,0,1,1,0,1,1
05496469,28,6,22,0,1,1,0,1,1
05496623,4,2,2,0,1,1,0,0,1
05496635,5,1,4,0,1,1,0,0,1
05496869,13,5,8,0,0,0,0,0,1
05496952,16,2,14,0,2,1,1,1,1
05496954,16,2,14,0,2,1,1,1,1
05496958,16,2,14,0,2,1,1,1,1
05497253,6,1,5,0,1,1,0,0,1
05497310,29,0,29,0,1,1,0,0,0
05497663,5,0,5,0,2,2,0,0,1
05497706,7,3,4,0,1,1,0,0,1
05497774,12,0,12,0,0,0,0,0,1
05497802,15,0,15,0,0,0,0,0,1
05498489,45,0,45,0,0,0,0,0,1
05498655,11,7,4,0,1,1,0,0,1
05498724,10,7,3,0,0,0,0,0,0
05498803,16,8,8,0,0,0,0,0,1
05499009,5,3,2,0,1,1,0,0,1
05499298,4,2,2,0,1,1,0,0,1
05499369,12,5,7,0,1,1,0,0,1
05499435,18,0,18,0,0,0,0,0,1
05499870,12,0,12,0,0,0,0,0,1
05499905,12,2,10,0,0,0,0,0,1
05500404,10,3,7,0,0,0,0,0,0
05500663,21,6,15,0,1,1,0,1,1
05500885,6,0,6,0,0,0,0,0,1
05501054,9,3,6,0,0,0,0,0,0
05501089,4,0,4,0,0,0,0,0,0
05501116,11,2,9,0,1,1,0,0,1
05501257,17,8,9,0,0,0,0,0,1
05501389,3,1,2,0,1,1,0,0,0
05501651,8,0,8,0,0,0,0,0,1
05501979,3,0,3,0,0,0,0,0,1
05502209,17,7,10,0,1,1,0,1,1
05503274,11,3,8,0,1,1,0,1,1
05503535,3,2,1,0,1,1,0,0,0
05504373,10,0,10,0,0,0,0,0,1
05504412,12,3,9,0,1,1,0,1,1
05504517,24,5,19,0,0,0,0,0,0
05504624,4,3,1,0,2,2,0,0,1
05504660,7,1,6,0,0,0,0,0,1
05504699,6,2,4,0,2,2,0,0,0
05504750,9,2,7,0,0,0,0,0,1
05504758,4,1,3,0,1,1,0,0,0
05504760,6,2,4,0,1,1,0,0,1
05504806,26,9,17,0,0,0,0,0,1
05505149,3,0,3,0,2,2,0,0,0
05505173,3,1,2,0,2,2,0,0,0
05505189,16,0,16,0,0,0,0,0,1
05505317,6,2,4,0,1,1,0,1,1
05505577,11,5,6,0,1,1,0,0,0
05505587,4,2,2,0,1,1,0,0,0
05505639,13,0,13,0,0,0,0,0,1
05505743,7,3,4,0,2,2,0,0,0
05505763,15,3,12,0,2,1,1,2,1
05505985,11,4,7,0,0,0,0,0,1
05506168,9,0,9,0,0,0,0,0,1
05506268,5,3,2,0,2,2,0,0,0
05506731,13,0,13,0,0,0,0,0,1
05506903,32,6,26,0,0,0,0,0,1
05507324,4,0,4,0,1,1,0,0,0
05507325,14,5,9,0,2,1,1,0,0
05507344,24,3,21,0,1,1,0,1,1
05507387,14,4,10,0,1,1,0,1,1
05507628,5,0,5,0,0,0,0,0,1
05507947,2,2,0,0,1,1,0,0,1
05508378,7,0,7,0,0,0,0,0,1
05508735,38,15,23,0,2,1,1,0,0
05508872,5,2,3,0,3,3,0,0,1
05508991,7,2,5,0,1,1,0,0,0
05509039,14,3,11,0,0,0,0,0,1
05509079,8,3,5,0,1,1,0,1,1
05509082,8,3,5,0,1,1,0,1,1
05509086,57,9,48,0,0,0,0,0,0
05509092,8,3,5,0,1,1,0,1,1
05509109,10,0,10,0,0,0,0,0,1
05509127,4,0,4,0,0,0,0,0,1
05509194,6,1,5,0,0,0,0,0,1
05509521,11,5,6,0,1,1,0,1,1
05510012,3,3,0,0,2,2,0,0,0
05510321,4,2,2,0,1,1,0,0,1
05510593,5,2,3,0,3,3,0,0,1
05510674,4,2,2,0,1,1,0,0,0
05510783,5,2,3,0,1,1,0,0,0
05510985,4,2,2,0,2,2,0,0,0
05511147,16,5,11,0,0,0,0,0,1
05511195,16,0,16,0,0,0,0,0,1
05511220,16,7,9,0,1,1,0,0,0
05511314,6,4,2,0,1,1,0,0,1
05511495,26,0,26,0,0,0,0,0,1
05511798,4,1,3,0,0,0,0,0,0
05511848,19,4,15,0,2,2,0,0,1
05511850,13,5,8,0,1,1,0,1,1
05511851,13,5,8,0,1,1,0,1,1
05512161,5,0,5,0,0,0,0,0,1
05512174,2,2,0,0,1,1,0,0,1
05512199,4,2,2,0,1,1,0,0,0
05512322,7,2,5,0,1,1,0,0,0
05512432,8,1,7,0,1,1,0,1,1
05512541,14,0,14,0,0,0,0,0,1
05512559,12,4,8,0,0,0,0,0,1
05512796,4,2,2,0,2,2,0,0,0
05512942,8,0,8,0,0,0,0,0,1
05512987,33,6,27,0,0,0,0,0,1
05513508,8,2,6,0,0,0,0,0,0
05513839,5,3,2,0,2,2,0,0,1
05514274,13,7,6,0,2,1,1,2,1
05514488,36,2,34,0,3,1,2,3,1
05514761,4,4,0,0,3,3,0,0,0
05514819,18,0,18,0,0,0,0,0,1
05514964,18,6,12,0,0,0,0,0,1
05515278,7,5,2,0,1,1,0,0,1
05515591,5,0,5,0,0,0,0,0,1
05515745,8,4,4,0,0,0,0,0,0
05515857,17,4,13,0,1,1,0,0,1
05516170,3,1,2,0,1,1,0,0,1
05516385,7,0,7,0,1,1,0,0,0
05516463,28,8,20,0,11,1,10,1,1
05516864,4,3,1,0,1,1,0,0,0
05516928,10,0,10,0,0,0,0,0,1
05516931,4,0,4,0,2,2,0,0,1
05517228,31,9,22,0,0,0,0,0,1
05517384,6,0,6,0,0,0,0,0,0
05517733,14,5,9,0,1,1,0,1,1
05518335,18,4,14,0,1,1,0,0,1
05518340,14,5,9,0,1,1,0,1,1
05518392,9,3,6,0,2,2,0,0,0
05518662,15,0,15,0,0,0,0,0,1
05519022,7,0,7,0,0,0,0,0,1
05519131,26,0,26,0,1,1,0,1,1
05519277,13,4,9,0,1,1,0,1,1
05519663,7,3,4,0,2,2,0,0,0
05519729,4,2,2,0,1,1,0,0,0
03200051,30,5,25,0,5,5,0,1,1
03200055,30,3,27,0,1,1,0,1,1
03200175,7,3,4,0,2,2,0,0,0
03200414,17,0,17,0,0,0,0,0,1
03200496,32,2,30,0,1,1,0,1,1
03200517,41,5,36,0,0,0,0,0,1
03200571,15,0,15,0,0,0,0,0,1
03200669,9,0,9,0,0,0,0,0,1
03201640,28,6,22,0,1,1,0,1,1
03201873,9,0,9,0,0,0,0,0,1
03201894,37,0,37,0,0,0,0,0,1
03201959,110,13,97,0,0,0,0,0,1
03202481,4,2,2,0,1,1,0,0,1
03202544,0,0,0,0,0,0,0,0,1
03202609,4,1,3,0,0,0,0,0,1
03202645,13,0,13,0,0,0,0,0,1
03203003,45,7,38,0,0,0,0,0,1
03203080,33,5,28,0,2,1,1,1,1
03203220,22,3,19,0,2,1,1,2,1
03203234,14,4,10,0,1,1,0,0,1
03203701,14,3,11,0,0,0,0,0,1
03203702,20,9,11,0,0,0,0,0,0
03203812,21,8,13,0,0,0,0,0,1
03203842,8,1,7,0,1,1,0,0,1
03203923,23,3,20,0,1,1,0,1,0
03204093,40,0,40,0,0,0,0,0,1
03204400,14,3,11,0,1,1,0,1,1
03204452,31,0,31,0,0,0,0,0,1
03204613,27,3,24,0,1,1,0,1,1
03204631,37,0,37,0,1,1,0,1,1
03204655,25,0,25,0,1,1,0,1,1
03204743,13,2,11,0,1,1,0,1,1
03204761,22,6,16,0,1,1,0,1,1
03204919,42,9,33,0,0,0,0,0,1
03205080,12,7,5,0,0,0,0,0,0
03205246,38,7,31,0,0,0,0,0,1
03205310,12,0,12,0,0,0,0,0,1
03205334,11,2,9,0,4,2,2,0,1
03205768,43,9,34,0,1,1,0,1,1
03205806,34,3,31,0,1,1,0,1,1
03205808,20,6,14,0,0,0,0,0,1
03205893,56,3,53,0,0,0,0,0,1
03206120,19,3,16,0,1,1,0,1,1
03206406,13,0,13,0,0,0,0,0,1
03206792,39,9,30,0,1,1,0,1,1
03206943,25,0,25,0,0,0,0,0,1
03206948,30,5,25,0,1,1,0,1,1
03207200,17,5,12,0,1,1,0,0,1
03207203,21,5,16,0,2,2,0,0,1
03208243,5,3,2,0,2,2,0,0,1
03208792,23,5,18,0,1,1,0,1,1
03208864,38,5,33,0,6,6,0,0,1
03209030,19,3,16,0,0,0,0,0,1
03209036,17,5,12,0,1,1,0,0,1
03209209,23,3,20,0,1,1,0,1,1
03209596,12,3,9,0,1,1,0,1,0
03209823,41,4,37,0,1,1,0,1,1
03210072,31,3,28,0,1,1,0,1,1
03210105,14,5,9,0,1,1,0,1,0
03210130,12,3,9,0,1,1,0,1,0
03210149,16,2,14,0,0,0,0,0,1
03210172,32,2,30,0,1,1,0,1,1
03210452,25,1,24,0,1,1,0,1,1
03210561,6,3,3,0,1,1,0,0,1
03210634,47,7,40,0,0,0,0,0,1
03211164,6,2,4,0,1,1,0,1,1
03211337,9,8,1,0,0,0,0,0,0
03211446,30,11,19,0,0,0,0,0,1
03211467,26,4,22,0,1,1,0,1,1
03211487,9,1,8,0,1,1,0,0,1
03211657,56,4,52,0,2,1,1,2,1
03211760,54,11,43,0,2,2,0,2,1
03211815,43,12,31,0,0,0,0,0,1
03212142,31,4,27,0,1,1,0,1,1
03212428,7,0,7,0,0,0,0,0,0
03212452,8,3,5,0,2,2,0,0,0
03212832,27,4,23,0,2,1,1,1,1
03213006,29,0,29,0,0,0,0,0,1
03213316,18,0,18,0,0,0,0,0,1
03213394,6,3,3,0,1,1,0,1,1
03213553,18,0,18,0,0,0,0,0,1
03213600,25,4,21,0,1,1,0,1,1
03213827,7,3,4,0,2,2,0,0,0
03213927,33,6,27,0,1,1,0,1,1
03213958,26,0,26,0,0,0,0,0,1
03214010,22,3,19,0,1,1,0,1,1
03214121,5,2,3,0,1,1,0,0,1
03214248,6,3,3,0,1,1,0,0,1
03214761,12,3,9,0,0,0,0,0,0
03214787,8,5,3,0,0,0,0,0,0
03214895,5,2,3,0,1,1,0,1,1
03214932,15,2,13,0,1,1,0,1,1
03215084,47,7,40,0,1,1,0,1,1
03215195,15,2,13,0,1,1,0,1,1
03215228,37,4,33,0,1,1,0,1,1
03215318,29,8,21,0,3,2,1,0,0
03215320,23,5,18,0,1,1,0,1,1
03215484,13,0,13,0,0,0,0,0,1
03215486,21,8,13,0,0,0,0,0,1
03215507,18,2,16,0,1,1,0,1,1
03215737,12,2,10,0,1,1,0,1,1
03215874,32,4,28,0,1,1,0,1,1
03215930,9,3,6,0,2,2,0,2,1
03216059,30,3,27,0,1,1,0,1,1
03216219,6,3,3,0,1,1,0,0,0
03216271,140,18,122,0,0,0,0,0,1
03216286,4,3,1,0,0,0,0,0,1
03216528,4,0,4,0,0,0,0,0,1
03216892,51,9,42,0,1,1,0,0,1
03216897,57,16,41,0,0,0,0,0,1
03217059,7,0,7,0,0,0,0,0,0
03217225,8,2,6,0,1,1,0,0,0
03217771,12,2,10,0,2,1,1,1,1
03217772,19,3,16,0,2,2,0,0,1
03217775,26,7,19,0,0,0,0,0,1
03217813,17,5,12,0,0,0,0,0,1
03217859,20,6,14,0,0,0,0,0,1
03218033,26,2,24,0,1,1,0,1,1
03218036,24,5,19,0,1,1,0,1,1
03218068,7,3,4,0,2,1,1,1,0
03218119,9,0,9,0,0,0,0,0,1
03218452,12,6,6,0,1,1,0,0,1
03218526,7,5,2,0,4,4,0,2,1
03218612,12,0,12,0,2,1,1,2,1
03218743,14,0,14,0,0,0,0,0,1
03218803,7,2,5,0,2,1,1,0,0
03218948,26,2,24,0,3,1,2,3,1
03218952,6,3,3,0,2,2,0,0,1
03219347,8,4,4,0,1,1,0,0,1
03219554,18,2,16,0,1,1,0,1,1
03219692,18,2,16,0,1,1,0,1,1
03219705,34,4,30,0,1,1,0,1,1
03219710,5,2,3,0,1,1,0,0,0
03219976,33,4,29,0,1,1,0,1,1
03220183,5,2,3,0,1,1,0,0,1
03220373,87,6,81,0,1,1,0,1,1
03220428,11,4,7,0,1,1,0,0,1
03220526,13,4,9,0,0,0,0,0,0
03220841,4,3,1,0,1,1,0,0,1
03220850,4,3,1,0,1,1,0,0,1
03221000,38,7,31,0,0,0,0,0,1
03221116,31,9,22,0,8,6,2,0,1
03221140,12,7,5,0,0,0,0,0,0
03221693,34,4,30,0,0,0,0,0,1
03221787,20,6,14,0,1,1,0,1,1
03221924,60,11,49,0,2,2,0,2,1
03221933,31,6,25,0,3,1,2,1,1
03222165,56,4,52,0,2,1,1,0,0
03222242,7,0,7,0,0,0,0,0,1
03222541,25,4,21,0,1,1,0,1,1
03222647,15,3,12,0,1,1,0,1,1
03223012,5,3,2,0,1,1,0,0,1
03223155,6,2,4,0,1,1,0,0,1
03223198,31,4,27,0,1,1,0,1,1
03223879,8,3,5,0,2,1,1,0,1
03224187,11,3,8,0,1,1,0,0,1
03224226,39,7,32,0,1,1,0,1,1
03224237,9,1,8,0,1,1,0,1,0
03224254,39,9,30,0,0,0,0,0,0
03224406,31,2,29,0,1,1,0,1,1
03224646,6,3,3,0,2,2,0,0,1
03224870,40,3,37,0,1,1,0,1,1
03224889,22,4,18,0,1,1,0,1,1
03225144,6,0,6,0,2,2,0,0,1
03225245,6,0,6,0,0,0,0,0,1
03225338,20,5,15,0,5,5,0,0,1
03225352,8,2,6,0,2,1,1,2,1
03225381,12,0,12,0,0,0,0,0,1
03225433,22,1,21,0,1,1,0,1,1
03225580,10,2,8,0,2,2,0,0,1
03225584,12,4,8,0,2,2,0,0,1
03225605,11,2,9,0,1,1,0,0,1
03225754,11,2,9,0,1,1,0,1,1
03225797,7,0,7,0,0,0,0,0,1
03225820,62,13,49,0,0,0,0,0,1
03225840,28,5,23,0,1,1,0,1,1
03226004,27,8,19,0,1,1,0,1,1
03226091,19,3,16,0,2,0,2,2,1
03226191,41,22,19,0,1,1,0,0,1
03226261,5,0,5,0,0,0,0,0,0
03226377,39,4,35,0,0,0,0,0,1
03226394,39,4,35,0,0,0,0,0,1
03226403,33,5,28,0,2,1,1,0,1
03226406,16,2,14,0,1,1,0,1,1
03226651,14,1,13,0,0,0,0,0,0
03226782,10,3,7,0,1,1,0,0,1
03226805,28,7,21,0,1,1,0,1,0
03226867,10,3,7,0,0,0,0,0,0
03226910,37,2,35,0,1,1,0,1,1
03226960,24,4,20,0,1,1,0,1,1
03227027,30,7,23,0,1,1,0,1,1
03227137,13,4,9,0,1,1,0,1,1
03227242,26,4,22,0,1,1,0,1,1
03227336,46,6,40,0,0,0,0,0,0
03227432,32,4,28,0,1,1,0,1,1
03227453,31,4,27,0,1,1,0,1,1
03228456,66,15,51,0,0,0,0,0,1
03228478,20,0,20,0,0,0,0,0,1
03228640,3,0,3,0,0,0,0,0,1
03228837,4,2,2,0,2,2,0,0,0
03228954,12,2,10,0,1,1,0,1,1
03228960,7,3,4,0,2,2,0,0,1
03228963,6,1,5,0,3,1,2,0,1
03229039,12,3,9,0,2,1,1,1,1
03229262,13,1,12,0,1,1,0,0,1
03229304,36,0,36,0,0,0,0,0,1
03229417,16,3,13,0,1,1,0,1,1
03229526,12,0,12,0,0,0,0,0,1
03229596,19,0,19,0,1,1,0,0,1
03229737,36,0,36,0,1,1,0,1,1
03229755,44,3,41,0,1,1,0,1,1
03968160,8,0,8,0,0,0,0,0,1
03968279,17,10,7,0,0,0,0,0,0
03968392,9,2,7,0,1,1,0,1,1
03968425,8,3,5,0,1,1,0,0,1
03968441,52,13,39,0,0,0,0,0,1
03968610,9,2,7,0,1,1,0,1,1
03968807,10,1,9,0,1,1,0,0,1
03968822,8,2,6,0,1,1,0,0,1
03969280,31,4,27,0,2,1,1,2,1
03969379,42,7,35,0,1,1,0,0,1
03969380,9,4,5,0,2,2,0,0,1
03969447,0,0,0,0,0,0,0,0,1
03969450,11,0,11,0,1,1,0,1,1
03969688,30,9,21,0,0,0,0,0,1
03969689,10,3,7,0,1,1,0,0,0
03969879,4,0,4,0,1,1,0,0,0
03969886,16,0,16,0,1,1,0,1,1
03969979,12,4,8,0,1,1,0,0,0
03970046,30,0,30,0,0,0,0,0,1
03970089,49,6,43,0,1,1,0,1,1
03970279,9,2,7,0,1,1,0,1,1
03970336,13,0,13,0,0,0,0,0,1
03970339,9,2,7,0,1,1,0,1,1
03970537,18,5,13,0,1,1,0,1,1
03970800,24,0,24,0,0,0,0,0,1
03970806,11,0,11,0,0,0,0,0,1
03971055,6,0,6,0,0,0,0,0,1
03971079,40,0,40,0,3,1,2,3,1
03971514,16,0,16,0,1,1,0,1,1
03971670,13,3,10,0,1,1,0,1,1
03971694,35,10,25,0,0,0,0,0,0
03971723,8,3,5,0,1,1,0,1,1
03971914,29,0,29,0,1,1,0,1,1
03972355,14,3,11,0,1,1,0,1,1
03972550,12,1,11,0,2,1,1,1,1
03972991,6,2,4,0,3,2,1,0,1
03973405,25,0,25,0,0,0,0,0,1
03973434,20,4,16,0,1,1,0,0,1
03973442,22,4,18,0,1,1,0,1,1
03973490,12,6,6,0,2,1,1,2,1
03973614,9,3,6,0,1,1,0,1,1
03973619,10,3,7,0,2,2,0,0,1
03973716,6,0,6,0,0,0,0,0,1
03973827,19,4,15,0,1,1,0,1,1
03973957,22,4,18,0,0,0,0,0,1
03974231,6,3,3,0,1,1,0,0,1
03974519,21,2,19,0,1,1,0,1,0
03974835,6,2,4,0,1,1,0,0,0
03974892,10,3,7,0,0,0,0,0,1
03975065,30,8,22,0,1,1,0,0,0
03975193,20,3,17,1,1,1,0,1,1
03975288,7,3,4,0,1,1,0,1,1
03975492,13,4,9,0,1,1,0,1,1
03975616,16,0,16,0,0,0,0,0,1
03975621,6,3,3,0,2,2,0,0,0
03975672,6,2,4,0,1,1,0,0,1
03975719,23,4,19,0,1,1,0,1,1
03975782,15,3,12,0,0,0,0,0,0
03975999,31,4,27,0,1,1,0,1,1
03976076,24,0,24,0,0,0,0,0,1
03976350,7,4,3,0,1,1,0,0,0
03976531,58,0,58,0,0,0,0,0,1
03976533,10,4,6,0,1,1,0,0,1
03976655,10,3,7,0,1,1,0,0,0
03976759,9,4,5,0,1,1,0,0,1
03976837,4,0,4,0,0,0,0,0,1
03977028,5,2,3,0,1,1,0,0,0
03977289,28,0,28,0,0,0,0,0,1
03977318,51,6,45,0,1,1,0,1,1
03977373,48,4,44,0,0,0,0,0,1
03977431,6,2,4,0,0,0,0,0,1
03977461,4,0,4,0,1,1,0,0,0
03977597,8,3,5,0,1,1,0,1,0
03977695,5,3,2,0,2,2,0,0,0
03977837,8,2,6,0,2,2,0,0,1
03977841,7,0,7,0,0,0,0,0,1
03977896,9,0,9,0,0,0,0,0,1
03977902,17,3,14,0,1,1,0,1,1
03977909,6,2,4,0,2,1,1,0,1
03977982,9,2,7,0,2,2,0,0,1
03977986,6,2,4,0,1,1,0,0,1
03978092,21,2,19,0,1,1,0,1,1
03978157,14,0,14,0,0,0,0,0,1
03978176,7,2,5,0,1,1,0,0,1
03978196,5,2,3,0,1,1,0,0,1
03978221,28,6,22,0,1,1,0,1,1
03978344,48,5,43,0,1,1,0,0,1
03978346,32,3,29,0,1,1,0,1,1
03978759,20,5,15,0,1,1,0,1,1
03979398,12,0,12,0,0,0,0,0,1
03979419,10,2,8,0,1,1,0,0,0
03979454,24,3,21,0,1,1,0,1,1
03979467,24,3,21,0,1,1,0,1,1
03979736,18,4,14,0,1,1,0,1,1
03979913,9,2,7,0,2,2,0,0,1
03980108,12,2,10,0,0,0,0,0,0
03980266,15,0,15,0,0,0,0,0,1
03980594,26,9,17,0,3,2,1,3,1
03980770,49,2,47,0,3,1,2,2,1
03980783,7,3,4,0,1,1,0,0,1
03980813,15,3,12,0,1,1,0,1,1
03981542,12,0,12,0,0,0,0,0,1
03981646,40,0,40,0,0,0,0,0,1
03982057,16,0,16,0,0,0,0,0,1
03982225,26,0,26,0,0,0,0,0,1
03982361,6,2,4,0,1,1,0,0,1
03982820,23,3,20,0,1,1,0,1,1
03982959,13,6,7,0,1,1,0,0,1
03983125,15,3,12,0,1,1,0,1,1
03983137,15,0,15,0,0,0,0,0,1
03983523,5,2,3,0,1,1,0,0,0
03983615,12,0,12,0,0,0,0,0,1
03984014,9,0,9,0,0,0,0,0,1
03984035,5,3,2,0,2,2,0,2,1
03984054,31,0,31,0,0,0,0,0,1
03984070,30,7,23,0,0,0,0,0,1
03984117,5,3,2,0,2,2,0,2,1
03984214,4,0,4,0,1,1,0,0,1
03984289,8,0,8,0,0,0,0,0,1
03984464,29,4,25,0,1,1,0,1,1
03984470,16,0,16,0,0,0,0,0,1
03984492,16,0,16,0,0,0,0,0,1
03984669,5,3,2,0,2,2,0,0,1
03985370,27,0,27,0,0,0,0,0,1
03985376,10,0,10,0,0,0,0,0,1
03985379,23,4,19,0,4,1,3,1,1
03985507,5,1,4,0,1,1,0,0,0
03985540,37,8,29,0,1,0,1,0,1
03985580,21,3,18,0,1,1,0,1,0
03985751,7,4,3,0,1,1,0,0,0
03985873,24,3,21,0,0,0,0,0,1
03986603,12,5,7,0,2,2,0,0,1
03986626,8,0,8,0,0,0,0,0,1
03986667,11,1,10,0,1,1,0,0,0
03986675,5,3,2,0,2,2,0,0,1
03987061,33,5,28,0,2,1,1,2,1
03987132,7,0,7,0,0,0,0,0,1
03987576,4,0,4,0,0,0,0,0,1
03987700,23,0,23,0,0,0,0,0,1
03987762,15,3,12,0,1,1,0,1,1
03987835,4,2,2,0,2,2,0,0,0
03987955,20,5,15,0,1,1,0,1,1
03988189,6,3,3,0,1,1,0,0,0
03988503,19,5,14,0,1,1,0,1,1
03988724,5,2,3,0,1,1,0,0,1
03988903,56,6,50,0,0,0,0,0,1
03989030,4,0,4,0,0,0,0,0,1
03989137,26,8,18,0,0,0,0,0,1
03989460,8,3,5,0,1,1,0,1,1
03990060,3,2,1,0,1,1,0,0,0
03990416,6,3,3,0,2,2,0,0,1
03990538,5,2,3,0,1,1,0,0,1
03990586,5,1,4,0,2,2,0,0,1
03990677,32,4,28,0,1,1,0,1,1
03990680,12,5,7,0,1,1,0,1,1
03990682,5,2,3,0,1,1,0,0,1
03991016,9,4,5,0,1,1,0,1,1
03991305,13,3,10,0,2,2,0,0,1
03991358,15,3,12,0,0,0,0,0,1
03991383,10,3,7,0,0,0,0,0,0
03991397,31,4,27,0,1,1,0,1,0
03991541,7,2,5,0,1,1,0,0,1
03991603,6,2,4,0,1,1,0,0,1
03991620,3,0,3,0,0,0,0,0,1
03991838,42,0,42,0,0,0,0,0,1
03991840,12,6,6,0,2,2,0,0,1
03993081,19,3,16,0,1,1,0,1,1
03993146,5,0,5,0,0,0,0,0,1
03993250,5,5,0,0,4,4,0,0,0
03993256,5,3,2,0,2,2,0,0,1
03993572,6,3,3,0,1,1,0,0,0
03994409,18,4,14,0,1,1,0,0,1
03994691,4,2,2,0,1,1,0,0,1
03994715,5,2,3,0,2,2,0,0,1
03994943,39,11,28,0,0,0,0,0,1
03995173,18,3,15,0,1,1,0,1,1
03995308,5,3,2,0,2,2,0,0,0
03995412,42,10,32,0,0,0,0,0,0
03995638,12,0,12,0,0,0,0,0,1
03996307,4,0,4,0,0,0,0,0,1
03996688,8,0,8,0,0,0,0,0,1
03996691,8,0,8,0,0,0,0,0,1
03996694,5,3,2,0,2,2,0,0,0
03996970,23,4,19,0,1,1,0,0,0
03997525,5,2,3,0,2,2,0,0,1
03997592,27,0,27,0,0,0,0,0,1
03997639,11,4,7,0,0,0,0,0,1
03997901,10,3,7,0,2,2,0,0,1
03997920,20,5,15,0,0,0,0,0,1
03998049,12,0,12,0,0,0,0,0,0
03998108,7,0,7,0,1,1,0,0,0
03998136,14,4,10,0,1,1,0,1,1
03998141,9,5,4,0,1,1,0,0,0
03998216,27,7,20,0,0,0,0,0,1
03998296,6,3,3,0,1,1,0,0,1
03998314,22,0,22,0,0,0,0,0,1
03998355,7,1,6,0,1,1,0,0,1
03998464,8,3,5,0,0,0,0,0,1
03998496,29,5,24,0,0,0,0,0,1
03998819,9,0,9,0,0,0,0,0,1
03998820,8,0,8,0,0,0,0,0,1
03998833,17,3,14,0,2,2,0,2,1
03998881,17,4,13,0,1,1,0,1,1
03998951,7,0,7,0,0,0,0,0,0
03999077,26,8,18,0,1,1,0,0,1
03999194,23,3,20,0,1,1,0,1,1
03999286,16,3,13,0,0,0,0,0,1
03999390,8,3,5,0,1,1,0,1,1
03999493,7,1,6,0,1,1,0,0,1
03999510,14,5,9,0,1,1,0,1,0
03999577,25,5,20,0,1,1,0,1,1
03999579,13,5,8,0,0,0,0,0,1
03999759,4,0,4,0,0,0,0,0,1
03999896,22,5,17,0,0,0,0,0,1
00149013,73,4,69,0,1,1,0,1,1
00149461,13,4,9,0,1,1,0,0,1
00149834,12,3,9,0,2,2,0,0,1
00149999,117,25,92,0,0,0,0,0,1
00150396,25,4,21,0,1,1,0,1,1
00150494,17,9,8,0,0,0,0,0,1
00150515,12,2,10,0,2,1,1,1,1
00150832,35,4,31,0,2,2,0,2,1
00150856,237,48,189,0,0,0,0,0,1
00151289,9,5,4,0,4,4,0,0,1
00151360,88,0,88,0,0,0,0,0,1
00151537,38,3,35,0,1,1,0,1,1
00151618,22,10,12,0,0,0,0,0,1
00151621,84,11,73,0,0,0,0,0,1
00151665,31,4,27,0,1,1,0,1,1
00151731,58,3,55,0,1,1,0,1,1
00152298,49,5,44,0,2,1,1,2,1
00152305,24,3,21,0,0,0,0,0,1
00152385,8,1,7,0,1,1,0,1,1
00152477,24,2,22,0,1,1,0,1,1
00153009,48,4,44,0,1,1,0,1,1
00153026,19,10,9,0,0,0,0,0,1
00153088,31,0,31,0,1,1,0,1,1
00153331,22,4,18,0,1,1,0,1,1
00153360,89,11,78,0,0,0,0,0,1
00154121,66,11,55,0,0,0,0,0,1
00154522,26,6,20,0,1,1,0,1,1
00155224,34,0,34,0,0,0,0,0,0
00155374,45,6,39,0,1,1,0,1,1
00155455,19,4,15,0,1,1,0,1,1
00155840,63,10,53,0,0,0,0,0,1
00155936,22,3,19,0,1,1,0,1,0
00156243,128,17,111,0,0,0,0,0,1
00156261,15,5,10,0,1,1,0,1,0
00156289,33,0,33,0,0,0,0,0,0
00156368,15,4,11,0,1,1,0,0,1
00156617,35,0,35,0,1,1,0,1,1
00156641,39,3,36,0,1,1,0,1,1
00157048,22,6,16,0,1,1,0,1,1
00157345,17,4,13,0,1,1,0,1,1
00157426,11,4,7,0,1,1,0,0,0
00157660,33,2,31,0,1,1,0,0,1
00157833,29,11,18,0,0,0,0,0,0
00157888,33,11,22,0,0,0,0,0,1
00158447,39,5,34,0,1,1,0,1,1
00158900,34,0,34,0,0,0,0,0,1
00159031,54,9,45,0,1,1,0,1,1
00159189,62,5,57,0,1,1,0,1,1
00159926,38,3,35,0,1,1,0,1,1
00160308,8,2,6,0,1,1,0,1,1
00160881,19,3,16,0,1,1,0,1,1
00160988,20,5,15,0,1,1,0,1,1
00160996,20,8,12,0,0,0,0,0,1
00161312,93,5,88,0,0,0,0,0,0
00161443,37,3,34,0,1,1,0,1,1
00161676,127,8,119,0,0,0,0,0,1
00162165,99,18,81,0,0,0,0,0,1
00162175,132,7,125,0,1,1,0,1,1
00162301,49,5,44,0,0,0,0,0,1
00162308,19,3,16,0,1,1,0,1,1
00162457,10,3,7,0,0,0,0,0,1
00162786,21,4,17,0,1,1,0,1,1
00162828,19,0,19,0,0,0,0,0,1
00162966,29,6,23,0,2,1,1,2,1
00163096,18,4,14,0,2,2,0,2,1
00163198,12,0,12,0,0,0,0,0,1
00163210,23,0,23,0,0,0,0,0,1
00163908,19,3,16,0,0,0,0,0,1
00164062,21,3,18,0,1,1,0,1,1
00164206,33,4,29,0,1,1,0,1,1
00164213,22,3,19,0,0,0,0,0,1
00164251,69,10,59,0,0,0,0,0,1
00164291,35,0,35,0,0,0,0,0,1
00164740,13,2,11,0,1,1,0,1,1
00164770,6,5,1,0,1,1,0,1,1
00165100,41,0,41,0,0,0,0,0,1
00165381,31,4,27,0,0,0,0,0,0
00165445,22,5,17,0,1,1,0,1,1
00165453,22,3,19,0,2,2,0,2,1
00165672,14,5,9,0,2,2,0,2,1
00165678,34,3,31,0,1,1,0,1,1
00166023,57,6,51,0,1,1,0,1,1
00166055,45,7,38,0,1,1,0,1,1
00166242,19,3,16,0,1,1,0,1,1
00166244,16,0,16,0,0,0,0,0,1
00166250,97,12,85,0,0,0,0,0,0
00166396,36,3,33,0,0,0,0,0,1
00166427,7,4,3,0,1,1,0,0,1
00166431,66,5,61,0,0,0,0,0,1
00166771,14,4,10,0,1,1,0,1,1
00166772,128,2,126,0,0,0,0,0,1
00167031,23,3,20,0,1,1,0,0,1
00167370,32,5,27,0,1,1,0,1,1
00167469,9,2,7,0,2,2,0,0,1
00167591,43,12,31,0,0,0,0,0,1
00167604,30,8,22,0,0,0,0,0,0
00167635,39,5,34,0,1,1,0,0,1
00167657,25,2,23,0,1,1,0,1,1
00168127,16,0,16,0,0,0,0,0,1
00168783,30,7,23,0,2,1,1,1,0
00168824,8,0,8,0,0,0,0,0,1
00168831,44,12,32,0,2,2,0,1,0
00169090,16,2,14,0,1,1,0,1,1
00169392,72,9,63,0,0,0,0,0,1
00169714,14,2,12,0,0,0,0,0,1
00169796,22,4,18,0,0,0,0,0,1
00170133,28,8,20,0,0,0,0,0,1
00170454,30,7,23,0,0,0,0,0,1
00170466,40,3,37,0,1,1,0,1,1
00170887,42,8,34,0,7,7,0,0,1
00170944,96,12,84,0,0,0,0,0,1
00171179,29,7,22,0,0,0,0,0,1
00171270,19,3,16,0,1,1,0,1,1
00171309,15,3,12,0,0,0,0,0,1
00171402,143,14,129,0,0,0,0,0,1
00171417,8,2,6,0,0,0,0,0,1
00171729,26,4,22,0,1,1,0,1,1
00171831,116,3,113,0,1,1,0,1,1
00171912,58,6,52,0,1,1,0,1,1
00172091,22,12,10,0,0,0,0,0,0
00172105,23,5,18,0,0,0,0,0,1
00172178,119,3,116,0,2,1,1,0,1
00172413,12,6,6,0,0,0,0,0,0
00172415,42,3,39,0,3,3,0,0,0
00172928,4,3,1,0,0,0,0,0,1
00173178,20,2,18,0,0,0,0,0,0
00173179,23,10,13,0,1,1,0,0,0
00173199,69,11,58,0,0,0,0,0,1
00173421,9,3,6,0,0,0,0,0,1
00173485,45,3,42,0,0,0,0,0,1
00173565,97,8,89,0,0,0,0,0,1
00173834,126,14,112,0,0,0,0,0,0
00174142,26,3,23,0,1,1,0,1,1
00174262,31,9,22,0,0,0,0,0,1
00174297,78,0,78,0,0,0,0,0,1
00174333,46,5,41,0,8,4,4,0,0
00174692,41,6,35,0,2,2,0,1,1
00174695,112,0,112,0,0,0,0,0,1
00174706,52,4,48,0,1,1,0,1,1
00174990,0,0,0,0,0,0,0,0,1
00175014,24,0,24,0,0,0,0,0,1
00175064,27,2,25,0,1,1,0,1,1
00175280,47,5,42,0,1,1,0,1,1
00175447,12,3,9,0,1,1,0,1,1
00175642,39,5,34,0,3,3,0,0,0
00176197,23,6,17,0,1,1,0,0,1
00176204,70,7,63,0,0,0,0,0,0
00176333,53,5,48,0,1,1,0,0,0
00176420,50,6,44,0,0,0,0,0,0
00176447,22,3,19,0,3,3,0,1,1
00176518,13,3,10,0,2,2,0,2,1
00176672,10,6,4,0,14,14,0,0,0
00176992,30,10,20,0,1,1,0,1,1
00177204,57,16,41,0,1,1,0,0,1
00177322,25,0,25,0,0,0,0,0,1
00177366,37,10,27,0,11,11,0,0,0
00177433,26,0,26,0,0,0,0,0,1
00177566,70,0,70,0,0,0,0,0,0
00177670,125,21,104,0,0,0,0,0,1
00177682,9,3,6,0,1,1,0,1,1
00177932,8,4,4,0,0,0,0,0,0
00177991,35,8,27,0,0,0,0,0,1
00178159,103,13,90,0,0,0,0,0,1
00178456,128,8,120,0,1,1,0,1,1
00178711,20,8,12,0,1,1,0,1,1
00179412,9,2,7,0,1,1,0,0,0
00179495,11,2,9,0,1,1,0,0,1
00180277,35,0,35,0,0,0,0,0,1
00180398,48,6,42,0,0,0,0,0,1
00180516,16,6,10,0,0,0,0,0,1
00180834,24,4,20,0,1,1,0,1,1
00181002,15,6,9,0,1,1,0,1,1
00181581,209,9,200,0,0,0,0,0,1
00181585,43,4,39,0,1,1,0,1,1
00181866,196,5,191,0,1,1,0,1,1
00181967,6,3,3,0,2,2,0,0,0
00182180,16,4,12,0,1,1,0,1,1
00183035,57,6,51,0,1,1,0,1,1
00183129,12,4,8,0,0,0,0,0,0
00183184,18,5,13,0,0,0,0,0,1
00184594,45,13,32,0,6,5,1,0,1
00184915,69,8,61,0,3,1,2,3,1
00185445,133,13,120,0,0,0,0,0,1
00185645,113,0,113,0,0,0,0,0,1
00185647,58,11,47,0,0,0,0,0,1
00185672,11,2,9,0,3,1,2,1,0
00185691,33,5,28,0,1,1,0,1,1
00185733,7,3,4,0,2,2,0,1,0
00185931,44,6,38,0,0,0,0,0,0
00186162,62,6,56,0,1,1,0,1,0
00186174,61,3,58,0,0,0,0,0,1
00186479,25,3,22,0,0,0,0,0,1
00186538,24,2,22,0,1,1,0,1,1
00187052,204,20,184,0,0,0,0,0,1
00187091,19,2,17,0,1,1,0,0,1
00187153,34,0,34,0,0,0,0,0,1
00187251,73,20,53,0,1,1,0,1,1
00187255,33,3,30,0,1,1,0,1,1
00187700,8,5,3,0,0,0,0,0,0
00187961,31,4,27,0,1,1,0,1,1
00188027,11,4,7,0,3,3,0,0,1
00188307,46,5,41,0,1,1,0,1,1
00188532,89,4,85,0,1,1,0,0,1
00188598,41,4,37,0,1,1,0,1,1
00188624,57,6,51,0,0,0,0,0,0
00188626,46,17,29,0,0,0,0,0,0
00189241,108,7,101,0,0,0,0,0,1
00189717,22,5,17,0,2,2,0,0,1
09316194,2,2,0,0,1,1,0,0,1
09316706,2,0,2,0,1,1,0,0,0
09316729,2,1,1,0,1,1,0,0,0
09316752,1,1,0,0,1,1,0,0,1
09316861,2,2,0,0,1,1,0,0,0
09316983,2,0,2,0,0,0,0,0,1
09317178,5,3,2,1,0,0,0,0,0
09317374,6,1,5,0,3,1,2,0,0
09317510,5,1,4,0,3,1,2,0,0
09318045,5,5,0,0,1,1,0,0,1
09318533,2,0,2,0,2,2,0,0,0
09318697,6,0,6,0,0,0,0,0,1
09318755,26,14,12,0,4,3,1,0,0
09318834,9,5,4,0,2,1,1,1,1
09318844,1,0,1,0,0,0,0,0,0
09318958,4,0,4,0,2,2,0,0,1
09318966,1,1,0,0,1,1,0,0,0
09318972,2,0,2,0,0,0,0,0,1
09319103,4,0,4,0,2,2,0,0,1
09319289,3,3,0,0,1,1,0,0,0
09319340,6,5,1,0,3,3,0,0,0
09319495,1,1,0,0,1,1,0,0,1
09319682,4,0,4,0,2,2,0,0,1
09319841,9,1,8,0,2,1,1,0,0
09319917,4,0,4,0,2,2,0,0,1
09319928,1,1,0,0,1,1,0,1,0
09320460,1,1,0,0,1,1,0,0,0
09320540,7,2,5,0,0,0,0,0,1
09320655,2,2,0,0,1,1,0,0,1
09320859,6,0,6,0,0,0,0,0,1
09321041,1,1,0,0,1,1,0,0,0
09321132,4,2,2,0,1,1,0,0,1
09321277,2,2,0,0,2,2,0,0,0
09321418,4,0,4,0,2,2,0,0,1
09321538,5,3,2,0,2,2,0,0,1
09321580,2,0,2,0,1,1,0,1,1
09321703,4,0,4,0,2,2,0,0,1
09321725,4,0,4,0,2,2,0,0,1
09321977,3,2,1,0,1,1,0,0,0
09322211,3,2,1,0,2,1,1,1,1
09322543,2,0,2,0,1,1,0,0,1
09322561,8,0,8,0,3,0,3,0,0
09322568,7,6,1,0,0,0,0,0,0
09322806,2,0,2,0,1,1,0,1,1
09322916,2,0,2,0,0,0,0,0,1
09322938,2,0,2,0,1,1,0,1,1
09322942,3,1,2,0,1,1,0,1,1
09323011,3,1,2,0,1,1,0,1,1
09323017,2,0,2,0,1,1,0,1,1
09323065,5,3,2,0,1,1,0,0,1
09323530,2,0,2,0,1,1,0,1,1
09324649,3,0,3,0,1,1,0,1,0
09324825,4,0,4,0,2,2,0,0,1
09324883,3,0,3,0,2,2,0,0,0
09324927,2,2,0,0,1,1,0,0,1
09325665,30,14,16,0,0,0,0,0,1
09325718,3,2,1,0,1,1,0,0,0
09325765,1,0,1,0,0,0,0,0,1
09325855,1,1,0,0,1,1,0,0,0
09326141,2,2,0,0,1,1,0,0,0
09326862,2,0,2,0,0,0,0,0,1
09327722,4,4,0,0,2,1,1,1,1
09328132,2,1,1,0,3,2,1,0,0
09328206,2,1,1,0,2,1,1,0,0
09328997,3,3,0,0,1,1,0,0,0
09329369,10,6,4,0,0,0,0,0,0
09329574,1,1,0,0,1,1,0,0,0
09329700,6,4,2,0,0,0,0,0,0
09330209,2,2,0,0,2,2,0,0,0
09330301,1,1,0,0,1,1,0,0,0
09330902,5,5,0,0,0,0,0,0,0
09331085,9,4,5,0,1,1,0,1,1
09331538,7,2,5,0,1,1,0,0,1
09332186,1,1,0,0,1,1,0,0,1
09332213,1,1,0,0,1,1,0,0,0
09332237,4,0,4,0,2,1,1,0,0
09332411,4,0,4,0,1,1,0,0,1
09332669,1,1,0,0,1,1,0,0,0
09332738,10,6,4,0,1,1,0,1,1
09332914,11,0,11,0,0,0,0,0,0
09333055,3,3,0,0,3,3,0,0,0
09333290,13,9,4,0,0,0,0,0,1
09333326,3,3,0,0,2,2,0,0,0
09334024,9,5,4,0,2,2,0,1,1
09334026,23,7,16,0,4,3,1,0,0
09334057,1,1,0,0,1,1,0,0,0
09334096,4,2,2,0,2,1,1,2,0
09335383,6,0,6,0,0,0,0,0,1
09335831,1,1,0,0,1,1,0,0,0
09335907,4,1,3,0,3,3,0,0,0
09336185,2,1,1,0,1,1,0,0,0
09336261,4,3,1,0,0,0,0,0,0
09336310,3,0,3,0,2,2,0,1,0
09336743,2,1,1,0,2,2,0,1,1
09337011,1,0,1,0,0,0,0,0,0
09337263,3,2,1,0,2,2,0,0,0
09337418,1,1,0,0,1,1,0,0,0
09337513,5,3,2,0,5,4,1,1,1
09338010,2,0,2,0,1,1,0,0,0
09338074,1,1,0,0,1,1,0,0,0
09338686,1,1,0,0,1,1,0,0,0
09338705,2,2,0,1,1,1,0,1,0
09338724,20,11,9,0,2,2,0,0,1
09338747,3,1,2,0,1,1,0,0,0
09339457,1,1,0,0,1,1,0,1,0
09339503,1,1,0,0,1,1,0,0,1
09339706,1,0,1,0,0,0,0,0,0
09339729,8,3,5,0,0,0,0,0,1
09339740,4,3,1,0,1,1,0,1,1
09340417,3,3,0,0,2,2,0,0,1
09340687,3,3,0,0,2,1,1,0,1
09340851,1,0,1,0,0,0,0,0,1
09340934,1,0,1,0,1,1,0,0,0
09341143,6,5,1,0,1,1,0,0,1
09341365,2,2,0,0,2,2,0,0,1
09341374,18,10,8,0,3,3,0,3,1
09341468,2,2,0,0,1,1,0,1,0
09341741,3,3,0,0,1,1,0,0,0
09341795,2,1,1,0,1,1,0,1,0
09341813,7,7,0,0,0,0,0,0,0
09341865,5,5,0,0,1,1,0,0,0
09341963,1,1,0,0,1,1,0,0,1
09341989,11,3,8,0,0,0,0,0,0
09342002,5,2,3,0,1,1,0,1,1
09342517,2,2,0,0,1,1,0,0,0
09342601,1,0,1,0,1,1,0,0,0
09342621,5,4,1,0,3,3,0,0,0
09342684,2,1,1,0,1,1,0,1,0
09342926,5,3,2,1,1,1,0,1,1
09342948,1,1,0,0,2,2,0,0,1
09343544,2,1,1,0,1,1,0,0,1
09343573,4,3,1,0,4,3,1,1,1
09343926,1,1,0,0,1,1,0,0,0
09344398,4,3,1,0,1,1,0,1,1
09345035,3,3,0,0,2,2,0,0,1
09345317,2,0,2,0,1,1,0,0,0
09345489,4,3,1,0,1,1,0,1,1
09345602,1,1,0,0,1,1,0,0,0
09345723,1,1,0,0,1,1,0,0,0
09346151,2,2,0,0,1,1,0,0,1
09346227,1,0,1,0,0,0,0,0,1
09346256,1,0,1,0,1,1,0,0,0
09346290,11,6,5,0,3,1,2,1,1
09346363,20,10,10,0,1,1,0,1,1
09346804,2,0,2,0,0,0,0,0,1
09346822,2,2,0,0,2,2,0,0,1
09347618,2,2,0,0,2,2,0,0,1
09347886,21,10,11,0,0,0,0,0,0
09347924,1,0,1,0,0,0,0,0,1
09348481,2,0,2,0,1,1,0,1,1
09348505,3,1,2,0,2,1,1,0,0
09348820,1,1,0,0,2,1,1,0,0
09349299,8,4,4,0,0,0,0,0,1
09349327,2,1,1,0,1,1,0,0,1
09349353,2,2,0,0,2,2,0,0,0
09349408,5,0,5,0,0,0,0,0,0
09349428,14,5,9,0,0,0,0,0,0
09349520,1,1,0,0,1,1,0,0,0
09349614,1,0,1,0,0,0,0,0,0
09349619,7,4,3,0,3,3,0,1,1
09349623,2,2,0,0,1,1,0,0,0
09349641,1,1,0,0,1,1,0,0,0
09349667,2,1,1,0,2,2,0,0,0
09349921,5,3,2,0,4,1,3,0,1
09349929,7,5,2,0,2,2,0,2,1
09350361,4,0,4,0,0,0,0,0,1
09350516,1,1,0,0,2,2,0,0,0
09351158,2,1,1,0,1,1,0,0,0
09351485,9,0,9,0,1,1,0,1,1
09351773,13,3,10,0,2,2,0,0,1
09351779,1,1,0,0,1,1,0,1,1
09351791,1,0,1,0,1,1,0,1,1
09351849,3,2,1,0,2,2,0,0,0
09351963,7,4,3,0,1,0,1,1,1
09352159,6,4,2,0,1,1,0,1,1
09352392,1,1,0,0,1,1,0,0,0
09352450,1,1,0,0,1,1,0,0,0
09352454,1,1,0,0,1,1,0,0,0
09352674,16,5,11,2,1,1,0,1,1
09353005,2,2,0,0,1,1,0,0,1
09353567,1,0,1,0,0,0,0,0,0
09353760,4,1,3,0,1,1,0,0,0
09354260,6,3,3,0,0,0,0,0,0
09354356,1,1,0,0,1,1,0,0,0
09354430,3,3,0,0,1,1,0,1,1
09354603,1,1,0,0,1,1,0,0,0
09354792,3,0,3,0,0,0,0,0,1
09354859,3,0,3,0,0,0,0,0,0
09355351,2,2,0,0,3,3,0,1,0
09355378,3,3,0,0,1,0,1,1,0
09356243,1,1,0,0,1,1,0,0,0
09356353,2,1,1,0,2,1,1,0,1
09356356,3,3,0,0,1,1,0,0,0
09357041,2,1,1,0,1,1,0,0,0
09357163,11,6,5,0,1,1,0,1,1
09357207,22,13,9,0,0,0,0,0,1
09357273,6,4,2,0,0,0,0,0,0
09357525,1,1,0,0,1,1,0,0,0
09357596,1,0,1,0,0,0,0,0,1
09357635,1,1,0,0,1,1,0,0,0
09357914,1,0,1,0,0,0,0,0,1
09358015,6,5,1,0,1,1,0,1,1
09358769,3,0,3,0,0,0,0,0,1
09358845,1,1,0,0,1,1,0,0,0
09359021,2,1,1,0,1,1,0,0,0
09359046,2,2,0,0,3,3,0,1,0
09359107,6,5,1,0,1,1,0,0,1
09359200,1,1,0,0,2,2,0,0,1
09359207,7,5,2,0,2,2,0,0,0
09359398,6,5,1,0,0,0,0,0,0
09359428,1,1,0,0,1,1,0,0,0
03640177,3,3,0,0,2,2,0,0,0
03640314,41,9,32,0,0,0,0,0,1
03640548,6,3,3,0,2,2,0,0,1
03640736,33,0,33,0,1,1,0,1,1
03640846,4,0,4,0,0,0,0,0,1
03640915,53,12,41,0,1,1,0,1,1
03641363,18,2,16,0,0,0,0,0,1
03641392,16,6,10,0,6,6,0,0,0
03641584,22,4,18,0,2,1,1,2,1
03641947,56,3,53,0,1,1,0,1,1
03642212,8,0,8,0,0,0,0,0,1
03642245,30,13,17,0,0,0,0,0,1
03642312,9,0,9,0,0,0,0,0,1
03642327,42,9,33,0,1,1,0,0,0
03642372,16,6,10,0,2,1,1,1,1
03642634,14,0,14,0,0,0,0,0,1
03643088,56,15,41,0,0,0,0,0,1
03643205,24,3,21,0,0,0,0,0,1
03643347,17,3,14,0,1,1,0,1,1
03643358,76,0,76,0,0,0,0,0,1
03643599,20,6,14,0,0,0,0,0,0
03643620,12,4,8,0,2,2,0,0,1
03643638,20,0,20,0,0,0,0,0,1
03643681,10,1,9,0,1,1,0,0,1
03643833,11,2,9,0,1,1,0,0,0
03643848,6,3,3,0,1,1,0,0,1
03643899,8,4,4,0,1,1,0,1,1
03644509,13,3,10,0,2,2,0,0,1
03644723,104,17,87,0,0,0,0,0,1
03645379,3,2,1,0,1,1,0,0,0
03645792,29,7,22,0,0,0,0,0,0
03645978,28,6,22,0,1,1,0,1,1
03646114,22,4,18,0,0,0,0,0,1
03646202,29,10,19,0,0,0,0,0,0
03646321,8,2,6,0,1,1,0,0,1
03646427,29,8,21,0,0,0,0,0,1
03646457,42,11,31,0,1,1,0,0,1
03646570,40,11,29,0,0,0,0,0,1
03646575,4,1,3,0,1,1,0,0,0
03647301,23,6,17,0,0,0,0,0,0
03647309,22,0,22,0,0,0,0,0,1
03647343,37,5,32,0,2,1,1,2,1
03647452,8,0,8,0,1,1,0,0,1
03647591,129,16,113,0,1,1,0,1,1
03647670,11,4,7,0,1,1,0,0,0
03647915,14,0,14,0,0,0,0,0,1
03647928,40,8,32,0,0,0,0,0,1
03648143,5,2,3,0,2,2,0,0,0
03648410,24,6,18,0,2,2,0,0,1
03648926,12,0,12,0,0,0,0,0,1
03649118,14,5,9,0,2,1,1,2,1
03649149,10,4,6,0,4,1,3,2,0
03649535,54,0,54,0,1,1,0,1,1
03649653,59,0,59,0,0,0,0,0,1
03649669,21,5,16,0,0,0,0,0,1
03650083,5,2,3,0,1,1,0,0,0
03650129,13,5,8,0,2,1,1,0,1
03650220,52,6,46,0,0,0,0,0,1
03650238,32,5,27,0,1,1,0,1,1
03650333,2,2,0,0,1,1,0,0,0
03650457,25,3,22,0,1,1,0,1,1
03650459,26,3,23,0,1,1,0,1,1
03650647,4,0,4,0,0,0,0,0,0
03650686,23,2,21,0,1,1,0,0,1
03650688,17,3,14,0,0,0,0,0,1
03650692,23,0,23,0,1,1,0,1,1
03650739,7,0,7,0,2,2,0,0,1
03650877,3,1,2,0,1,1,0,0,1
03651122,15,5,10,0,0,0,0,0,1
03651213,21,5,16,0,0,0,0,0,1
03651655,4,1,3,0,2,2,0,0,0
03652059,31,2,29,0,1,1,0,1,1
03652559,43,13,30,0,0,0,0,0,1
03653506,40,10,30,0,0,0,0,0,1
03653606,29,3,26,0,3,1,2,3,1
03653626,18,9,9,0,1,1,0,0,1
03653995,21,2,19,0,2,2,0,0,1
03654271,73,0,73,0,0,0,0,0,1
03654576,33,6,27,0,3,2,1,0,1
03654675,45,3,42,0,1,1,0,1,1
03654887,10,4,6,0,1,1,0,0,1
03655012,7,2,5,0,1,1,0,0,0
03655014,19,4,15,0,3,3,0,0,1
03655220,33,0,33,0,0,0,0,0,1
03655231,23,2,21,0,1,1,0,1,1
03655247,15,2,13,0,0,0,0,0,1
03655704,27,8,19,0,1,1,0,1,1
03655815,15,2,13,0,1,1,0,1,1
03656746,13,4,9,0,0,0,0,0,1
03656798,30,6,24,0,1,1,0,1,1
03656832,16,3,13,0,1,1,0,1,1
03657767,23,4,19,0,1,1,0,1,1
03657811,5,1,4,0,1,1,0,0,0
03657921,4,2,2,0,1,1,0,0,0
03658022,20,3,17,0,1,1,0,0,1
03658165,23,5,18,0,0,0,0,0,1
03658378,53,10,43,0,0,0,0,0,1
03658619,9,0,9,0,0,0,0,0,1
03658772,40,17,23,0,1,1,0,0,1
03659361,52,11,41,0,0,0,0,0,1
03659692,13,5,8,0,1,1,0,1,1
03659707,5,1,4,0,1,1,0,0,1
03659957,6,2,4,0,2,2,0,0,0
03659970,32,8,24,0,1,1,0,1,1
03660222,28,0,28,0,1,1,0,1,1
03660475,6,3,3,0,0,0,0,0,0
03660903,41,6,35,0,0,0,0,0,1
03661446,32,9,23,0,1,1,0,0,1
03662414,47,0,47,0,0,0,0,0,1
03662515,19,1,18,0,0,0,0,0,1
03663181,62,12,50,0,0,0,0,0,1
03663182,12,0,12,0,0,0,0,0,1
03663454,11,0,11,0,0,0,0,0,1
03663563,31,3,28,0,1,1,0,1,1
03663661,41,7,34,0,0,0,0,0,0
03663818,3,3,0,0,2,2,0,0,0
03663823,52,11,41,0,1,1,0,0,0
03664008,63,9,54,0,0,0,0,0,1
03664488,10,0,10,0,0,0,0,0,1
03664571,57,11,46,0,1,1,0,1,1
03664614,31,4,27,0,3,1,2,3,1
03664881,11,0,11,0,0,0,0,0,1
03665545,9,4,5,0,4,4,0,0,1
03665770,34,2,32,0,1,1,0,1,1
03665797,15,6,9,0,0,0,0,0,1
03665803,9,3,6,0,2,2,0,0,1
03665996,46,7,39,0,1,1,0,0,1
03666198,7,0,7,0,1,1,0,0,1
03666242,9,3,6,0,2,2,0,0,1
03666347,19,0,19,0,0,0,0,0,1
03666441,15,3,12,0,1,1,0,1,1
03666449,13,0,13,0,1,1,0,1,1
03666799,9,3,6,0,1,1,0,0,1
03666981,11,2,9,0,0,0,0,0,1
03667015,6,3,3,0,1,1,0,1,1
03667290,48,9,39,0,0,0,0,0,1
03667408,19,0,19,0,0,0,0,0,0
03667688,13,0,13,0,0,0,0,0,1
03667753,46,4,42,0,1,1,0,1,1
03667800,25,3,22,0,1,1,0,1,1
03667927,10,3,7,0,2,2,0,0,1
03667930,7,2,5,0,1,1,0,1,1
03668014,4,0,4,0,0,0,0,0,1
03668521,7,4,3,0,1,1,0,0,0
03668663,27,6,21,0,1,1,0,1,1
03668828,70,7,63,0,2,1,1,2,1
03669086,10,2,8,0,1,1,0,0,1
03669198,13,3,10,0,1,1,0,1,0
03669269,11,4,7,0,1,1,0,0,1
03669676,19,0,19,0,1,0,1,0,0
03669744,7,2,5,0,1,1,0,1,1
03669957,9,3,6,0,0,0,0,0,0
03670081,6,0,6,0,0,0,0,0,1
03670360,11,6,5,0,4,3,1,0,1
03671093,27,6,21,0,1,1,0,1,1
03671207,13,0,13,0,0,0,0,0,1
03671215,7,3,4,0,2,2,0,0,1
03671286,7,0,7,0,1,1,0,0,1
03671320,15,2,13,0,1,1,0,1,1
03671447,10,4,6,0,1,1,0,0,1
03671688,13,0,13,0,0,0,0,0,1
03671867,15,0,15,0,0,0,0,0,1
03671925,7,0,7,0,1,1,0,0,0
03672268,7,4,3,0,1,1,0,0,1
03672291,15,4,11,0,2,1,1,0,1
03672399,23,7,16,0,0,0,0,0,1
03672924,34,6,28,0,1,1,0,1,1
03672926,19,0,19,0,1,1,0,1,1
03673168,32,10,22,0,0,0,0,0,0
03673220,21,0,21,0,0,0,0,0,1
03673223,8,5,3,0,1,1,0,0,0
03673852,5,3,2,0,2,2,0,0,1
03673978,28,7,21,0,1,1,0,0,1
03674453,15,2,13,0,1,1,0,1,1
03674534,6,4,2,0,2,2,0,0,0
03674691,8,3,5,0,2,2,0,0,1
03674827,27,5,22,0,2,2,0,2,1
03674842,23,4,19,0,1,1,0,1,1
03674956,10,1,9,0,1,1,0,1,1
03674960,6,0,6,0,0,0,0,0,1
03674979,35,1,34,0,1,1,0,1,1
03674999,25,7,18,0,0,0,0,0,1
03675048,5,3,2,0,2,2,0,0,0
03675362,22,9,13,0,1,1,0,0,1
03675676,25,1,24,0,2,2,0,1,1
03675755,10,0,10,0,0,0,0,0,1
03675858,4,3,1,0,1,1,0,0,1
03675994,4,3,1,0,1,1,0,0,1
03676533,9,0,9,0,0,0,0,0,1
03676547,6,0,6,0,0,0,0,0,1
03676780,20,0,20,0,0,0,0,0,1
03677048,9,3,6,0,1,1,0,1,1
03677186,83,10,73,0,2,1,1,0,1
03677276,10,4,6,0,1,1,0,1,1
03677311,33,4,29,0,1,1,0,1,1
03677627,28,5,23,0,1,1,0,1,1
03678507,48,7,41,0,1,1,0,1,1
03678984,14,2,12,0,2,2,0,0,1
03679085,11,3,8,0,1,1,0,1,1
03679187,10,4,6,0,0,0,0,0,0
03679198,6,3,3,0,1,1,0,0,0
03679270,6,2,4,0,1,1,0,0,0
03679284,24,10,14,0,2,2,0,2,1
03679296,55,12,43,0,1,1,0,1,1
03679711,14,2,12,0,0,0,0,0,1
03679758,7,4,3,0,4,4,0,1,1
03679828,53,4,49,0,1,1,0,1,1
03679951,6,3,3,0,2,2,0,0,1
