Company number,Total number of officers,Number of active officers,Number of inactive officers,Number of non-persons officers,Total number of person with significant control,Number of active persons with significant control,Number of ceased persons with significant control,Number of non-persons with significant control,Good/Bad
SC371916,8,5,3,0,1,1,0,1,1
SC371917,9,5,4,0,1,1,0,1,1
SC371918,8,5,3,0,1,1,0,1,1
SC372071,1,1,0,0,2,2,0,0,0
SC372199,35,14,21,0,0,0,0,0,1
SC372526,23,4,19,0,1,1,0,1,1
SC372837,17,4,13,1,1,1,0,1,1
SC373018,5,0,5,0,1,1,0,0,1
SC373086,5,1,4,0,0,0,0,0,0
SC373215,9,0,9,0,0,0,0,0,1
SC373332,5,2,3,0,1,1,0,0,0
SC373349,3,2,1,0,1,1,0,0,0
SC373389,4,1,3,0,2,1,1,1,1
SC373732,3,0,3,0,0,0,0,0,0
SC373801,4,2,2,0,1,1,0,0,0
SC373858,1,0,1,0,1,1,0,0,0
SC373907,2,0,2,0,0,0,0,0,0
SC373918,3,0,3,0,0,0,0,0,1
SC373921,7,0,7,0,1,1,0,0,1
SC373947,4,3,1,0,1,1,0,0,1
SC374255,15,6,9,0,0,0,0,0,0
SC374268,3,3,0,0,2,2,0,0,1
SC374486,4,4,0,0,0,0,0,0,0
SC374737,2,0,2,0,0,0,0,0,0
SC374789,3,2,1,0,1,1,0,0,1
SC374816,9,6,3,0,1,1,0,0,0
SC374873,5,0,5,0,0,0,0,0,1
SC374896,3,0,3,0,0,0,0,0,0
SC375022,2,1,1,0,1,1,0,0,0
SC375254,24,5,19,0,1,1,0,1,1
SC375277,11,0,11,0,1,1,0,1,1
SC375359,1,0,1,0,1,1,0,0,0
SC375395,6,4,2,4,1,1,0,0,0
SC375466,9,4,5,0,1,1,0,1,1
SC375774,2,2,0,0,1,1,0,0,1
SC375825,3,1,2,0,1,1,0,0,0
SC375856,32,9,23,0,0,0,0,0,0
SC375912,4,3,1,0,1,1,0,0,1
SC375940,6,2,4,0,1,1,0,0,0
SC375944,5,5,0,0,2,2,0,0,1
SC375957,5,0,5,0,0,0,0,0,1
SC375958,4,2,2,0,1,1,0,0,1
SC375961,4,3,1,0,2,2,0,0,1
SC375962,8,0,8,0,0,0,0,0,1
SC375963,12,0,12,0,2,1,1,2,1
SC376021,15,5,10,1,1,1,0,1,1
SC376269,6,3,3,0,1,1,0,0,1
SC376327,2,1,1,0,1,1,0,0,0
SC376707,32,5,27,0,1,0,1,0,1
SC376823,7,6,1,0,1,1,0,1,1
SC376824,4,0,4,0,0,0,0,0,1
SC376901,2,0,2,0,0,0,0,0,0
SC376945,5,0,5,0,0,0,0,0,1
SC377149,25,5,20,0,0,0,0,0,1
SC377176,4,0,4,0,0,0,0,0,0
SC377236,8,5,3,0,0,0,0,0,0
SC377377,30,8,22,0,0,0,0,0,0
SC377447,2,0,2,0,0,0,0,0,0
SC377654,2,1,1,0,1,1,0,0,0
SC377982,2,2,0,0,2,2,0,0,0
SC378037,2,2,0,0,2,2,0,0,0
SC378444,6,4,2,0,2,1,1,1,1
SC378650,3,2,1,0,2,2,0,0,0
SC378733,4,2,2,0,3,3,0,1,1
SC378968,5,0,5,0,0,0,0,0,1
SC378969,3,1,2,0,1,1,0,0,1
SC378970,3,1,2,0,1,1,0,0,1
SC379005,4,0,4,0,0,0,0,0,1
SC379141,10,7,3,0,0,0,0,0,0
SC379263,2,0,2,0,0,0,0,0,1
SC379264,2,1,1,0,1,1,0,0,1
SC379266,4,2,2,0,4,4,0,0,1
SC379584,4,2,2,0,3,1,2,1,1
SC379628,6,3,3,0,2,2,0,0,0
SC379713,2,1,1,0,1,1,0,0,0
SC379870,3,3,0,0,2,2,0,0,0
SC380133,9,0,9,0,0,0,0,0,0
SC380297,9,7,2,0,0,0,0,0,1
SC380533,7,5,2,0,0,0,0,0,1
SC380577,11,7,4,0,1,1,0,1,1
SC380596,3,3,0,0,1,1,0,0,1
SC380626,8,7,1,0,0,0,0,0,0
SC380708,11,4,7,1,1,1,0,1,0
SC381012,2,2,0,0,2,2,0,0,0
SC381034,4,2,2,0,1,1,0,0,0
SC381243,8,5,3,0,3,3,0,0,1
SC381446,3,3,0,0,2,2,0,0,0
SC381447,1,0,1,0,0,0,0,0,0
SC381553,3,0,3,1,0,0,0,0,1
SC381634,5,0,5,0,1,1,0,0,0
SC381737,30,5,25,0,0,0,0,0,1
SC382011,25,8,17,0,1,1,0,1,1
SC382314,3,3,0,0,2,2,0,0,0
SC382535,5,1,4,0,1,1,0,0,1
SC382573,8,5,3,0,1,1,0,1,1
SC382635,5,2,3,0,2,2,0,0,1
SC382636,3,1,2,0,2,2,0,0,1
SC382699,3,1,2,0,1,1,0,0,1
SC382702,3,1,2,0,1,1,0,0,1
SC382739,3,3,0,1,1,1,0,1,1
SC382883,5,1,4,0,1,1,0,0,0
SC382934,7,3,4,0,3,1,2,1,1
SC383178,3,2,1,0,1,1,0,0,0
SC383232,7,0,7,0,2,2,0,1,1
SC383233,9,4,5,0,1,1,0,0,1
SC383269,7,6,1,0,2,2,0,1,1
SC383455,18,5,13,1,1,1,0,1,1
SC383473,2,0,2,0,0,0,0,0,0
SC383500,13,2,11,0,1,1,0,1,1
SC383530,1,1,0,0,1,1,0,0,0
SC383673,2,0,2,0,0,0,0,0,0
SC383728,5,2,3,0,1,1,0,1,0
SC384458,2,0,2,0,0,0,0,0,0
SC384619,18,7,11,0,0,0,0,0,1
SC384652,3,2,1,0,1,1,0,0,0
SC384777,4,3,1,0,1,1,0,1,1
SC384884,3,0,3,0,0,0,0,0,0
SC385156,1,0,1,0,0,0,0,0,0
SC385506,3,0,3,0,1,1,0,1,1
SC385667,2,2,0,0,2,2,0,0,0
SC385905,4,2,2,0,1,1,0,1,1
SC385984,3,0,3,0,0,0,0,0,1
SC385985,3,0,3,0,0,0,0,0,1
SC386419,3,1,2,0,3,1,2,0,0
SC386506,5,3,2,0,1,1,0,0,0
SC386842,6,0,6,0,0,0,0,0,1
SC386922,18,9,9,0,0,0,0,0,1
SC386978,6,5,1,0,1,1,0,0,0
SC386987,3,1,2,0,1,1,0,0,0
SC387207,17,9,8,0,0,0,0,0,1
SC387208,12,7,5,0,0,0,0,0,0
SC387359,11,0,11,0,0,0,0,0,1
SC387374,14,3,11,0,2,1,1,1,1
SC387377,15,3,12,0,2,1,1,1,1
SC387575,7,4,3,1,3,3,0,1,1
SC387672,27,9,18,0,2,2,0,2,1
SC387740,12,2,10,0,3,1,2,1,1
SC387762,2,0,2,0,0,0,0,0,0
SC387903,13,4,9,0,0,0,0,0,1
SC387906,2,0,2,0,1,1,0,0,1
SC387944,18,12,6,0,1,1,0,0,0
SC387959,4,0,4,0,1,1,0,0,1
SC388092,4,2,2,1,1,1,0,1,1
SC388110,17,11,6,0,0,0,0,0,1
SC388204,4,0,4,0,1,1,0,0,1
SC388407,4,0,4,0,0,0,0,0,1
SC388413,1,0,1,0,0,0,0,0,0
SC388762,2,2,0,0,2,2,0,0,0
00650164,25,3,22,0,1,1,0,1,1
00650363,18,0,18,0,1,1,0,1,1
00650386,3,3,0,0,0,0,0,0,0
00650598,14,0,14,0,0,0,0,0,1
00650900,6,3,3,0,2,2,0,0,1
00650937,22,7,15,0,1,1,0,1,1
00650979,27,6,21,0,0,0,0,0,1
00651198,20,3,17,0,1,1,0,1,1
00651376,58,3,55,0,0,0,0,0,1
00651422,34,8,26,0,2,1,1,2,1
00651587,5,0,5,0,0,0,0,0,0
00651692,33,6,27,0,1,1,0,1,1
00652819,37,5,32,0,1,1,0,1,1
00652955,16,0,16,0,0,0,0,0,1
00653171,24,5,19,0,0,0,0,0,1
00653323,32,0,32,0,1,1,0,1,1
00653331,45,6,39,0,1,1,0,1,1
00653366,22,3,19,0,1,1,0,1,1
00653423,11,0,11,0,0,0,0,0,1
00653500,19,4,15,0,1,1,0,1,1
00653663,27,6,21,0,0,0,0,0,1
00654053,6,0,6,0,0,0,0,0,1
00654131,29,5,24,0,1,1,0,1,1
00654265,31,3,28,0,0,0,0,0,1
00654302,8,3,5,0,2,2,0,0,1
00654564,28,2,26,0,1,1,0,1,1
00654622,41,4,37,0,2,2,0,0,1
00655044,22,2,20,0,1,1,0,1,1
00655156,4,3,1,0,2,2,0,0,0
00655436,25,2,23,0,1,1,0,1,1
00655647,24,3,21,0,1,1,0,1,0
00655990,6,3,3,0,1,1,0,0,0
00656393,13,6,7,0,1,1,0,1,1
00657176,27,0,27,0,1,1,0,1,1
00657359,13,0,13,0,0,0,0,0,0
00658133,31,5,26,0,1,1,0,1,1
00658155,24,4,20,0,1,1,0,1,1
00658166,40,3,37,0,1,1,0,1,1
00658368,36,3,33,0,0,0,0,0,1
00658433,4,0,4,0,1,1,0,0,0
00658516,13,0,13,0,0,0,0,0,1
00658819,13,4,9,0,1,1,0,1,0
00658826,15,0,15,0,0,0,0,0,1
00658907,43,4,39,0,1,1,0,1,1
00658997,3,3,0,0,2,2,0,0,1
00659028,10,7,3,0,1,1,0,1,1
00660541,17,2,15,0,1,1,0,1,1
00661133,31,3,28,0,1,1,0,1,1
00661742,23,0,23,0,0,0,0,0,1
00661747,13,4,9,0,1,1,0,1,1
00662127,5,2,3,0,2,2,0,0,0
00662195,7,4,3,0,2,2,0,0,0
00662374,58,11,47,0,0,0,0,0,1
00662696,11,2,9,0,1,1,0,1,1
00662712,87,14,73,0,0,0,0,0,1
00663029,28,0,28,0,0,0,0,0,1
00663227,13,0,13,0,0,0,0,0,1
00663372,42,0,42,0,0,0,0,0,1
00664118,33,11,22,0,0,0,0,0,1
00664261,8,4,4,0,1,1,0,0,0
00664466,8,6,2,0,1,1,0,0,1
00664578,22,4,18,0,0,0,0,0,1
00664602,15,3,12,0,0,0,0,0,0
00664611,33,4,29,0,1,1,0,1,1
00664749,33,13,20,0,0,0,0,0,0
00664862,32,6,26,0,1,1,0,1,1
00665102,41,6,35,0,0,0,0,0,1
00665434,12,3,9,0,1,1,0,1,1
00665667,13,1,12,0,0,0,0,0,1
00666457,7,5,2,0,5,4,1,0,0
00666652,13,3,10,0,1,1,0,1,1
00667002,8,4,4,0,2,2,0,0,1
00667041,3,2,1,0,1,1,0,0,0
00667817,57,14,43,0,0,0,0,0,1
00667980,38,6,32,0,1,1,0,1,1
00668238,20,4,16,0,2,2,0,2,1
00668339,41,0,41,0,0,0,0,0,1
00668388,20,2,18,0,1,1,0,1,1
00668972,21,3,18,0,1,1,0,1,1
00668982,4,2,2,0,1,1,0,0,0
00669613,46,11,35,0,0,0,0,0,0
00669986,13,2,11,0,1,1,0,1,1
00670130,40,6,34,0,1,1,0,1,1
00670251,76,3,73,0,1,1,0,1,1
00671099,18,8,10,0,0,0,0,0,1
00671321,36,0,36,0,1,1,0,1,1
00671778,4,2,2,0,3,3,0,0,0
00672059,30,4,26,0,0,0,0,0,0
00672085,14,10,4,0,0,0,0,0,1
00672275,13,4,9,0,1,1,0,1,1
00672435,14,3,11,0,0,0,0,0,1
00672569,47,7,40,0,0,0,0,0,1
00672696,6,3,3,0,1,1,0,0,0
00672908,27,5,22,0,1,1,0,1,1
00672930,9,4,5,0,1,1,0,0,1
00672988,15,0,15,0,0,0,0,0,0
00673274,28,0,28,0,0,0,0,0,1
00673557,7,3,4,0,1,1,0,1,0
00673822,13,5,8,0,1,1,0,0,1
00674597,11,3,8,0,1,1,0,1,1
00674678,29,4,25,0,1,1,0,1,1
00674686,5,2,3,0,1,1,0,0,1
00674709,33,0,33,0,1,1,0,1,1
00674872,7,4,3,0,1,1,0,0,0
00675001,27,4,23,0,1,1,0,1,1
00675195,19,7,12,0,1,1,0,1,1
00675211,16,3,13,0,1,1,0,1,1
00675355,19,3,16,0,1,1,0,1,1
00675386,27,0,27,0,0,0,0,0,1
00675586,26,6,20,0,0,0,0,0,0
00676121,20,3,17,0,1,1,0,1,1
00676139,64,2,62,0,1,1,0,1,1
00676207,3,2,1,0,2,2,0,0,0
00676373,5,3,2,0,1,0,1,0,1
00677457,35,6,29,0,0,0,0,0,0
00677665,58,8,50,0,1,1,0,1,1
00677799,37,4,33,0,0,0,0,0,1
00677971,35,3,32,0,1,1,0,1,1
00678077,50,13,37,0,0,0,0,0,1
00678294,35,4,31,0,1,1,0,1,1
00678565,37,10,27,0,0,0,0,0,1
00678777,35,5,30,0,1,1,0,1,1
00678786,24,0,24,0,0,0,0,0,1
00679647,23,5,18,0,1,1,0,1,1
00679749,36,0,36,0,0,0,0,0,1
00679960,96,9,87,0,0,0,0,0,1
00680313,27,3,24,0,1,1,0,1,1
00680345,5,4,1,0,2,2,0,0,0
00680907,29,0,29,0,0,0,0,0,1
00680973,10,3,7,0,1,1,0,1,1
00681231,20,4,16,0,1,1,0,1,1
00681534,12,3,9,0,1,1,0,1,1
00681535,10,3,7,0,1,1,0,1,1
00681537,25,7,18,0,1,1,0,1,1
00681880,77,15,62,0,0,0,0,0,1
00683275,63,12,51,0,0,0,0,0,1
00683359,31,13,18,0,0,0,0,0,1
00683361,21,5,16,0,1,1,0,1,1
00683698,20,3,17,0,1,1,0,1,1
00683702,36,5,31,0,1,1,0,1,1
00683947,34,0,34,0,0,0,0,0,1
00683948,21,0,21,0,0,0,0,0,1
00684145,8,4,4,0,1,1,0,0,0
00684800,43,4,39,0,2,2,0,2,1
00685558,25,4,21,0,1,1,0,1,1
00685718,34,5,29,0,1,1,0,1,1
00685732,8,3,5,0,1,1,0,1,0
00686707,47,8,39,0,0,0,0,0,1
00687121,8,3,5,0,4,1,3,1,0
00687995,23,0,23,0,0,0,0,0,1
00688041,23,3,20,0,1,1,0,1,1
00688587,20,14,6,0,1,1,0,1,1
00688602,16,0,16,0,0,0,0,0,1
00688773,10,2,8,0,1,1,0,1,1
00688832,18,5,13,0,0,0,0,0,1
00689260,35,6,29,0,1,1,0,1,1
00689388,8,0,8,0,1,1,0,1,1
00689578,10,0,10,0,0,0,0,0,1
00689729,53,6,47,0,1,1,0,1,1
00690089,21,3,18,0,2,2,0,2,1
00690236,32,4,28,0,1,1,0,1,1
00690838,5,2,3,0,2,2,0,0,0
00691252,57,4,53,0,1,1,0,1,1
00691259,5,3,2,0,2,2,0,0,0
00691499,12,3,9,0,1,1,0,1,1
00691599,8,3,5,0,2,2,0,0,0
00692380,19,0,19,0,0,0,0,0,1
00692660,7,3,4,0,2,2,0,0,0
00692780,9,3,6,0,1,1,0,0,1
00692978,6,2,4,0,1,1,0,0,1
00693119,12,2,10,1,0,0,0,0,0
00693374,18,5,13,0,4,0,4,0,1
00693662,5,4,1,0,2,2,0,0,0
00694642,6,4,2,0,0,0,0,0,0
00694736,16,4,12,0,1,1,0,1,1
00694894,13,3,10,0,1,1,0,0,0
00695530,46,0,46,0,0,0,0,0,1
00696057,28,2,26,0,1,1,0,1,1
00696578,5,4,1,0,1,1,0,0,0
00696612,15,3,12,0,3,1,2,1,1
00696919,35,0,35,0,0,0,0,0,1
00697109,9,3,6,0,1,1,0,1,1
00697311,4,2,2,0,1,1,0,0,0
00697348,37,7,30,0,0,0,0,0,0
00697555,7,4,3,0,2,2,0,0,1
00697641,28,10,18,0,1,1,0,1,1
00697738,29,0,29,0,0,0,0,0,1
00697744,48,0,48,0,0,0,0,0,1
00698174,29,0,29,0,0,0,0,0,1
00698840,17,5,12,0,1,1,0,1,1
00698851,74,9,65,0,0,0,0,0,1
00699314,23,4,19,0,1,1,0,1,1
00699316,20,0,20,0,0,0,0,0,1
00699324,8,4,4,0,1,1,0,0,1
00699334,7,4,3,0,1,1,0,0,1
00699547,122,14,108,0,0,0,0,0,1
00699601,38,4,34,0,0,0,0,0,1
00699663,21,3,18,0,1,1,0,1,1
00700132,76,9,67,0,0,0,0,0,1
00700184,34,3,31,0,0,0,0,0,1
00700188,41,6,35,0,1,1,0,1,1
00700758,13,2,11,0,1,1,0,1,1
00700925,15,3,12,0,1,1,0,1,1
00700950,8,4,4,0,1,1,0,0,1
00701279,34,0,34,0,0,0,0,0,1
00701756,9,2,7,0,1,1,0,1,1
00701841,39,0,39,0,0,0,0,0,1
00702484,57,9,48,0,0,0,0,0,1
00702539,6,4,2,0,2,2,0,0,0
00702844,25,0,25,0,0,0,0,0,1
00702983,48,7,41,0,0,0,0,0,1
00703021,14,5,9,0,3,3,0,0,0
00703170,59,18,41,0,0,0,0,0,1
00703317,72,8,64,0,1,1,0,1,1
00703348,15,2,13,0,1,1,0,1,0
00703741,45,0,45,0,0,0,0,0,1
00703883,19,0,19,0,0,0,0,0,1
00703962,20,5,15,0,0,0,0,0,1
00704320,50,8,42,0,1,1,0,1,1
00704322,32,2,30,0,1,1,0,1,1
00705101,26,4,22,0,1,1,0,1,1
00705211,10,2,8,0,1,1,0,1,1
00705341,4,0,4,0,0,0,0,0,1
00705357,108,12,96,0,0,0,0,0,1
00705424,6,3,3,0,1,1,0,0,0
00705627,10,5,5,0,4,4,0,0,1
00705760,8,0,8,0,2,2,0,0,0
00706042,29,10,19,0,1,1,0,1,1
00706083,31,5,26,0,2,1,1,2,1
00706295,19,4,15,0,2,2,0,2,0
00706445,15,8,7,0,1,1,0,0,1
00706607,17,4,13,0,1,1,0,1,1
00706645,62,7,55,0,1,1,0,1,1
00706704,22,3,19,0,0,0,0,0,1
00706831,47,7,40,0,1,1,0,1,1
00707069,14,0,14,0,0,0,0,0,1
00707180,57,14,43,0,0,0,0,0,1
00707300,53,6,47,0,0,0,0,0,1
00707312,34,9,25,0,0,0,0,0,1
00707708,26,4,22,0,0,0,0,0,1
00707749,33,3,30,0,0,0,0,0,1
00707869,11,5,6,0,0,0,0,0,1
00708968,13,4,9,0,1,1,0,1,1
00709093,26,5,21,0,1,1,0,1,1
00709159,49,14,35,0,0,0,0,0,1
00709915,17,5,12,0,1,1,0,1,1
00709961,20,4,16,0,1,1,0,1,1
00710004,7,2,5,0,4,4,0,0,1
00710112,40,3,37,0,3,2,1,0,1
00710157,9,3,6,0,2,1,1,2,1
00710582,38,3,35,0,0,0,0,0,1
00710603,30,3,27,0,2,1,1,2,0
00710860,26,3,23,0,1,1,0,1,1
00711047,25,3,22,0,1,1,0,1,1
00711835,28,2,26,0,1,1,0,1,1
00711851,43,5,38,0,1,1,0,1,1
00711914,4,4,0,0,3,3,0,0,0
00712006,20,2,18,0,0,0,0,0,1
00712260,116,11,105,0,8,0,8,0,1
00712286,43,6,37,0,2,1,1,0,1
00712425,34,7,27,0,0,0,0,0,0
00712444,60,12,48,0,0,0,0,0,1
00712789,0,0,0,0,0,0,0,0,0
00713188,6,1,5,0,1,1,0,0,1
00713225,25,2,23,0,1,1,0,1,1
00713226,34,5,29,0,1,1,0,1,1
00713227,20,3,17,0,1,1,0,1,1
00713317,16,0,16,0,0,0,0,0,1
00713374,16,0,16,0,0,0,0,0,1
00713414,11,4,7,0,1,1,0,1,1
00714070,161,3,158,0,1,1,0,1,1
00714804,31,4,27,0,1,1,0,1,1
00715189,33,2,31,0,3,1,2,3,1
00715338,30,0,30,0,0,0,0,0,1
00715599,22,5,17,0,0,0,0,0,1
00716004,14,3,11,0,1,1,0,1,1
00716035,68,10,58,0,0,0,0,0,1
00716105,11,3,8,0,3,3,0,1,1
00716304,34,5,29,0,1,1,0,1,1
00716615,35,11,24,0,0,0,0,0,0
00716839,27,0,27,0,0,0,0,0,1
00716923,15,5,10,0,1,1,0,1,1
00717344,13,4,9,0,1,1,0,1,1
00717446,41,3,38,0,4,1,3,1,1
00718074,16,4,12,0,0,0,0,0,0
00718149,29,3,26,0,1,1,0,1,1
00718151,40,7,33,0,1,1,0,1,1
00718329,23,3,20,0,1,1,0,1,1
00718351,19,3,16,0,1,1,0,1,1
00718623,10,6,4,0,0,0,0,0,1
00718772,18,4,14,0,1,1,0,1,1
00718823,31,9,22,0,0,0,0,0,0
00718903,41,3,38,0,1,1,0,1,1
00719501,18,2,16,0,1,1,0,1,1
00719504,130,16,114,0,0,0,0,0,1
00719804,40,3,37,0,1,1,0,1,1
00719885,75,11,64,0,0,0,0,0,1
00720249,20,0,20,0,1,1,0,0,1
00720550,31,4,27,0,1,1,0,1,1
00720669,18,5,13,0,1,1,0,1,1
00720918,31,3,28,0,1,1,0,1,1
00720976,27,5,22,0,1,1,0,1,0
00720989,11,3,8,0,1,1,0,1,1
00721107,22,0,22,0,0,0,0,0,1
00722043,41,3,38,0,1,1,0,1,1
00722071,98,0,98,0,0,0,0,0,1
00722466,16,5,11,0,1,1,0,1,1
00722626,8,4,4,0,3,3,0,1,0
00722836,19,0,19,0,0,0,0,0,1
00723084,13,9,4,0,1,1,0,1,1
00723154,6,4,2,0,2,2,0,0,0
00723336,25,5,20,0,1,1,0,1,1
00723627,8,4,4,0,3,3,0,0,1
00724030,15,3,12,0,3,2,1,0,1
00724133,111,11,100,0,0,0,0,0,1
00724451,24,5,19,0,2,1,1,2,1
00724689,27,0,27,0,1,1,0,1,1
00724728,54,5,49,0,1,1,0,1,0
00724811,60,15,45,0,1,0,1,0,1
00724907,18,8,10,0,1,1,0,0,0
00724999,5,2,3,0,1,1,0,0,0
00725052,15,0,15,0,0,0,0,0,1
00725238,32,8,24,0,0,0,0,0,0
00725548,23,2,21,0,1,1,0,1,1
00726022,0,0,0,0,0,0,0,0,1
00726677,15,4,11,0,3,3,0,0,0
00726897,12,3,9,0,1,1,0,1,1
00727476,18,7,11,0,0,0,0,0,1
00727600,10,0,10,0,0,0,0,0,1
00727817,38,4,34,0,1,1,0,1,1
00728246,33,2,31,0,1,1,0,1,1
00728391,26,11,15,0,0,0,0,0,1
00728502,61,9,52,0,1,1,0,1,1
00729279,12,4,8,0,1,1,0,1,1
00729751,23,0,23,0,0,0,0,0,1
00730144,13,0,13,0,0,0,0,0,1
00730286,23,3,20,0,1,1,0,1,1
00730446,38,5,33,0,0,0,0,0,0
00730466,55,0,55,0,0,0,0,0,1
00730467,37,0,37,0,0,0,0,0,1
00730536,81,11,70,0,1,1,0,0,1
00730539,5,3,2,0,5,5,0,0,1
00730711,19,2,17,0,0,0,0,0,0
00731132,92,16,76,0,0,0,0,0,1
00731249,19,6,13,0,0,0,0,0,0
00731549,15,4,11,0,1,0,1,0,1
00732250,23,3,20,0,1,1,0,0,1
00732588,3,3,0,0,2,2,0,0,0
00732602,44,6,38,0,1,1,0,1,1
00732757,33,3,30,0,0,0,0,0,1
00732993,34,5,29,0,1,1,0,1,1
00733377,8,7,1,0,0,0,0,0,0
00733387,16,0,16,0,0,0,0,0,1
00733425,21,5,16,0,0,0,0,0,1
00733443,17,4,13,0,1,1,0,1,1
00733498,23,4,19,0,1,1,0,1,1
00733503,64,5,59,0,1,1,0,1,1
00734015,23,1,22,0,0,0,0,0,0
00734351,0,0,0,0,0,0,0,0,0
00734396,32,4,28,0,2,2,0,2,1
00734421,43,9,34,0,2,1,1,2,1
00735040,85,12,73,0,0,0,0,0,1
00735270,22,0,22,0,0,0,0,0,1
00735760,3,3,0,0,1,1,0,0,0
00735868,37,5,32,0,1,1,0,1,1
00736475,0,0,0,0,0,0,0,0,0
00736698,26,0,26,0,1,1,0,1,1
00736905,13,4,9,0,1,1,0,1,1
00737328,7,3,4,0,2,2,0,0,1
00737366,49,5,44,0,1,1,0,1,1
00737501,16,3,13,0,0,0,0,0,0
00737993,106,2,104,0,0,0,0,0,1
00738089,64,11,53,0,0,0,0,0,1
00738358,0,0,0,0,0,0,0,0,0
00738473,20,4,16,0,1,1,0,1,1
00738674,45,3,42,0,0,0,0,0,1
00738693,86,13,73,0,15,13,2,0,1
00739057,6,1,5,0,2,1,1,1,1
00739136,8,6,2,0,1,1,0,0,0
00739180,34,3,31,0,1,1,0,1,1
00739476,8,3,5,0,2,2,0,0,1
02274227,31,10,21,0,1,1,0,1,1
02274693,13,4,9,0,1,1,0,1,1
02274855,123,6,117,0,3,3,0,0,1
02274887,19,3,16,0,1,1,0,1,1
02274964,52,0,52,0,1,1,0,0,1
02275006,31,2,29,0,1,1,0,1,1
02275144,32,9,23,0,0,0,0,0,0
02275265,27,5,22,0,1,1,0,1,1
02275441,21,4,17,0,1,1,0,0,1
02275676,79,9,70,0,1,1,0,0,0
02275780,45,2,43,0,4,2,2,0,1
02276208,90,9,81,0,0,0,0,0,0
02276358,27,3,24,0,2,2,0,2,1
02276597,12,0,12,0,0,0,0,0,1
02276707,13,0,13,0,1,1,0,1,1
02276727,24,1,23,0,2,2,0,0,1
02276839,14,2,12,0,1,1,0,1,1
02276950,10,0,10,0,0,0,0,0,1
02277006,62,10,52,0,0,0,0,0,1
02277097,19,4,15,0,1,1,0,1,1
02277210,21,5,16,0,1,1,0,0,1
02277333,18,3,15,0,1,1,0,1,1
02277689,6,5,1,0,1,1,0,0,0
02277771,31,0,31,0,0,0,0,0,1
02278164,4,3,1,0,2,2,0,0,1
02278223,44,13,31,0,0,0,0,0,0
02278272,17,3,14,0,0,0,0,0,1
02278524,10,5,5,0,0,0,0,0,1
02278852,24,1,23,0,2,1,1,1,1
02278988,6,2,4,0,0,0,0,0,0
02279167,41,4,37,0,1,1,0,1,1
02279557,19,5,14,0,0,0,0,0,1
02279591,79,3,76,0,1,1,0,1,1
02279606,3,3,0,0,2,2,0,0,0
02280000,57,8,49,0,2,2,0,2,1
02280025,83,7,76,0,0,0,0,0,1
02280277,58,13,45,0,0,0,0,0,1
02280541,8,0,8,0,0,0,0,0,1
02280630,8,2,6,0,2,1,1,1,1
02280743,16,3,13,0,1,1,0,1,1
02280893,114,14,100,0,0,0,0,0,1
02280991,46,13,33,0,0,0,0,0,1
02281402,12,3,9,0,1,1,0,1,1
02281640,24,7,17,0,0,0,0,0,1
02282021,38,4,34,0,1,1,0,1,1
02282283,9,0,9,0,0,0,0,0,1
02282693,25,3,22,0,1,1,0,1,1
02282965,12,0,12,0,0,0,0,0,1
02283200,2,2,0,0,2,2,0,0,0
02283381,24,2,22,0,1,1,0,1,1
02283418,36,4,32,0,1,1,0,1,1
02283443,20,0,20,0,1,1,0,1,1
02283668,23,2,21,0,1,1,0,1,1
02283697,22,3,19,0,1,1,0,1,1
02283837,5,0,5,0,0,0,0,0,1
02283985,24,4,20,0,0,0,0,0,1
02284019,19,3,16,0,2,2,0,2,1
02284215,28,0,28,0,0,0,0,0,1
02284295,33,5,28,0,0,0,0,0,1
02284303,22,3,19,0,1,1,0,1,1
02284339,29,0,29,0,0,0,0,0,1
02284499,136,0,136,0,1,1,0,1,1
02285121,30,4,26,0,0,0,0,0,1
02285497,29,5,24,0,1,1,0,1,1
02285524,30,4,26,0,1,1,0,1,1
02285556,17,4,13,0,1,1,0,1,1
02285847,31,4,27,0,1,1,0,0,1
02285865,11,5,6,0,1,1,0,0,0
02286034,41,7,34,0,0,0,0,0,1
02286149,22,3,19,0,1,1,0,1,1
02286167,16,10,6,0,0,0,0,0,0
02286338,26,0,26,0,0,0,0,0,1
02287319,9,2,7,0,4,3,1,1,0
02287654,28,0,28,0,0,0,0,0,1
02287862,35,3,32,0,1,1,0,1,1
02288093,52,7,45,0,0,0,0,0,1
02288118,7,0,7,0,0,0,0,0,0
02288142,23,4,19,0,0,0,0,0,1
02288239,78,9,69,0,1,1,0,0,1
02288330,24,4,20,0,0,0,0,0,1
02288607,61,14,47,0,4,2,2,0,1
02289176,17,5,12,0,1,1,0,1,1
02289261,23,2,21,0,2,1,1,0,0
02289507,23,3,20,0,0,0,0,0,1
02289932,12,4,8,0,3,3,0,0,0
02290200,39,10,29,0,1,1,0,0,1
02290281,12,0,12,0,1,1,0,0,1
02290400,26,0,26,0,0,0,0,0,1
02290487,34,0,34,0,0,0,0,0,1
02290692,14,5,9,0,0,0,0,0,1
02290856,44,2,42,0,1,1,0,1,1
02291198,38,4,34,0,1,1,0,1,1
02291641,46,0,46,0,0,0,0,0,1
02291753,69,4,65,0,1,1,0,1,1
02291970,12,5,7,0,1,1,0,1,1
02292048,10,3,7,0,1,1,0,1,1
02292440,0,0,0,0,0,0,0,0,1
02292795,41,4,37,0,0,0,0,0,1
02293123,27,0,27,0,0,0,0,0,0
02293376,3,0,3,0,0,0,0,0,0
02293764,19,3,16,0,2,2,0,0,1
02293962,18,3,15,0,1,1,0,1,0
02294089,40,11,29,0,0,0,0,0,1
02294562,25,4,21,0,0,0,0,0,1
02294747,94,14,80,0,1,1,0,1,1
02294777,8,4,4,0,0,0,0,0,1
02294905,16,2,14,0,1,1,0,1,1
02294926,16,4,12,0,0,0,0,0,1
02294980,42,5,37,0,1,0,1,1,1
02295119,50,4,46,0,1,1,0,1,0
02295226,17,5,12,0,0,0,0,0,1
02295416,13,3,10,0,1,1,0,0,1
02295801,10,2,8,0,1,1,0,1,1
02295886,16,5,11,0,3,2,1,0,1
02295890,12,2,10,0,2,1,1,2,1
02295965,22,5,17,0,2,1,1,0,0
02296071,10,3,7,0,1,1,0,1,1
02296144,40,0,40,0,0,0,0,0,1
02296250,42,9,33,0,0,0,0,0,1
02296329,42,7,35,0,0,0,0,0,1
02296476,23,10,13,0,1,1,0,1,1
02296559,24,5,19,0,2,2,0,0,1
02296645,28,6,22,0,1,1,0,1,1
02297269,14,0,14,0,0,0,0,0,1
02297679,8,0,8,0,0,0,0,0,1
02298021,25,0,25,0,1,1,0,1,1
02298197,13,5,8,0,1,1,0,0,1
02298338,6,0,6,0,0,0,0,0,1
02298749,3,0,3,0,0,0,0,0,1
02299189,25,5,20,0,6,6,0,0,1
02299428,50,3,47,0,1,1,0,1,0
02299747,52,7,45,0,1,1,0,1,1
02299788,22,0,22,0,0,0,0,0,1
02299800,14,4,10,0,0,0,0,0,0
02299975,25,0,25,0,0,0,0,0,1
02300182,15,2,13,0,0,0,0,0,1
02300516,26,0,26,0,0,0,0,0,1
02300676,28,0,28,0,0,0,0,0,1
02300692,48,3,45,0,1,1,0,1,1
02300741,41,0,41,0,0,0,0,0,1
02300862,40,5,35,0,1,0,1,1,1
02300985,15,2,13,0,1,1,0,1,1
02301272,30,3,27,0,2,1,1,2,1
02301292,11,3,8,0,2,1,1,1,1
02301423,30,6,24,0,1,1,0,1,1
02301452,83,10,73,0,1,0,1,0,1
02301779,20,3,17,0,2,2,0,2,1
02301810,42,10,32,0,1,1,0,1,1
02302373,55,15,40,0,0,0,0,0,1
02303094,12,6,6,0,1,1,0,1,1
02303103,12,3,9,0,1,1,0,1,1
02303173,21,1,20,0,1,1,0,1,1
02303464,63,9,54,0,3,2,1,0,1
02303579,1,0,1,0,0,0,0,0,1
02303656,12,5,7,0,2,1,1,2,1
02303666,29,4,25,0,2,1,1,2,1
02303980,3,3,0,0,2,2,0,0,1
02304039,21,0,21,0,0,0,0,0,1
02304195,31,8,23,0,0,0,0,0,1
02304198,34,0,34,0,0,0,0,0,1
02304253,23,6,17,0,0,0,0,0,1
02304681,6,3,3,0,1,1,0,0,1
02304755,39,7,32,0,1,1,0,1,1
02304992,57,4,53,0,3,1,2,3,1
02305096,31,4,27,0,0,0,0,0,1
02305098,22,0,22,0,0,0,0,0,1
02305249,5,3,2,0,2,2,0,0,0
02306113,49,6,43,0,1,1,0,1,1
02306349,25,0,25,0,0,0,0,0,1
02306732,21,0,21,0,0,0,0,0,1
02306906,32,5,27,0,2,2,0,2,1
02306954,7,3,4,0,1,1,0,0,0
02307096,30,3,27,0,2,2,0,2,1
02307211,31,4,27,0,1,1,0,1,1
02307220,20,4,16,0,1,1,0,1,1
02307296,11,3,8,0,1,1,0,0,1
02307319,7,3,4,0,0,0,0,0,0
02307330,53,14,39,0,0,0,0,0,1
02307341,8,3,5,0,2,1,1,1,1
02307374,50,5,45,0,1,1,0,1,1
02307455,21,3,18,0,1,1,0,1,1
02307505,3,3,0,0,1,1,0,0,0
02307571,19,3,16,0,0,0,0,0,1
02308101,54,13,41,0,1,1,0,0,1
02308265,52,0,52,0,0,0,0,0,1
02308269,27,6,21,0,0,0,0,0,1
02308463,29,5,24,0,0,0,0,0,1
02309360,39,4,35,0,0,0,0,0,1
02309374,11,3,8,0,2,2,0,0,1
02309407,15,5,10,0,1,1,0,1,1
02310557,23,3,20,0,0,0,0,0,0
02310560,68,0,68,0,0,0,0,0,1
02310571,27,5,22,0,1,1,0,1,1
02310614,18,4,14,0,1,1,0,1,1
02310981,33,4,29,0,1,1,0,1,1
02311359,13,1,12,0,3,3,0,3,0
02311588,26,1,25,0,1,1,0,1,1
02311621,10,3,7,0,1,1,0,1,1
02311721,22,3,19,0,1,1,0,1,1
02311781,11,0,11,0,0,0,0,0,1
02311843,11,4,7,0,1,1,0,1,1
02311977,19,5,14,0,1,1,0,1,1
02312079,255,9,246,0,1,1,0,1,1
02312304,7,3,4,0,0,0,0,0,0
02312426,66,0,66,0,0,0,0,0,1
02312569,37,10,27,0,1,1,0,0,1
02313902,33,7,26,0,0,0,0,0,1
02314002,4,2,2,0,0,0,0,0,0
02314119,12,1,11,0,1,0,1,0,0
02314294,17,7,10,0,1,1,0,0,1
02314735,32,13,19,0,0,0,0,0,1
02314890,12,8,4,0,4,1,3,1,1
02315596,24,5,19,0,1,1,0,1,1
02316122,8,0,8,0,0,0,0,0,1
02316129,13,1,12,0,1,1,0,0,1
02316298,21,4,17,0,1,1,0,1,0
02316301,35,9,26,0,1,1,0,1,1
02316369,5,2,3,0,3,2,1,0,0
02316630,91,0,91,0,0,0,0,0,1
02316653,25,8,17,0,1,1,0,1,1
02316671,23,0,23,0,0,0,0,0,1
02316966,3,1,2,0,1,1,0,0,1
02316967,26,3,23,0,1,1,0,1,1
02317133,52,6,46,0,1,1,0,1,1
02317277,13,0,13,0,1,1,0,0,1
02317280,24,0,24,0,0,0,0,0,1
02317362,33,12,21,0,0,0,0,0,0
02317609,17,4,13,0,1,1,0,1,1
02317814,68,0,68,0,0,0,0,0,1
02318099,11,6,5,0,4,3,1,0,1
02318644,4,3,1,0,1,1,0,1,0
02318754,36,5,31,0,1,1,0,1,0
02318796,11,0,11,0,1,1,0,1,1
02318863,0,0,0,0,0,0,0,0,1
02318923,152,43,109,0,1,1,0,1,1
02318925,147,38,109,0,1,1,0,1,1
02319026,8,3,5,0,2,2,0,0,1
02319124,24,1,23,0,1,1,0,0,0
02319160,29,0,29,0,0,0,0,0,1
02319269,96,8,88,0,0,0,0,0,1
02319478,58,10,48,0,0,0,0,0,1
02319732,6,0,6,0,0,0,0,0,1
02319743,27,5,22,0,0,0,0,0,0
02319746,6,2,4,0,0,0,0,0,0
02320279,11,6,5,0,0,0,0,0,1
02320388,0,0,0,0,0,0,0,0,0
02320508,26,0,26,0,0,0,0,0,1
02320538,29,7,22,0,0,0,0,0,1
02320966,21,3,18,0,1,1,0,1,1
02321168,56,0,56,0,0,0,0,0,1
02321201,4,0,4,0,0,0,0,0,1
02321294,11,7,4,0,1,1,0,0,1
02321360,10,0,10,0,0,0,0,0,1
02321562,18,5,13,0,2,2,0,0,1
02321767,4,2,2,0,1,1,0,0,1
02321802,73,9,64,0,1,1,0,1,1
02321868,34,2,32,0,1,1,0,1,1
02321871,16,3,13,0,0,0,0,0,0
02322069,17,6,11,0,1,1,0,1,1
02322202,36,2,34,0,1,1,0,1,1
02322502,15,0,15,0,0,0,0,0,1
02322741,26,3,23,0,1,1,0,1,1
02322764,6,3,3,0,1,1,0,0,1
02322852,51,6,45,0,7,0,7,0,1
02322918,15,6,9,0,1,1,0,1,1
02322945,33,0,33,0,0,0,0,0,1
02323141,91,10,81,0,2,2,0,0,0
02323258,6,1,5,0,1,1,0,0,1
02323420,33,2,31,0,2,2,0,0,1
02323516,12,1,11,0,4,2,2,1,1
02323529,45,6,39,0,1,1,0,1,1
02323582,6,1,5,0,1,1,0,1,1
02323723,10,3,7,0,2,1,1,0,1
02324094,45,3,42,0,1,1,0,1,1
02324172,147,8,139,0,0,0,0,0,1
02324219,43,6,37,0,1,1,0,0,1
02324596,11,2,9,0,1,1,0,0,1
02324637,32,0,32,0,0,0,0,0,1
02324663,12,1,11,0,0,0,0,0,0
02324869,116,12,104,0,0,0,0,0,1
02324965,6,0,6,0,0,0,0,0,1
02325092,67,22,45,0,0,0,0,0,1
02325171,24,3,21,0,0,0,0,0,1
02325314,13,4,9,0,2,1,1,0,1
02325437,31,5,26,0,0,0,0,0,1
02325778,15,4,11,0,2,2,0,0,1
02325831,32,6,26,0,2,1,1,0,1
02325905,52,13,39,0,0,0,0,0,1
02325911,28,0,28,0,1,1,0,1,1
02325912,36,3,33,0,1,1,0,1,1
06770317,2,1,1,0,1,1,0,0,0
06770414,12,2,10,0,0,0,0,0,1
06770434,13,0,13,0,0,0,0,0,0
06770500,3,0,3,0,0,0,0,0,0
06770671,10,7,3,0,1,1,0,1,1
06771027,19,12,7,0,1,1,0,0,1
06771358,1,1,0,0,1,1,0,1,0
06771724,4,2,2,0,1,1,0,0,1
06771928,24,8,16,0,0,0,0,0,1
06771937,30,8,22,0,0,0,0,0,0
06771957,3,0,3,0,0,0,0,0,0
06771999,6,2,4,0,1,1,0,1,1
06772181,33,3,30,0,3,3,0,1,1
06772190,5,3,2,0,1,1,0,0,1
06772474,16,8,8,0,2,1,1,1,1
06772821,2,2,0,0,2,2,0,0,0
06773137,2,0,2,0,1,1,0,0,1
06773328,12,0,12,0,0,0,0,0,1
06773430,2,2,0,0,1,1,0,1,1
06773501,7,3,4,0,2,2,0,2,1
06773610,24,3,21,0,1,1,0,1,1
06773809,4,3,1,0,1,1,0,1,1
06773901,3,3,0,0,2,2,0,0,0
06774011,5,3,2,0,1,1,0,0,0
06774645,5,3,2,0,2,2,0,0,1
06774879,5,3,2,0,0,0,0,0,0
06775291,2,2,0,0,1,1,0,1,0
06775402,28,9,19,0,1,0,1,0,1
06775606,18,5,13,0,1,1,0,1,1
06775727,15,4,11,0,1,1,0,1,1
06775730,5,3,2,0,3,3,0,0,1
06776194,8,6,2,0,1,1,0,1,0
06776539,15,0,15,0,0,0,0,0,1
06776599,3,1,2,0,1,1,0,0,1
06776769,13,0,13,0,1,1,0,1,1
06776830,10,5,5,0,0,0,0,0,0
06776868,18,7,11,0,0,0,0,0,0
06777231,1,1,0,0,1,1,0,0,0
06777364,6,2,4,0,1,1,0,1,1
06777542,2,2,0,0,1,1,0,0,0
06777559,7,5,2,0,2,2,0,0,1
06777594,5,2,3,0,1,1,0,0,1
06777602,7,5,2,0,2,2,0,0,1
06777631,4,1,3,0,1,0,1,0,1
06777781,11,2,9,0,2,2,0,2,1
06777793,9,4,5,0,2,2,0,0,1
06777870,3,0,3,0,0,0,0,0,1
06777998,2,1,1,0,1,1,0,0,0
06778021,15,3,12,0,1,1,0,1,1
06778100,3,3,0,0,4,4,0,0,0
06778194,16,7,9,0,3,0,3,1,1
06778682,3,2,1,0,0,0,0,0,1
06778903,2,0,2,0,2,2,0,0,1
06778905,16,7,9,0,3,2,1,2,1
06779116,20,10,10,0,0,0,0,0,0
06779241,37,11,26,0,0,0,0,0,1
06779873,20,6,14,0,0,0,0,0,0
06780105,10,3,7,1,4,1,3,2,0
06780161,42,9,33,0,3,1,2,2,0
06780221,6,3,3,0,1,1,0,1,1
06780612,8,5,3,0,0,0,0,0,1
06780661,5,5,0,0,3,1,2,1,1
06781106,24,7,17,0,2,1,1,0,1
06781349,5,0,5,0,0,0,0,0,1
06781654,5,3,2,0,2,2,0,0,0
06782365,4,2,2,0,1,1,0,1,1
06782761,3,2,1,0,2,2,0,0,0
06782784,3,0,3,0,0,0,0,0,1
06783085,3,1,2,0,1,1,0,0,1
06783496,20,7,13,0,0,0,0,0,1
06783983,4,0,4,0,1,1,0,0,0
06784185,14,5,9,0,0,0,0,0,0
06784389,16,2,14,0,1,1,0,1,1
06784541,28,9,19,0,0,0,0,0,0
06784688,6,0,6,0,0,0,0,0,0
06784875,10,3,7,0,0,0,0,0,1
06784998,6,0,6,0,0,0,0,0,0
06785041,25,8,17,0,0,0,0,0,1
06785156,4,0,4,0,0,0,0,0,1
06785189,10,0,10,0,0,0,0,0,1
06785444,10,2,8,0,1,1,0,1,1
06785641,6,2,4,0,2,2,0,0,0
06785724,21,5,16,0,1,1,0,0,0
06786364,3,2,1,0,1,1,0,1,1
06786408,4,3,1,0,2,2,0,0,1
06786448,23,6,17,0,2,1,1,0,0
06786487,5,1,4,0,2,2,0,0,1
06786519,20,6,14,0,1,1,0,1,1
06786615,8,5,3,0,0,0,0,0,1
06786693,5,2,3,0,1,1,0,0,0
06786755,3,3,0,0,1,1,0,0,1
06786915,8,2,6,0,5,3,2,2,1
06787075,13,6,7,0,0,0,0,0,1
06787169,3,1,2,0,0,0,0,0,1
06787594,4,1,3,0,3,2,1,1,1
06787696,3,2,1,0,2,2,0,0,0
06787725,8,0,8,0,0,0,0,0,1
06787740,2,1,1,0,2,1,1,0,0
06787805,4,3,1,0,2,1,1,2,1
06788061,5,4,1,0,2,2,0,0,1
06788282,20,12,8,0,3,3,0,0,0
06788898,8,0,8,0,0,0,0,0,1
06788902,4,3,1,0,1,1,0,1,1
06788904,8,0,8,0,0,0,0,0,1
06788932,20,6,14,0,1,1,0,1,1
06788950,4,0,4,0,0,0,0,0,1
06788955,8,0,8,0,0,0,0,0,1
06788964,7,0,7,0,0,0,0,0,1
06788988,4,3,1,0,2,1,1,2,1
06788991,4,0,4,0,0,0,0,0,1
06789173,3,3,0,0,1,1,0,0,0
06789187,13,4,9,0,0,0,0,0,1
06789204,5,3,2,0,0,0,0,0,1
06789548,5,3,2,0,1,1,0,0,1
06789606,17,4,13,0,2,2,0,2,1
06789783,66,21,45,0,1,1,0,0,1
06790494,5,1,4,0,0,0,0,0,0
06790590,4,1,3,0,1,1,0,0,1
06790610,6,0,6,0,0,0,0,0,1
06790623,24,13,11,0,0,0,0,0,0
06790964,7,3,4,0,1,1,0,1,0
06791375,3,2,1,0,1,1,0,0,1
06791610,8,3,5,0,1,1,0,1,1
06791654,3,2,1,0,1,1,0,0,1
06791684,2,2,0,0,2,2,0,0,0
06791883,1,0,1,0,0,0,0,0,0
06791916,8,3,5,0,3,3,0,0,1
06791987,5,3,2,0,0,0,0,0,1
06792129,6,4,2,0,1,1,0,0,1
06792165,10,5,5,0,3,3,0,0,0
06792261,2,0,2,0,0,0,0,0,1
06792370,4,1,3,0,1,1,0,0,1
06792516,4,3,1,0,2,2,0,0,0
06792572,14,4,10,0,0,0,0,0,0
06792800,12,7,5,0,8,6,2,0,0
06792959,23,3,20,0,1,1,0,1,1
06793030,3,3,0,0,1,1,0,0,0
06793041,6,0,6,0,0,0,0,0,1
06793262,9,3,6,0,0,0,0,0,1
06793272,9,3,6,0,0,0,0,0,1
06793290,9,3,6,0,0,0,0,0,1
06793302,9,3,6,0,0,0,0,0,1
06793328,9,3,6,0,0,0,0,0,1
06793345,9,3,6,0,0,0,0,0,1
06793351,9,3,6,0,0,0,0,0,1
06793354,9,3,6,0,0,0,0,0,1
06793355,9,3,6,0,0,0,0,0,1
06793356,9,2,7,0,0,0,0,0,1
06793664,5,2,3,0,2,2,0,0,0
06793737,3,1,2,0,1,1,0,0,1
06793762,1,1,0,0,1,1,0,0,1
06793764,2,1,1,0,1,1,0,0,1
06793812,2,1,1,0,2,1,1,0,1
06793873,12,0,12,0,0,0,0,0,1
06793948,7,2,5,0,3,2,1,0,1
06794152,4,2,2,0,1,1,0,0,1
06794157,6,3,3,0,1,1,0,0,1
06794259,9,0,9,0,0,0,0,0,1
06794260,4,0,4,0,0,0,0,0,1
06794616,1,1,0,0,2,2,0,0,1
06794689,22,12,10,0,0,0,0,0,1
06794772,5,3,2,0,2,2,0,0,1
06794775,4,2,2,0,1,1,0,0,1
06794827,7,4,3,0,1,1,0,1,1
06795079,6,3,3,0,3,2,1,0,1
06795359,11,3,8,0,1,1,0,1,1
06795362,7,4,3,0,1,1,0,1,1
06795591,3,3,0,0,1,1,0,0,0
06796070,8,3,5,0,0,0,0,0,0
06796506,7,4,3,0,3,3,0,0,1
06796578,5,3,2,0,2,2,0,0,1
06796765,2,1,1,0,1,1,0,0,0
06797099,10,3,7,0,2,1,1,1,1
06797110,2,0,2,0,0,0,0,0,1
06797277,8,2,6,1,0,0,0,0,0
06797328,21,9,12,0,1,1,0,1,1
06797626,2,1,1,0,2,2,0,0,0
06797731,8,0,8,0,1,1,0,1,1
06797867,4,0,4,0,1,1,0,0,1
06798047,22,17,5,0,1,1,0,0,1
06798106,42,16,26,0,0,0,0,0,1
06798131,3,0,3,0,0,0,0,0,0
06799198,2,1,1,0,1,1,0,0,0
06799879,3,3,0,0,1,1,0,1,1
06799889,3,1,2,0,0,0,0,0,0
06800042,6,2,4,0,1,1,0,0,1
06800071,19,6,13,0,1,1,0,0,1
06800081,3,0,3,0,0,0,0,0,0
06800120,4,3,1,0,1,1,0,1,1
06800145,4,3,1,0,2,2,0,0,1
06800363,2,2,0,0,1,1,0,0,0
06800561,9,4,5,0,1,1,0,1,1
06800671,3,0,3,0,0,0,0,0,1
06800796,6,2,4,0,0,0,0,0,1
06800865,7,2,5,0,1,1,0,0,1
06800879,10,4,6,0,2,1,1,0,1
06801079,29,9,20,0,0,0,0,0,0
06801717,10,3,7,0,1,1,0,1,1
06801953,24,15,9,0,1,1,0,1,1
06802173,20,14,6,0,0,0,0,0,0
06802252,10,2,8,0,1,1,0,1,1
06802357,6,3,3,0,1,1,0,1,1
06802755,4,3,1,0,1,1,0,0,0
06802981,5,0,5,0,2,2,0,2,1
06803069,8,4,4,0,1,1,0,0,1
06803084,9,0,9,1,1,1,0,0,1
06803094,5,0,5,0,0,0,0,0,1
06803262,13,5,8,0,0,0,0,0,0
06803572,7,2,5,0,1,1,0,0,1
06803586,3,3,0,0,1,1,0,0,0
06804184,3,0,3,0,0,0,0,0,1
06804186,5,0,5,0,0,0,0,0,0
06804197,8,6,2,0,1,1,0,1,1
06804204,3,1,2,0,1,1,0,0,1
06804208,11,5,6,0,1,1,0,0,1
06804340,17,6,11,0,2,2,0,1,1
06804599,9,0,9,0,0,0,0,0,1
06804606,2,2,0,0,0,0,0,0,0
06805012,8,7,1,0,0,0,0,0,0
06805456,4,1,3,0,2,2,0,0,0
06805467,8,0,8,0,0,0,0,0,1
06806086,2,0,2,0,1,1,0,0,1
06806112,1,1,0,0,1,1,0,0,0
06806153,6,5,1,0,1,1,0,1,1
06806352,1,1,0,0,1,1,0,0,0
06806728,5,4,1,0,1,0,1,1,1
06806764,1,1,0,0,1,1,0,0,0
06807552,15,3,12,0,1,1,0,1,0
06807597,2,2,0,0,1,1,0,0,1
06808056,4,2,2,0,1,1,0,0,0
06808473,2,2,0,0,1,1,0,0,0
06808641,5,2,3,0,1,1,0,0,0
06808830,7,7,0,0,1,1,0,0,0
06808967,2,0,2,0,1,1,0,0,0
06809700,10,5,5,0,0,0,0,0,0
06809858,8,1,7,0,1,1,0,1,0
06810311,11,0,11,0,0,0,0,0,1
06810585,19,6,13,0,1,1,0,1,1
06810857,7,5,2,0,1,1,0,1,1
06811082,5,0,5,0,2,2,0,0,1
06811491,3,2,1,0,1,1,0,0,1
06811566,24,4,20,0,1,1,0,1,1
06811936,7,3,4,0,4,2,2,0,0
06811987,57,10,47,0,1,1,0,1,1
06811996,0,0,0,0,0,0,0,0,1
06812880,9,0,9,0,0,0,0,0,1
06813003,2,0,2,0,0,0,0,0,1
06813155,2,0,2,0,0,0,0,0,1
06813192,6,0,6,0,0,0,0,0,1
06813694,16,7,9,0,1,1,0,0,1
06813950,6,0,6,0,0,0,0,0,1
06814035,6,3,3,0,3,2,1,2,0
06814180,16,4,12,0,1,1,0,1,1
06814236,5,0,5,0,0,0,0,0,1
06814453,13,0,13,0,0,0,0,0,1
06815140,3,0,3,0,1,1,0,0,0
06815492,9,0,9,0,0,0,0,0,1
06815606,7,6,1,0,0,0,0,0,1
06816516,3,2,1,0,2,2,0,0,0
06816766,6,0,6,0,0,0,0,0,1
06817150,4,3,1,0,2,2,0,0,1
06817422,11,4,7,0,2,2,0,2,1
06817424,23,6,17,0,0,0,0,0,0
06817868,32,14,18,0,0,0,0,0,1
06817960,22,8,14,0,0,0,0,0,0
06818165,4,1,3,0,0,0,0,0,0
06818415,11,3,8,0,1,1,0,1,1
06818428,11,3,8,0,1,1,0,1,1
06818458,14,4,10,0,1,1,0,1,1
06818468,17,5,12,0,0,0,0,0,1
06818742,19,1,18,0,1,1,0,0,1
06818756,11,4,7,0,1,1,0,1,1
06818774,8,4,4,0,3,3,0,0,1
06818920,9,7,2,0,1,0,1,0,1
06819033,7,4,3,0,0,0,0,0,0
06819200,1,1,0,0,1,1,0,0,0
06819250,8,7,1,0,2,2,0,2,1
06819358,2,0,2,0,0,0,0,0,0
06819643,9,1,8,0,1,1,0,0,1
06819722,12,0,12,0,1,1,0,1,1
06819800,16,7,9,0,0,0,0,0,1
05286311,4,2,2,0,2,2,0,0,1
05286403,17,3,14,0,1,1,0,1,1
05286434,3,2,1,0,1,1,0,0,0
05286556,16,4,12,0,0,0,0,0,0
05286591,10,0,10,0,0,0,0,0,1
05286763,4,0,4,0,1,1,0,0,1
05287142,17,7,10,0,0,0,0,0,1
05287366,5,3,2,0,0,0,0,0,0
05287515,17,8,9,0,0,0,0,0,0
05287573,17,4,13,0,5,3,2,0,1
05287710,3,3,0,0,2,2,0,0,0
05288067,29,7,22,0,0,0,0,0,0
05288206,10,0,10,0,0,0,0,0,1
05288364,5,3,2,0,1,1,0,0,1
05288575,11,0,11,0,0,0,0,0,1
05288643,12,6,6,0,0,0,0,0,1
05288808,8,2,6,0,0,0,0,0,1
05288826,19,4,15,0,2,2,0,2,1
05288828,29,14,15,0,0,0,0,0,1
05289086,27,10,17,0,2,1,1,0,1
05289321,14,5,9,0,0,0,0,0,1
05289600,4,0,4,0,0,0,0,0,1
05289636,23,3,20,0,1,1,0,1,1
05289640,14,3,11,0,0,0,0,0,1
05289692,10,0,10,0,1,1,0,0,1
05290088,33,4,29,0,0,0,0,0,0
05290247,29,2,27,0,0,0,0,0,1
05290277,26,7,19,0,0,0,0,0,0
05290700,4,2,2,0,1,1,0,0,1
05290808,5,2,3,0,1,1,0,0,1
05291078,13,2,11,0,1,1,0,0,1
05291229,25,2,23,0,1,1,0,1,1
05291386,3,2,1,0,1,1,0,1,0
05291473,21,11,10,0,2,1,1,0,1
05291619,7,3,4,0,1,1,0,0,1
05291959,4,2,2,0,2,2,0,0,0
05292091,5,3,2,0,3,3,0,0,0
05292114,7,0,7,0,0,0,0,0,1
05292122,6,0,6,0,1,1,0,0,1
05292578,5,0,5,0,0,0,0,0,1
05292627,24,9,15,0,0,0,0,0,0
05293109,5,2,3,0,1,1,0,0,1
05293119,4,0,4,0,1,1,0,0,0
05293766,5,1,4,0,1,1,0,0,1
05293864,18,0,18,0,0,0,0,0,1
05293989,6,4,2,0,3,3,0,0,1
05294193,10,2,8,0,0,0,0,0,1
05294243,31,7,24,0,1,1,0,1,1
05294258,12,4,8,0,4,4,0,0,1
05294321,41,9,32,0,1,0,1,0,1
05294329,23,0,23,0,1,1,0,1,1
05294367,2,2,0,0,1,1,0,0,0
05294526,18,5,13,0,1,1,0,1,1
05294630,6,4,2,0,0,0,0,0,0
05294632,26,4,22,0,1,1,0,1,1
05294760,7,3,4,0,1,1,0,0,1
05294910,6,3,3,0,1,1,0,1,1
05295689,5,2,3,0,1,1,0,0,0
05295692,5,1,4,0,2,2,0,0,0
05297541,7,2,5,0,1,1,0,0,0
05297650,15,3,12,0,2,2,0,0,0
05297675,9,4,5,0,0,0,0,0,1
05298074,15,0,15,0,0,0,0,0,1
05298090,35,6,29,0,1,1,0,0,0
05298094,6,2,4,0,1,1,0,1,1
05298102,2,2,0,0,1,1,0,0,0
05298702,5,3,2,0,1,1,0,0,0
05298959,15,3,12,0,0,0,0,0,0
05299017,15,0,15,0,0,0,0,0,1
05299058,18,3,15,0,1,1,0,1,1
05299331,5,2,3,0,1,1,0,1,1
05299349,4,2,2,0,1,1,0,0,1
05300020,13,6,7,0,0,0,0,0,1
05300148,15,5,10,0,0,0,0,0,0
05300408,11,2,9,0,2,2,0,0,1
05300693,44,8,36,0,0,0,0,0,1
05300753,5,2,3,0,0,0,0,0,1
05300755,22,5,17,0,0,0,0,0,1
05300860,7,3,4,0,1,1,0,0,1
05300865,16,5,11,0,1,1,0,1,1
05300876,16,3,13,0,0,0,0,0,1
05300885,5,3,2,0,3,1,2,1,0
05301355,4,0,4,0,0,0,0,0,0
05301576,25,8,17,0,0,0,0,0,1
05301758,18,5,13,0,1,1,0,1,1
05301823,2,1,1,0,1,1,0,0,0
05301920,28,9,19,0,0,0,0,0,0
05302374,7,5,2,0,1,1,0,0,1
05302397,3,1,2,0,1,1,0,0,0
05302708,17,0,17,0,0,0,0,0,1
05302821,15,3,12,0,1,1,0,0,0
05302966,2,2,0,0,1,1,0,0,1
05303167,16,5,11,0,1,1,0,1,1
05303594,4,0,4,0,2,2,0,0,0
05303696,4,4,0,0,2,1,1,0,0
05303818,17,3,14,0,1,1,0,1,1
05303883,60,11,49,0,0,0,0,0,1
05304337,11,0,11,0,0,0,0,0,1
05304411,7,0,7,0,0,0,0,0,1
05304412,10,0,10,0,0,0,0,0,1
05305022,8,0,8,0,0,0,0,0,1
05305093,4,2,2,0,1,1,0,0,0
05305121,10,3,7,0,1,1,0,1,1
05305159,15,4,11,0,1,1,0,1,1
05305321,14,0,14,0,0,0,0,0,1
05305489,7,0,7,0,0,0,0,0,1
05305490,7,0,7,0,0,0,0,0,1
05306239,5,1,4,0,2,1,1,0,0
05306249,17,4,13,0,1,1,0,1,1
05306293,5,4,1,0,1,1,0,0,0
05306796,25,3,22,0,1,1,0,1,1
05306974,12,0,12,0,0,0,0,0,1
05307068,28,0,28,0,0,0,0,0,1
05307129,3,0,3,0,0,0,0,0,0
05307690,5,3,2,0,0,0,0,0,0
05307721,6,0,6,0,2,2,0,0,1
05307852,6,3,3,0,1,1,0,0,1
05307860,6,3,3,0,1,1,0,1,1
05307891,28,5,23,0,0,0,0,0,1
05307990,6,2,4,0,3,2,1,0,0
05308064,19,1,18,0,1,1,0,1,1
05308244,28,2,26,0,1,1,0,0,1
05308617,4,0,4,0,1,1,0,0,1
05308745,18,7,11,0,1,1,0,1,1
05308760,8,0,8,0,0,0,0,0,1
05309042,26,3,23,0,1,1,0,1,1
05309624,5,3,2,0,2,2,0,0,1
05310024,9,0,9,0,0,0,0,0,1
05310030,9,0,9,0,0,0,0,0,1
05310047,9,0,9,0,0,0,0,0,1
05310224,19,0,19,0,0,0,0,0,1
05310616,74,26,48,0,0,0,0,0,1
05310628,11,0,11,0,0,0,0,0,1
05310655,36,6,30,0,1,1,0,1,1
05310656,30,6,24,0,1,1,0,1,1
05310778,5,1,4,0,0,0,0,0,0
05310977,5,1,4,0,1,1,0,0,0
05310997,8,0,8,0,0,0,0,0,1
05311545,5,2,3,0,1,1,0,1,1
05311551,7,3,4,0,0,0,0,0,1
05311572,10,2,8,0,1,1,0,0,1
05311623,23,0,23,0,0,0,0,0,1
05311646,24,10,14,0,1,0,1,0,1
05311990,15,8,7,0,0,0,0,0,0
05312114,5,2,3,0,1,1,0,0,0
05312424,6,1,5,0,1,1,0,0,0
05312467,13,0,13,0,1,1,0,1,1
05312588,8,0,8,0,0,0,0,0,1
05312655,6,3,3,0,1,1,0,0,0
05312703,37,2,35,0,2,2,0,0,1
05312722,10,2,8,0,1,1,0,1,1
05312868,3,1,2,0,0,0,0,0,1
05312941,31,9,22,0,0,0,0,0,1
05312954,32,6,26,0,0,0,0,0,1
05313008,4,0,4,0,0,0,0,0,1
05313087,11,4,7,0,0,0,0,0,1
05313254,10,3,7,0,1,1,0,0,1
05313369,10,2,8,0,1,1,0,0,1
05313745,16,2,14,0,1,1,0,0,1
05313861,6,3,3,0,2,2,0,0,0
05314012,10,3,7,0,0,0,0,0,1
05314227,25,5,20,0,0,0,0,0,1
05314362,4,3,1,0,1,1,0,0,1
05314981,7,0,7,0,0,0,0,0,0
05315087,7,3,4,0,1,1,0,0,0
05315704,11,3,8,0,1,1,0,0,1
05315911,17,4,13,0,1,1,0,1,1
05316172,6,3,3,0,1,1,0,0,1
05316243,13,5,8,0,0,0,0,0,1
05316320,13,5,8,0,1,1,0,0,1
05316336,6,0,6,0,0,0,0,0,1
05316370,6,2,4,0,1,1,0,0,0
05316382,44,5,39,0,1,1,0,1,1
05316463,2,1,1,0,2,2,0,0,0
05316589,7,1,6,0,1,1,0,1,1
05316600,4,2,2,0,1,1,0,0,1
05316930,6,0,6,0,0,0,0,0,1
05317210,16,3,13,0,1,1,0,1,1
05317433,7,4,3,0,0,0,0,0,0
05317485,26,7,19,0,0,0,0,0,0
05317612,21,0,21,0,0,0,0,0,1
05317618,20,1,19,0,1,1,0,0,1
05317683,32,9,23,0,0,0,0,0,1
05317726,7,3,4,0,1,1,0,0,1
05318138,11,6,5,0,0,0,0,0,1
05318176,23,4,19,0,3,3,0,0,0
05318222,9,2,7,1,0,0,0,0,1
05318245,26,3,23,0,1,1,0,1,1
05318271,13,6,7,0,1,1,0,1,1
05318359,4,3,1,0,1,1,0,0,0
05318694,5,3,2,0,2,2,0,0,0
05319075,2,0,2,0,0,0,0,0,1
05319109,10,4,6,0,0,0,0,0,1
05319133,7,3,4,0,1,1,0,0,1
05319140,7,3,4,0,1,1,0,0,1
05319177,24,4,20,0,1,1,0,1,1
05319222,9,5,4,0,1,1,0,1,1
05319230,13,5,8,0,1,1,0,1,1
05319530,4,2,2,0,1,1,0,0,1
05319558,6,5,1,0,3,1,2,1,0
05319589,6,5,1,0,3,1,2,1,0
05319595,5,1,4,0,1,1,0,0,1
05319802,4,2,2,0,1,1,0,0,0
05319962,5,1,4,0,1,1,0,0,1
05320237,25,0,25,0,1,1,0,0,1
05320290,17,9,8,0,0,0,0,0,1
05320350,54,12,42,0,0,0,0,0,1
05320378,9,4,5,0,1,1,0,0,0
05320608,19,5,14,0,0,0,0,0,1
05320657,11,5,6,0,1,1,0,0,1
05320894,3,3,0,0,2,2,0,0,0
05321115,26,2,24,0,1,1,0,1,1
05321203,25,9,16,0,0,0,0,0,0
05321261,10,4,6,0,0,0,0,0,1
05321354,12,8,4,0,0,0,0,0,1
05321715,14,9,5,0,0,0,0,0,0
05321837,26,0,26,1,0,0,0,0,1
03339097,7,3,4,0,1,1,0,0,1
03339143,38,6,32,0,1,1,0,0,0
03339154,31,0,31,0,1,1,0,1,1
03339237,10,3,7,0,1,1,0,0,1
03339382,26,0,26,0,0,0,0,0,1
03339548,23,4,19,0,1,1,0,1,1
03339975,56,10,46,0,0,0,0,0,1
03340011,4,1,3,0,1,1,0,0,1
03340083,35,2,33,0,0,0,0,0,0
03340107,16,0,16,0,0,0,0,0,0
03340252,45,9,36,0,0,0,0,0,1
03340325,34,8,26,0,0,0,0,0,0
03340454,6,3,3,0,2,2,0,0,0
03340541,46,11,35,0,2,1,1,0,1
03340629,18,2,16,0,1,1,0,0,0
03340659,29,3,26,0,1,1,0,1,1
03340891,11,3,8,0,2,1,1,2,1
03341029,47,4,43,0,2,2,0,2,1
03341042,23,8,15,0,1,1,0,0,1
03341224,30,3,27,0,1,1,0,1,1
03341254,26,4,22,0,1,1,0,1,1
03341314,8,0,8,0,0,0,0,0,1
03341421,17,0,17,0,1,1,0,1,1
03341450,4,1,3,0,1,1,0,0,0
03341567,16,13,3,0,3,3,0,0,1
03341701,11,5,6,0,2,2,0,1,1
03341786,20,4,16,0,2,1,1,2,1
03341932,20,3,17,0,1,1,0,1,1
03341959,47,10,37,0,7,0,7,0,1
03341992,28,4,24,0,1,1,0,1,1
03342327,4,2,2,0,1,1,0,0,0
03342336,17,7,10,0,3,2,1,3,1
03342487,5,2,3,0,0,0,0,0,0
03342581,57,11,46,0,0,0,0,0,1
03342824,8,4,4,0,1,1,0,0,1
03342898,18,0,18,0,0,0,0,0,1
03342987,4,1,3,0,1,1,0,0,0
03343011,5,0,5,0,0,0,0,0,1
03343192,5,2,3,0,1,1,0,0,1
03343304,6,3,3,0,1,1,0,0,1
03343307,40,8,32,0,1,1,0,1,1
03343568,13,5,8,0,0,0,0,0,1
03343623,45,0,45,0,0,0,0,0,1
03343863,4,1,3,0,1,1,0,0,1
03343961,25,0,25,0,0,0,0,0,1
03344406,30,4,26,0,2,1,1,2,1
03344548,19,0,19,0,0,0,0,0,1
03344653,42,2,40,0,1,1,0,1,1
03344784,96,18,78,0,1,0,1,1,1
03344871,22,9,13,0,0,0,0,0,0
03345052,8,3,5,0,2,2,0,0,0
03345194,84,16,68,0,0,0,0,0,1
03345230,35,10,25,0,0,0,0,0,0
03345437,7,3,4,0,3,3,0,0,0
03345794,4,0,4,0,0,0,0,0,0
03346014,23,0,23,0,0,0,0,0,1
03346172,24,0,24,0,0,0,0,0,1
03346356,22,6,16,0,1,1,0,0,1
03346773,5,2,3,0,0,0,0,0,1
03346853,32,7,25,0,1,1,0,0,1
03346936,21,5,16,0,1,1,0,1,1
03347086,7,1,6,0,0,0,0,0,1
03347110,23,4,19,0,1,1,0,1,1
03347241,5,2,3,0,2,2,0,0,0
03347261,17,0,17,0,0,0,0,0,1
03347385,15,0,15,0,0,0,0,0,1
03347386,29,0,29,0,1,1,0,1,1
03347440,16,3,13,1,0,0,0,0,1
03347650,45,12,33,0,1,1,0,0,1
03347683,25,0,25,0,0,0,0,0,1
03347758,16,0,16,0,0,0,0,0,1
03347939,17,5,12,0,0,0,0,0,1
03347950,4,1,3,0,1,1,0,0,1
03348112,20,0,20,0,0,0,0,0,1
03348119,7,5,2,0,3,3,0,0,1
03348456,40,10,30,0,0,0,0,0,1
03348508,24,0,24,0,0,0,0,0,0
03348630,7,0,7,0,0,0,0,0,1
03349084,53,10,43,0,3,3,0,3,1
03349501,21,6,15,0,2,2,0,2,1
03349536,7,3,4,0,1,1,0,1,1
03350065,4,1,3,0,1,1,0,0,1
03350147,35,7,28,0,1,1,0,1,1
03350641,19,5,14,0,3,3,0,0,1
03350729,25,10,15,0,0,0,0,0,1
03351283,5,0,5,0,1,1,0,0,1
03351628,33,4,29,0,0,0,0,0,1
03351661,5,3,2,0,2,2,0,0,0
03351775,33,0,33,0,0,0,0,0,1
03351832,26,6,20,0,0,0,0,0,0
03352066,4,1,3,0,1,1,0,0,0
03352439,10,2,8,0,2,2,0,0,0
03352609,9,2,7,0,1,1,0,0,1
03352721,8,3,5,0,1,1,0,0,0
03353144,17,3,14,0,2,2,0,1,1
03353423,11,3,8,0,1,1,0,1,0
03353517,26,0,26,0,0,0,0,0,1
03353746,15,2,13,0,1,1,0,0,0
03353978,4,0,4,0,0,0,0,0,1
03354124,24,3,21,0,1,1,0,1,1
03354127,52,9,43,0,0,0,0,0,1
03355252,16,3,13,0,0,0,0,0,0
03355290,28,0,28,0,0,0,0,0,1
03355411,53,10,43,0,0,0,0,0,1
03355423,53,8,45,0,3,0,3,0,1
03355588,37,8,29,0,1,1,0,1,1
03355618,39,0,39,0,0,0,0,0,1
03355651,39,3,36,0,2,2,0,2,1
03355995,18,5,13,0,1,1,0,0,1
03356376,4,3,1,0,2,2,0,0,1
03356444,23,0,23,0,0,0,0,0,1
03356526,91,21,70,0,0,0,0,0,1
03356950,13,0,13,0,0,0,0,0,1
03357260,95,11,84,0,1,1,0,1,1
03357705,13,0,13,0,0,0,0,0,1
03358021,21,7,14,0,6,6,0,0,1
03358035,40,3,37,0,1,1,0,1,1
03358561,13,4,9,2,5,5,0,0,1
03358919,21,4,17,0,0,0,0,0,0
03359127,36,3,33,0,1,1,0,1,1
03359425,45,0,45,0,0,0,0,0,1
03359457,42,5,37,0,0,0,0,0,0
03359692,27,4,23,0,1,1,0,1,1
03359805,21,5,16,0,1,1,0,1,1
03360075,32,8,24,0,0,0,0,0,1
03360122,28,3,25,0,1,1,0,1,1
03360313,10,3,7,0,1,1,0,1,0
03360334,55,9,46,0,1,1,0,0,0
03360695,38,0,38,0,0,0,0,0,1
03360815,8,2,6,0,2,2,0,0,0
03360899,7,5,2,0,3,1,2,1,0
03361570,6,3,3,0,1,1,0,0,1
03361599,16,3,13,0,1,1,0,0,1
03361716,42,7,35,0,0,0,0,0,1
03362860,23,3,20,0,1,1,0,1,1
03362875,12,0,12,0,9,5,4,1,0
03363450,8,1,7,0,1,1,0,0,1
03363459,19,0,19,0,0,0,0,0,1
03363834,16,4,12,0,1,1,0,0,1
03363943,34,3,31,0,1,1,0,1,1
03364046,5,3,2,0,1,1,0,0,1
03364048,23,7,16,1,0,0,0,0,1
03364119,8,3,5,0,1,1,0,1,0
03364151,27,10,17,0,0,0,0,0,1
03364308,65,10,55,0,0,0,0,0,1
03364548,13,3,10,0,3,3,0,0,1
03365098,25,6,19,0,0,0,0,0,0
03365166,16,0,16,0,0,0,0,0,1
03365455,6,1,5,0,1,1,0,0,0
03365478,7,5,2,0,1,1,0,0,0
03365593,8,2,6,0,1,1,0,0,0
03365725,12,2,10,0,1,1,0,1,1
03365953,16,3,13,0,1,1,0,1,1
03366506,44,0,44,0,0,0,0,0,1
03366959,19,0,19,0,0,0,0,0,1
03367354,16,4,12,0,1,1,0,1,1
03367574,29,7,22,0,0,0,0,0,1
03367647,16,2,14,0,1,1,0,1,1
03367648,30,7,23,0,1,1,0,1,1
03368357,14,0,14,0,0,0,0,0,1
03368447,15,7,8,0,2,1,1,1,1
03368909,16,3,13,0,3,3,0,0,0
03368961,18,4,14,0,1,1,0,1,1
03369700,8,2,6,0,1,1,0,1,1
03369707,7,5,2,0,4,4,0,2,1
03369745,8,3,5,0,2,2,0,0,1
03369799,19,5,14,0,1,1,0,1,1
03369902,11,4,7,0,0,0,0,0,0
03370625,20,4,16,0,0,0,0,0,1
03370863,15,0,15,0,1,1,0,1,1
03371038,138,18,120,0,0,0,0,0,1
03371104,22,5,17,0,1,1,0,1,1
03371321,11,5,6,0,2,2,0,0,1
03371398,26,7,19,0,0,0,0,0,1
03371525,7,3,4,0,2,2,0,0,0
03371977,51,5,46,0,0,0,0,0,1
03372016,8,2,6,0,1,1,0,0,0
03372097,37,0,37,0,0,0,0,0,1
03372177,26,5,21,0,0,0,0,0,0
03372190,28,3,25,0,2,1,1,2,1
03372284,9,2,7,0,2,1,1,1,1
03372538,5,2,3,0,2,1,1,0,0
03372540,24,5,19,0,1,1,0,1,1
03372721,6,0,6,0,0,0,0,0,1
03372928,29,3,26,0,1,1,0,1,1
03373001,26,0,26,0,0,0,0,0,1
03373167,12,0,12,0,0,0,0,0,1
03373260,20,8,12,0,0,0,0,0,1
03373274,8,2,6,0,3,1,2,1,1
03373384,29,4,25,0,1,1,0,0,0
03373453,10,4,6,0,2,2,0,0,0
03373865,19,11,8,0,0,0,0,0,0
03374064,36,0,36,0,0,0,0,0,1
03374741,15,2,13,0,1,1,0,1,0
03374941,32,11,21,0,1,1,0,0,1
03375025,71,4,67,0,0,0,0,0,0
03375041,13,3,10,0,2,1,1,0,0
03375080,5,0,5,0,3,3,0,0,0
03375210,17,4,13,0,2,1,1,2,1
03375244,27,0,27,0,0,0,0,0,1
03375306,52,7,45,0,0,0,0,0,1
03375345,14,2,12,0,1,1,0,1,1
03375681,18,5,13,0,2,2,0,0,1
03375876,14,1,13,0,1,1,0,0,1
03375891,17,0,17,0,1,1,0,1,1
03375897,27,3,24,0,1,1,0,1,1
03375980,5,3,2,0,1,1,0,0,0
03376014,16,4,12,0,1,1,0,1,1
03376143,23,0,23,0,0,0,0,0,1
03376238,9,2,7,0,1,1,0,0,1
03376377,19,7,12,1,0,0,0,0,1
03376785,17,2,15,0,0,0,0,0,1
03376847,29,8,21,0,0,0,0,0,1
03377249,35,3,32,0,1,1,0,1,1
03377605,3,2,1,0,2,2,0,0,0
03377714,7,3,4,0,2,2,0,0,1
03377901,7,4,3,0,1,1,0,0,0
03377905,7,4,3,0,1,1,0,0,0
03377924,72,6,66,0,1,1,0,1,1
03377936,18,0,18,0,0,0,0,0,1
03377965,26,9,17,0,0,0,0,0,1
03378047,11,2,9,0,1,1,0,1,1
03378202,28,0,28,0,0,0,0,0,1
03378479,22,2,20,0,1,1,0,1,1
03378491,8,2,6,0,2,2,0,0,1
03378550,11,4,7,0,0,0,0,0,1
03378610,32,0,32,0,0,0,0,0,1
03378656,22,2,20,0,2,1,1,2,1
03378699,15,3,12,0,0,0,0,0,1
03378770,11,3,8,0,1,1,0,0,1
03379032,9,5,4,0,1,1,0,1,0
03379114,5,0,5,0,0,0,0,0,1
03379174,10,1,9,0,1,1,0,0,1
03379450,24,0,24,0,0,0,0,0,1
03379479,15,3,12,0,8,8,0,0,1
03379482,15,0,15,0,0,0,0,0,1
03379484,24,0,24,0,0,0,0,0,1
03379501,30,0,30,0,1,1,0,0,0
03379580,25,6,19,0,0,0,0,0,1
03379646,25,11,14,0,0,0,0,0,1
03379689,8,2,6,0,0,0,0,0,0
03380071,16,4,12,0,1,1,0,0,1
03380445,9,4,5,0,3,3,0,0,0
03380658,34,7,27,0,1,1,0,1,1
03381400,16,2,14,0,0,0,0,0,1
03381538,20,0,20,0,0,0,0,0,1
03381606,12,5,7,0,3,3,0,0,1
03381826,6,3,3,0,1,1,0,0,1
03382237,34,4,30,0,1,1,0,1,1
03382553,23,8,15,0,1,1,0,1,1
03383236,11,0,11,1,0,0,0,0,0
03383475,50,4,46,0,1,1,0,1,0
03383797,87,14,73,0,0,0,0,0,1
03383881,13,4,9,0,1,1,0,1,1
03384487,13,4,9,0,1,1,0,1,1
03384699,15,6,9,0,1,0,1,1,1
03384709,20,3,17,0,0,0,0,0,1
03384710,37,4,33,0,1,1,0,1,1
03384783,20,0,20,0,0,0,0,0,1
03385016,26,0,26,0,0,0,0,0,1
03385025,34,4,30,0,1,1,0,1,0
03385322,14,2,12,0,0,0,0,0,0
03385731,32,5,27,0,0,0,0,0,1
03385838,5,1,4,0,1,1,0,0,0
03386018,11,0,11,0,0,0,0,0,1
03386056,26,0,26,0,0,0,0,0,1
03386284,16,5,11,0,1,1,0,1,1
03386417,5,2,3,0,1,1,0,0,1
03386645,13,3,10,0,1,1,0,1,1
03386839,49,9,40,0,1,1,0,0,1
03386860,5,2,3,0,1,1,0,1,1
03386900,23,0,23,0,0,0,0,0,1
03386922,25,3,22,0,2,1,1,2,1
03386929,38,9,29,0,0,0,0,0,1
03386998,16,0,16,0,0,0,0,0,1
03387045,22,3,19,0,1,1,0,1,1
03387094,36,2,34,0,1,1,0,1,0
03387095,29,8,21,0,1,1,0,1,1
03387274,5,3,2,0,1,1,0,0,1
03387537,41,9,32,0,0,0,0,0,0
03387647,29,2,27,0,1,0,1,1,1
03387663,8,0,8,0,0,0,0,0,1
03387790,67,1,66,0,0,0,0,0,1
03387792,4,2,2,0,2,2,0,0,1
03387838,42,0,42,0,0,0,0,0,1
03387957,4,0,4,0,1,1,0,0,1
03387975,5,0,5,0,0,0,0,0,0
03388017,81,10,71,0,0,0,0,0,0
03388137,43,14,29,0,0,0,0,0,1
03388395,11,2,9,0,1,1,0,0,1
03388671,52,10,42,0,0,0,0,0,1
03388707,15,0,15,0,0,0,0,0,1
03389067,14,0,14,0,0,0,0,0,1
03389372,8,1,7,0,1,1,0,0,1
03389389,15,4,11,0,0,0,0,0,1
03389617,24,5,19,0,0,0,0,0,1
03389645,24,6,18,0,0,0,0,0,1
03389930,12,2,10,0,0,0,0,0,1
03389978,50,5,45,0,1,1,0,1,1
03390085,5,3,2,0,2,2,0,0,1
03390138,36,7,29,0,0,0,0,0,1
03390170,30,8,22,0,1,1,0,1,0
03390258,30,4,26,0,1,1,0,1,1
03390345,29,3,26,0,1,1,0,1,1
03390541,35,10,25,0,0,0,0,0,1
03390673,32,3,29,0,1,1,0,0,1
03390717,12,2,10,0,1,1,0,1,1
03390839,47,3,44,0,1,1,0,1,1
03390862,6,4,2,0,2,2,0,0,1
03390911,6,0,6,0,0,0,0,0,1
03390944,16,4,12,0,1,1,0,1,1
03391060,19,0,19,0,0,0,0,0,1
03391073,19,0,19,0,0,0,0,0,1
03391144,13,3,10,0,1,1,0,1,1
03391578,10,0,10,0,0,0,0,0,1
03391758,93,6,87,0,0,0,0,0,1
03391867,7,3,4,0,0,0,0,0,0
03392183,6,0,6,0,0,0,0,0,0
03392267,8,5,3,0,1,1,0,0,0
03392310,14,1,13,0,0,0,0,0,1
03392527,36,7,29,0,0,0,0,0,1
03392535,18,3,15,0,1,1,0,1,1
03392685,17,5,12,0,1,1,0,1,1
03393310,7,4,3,0,2,2,0,2,1
03393610,34,5,29,0,2,2,0,2,1
03394234,29,3,26,0,1,1,0,1,1
03394380,4,2,2,0,3,3,0,0,0
03394534,20,0,20,0,1,1,0,1,1
03394622,23,3,20,0,2,2,0,2,0
03394910,23,6,17,0,0,0,0,0,1
03394958,30,13,17,0,0,0,0,0,1
03394992,38,8,30,0,1,1,0,1,1
03395389,38,12,26,0,0,0,0,0,1
03395416,28,6,22,0,1,1,0,1,1
03395489,41,6,35,0,1,1,0,1,1
03395491,38,0,38,0,0,0,0,0,1
03395681,98,11,87,0,0,0,0,0,1
03395695,7,3,4,0,1,1,0,1,0
03395860,24,0,24,0,0,0,0,0,1
03396067,13,3,10,0,1,1,0,0,1
03396170,10,4,6,0,1,1,0,0,1
03396496,16,0,16,0,0,0,0,0,1
03396520,22,0,22,0,0,0,0,0,1
03396797,5,2,3,0,2,2,0,0,1
03396935,12,3,9,0,1,1,0,1,1
03396992,17,0,17,0,1,1,0,1,1
03397032,12,2,10,0,1,1,0,1,1
03397696,4,3,1,0,1,1,0,0,1
03397797,12,0,12,0,0,0,0,0,1
03397895,36,3,33,0,5,4,1,0,0
03397960,22,2,20,0,2,1,1,2,1
03398004,5,0,5,0,0,0,0,0,1
03398021,11,4,7,0,2,1,1,2,1
03398152,5,0,5,0,2,1,1,2,1
03398515,7,0,7,0,0,0,0,0,0
03398534,22,2,20,0,3,3,0,1,1
03398855,7,4,3,0,1,1,0,0,0
03399276,29,0,29,0,0,0,0,0,1
03399306,4,2,2,0,1,1,0,0,0
03399480,8,2,6,0,1,1,0,0,0
03399524,6,0,6,0,0,0,0,0,1
03399536,7,0,7,0,0,0,0,0,1
03399653,3,0,3,0,0,0,0,0,1
03399923,35,5,30,0,0,0,0,0,1
05764038,3,2,1,0,1,1,0,0,0
05764141,14,5,9,0,1,1,0,1,1
05764165,12,6,6,0,3,1,2,2,1
05764516,3,3,0,0,1,1,0,0,0
05764555,5,3,2,0,2,2,0,0,1
05764664,2,0,2,0,0,0,0,0,1
05764810,21,4,17,0,0,0,0,0,1
05764838,17,6,11,0,2,1,1,2,1
05764848,16,6,10,0,1,1,0,1,1
05764956,6,4,2,0,2,2,0,0,1
05765413,2,0,2,0,0,0,0,0,1
05765499,4,2,2,0,1,1,0,0,1
05765597,3,2,1,0,1,1,0,0,0
05765738,22,5,17,0,2,1,1,2,1
05765757,2,2,0,0,1,1,0,0,0
05765833,10,3,7,0,2,2,0,2,1
05765876,18,0,18,0,0,0,0,0,1
05765961,4,0,4,0,0,0,0,0,1
05765986,14,6,8,0,1,1,0,0,0
05766028,2,1,1,0,1,1,0,0,0
05766258,5,3,2,0,2,2,0,0,1
05766993,3,2,1,0,2,2,0,0,1
05767003,3,0,3,0,2,2,0,0,0
05768008,7,4,3,0,3,3,0,0,1
05768311,4,2,2,0,1,0,1,1,1
05768358,6,0,6,0,0,0,0,0,1
05768373,20,4,16,0,1,1,0,1,1
05768401,4,0,4,0,0,0,0,0,0
05768446,4,2,2,0,1,1,0,0,0
05768459,2,2,0,0,1,1,0,0,1
05768654,9,3,6,0,0,0,0,0,1
05768822,4,0,4,0,0,0,0,0,1
05768823,3,0,3,0,0,0,0,0,1
05768914,18,6,12,0,0,0,0,0,1
05768994,8,5,3,0,1,1,0,1,1
05769142,18,8,10,0,0,0,0,0,1
05769472,12,6,6,0,1,1,0,0,0
05769525,28,0,28,0,1,1,0,1,1
05769539,6,2,4,0,2,2,0,0,0
05769604,19,0,19,0,0,0,0,0,1
05769615,2,1,1,0,2,2,0,0,0
05769622,7,3,4,0,1,1,0,0,0
05769844,8,2,6,0,1,1,0,0,1
05770270,16,0,16,0,0,0,0,0,1
05770311,4,2,2,0,1,1,0,0,1
05770898,4,2,2,0,2,2,0,0,0
05770953,3,2,1,0,1,1,0,0,1
05771039,3,1,2,0,1,1,0,0,1
05771283,9,2,7,0,1,1,0,1,0
05771327,3,0,3,0,0,0,0,0,1
05771493,3,2,1,0,1,1,0,0,0
05772181,4,2,2,0,1,1,0,0,1
05772223,3,1,2,0,1,1,0,0,1
05772287,4,3,1,0,1,1,0,0,1
05772297,9,0,9,0,0,0,0,0,1
05772965,5,3,2,0,2,2,0,0,0
05772999,39,9,30,0,0,0,0,0,1
05773174,5,1,4,0,1,1,0,0,0
05773238,5,3,2,0,2,2,0,0,1
05774175,21,4,17,0,1,1,0,1,1
05774879,4,2,2,0,1,1,0,0,1
05775046,3,3,0,0,1,1,0,0,1
05775190,4,3,1,0,2,2,0,0,1
05775464,4,3,1,0,2,2,0,0,1
05775955,12,0,12,0,0,0,0,0,1
05776211,14,0,14,0,2,0,2,2,0
05776300,22,0,22,0,0,0,0,0,1
05776368,5,2,3,0,1,1,0,0,1
05776675,6,0,6,0,0,0,0,0,1
05777017,6,4,2,0,1,1,0,1,0
05777067,20,5,15,0,1,1,0,1,1
05777204,8,3,5,0,0,0,0,0,0
05777438,9,0,9,0,0,0,0,0,1
05777728,43,9,34,0,1,1,0,1,1
05777772,6,3,3,0,4,4,0,1,1
05778052,11,5,6,0,5,4,1,0,0
05778147,2,2,0,0,1,1,0,1,1
05778204,5,0,5,0,1,1,0,1,0
05778207,5,3,2,0,2,1,1,2,0
05778231,22,0,22,0,1,1,0,1,1
05778362,4,2,2,0,1,1,0,0,1
05778493,6,0,6,0,0,0,0,0,1
05778768,19,0,19,0,1,1,0,0,1
05778832,15,8,7,0,1,1,0,0,1
05779059,11,3,8,0,1,1,0,1,1
05779226,7,2,5,0,1,1,0,1,1
05779334,6,0,6,0,0,0,0,0,1
05779997,7,5,2,0,1,1,0,1,1
05780094,4,2,2,0,1,1,0,0,0
05780181,7,1,6,0,2,1,1,0,1
05780353,2,2,0,0,1,1,0,0,0
05780587,3,2,1,0,1,1,0,0,0
05780883,4,1,3,0,1,1,0,0,1
05781011,18,0,18,0,1,1,0,1,1
05781320,5,2,3,0,1,1,0,0,1
05781496,9,4,5,0,1,1,0,1,1
05782682,4,1,3,0,1,1,0,0,1
05783175,2,2,0,0,1,1,0,0,1
05783452,9,3,6,0,1,1,0,1,1
05783850,4,2,2,0,1,1,0,0,0
05783924,2,1,1,0,1,1,0,0,1
05784012,6,2,4,0,1,1,0,0,0
05784041,3,3,0,0,4,4,0,0,0
05784087,5,3,2,0,1,1,0,0,1
05784772,2,2,0,0,1,1,0,0,0
05786104,3,1,2,0,1,1,0,0,0
05787179,6,3,3,0,2,2,0,0,1
05787426,4,1,3,1,2,1,1,0,0
05787439,16,5,11,0,2,1,1,2,1
05787554,9,3,6,0,0,0,0,0,0
05787855,5,0,5,0,0,0,0,0,0
05788427,5,0,5,0,1,1,0,0,0
05788465,7,2,5,0,1,1,0,1,1
05788622,5,2,3,0,1,1,0,1,0
05788626,5,2,3,0,1,1,0,1,0
05788648,5,2,3,0,1,1,0,1,0
05789411,4,2,2,0,2,2,0,0,0
05790132,3,3,0,0,2,2,0,0,0
05790256,4,2,2,0,1,1,0,1,1
05790312,3,3,0,0,2,2,0,0,0
05790343,9,3,6,0,1,1,0,0,1
05790394,6,0,6,0,0,0,0,0,1
05790471,9,5,4,0,1,1,0,1,1
05790506,6,3,3,0,2,2,0,0,1
05791377,5,3,2,0,2,2,0,0,1
05791450,4,0,4,0,0,0,0,0,1
05791589,9,3,6,0,1,1,0,1,1
05791612,9,0,9,0,0,0,0,0,1
05792123,17,2,15,0,2,1,1,2,1
05792192,4,1,3,0,1,1,0,0,1
05792278,4,1,3,0,1,1,0,0,1
05792362,6,4,2,0,0,0,0,0,1
05792400,4,1,3,0,1,1,0,0,1
05792500,8,3,5,0,3,1,2,2,1
05792692,6,4,2,0,3,3,0,0,0
05792977,2,1,1,0,2,2,0,0,0
05793063,5,3,2,0,1,1,0,0,1
05794246,3,2,1,0,2,2,0,0,1
05794281,17,9,8,0,0,0,0,0,1
05794494,12,2,10,0,1,1,0,1,1
05794909,8,2,6,0,0,0,0,0,1
05795115,3,0,3,0,0,0,0,0,1
05795193,6,0,6,0,0,0,0,0,1
05795248,5,0,5,0,2,2,0,0,0
05796154,4,2,2,0,1,1,0,0,1
05796173,3,0,3,0,0,0,0,0,1
05796180,3,1,2,0,1,1,0,0,1
05796357,4,1,3,0,1,1,0,0,1
05796766,25,4,21,0,1,1,0,1,1
05797367,6,3,3,0,2,2,0,0,0
05797411,6,0,6,0,0,0,0,0,0
05797448,6,1,5,0,2,1,1,0,0
05797584,6,3,3,0,1,1,0,1,1
05797585,6,3,3,0,1,1,0,1,1
05797623,7,3,4,0,2,2,0,0,1
05797743,12,3,9,0,0,0,0,0,1
05797774,39,8,31,0,1,1,0,1,1
05797779,36,9,27,0,1,1,0,1,1
05797818,10,5,5,0,0,0,0,0,0
05797852,5,0,5,0,0,0,0,0,1
05797953,3,1,2,0,1,1,0,0,1
05797992,3,3,0,0,1,1,0,1,0
05798208,9,0,9,0,0,0,0,0,0
05798225,17,5,12,0,1,1,0,1,1
05798860,2,2,0,0,1,1,0,0,0
05799080,10,4,6,0,0,0,0,0,1
05799215,18,0,18,0,1,1,0,1,1
05799601,3,0,3,0,2,2,0,0,1
05799659,5,3,2,0,2,2,0,0,0
05799782,6,3,3,0,1,1,0,1,1
05800210,4,1,3,0,1,1,0,1,0
05800435,5,4,1,0,3,3,0,0,1
05800768,16,2,14,0,1,1,0,1,1
05800771,4,2,2,0,2,2,0,0,0
05801082,15,0,15,0,0,0,0,0,1
05801407,29,8,21,0,0,0,0,0,1
05801433,17,2,15,0,0,0,0,0,1
05801467,17,2,15,0,1,1,0,1,1
05801655,6,1,5,0,1,1,0,0,1
05802093,7,5,2,0,4,4,0,1,1
05802101,9,2,7,0,1,1,0,0,1
05802246,17,6,11,0,0,0,0,0,1
05802437,5,0,5,0,1,1,0,0,0
05802661,15,4,11,0,1,1,0,1,1
05802963,14,3,11,0,1,1,0,1,1
05803075,2,0,2,0,0,0,0,0,1
05803939,12,2,10,0,0,0,0,0,1
05803985,4,2,2,0,1,1,0,0,1
05804264,4,0,4,0,0,0,0,0,1
05804288,6,3,3,0,0,0,0,0,1
05804397,26,2,24,0,2,1,1,2,1
05805010,7,4,3,0,0,0,0,0,0
05805069,14,3,11,0,0,0,0,0,1
05805276,3,0,3,0,1,1,0,0,0
05805327,6,3,3,0,1,1,0,0,0
05805541,6,2,4,0,2,2,0,0,0
05805640,5,3,2,0,2,2,0,0,1
05805789,8,3,5,0,3,1,2,1,1
05805820,13,5,8,0,3,3,0,0,1
05806409,4,3,1,0,1,1,0,0,1
05806761,12,4,8,0,0,0,0,0,1
05806904,4,0,4,0,1,1,0,0,1
05806941,9,2,7,0,0,0,0,0,0
05806943,6,0,6,0,0,0,0,0,1
05807220,3,1,2,0,1,1,0,0,0
05807296,6,0,6,0,0,0,0,0,1
05807499,12,5,7,0,1,1,0,1,1
05807690,13,3,10,0,1,1,0,1,1
05807776,4,3,1,0,3,3,0,1,0
05808040,27,3,24,0,4,2,2,0,1
05808051,4,2,2,0,1,1,0,0,1
05808375,8,1,7,0,1,1,0,0,0
05808563,2,2,0,0,1,1,0,0,0
05808791,9,1,8,0,1,1,0,1,1
05809399,21,8,13,0,1,1,0,1,1
05809432,9,5,4,0,1,1,0,1,1
05809569,5,3,2,0,1,1,0,0,1
05809683,6,3,3,0,1,1,0,0,0
05809949,9,5,4,0,1,1,0,1,1
05810043,14,3,11,0,1,1,0,1,1
05810661,11,3,8,0,1,1,0,1,1
05810921,9,3,6,0,2,2,0,0,0
05811253,6,0,6,0,1,1,0,0,1
05811355,12,2,10,0,1,1,0,1,1
05811364,21,5,16,0,1,1,0,1,1
05811374,12,2,10,0,1,1,0,1,1
05811376,7,1,6,0,1,1,0,1,1
05811470,7,3,4,0,0,0,0,0,1
05811471,4,0,4,0,0,0,0,0,1
05811755,3,1,2,0,1,1,0,0,0
05811807,5,1,4,0,1,1,0,0,1
05811851,7,3,4,0,1,1,0,1,0
05811865,4,2,2,0,1,1,0,0,0
05812162,3,0,3,0,0,0,0,0,1
05812177,6,0,6,0,0,0,0,0,1
05812195,3,2,1,0,1,1,0,0,0
05812287,9,2,7,0,0,0,0,0,1
05812600,4,1,3,0,1,1,0,0,1
05812725,7,4,3,0,0,0,0,0,1
05812951,10,5,5,0,2,2,0,1,1
05812953,12,5,7,0,2,2,0,2,1
05812954,11,2,9,0,0,0,0,0,1
05813129,2,0,2,0,1,1,0,0,0
05813190,3,0,3,0,0,0,0,0,1
05813566,2,2,0,0,1,1,0,0,0
05813575,10,3,7,0,1,1,0,0,1
05813603,8,3,5,0,1,1,0,1,1
05813853,13,6,7,0,0,0,0,0,1
05814032,29,10,19,0,0,0,0,0,0
05814047,12,5,7,0,0,0,0,0,1
05814156,5,3,2,0,2,2,0,0,0
05814316,13,4,9,0,4,4,0,0,0
05814349,4,3,1,0,2,2,0,0,1
05814426,4,0,4,0,0,0,0,0,1
05814480,4,1,3,0,1,1,0,0,0
05814487,12,2,10,0,0,0,0,0,1
05814584,25,4,21,0,1,1,0,1,1
05814586,18,5,13,0,1,1,0,1,1
05814686,41,16,25,0,0,0,0,0,1
05814704,5,0,5,0,0,0,0,0,1
05814872,6,0,6,0,0,0,0,0,1
05814962,7,3,4,0,2,1,1,0,0
05815637,4,0,4,0,0,0,0,0,1
05815806,37,5,32,0,2,1,1,2,1
05815868,3,3,0,0,2,2,0,0,0
05815942,9,0,9,0,1,1,0,1,1
05816335,7,3,4,0,1,1,0,0,1
05816565,16,9,7,0,7,7,0,0,1
05817045,19,4,15,0,1,1,0,1,1
05817235,4,3,1,0,2,2,0,0,0
05817558,8,3,5,0,1,1,0,0,0
05818196,6,3,3,0,1,1,0,0,1
05818267,7,4,3,0,2,2,0,0,1
05818308,5,2,3,0,1,1,0,0,1
05818369,3,3,0,0,0,0,0,0,0
05818448,5,2,3,0,2,2,0,0,0
05818571,4,2,2,0,1,1,0,0,0
05818607,5,3,2,0,2,2,0,0,1
05819052,13,5,8,0,0,0,0,0,0
05819097,6,4,2,0,1,1,0,0,0
05819202,10,7,3,0,1,1,0,0,1
05819233,2,2,0,0,1,1,0,0,0
05819273,12,7,5,0,6,6,0,0,0
05819388,28,7,21,0,1,1,0,0,1
05819470,6,2,4,0,1,1,0,0,1
05819475,10,2,8,0,1,1,0,0,1
05819525,9,1,8,0,1,1,0,1,1
05819580,15,1,14,0,2,1,1,2,1
05819705,5,0,5,0,1,1,0,0,1
05819791,52,9,43,0,0,0,0,0,0
05819852,12,4,8,0,2,2,0,0,1
05820636,10,7,3,0,1,1,0,1,1
05820897,7,0,7,0,0,0,0,0,1
05820910,5,2,3,0,1,1,0,0,1
05821054,3,3,0,0,2,2,0,0,1
05821073,2,2,0,0,1,1,0,0,1
05821406,3,0,3,0,0,0,0,0,1
05821585,16,5,11,0,1,1,0,0,1
05821594,5,2,3,0,1,1,0,0,0
05821633,3,2,1,0,1,1,0,0,1
05821987,20,4,16,0,2,2,0,2,1
05822082,4,2,2,0,2,1,1,0,0
05822343,4,3,1,0,1,1,0,0,1
05822489,14,3,11,0,2,1,1,2,1
05822581,32,8,24,0,0,0,0,0,0
05822622,3,2,1,0,1,1,0,0,1
05822773,4,0,4,0,0,0,0,0,1
05822818,32,9,23,0,0,0,0,0,0
05822854,6,3,3,0,1,1,0,0,1
05822975,8,0,8,0,0,0,0,0,1
05822983,6,2,4,0,1,1,0,0,0
05823102,2,2,0,0,1,1,0,0,1
05823194,16,8,8,0,0,0,0,0,1
05823283,3,0,3,0,0,0,0,0,1
05823413,51,16,35,0,0,0,0,0,1
05823583,11,0,11,0,0,0,0,0,1
05823597,8,4,4,0,2,2,0,0,0
05823763,20,4,16,0,0,0,0,0,1
09090223,6,2,4,0,4,1,3,4,1
09090276,15,9,6,0,1,1,0,1,1
09090448,6,2,4,0,2,1,1,2,1
09090452,6,2,4,0,1,1,0,1,1
09090458,8,2,6,0,1,1,0,1,1
09090502,8,2,6,0,1,1,0,1,1
09090594,1,1,0,0,1,1,0,0,0
09091180,1,1,0,0,1,1,0,0,0
09091890,5,3,2,0,0,0,0,0,1
09091944,18,6,12,0,1,1,0,1,1
09092061,6,0,6,0,0,0,0,0,1
09092077,2,1,1,0,2,1,1,0,0
09092128,6,0,6,0,0,0,0,0,1
09092149,12,9,3,0,2,2,0,0,1
09092227,2,2,0,0,0,0,0,0,0
09093009,6,5,1,0,0,0,0,0,1
09093037,1,1,0,0,1,1,0,0,1
09093331,15,11,4,0,0,0,0,0,1
09093512,1,0,1,0,0,0,0,0,0
09093942,2,2,0,0,2,2,0,0,1
09094260,3,3,0,0,1,1,0,1,1
09094311,1,0,1,0,1,1,0,0,0
09094389,5,5,0,0,0,0,0,0,1
09094680,6,0,6,0,1,1,0,1,1
09094820,2,2,0,0,2,2,0,0,1
09094829,1,1,0,0,1,1,0,0,0
09095146,1,1,0,0,1,1,0,0,0
09095367,1,0,1,0,1,1,0,0,0
09095511,2,2,0,0,1,1,0,1,1
09095773,2,2,0,0,2,2,0,0,0
09095978,1,1,0,0,1,1,0,0,0
09095991,1,0,1,0,0,0,0,0,0
09095995,3,0,3,0,0,0,0,0,0
09096155,7,4,3,0,0,0,0,0,1
09096485,1,1,0,0,2,2,0,0,0
09096998,4,0,4,0,0,0,0,0,1
09097566,1,1,0,0,1,1,0,0,0
09097919,3,1,2,0,3,2,1,1,1
09098251,4,4,0,0,2,2,0,0,0
09098358,1,0,1,0,0,0,0,0,0
09098445,7,3,4,0,3,1,2,2,1
09098472,1,0,1,0,0,0,0,0,1
09099533,2,2,0,0,1,1,0,0,0
09099708,3,3,0,0,1,1,0,1,1
09099972,2,2,0,0,2,2,0,0,0
09100148,5,0,5,0,1,1,0,0,1
09100159,2,2,0,0,1,1,0,0,0
09100180,2,0,2,0,0,0,0,0,1
09100319,2,0,2,0,0,0,0,0,0
09100325,2,0,2,0,0,0,0,0,0
09100501,14,6,8,1,1,1,0,1,1
09100833,5,5,0,0,1,1,0,1,1
09100835,8,2,6,0,0,0,0,0,1
09100870,3,0,3,0,1,1,0,0,1
09100883,7,3,4,0,0,0,0,0,1
09100905,1,1,0,0,1,1,0,0,0
09100954,5,4,1,0,0,0,0,0,1
09101743,1,0,1,0,0,0,0,0,0
09101981,2,0,2,0,1,1,0,0,0
09102015,11,7,4,0,2,1,1,1,1
09102435,5,2,3,0,0,0,0,0,1
09102436,5,2,3,0,0,0,0,0,1
09102480,13,5,8,0,1,1,0,1,1
09102509,3,2,1,0,2,2,0,0,1
09102558,13,9,4,0,2,1,1,0,1
09103050,3,3,0,0,3,3,0,0,1
09103165,6,3,3,0,2,1,1,2,1
09103286,6,3,3,0,2,1,1,2,1
09103491,2,1,1,0,1,1,0,0,0
09103585,2,2,0,0,2,2,0,0,0
09103667,1,1,0,0,1,1,0,0,0
09104001,1,0,1,0,0,0,0,0,0
09104211,1,1,0,0,1,1,0,0,0
09104263,1,1,0,0,1,1,0,0,0
09104414,3,3,0,0,1,1,0,0,1
09104491,20,14,6,0,1,1,0,0,1
09104672,3,0,3,1,0,0,0,0,1
09104814,2,2,0,0,1,1,0,0,0
09104821,5,3,2,0,1,1,0,0,0
09105139,2,2,0,0,1,1,0,0,0
09105373,5,4,1,0,0,0,0,0,1
09105486,2,2,0,0,2,2,0,0,0
09105666,2,2,0,0,2,2,0,0,0
09105948,2,1,1,0,1,1,0,0,1
09106000,6,6,0,0,2,2,0,2,1
09106062,1,1,0,0,1,1,0,0,0
09106115,1,1,0,0,1,1,0,0,0
09106343,1,1,0,0,1,1,0,0,0
09106540,4,4,0,0,2,2,0,0,1
09106604,10,8,2,0,3,3,0,0,1
09107277,2,0,2,0,1,1,0,0,1
09107369,4,2,2,0,1,1,0,0,1
09107894,1,1,0,0,1,1,0,1,0
09108354,1,1,0,0,1,1,0,0,0
09108519,5,3,2,0,4,4,0,2,1
09108533,2,2,0,0,1,1,0,0,0
09108987,2,0,2,0,1,1,0,0,1
09109364,2,2,0,0,1,1,0,1,1
09110798,2,0,2,0,1,1,0,0,0
09111449,25,12,13,0,1,1,0,0,1
09111698,10,1,9,0,3,1,2,0,0
09111783,10,1,9,0,6,1,5,0,0
09112085,2,0,2,0,0,0,0,0,1
09112135,1,1,0,0,1,1,0,0,0
09112245,2,0,2,0,0,0,0,0,0
09112348,4,0,4,0,0,0,0,0,1
09112366,5,0,5,0,0,0,0,0,1
09112415,6,2,4,0,1,1,0,1,1
09112800,1,0,1,0,0,0,0,0,0
09113029,1,1,0,0,1,1,0,0,0
09113046,2,2,0,0,1,1,0,0,1
09113696,1,1,0,0,2,2,0,1,0
09113787,5,4,1,0,3,2,1,0,1
09113819,2,2,0,0,1,1,0,0,0
09114167,1,1,0,0,1,1,0,0,0
09114258,9,1,8,0,5,1,4,0,0
09114684,3,3,0,0,1,1,0,0,0
09114888,14,5,9,0,6,2,4,4,1
09114957,2,2,0,0,1,1,0,0,1
09115085,1,1,0,0,1,1,0,0,0
09115170,2,2,0,0,3,3,0,1,1
09115222,10,6,4,0,1,1,0,0,1
09115553,4,2,2,0,2,1,1,2,0
09115861,1,1,0,0,1,1,0,0,0
09116502,5,3,2,0,2,2,0,0,1
09116596,2,0,2,0,0,0,0,0,0
09116683,2,1,1,0,1,1,0,0,1
09116938,2,2,0,0,2,2,0,0,1
09117243,13,6,7,0,3,3,0,3,1
09117256,1,1,0,0,2,2,0,0,0
09117961,12,5,7,0,2,2,0,2,0
09118770,16,10,6,0,5,4,1,0,1
09118860,1,0,1,0,0,0,0,0,0
09118912,3,3,0,0,3,3,0,1,1
09119069,2,1,1,0,2,2,0,0,0
09119229,1,0,1,0,0,0,0,0,0
09121158,3,3,0,0,2,2,0,0,1
09121352,19,10,9,0,2,2,0,2,1
09121572,23,10,13,0,1,1,0,1,1
09121616,4,4,0,0,4,4,0,0,0
09122058,2,0,2,0,1,1,0,0,0
09122076,2,0,2,0,1,1,0,0,0
09122123,4,4,0,0,3,3,0,0,0
09122208,2,0,2,0,1,1,0,0,0
09122589,1,1,0,0,1,1,0,1,0
09123030,3,1,2,0,1,1,0,0,0
09123347,2,0,2,0,1,1,0,0,0
09123355,2,0,2,0,1,1,0,0,0
09123359,2,0,2,0,1,1,0,0,0
09123386,2,0,2,0,1,1,0,0,0
09123466,4,2,2,0,1,1,0,0,0
09123563,4,0,4,0,1,1,0,0,0
09123578,2,0,2,0,1,1,0,0,0
09123615,7,0,7,0,0,0,0,0,1
09123713,9,5,4,0,1,1,0,0,1
09123811,9,2,7,0,7,1,6,4,1
09124006,4,2,2,0,2,2,0,0,0
09124176,1,0,1,0,0,0,0,0,0
09124758,2,2,0,0,1,1,0,0,0
09125322,3,2,1,0,2,2,0,0,0
09125376,2,0,2,0,1,1,0,0,0
09125426,6,5,1,0,1,1,0,1,1
09125441,7,0,7,0,0,0,0,0,1
09125474,2,0,2,0,1,1,0,0,0
09125522,2,0,2,0,1,1,0,0,0
09125542,4,3,1,0,3,3,0,0,0
09125898,1,1,0,0,2,2,0,0,0
09125901,3,2,1,0,2,2,0,0,0
09125965,2,2,0,0,2,2,0,0,0
09126010,13,10,3,0,0,0,0,0,0
09126455,2,2,0,0,2,2,0,0,1
09126513,1,1,0,0,1,1,0,0,0
09126900,1,1,0,0,1,1,0,0,1
09127240,1,1,0,0,1,1,0,0,0
09127390,4,3,1,0,1,1,0,1,1
09127436,7,5,2,0,1,1,0,1,1
09127524,4,4,0,0,0,0,0,0,1
09127721,1,1,0,0,1,1,0,0,0
09127749,6,0,6,0,4,1,3,1,0
09127759,5,2,3,0,3,3,0,1,0
09128004,4,3,1,0,1,1,0,0,1
09128201,5,2,3,0,3,3,0,1,0
09128258,5,2,3,0,3,3,0,1,0
09128554,1,0,1,0,1,1,0,0,0
09129276,2,0,2,0,0,0,0,0,0
09129871,1,0,1,0,1,1,0,0,0
09129982,2,0,2,0,1,1,0,0,0
09130241,2,1,1,0,2,2,0,0,1
09130256,7,4,3,0,1,1,0,1,1
09130381,7,6,1,0,0,0,0,0,0
09130543,2,0,2,0,0,0,0,0,1
09130872,2,1,1,0,1,1,0,0,1
09131035,2,2,0,0,0,0,0,0,0
09131462,2,2,0,0,2,2,0,0,1
09131766,3,2,1,0,1,1,0,1,0
09131811,2,1,1,0,1,1,0,0,0
09131927,1,1,0,0,1,1,0,0,1
09131932,2,0,2,0,0,0,0,0,1
09132182,3,0,3,0,0,0,0,0,0
09132197,2,0,2,1,0,0,0,0,1
09132285,2,1,1,0,2,1,1,0,0
09132565,3,1,2,0,1,1,0,0,0
09132788,2,1,1,0,1,1,0,0,0
09132799,5,0,5,0,2,1,1,0,0
09132892,5,1,4,0,3,1,2,0,0
09133329,1,0,1,0,0,0,0,0,0
09133376,1,1,0,0,1,1,0,0,0
09133434,7,4,3,0,1,1,0,0,1
09134529,6,0,6,0,0,0,0,0,1
09134997,17,8,9,0,1,1,0,1,1
09135131,10,2,8,0,1,1,0,1,1
09135247,3,0,3,0,3,3,0,1,1
09136178,2,2,0,0,1,1,0,0,0
09136241,4,2,2,0,1,1,0,0,0
09136349,4,2,2,0,1,1,0,1,1
09136408,7,3,4,0,2,2,0,0,0
09136426,2,0,2,0,2,2,0,0,1
09136445,24,13,11,0,0,0,0,0,1
09136556,22,10,12,0,0,0,0,0,0
09136562,2,0,2,0,0,0,0,0,1
09136616,8,1,7,0,2,1,1,0,0
09136682,3,2,1,0,1,1,0,0,1
09136791,9,1,8,0,3,1,2,0,0
09137257,3,3,0,0,2,2,0,0,0
09137361,2,2,0,0,2,2,0,1,0
09137387,7,7,0,0,4,2,2,2,1
09137413,5,1,4,0,3,1,2,0,0
09137525,10,1,9,0,4,1,3,0,0
09137766,4,3,1,0,4,3,1,0,0
09137938,3,0,3,0,2,2,0,0,0
09137960,1,1,0,0,1,1,0,0,0
09138004,6,3,3,0,0,0,0,0,0
09138181,3,2,1,0,1,1,0,1,0
09138209,2,2,0,0,2,2,0,0,0
09138475,1,0,1,0,1,1,0,0,1
09138849,4,1,3,0,1,1,0,0,1
09138890,1,1,0,0,1,1,0,0,0
09138930,14,8,6,0,0,0,0,0,1
09138979,8,1,7,0,5,1,4,0,0
09139224,8,1,7,0,3,1,2,0,0
09139394,4,2,2,0,2,2,0,0,0
09140467,1,1,0,0,2,2,0,0,0
09140632,4,4,0,0,2,2,0,0,1
09141136,2,2,0,0,1,1,0,0,1
09141973,1,1,0,0,1,1,0,0,0
09142567,3,2,1,0,1,1,0,0,1
09142724,10,6,4,0,2,2,0,0,1
09142792,2,0,2,0,0,0,0,0,1
09142869,3,2,1,0,1,1,0,0,0
09143049,2,0,2,0,1,1,0,0,1
09143387,1,0,1,0,1,1,0,0,1
09143445,3,1,2,0,1,1,0,0,0
09143532,2,2,0,0,1,1,0,0,1
09143585,1,1,0,0,1,1,0,0,0
09143601,16,1,15,0,6,1,5,0,0
09143718,3,2,1,0,1,1,0,0,0
09144647,14,8,6,0,2,1,1,2,1
09144761,2,1,1,0,2,1,1,0,0
09144802,3,3,0,0,0,0,0,0,0
09144988,2,0,2,0,0,0,0,0,1
09145056,2,2,0,0,2,2,0,0,0
09145229,2,2,0,0,2,2,0,0,0
09145239,1,1,0,0,1,1,0,0,0
09145297,2,2,0,0,2,2,0,0,0
09145336,4,0,4,0,0,0,0,0,1
09145482,1,1,0,0,2,2,0,0,0
09145527,1,0,1,0,1,1,0,0,0
09145635,1,1,0,0,1,1,0,0,0
09145738,6,3,3,0,3,1,2,1,1
09145939,3,3,0,0,2,2,0,0,0
09146125,4,1,3,0,1,1,0,0,1
09146323,3,0,3,0,0,0,0,0,1
09146452,1,1,0,0,1,1,0,0,0
09146865,1,1,0,0,1,1,0,0,0
09147059,11,6,5,0,0,0,0,0,0
09147156,3,2,1,0,2,2,0,0,0
09147268,8,0,8,0,3,1,2,0,0
09147297,2,0,2,0,0,0,0,0,0
09147387,3,2,1,0,1,1,0,0,0
09147870,3,3,0,0,1,1,0,0,0
09147951,3,0,3,0,0,0,0,0,0
09148081,3,3,0,0,3,3,0,0,0
09148134,6,5,1,0,1,1,0,1,1
09148310,4,4,0,0,1,1,0,0,1
09148399,1,1,0,0,1,1,0,0,0
09148747,3,1,2,0,1,1,0,0,1
09148896,2,0,2,0,2,2,0,0,0
09148904,3,1,2,0,1,1,0,0,1
09149004,5,5,0,0,1,1,0,1,1
09149177,1,1,0,0,1,1,0,0,0
09149419,1,0,1,0,0,0,0,0,0
09150035,5,4,1,0,1,1,0,0,0
09150715,21,9,12,0,0,0,0,0,0
09150752,2,1,1,0,2,1,1,0,0
09150859,2,2,0,0,1,1,0,0,1
09151051,22,3,19,0,0,0,0,0,1
09151056,1,1,0,0,1,1,0,0,0
09151816,1,1,0,0,1,1,0,0,0
09152074,2,1,1,0,1,1,0,0,0
09152652,3,3,0,0,2,2,0,0,0
09153785,4,3,1,0,2,2,0,1,0
09154350,4,1,3,0,1,1,0,0,0
09154420,2,0,2,0,1,1,0,1,1
09154707,4,4,0,0,1,1,0,0,0
09154843,1,1,0,0,1,1,0,0,0
09154850,22,4,18,0,1,1,0,1,1
09154929,6,5,1,0,0,0,0,0,0
09155074,1,1,0,0,1,1,0,0,0
09155112,34,16,18,0,0,0,0,0,1
09155226,3,0,3,0,2,2,0,0,0
09155669,2,0,2,0,0,0,0,0,0
09155970,17,3,14,0,1,1,0,1,1
09155980,17,3,14,0,1,1,0,1,1
09156393,23,14,9,0,0,0,0,0,1
09156590,4,0,4,0,0,0,0,0,1
09156760,2,1,1,0,2,1,1,0,0
09156982,2,2,0,0,2,2,0,0,1
09157039,4,4,0,0,2,2,0,0,0
09157216,3,1,2,0,2,1,1,0,0
09157234,5,1,4,0,1,1,0,0,0
09157307,2,2,0,0,3,3,0,1,0
09157851,2,2,0,0,2,2,0,0,1
09157892,22,4,18,0,1,1,0,1,1
09158229,1,1,0,0,1,1,0,0,1
09158397,4,3,1,0,0,0,0,0,0
09158492,2,0,2,0,1,1,0,0,0
09158586,8,6,2,0,0,0,0,0,1
09159397,3,3,0,0,2,2,0,0,0
09159507,1,1,0,0,2,2,0,2,0
09160126,9,3,6,0,1,1,0,1,1
09160650,2,2,0,0,2,2,0,0,0
09161046,1,1,0,0,2,2,0,0,0
09161117,3,2,1,0,2,2,0,0,0
09161172,2,0,2,0,0,0,0,0,0
09161859,4,3,1,0,1,1,0,1,1
09162507,7,5,2,0,3,1,2,1,1
09162767,7,3,4,0,1,1,0,1,1
09162879,2,2,0,0,3,1,2,1,1
09163577,10,3,7,0,1,1,0,1,1
09163676,4,0,4,0,1,1,0,0,0
09164117,2,2,0,0,1,1,0,0,0
09164128,2,1,1,0,2,1,1,0,0
09164146,6,5,1,0,1,1,0,1,1
09164322,6,0,6,0,2,1,1,2,1
09164378,6,3,3,0,2,1,1,2,1
09164504,2,1,1,0,2,2,0,1,0
09164619,6,4,2,0,3,1,2,1,1
09164759,2,0,2,0,0,0,0,0,1
09165169,1,1,0,0,1,1,0,0,0
09165174,1,0,1,0,0,0,0,0,0
09165220,9,4,5,0,1,1,0,1,1
09165649,1,1,0,0,1,1,0,0,0
09166030,5,5,0,0,2,2,0,0,1
09166756,2,0,2,0,2,2,0,1,1
09166782,8,6,2,0,1,1,0,0,1
09166829,2,1,1,0,2,1,1,2,1
09167362,2,2,0,0,2,2,0,0,0
09168993,7,3,4,0,3,1,2,1,1
09169441,1,1,0,0,0,0,0,0,1
09169583,4,4,0,0,1,1,0,0,1
09169881,1,0,1,0,0,0,0,0,0
02995487,14,5,9,0,2,2,0,0,1
02995531,44,4,40,0,1,1,0,1,1
02995545,8,2,6,0,1,1,0,0,0
02995748,16,4,12,0,1,1,0,0,1
02995811,55,6,49,0,0,0,0,0,1
02995859,44,3,41,0,0,0,0,0,1
02996018,5,0,5,0,0,0,0,0,1
02996104,76,5,71,0,1,1,0,1,1
02996181,20,2,18,0,1,1,0,1,1
02996482,9,2,7,0,1,1,0,0,1
02996620,25,0,25,0,0,0,0,0,1
02996991,4,2,2,0,2,2,0,0,1
02997013,11,3,8,0,2,2,0,0,1
02997067,28,6,22,0,0,0,0,0,1
02997371,25,6,19,0,1,1,0,1,1
02997500,25,2,23,0,1,1,0,1,1
02997682,22,0,22,0,0,0,0,0,1
02997845,25,6,19,0,1,1,0,1,1
02997883,56,9,47,0,0,0,0,0,1
02997884,7,0,7,0,0,0,0,0,1
02997941,29,4,25,0,1,1,0,1,1
02997981,17,3,14,0,4,1,3,1,0
02998017,17,7,10,0,1,1,0,0,1
02998217,68,4,64,0,1,1,0,1,1
02998223,12,4,8,1,2,0,2,2,1
02998337,13,2,11,0,1,1,0,1,1
02998440,31,0,31,0,0,0,0,0,1
02998539,13,2,11,0,1,1,0,0,1
02998558,21,3,18,0,1,1,0,1,1
02998594,53,7,46,0,2,2,0,2,1
02998595,49,10,39,0,3,1,2,1,1
02998648,55,4,51,0,1,1,0,1,1
02998677,11,2,9,0,2,1,1,1,1
02998803,36,4,32,0,2,1,1,2,1
02998831,15,4,11,0,2,2,0,1,0
02998937,19,5,14,0,0,0,0,0,1
02998938,7,2,5,0,1,1,0,0,1
02999055,83,9,74,0,0,0,0,0,1
02999282,13,3,10,0,0,0,0,0,1
02999396,23,3,20,0,1,1,0,1,1
02999408,25,4,21,0,1,1,0,1,0
02999760,21,1,20,0,1,1,0,1,1
02999946,10,0,10,0,0,0,0,0,1
02999960,34,4,30,0,1,1,0,1,1
03000049,37,11,26,0,0,0,0,0,1
03000118,13,5,8,0,1,1,0,0,1
03000262,5,3,2,0,3,2,1,0,0
03000322,16,4,12,0,0,0,0,0,0
03000727,16,0,16,0,1,1,0,1,1
03001101,19,9,10,0,0,0,0,0,1
03001280,23,5,18,0,1,1,0,0,1
03001328,7,0,7,0,0,0,0,0,1
03001459,13,3,10,0,1,1,0,0,1
03001560,28,4,24,0,0,0,0,0,1
03001770,22,2,20,0,0,0,0,0,1
03001965,6,2,4,0,1,1,0,0,0
03002007,19,3,16,1,1,1,0,1,1
03002060,7,2,5,0,2,2,0,0,1
03002073,21,3,18,0,1,1,0,1,1
03002114,47,0,47,0,0,0,0,0,1
03002128,25,4,21,0,1,1,0,1,1
03002174,20,2,18,0,1,1,0,1,1
03002186,14,0,14,0,0,0,0,0,1
03002190,0,0,0,0,0,0,0,0,1
03002199,14,0,14,0,0,0,0,0,1
03002306,9,2,7,0,2,2,0,0,1
03002336,9,3,6,0,2,2,0,0,0
03002557,12,3,9,0,1,1,0,1,1
03002592,35,0,35,0,0,0,0,0,1
03002594,5,3,2,0,2,2,0,0,1
03002689,17,3,14,0,1,1,0,1,1
03002772,18,3,15,0,1,1,0,1,0
03002784,17,0,17,0,0,0,0,0,1
03003212,24,0,24,0,0,0,0,0,1
03003338,30,5,25,0,0,0,0,0,1
03003429,46,6,40,0,0,0,0,0,1
03003533,32,0,32,0,0,0,0,0,1
03003537,5,3,2,0,2,2,0,0,1
03003539,4,1,3,0,1,1,0,1,1
03003612,9,4,5,0,1,1,0,1,1
03003797,21,0,21,0,0,0,0,0,1
03003852,6,0,6,0,0,0,0,0,1
03003900,23,5,18,0,0,0,0,0,1
03004156,19,5,14,0,4,4,0,0,1
03004175,6,1,5,0,1,1,0,0,1
03004377,55,10,45,0,0,0,0,0,1
03004438,4,2,2,0,1,1,0,0,1
03004769,34,3,31,0,1,1,0,1,1
03004959,39,8,31,0,1,1,0,1,1
03005111,9,4,5,0,1,1,0,0,0
03005185,4,2,2,0,1,1,0,0,0
03005200,10,7,3,0,2,2,0,0,1
03005233,14,2,12,0,2,1,1,1,0
03005366,10,3,7,0,3,2,1,0,1
03005520,63,13,50,0,1,1,0,0,1
03005581,11,0,11,0,0,0,0,0,1
03005603,42,6,36,0,0,0,0,0,1
03005621,3,2,1,0,1,1,0,0,0
03005720,14,3,11,0,1,1,0,1,1
03005721,22,4,18,0,0,0,0,0,1
03005774,40,4,36,0,1,1,0,1,1
03005933,67,15,52,0,0,0,0,0,1
03006066,17,6,11,0,0,0,0,0,1
03006074,5,3,2,0,2,2,0,0,1
03006203,22,3,19,0,2,2,0,0,1
03006237,5,1,4,0,1,1,0,0,1
03006529,27,6,21,0,1,1,0,1,1
03006563,38,3,35,0,1,1,0,1,1
03006571,34,1,33,0,1,1,0,1,1
03006668,11,3,8,0,2,2,0,0,1
03006948,43,0,43,0,0,0,0,0,1
03007373,6,3,3,0,0,0,0,0,1
03007386,6,3,3,0,1,1,0,0,1
03007422,16,0,16,0,0,0,0,0,1
03007485,12,2,10,0,1,1,0,1,1
03007536,30,1,29,0,1,1,0,1,1
03007662,56,9,47,0,0,0,0,0,1
03007934,45,2,43,0,1,1,0,1,1
03007935,45,2,43,0,1,1,0,1,1
03007938,40,2,38,0,1,1,0,1,1
03007943,33,2,31,0,1,1,0,1,1
03007944,49,2,47,0,1,1,0,1,1
03008394,6,4,2,0,1,1,0,1,1
03008538,14,0,14,0,0,0,0,0,1
03008745,12,5,7,0,0,0,0,0,1
03008820,45,0,45,0,0,0,0,0,1
03008942,14,4,10,0,0,0,0,0,1
03008953,6,3,3,0,2,2,0,0,1
03008968,32,3,29,0,1,1,0,1,1
03008985,14,4,10,0,1,1,0,1,1
03008987,20,0,20,0,1,1,0,1,1
03009023,10,5,5,0,1,1,0,1,1
03009111,10,2,8,0,0,0,0,0,1
03009141,44,6,38,0,0,0,0,0,0
03009426,44,5,39,0,1,1,0,1,1
03009441,11,0,11,0,0,0,0,0,0
03009473,10,3,7,0,3,3,0,1,0
03009598,21,2,19,0,1,1,0,0,1
03009972,68,7,61,0,4,3,1,3,1
03009992,20,0,20,0,0,0,0,0,1
03010091,21,4,17,0,0,0,0,0,1
03010219,3,0,3,0,0,0,0,0,1
03010228,49,10,39,0,0,0,0,0,1
03010321,45,3,42,0,1,1,0,1,1
03010460,21,1,20,0,1,1,0,1,0
03010919,45,3,42,0,1,1,0,1,1
03011024,4,0,4,0,0,0,0,0,1
03011029,57,2,55,0,1,1,0,1,1
03011053,71,10,61,0,1,1,0,0,1
03011075,7,0,7,0,0,0,0,0,1
03011193,65,4,61,0,1,1,0,1,1
03011737,60,11,49,0,13,10,3,0,1
03011753,39,0,39,0,0,0,0,0,1
03011768,20,5,15,0,0,0,0,0,1
03011784,37,4,33,0,1,1,0,1,1
03012087,8,3,5,0,0,0,0,0,0
03012216,16,0,16,0,0,0,0,0,1
03012218,33,5,28,0,1,1,0,1,1
03012293,19,3,16,0,2,1,1,2,1
03012315,10,2,8,0,1,1,0,0,1
03012351,54,14,40,0,0,0,0,0,1
03012622,19,2,17,0,1,1,0,1,1
03012624,15,0,15,0,0,0,0,0,1
03012758,22,4,18,0,0,0,0,0,1
03013036,45,0,45,0,0,0,0,0,1
03013136,11,0,11,0,0,0,0,0,1
03013232,39,3,36,0,1,1,0,1,1
03013260,8,1,7,0,0,0,0,0,0
03013301,17,4,13,0,6,6,0,0,1
03013406,24,3,21,0,1,1,0,1,1
03013493,79,0,79,0,0,0,0,0,1
03013518,10,2,8,0,1,1,0,0,0
03013570,4,2,2,0,2,2,0,0,1
03013578,10,0,10,0,1,1,0,1,1
03013581,5,1,4,0,1,1,0,0,1
03013585,8,4,4,0,1,1,0,0,1
03013591,5,0,5,0,2,2,0,0,1
03013746,8,2,6,0,1,1,0,1,1
03014046,5,2,3,0,2,2,0,0,1
03014351,25,3,22,0,0,0,0,0,0
03014389,9,5,4,0,2,2,0,0,1
03014422,18,4,14,0,0,0,0,0,0
03014594,12,4,8,0,1,1,0,0,0
03014889,22,3,19,0,2,1,1,2,1
03015012,101,13,88,0,1,1,0,0,1
03015175,13,4,9,0,1,1,0,1,1
03015215,18,2,16,0,1,1,0,1,1
03015434,13,3,10,0,1,1,0,1,1
03015439,21,5,16,0,1,1,0,0,1
03015817,12,0,12,0,0,0,0,0,1
03015880,6,2,4,0,0,0,0,0,1
03016120,9,2,7,0,2,2,0,0,1
03016409,28,3,25,0,1,1,0,1,1
03016445,9,1,8,0,1,1,0,0,1
03016796,26,9,17,0,0,0,0,0,1
03016827,6,3,3,0,2,2,0,0,0
03016875,10,2,8,0,2,2,0,1,0
03016902,15,0,15,0,0,0,0,0,1
03017046,26,0,26,0,0,0,0,0,1
03017258,30,5,25,0,2,1,1,1,1
03017341,4,0,4,0,0,0,0,0,1
03017402,10,2,8,0,1,1,0,0,1
03017503,15,3,12,0,2,2,0,0,1
03017758,4,2,2,0,0,0,0,0,0
03017841,28,14,14,0,2,1,1,2,0
03017958,48,3,45,0,1,1,0,1,1
03018113,5,3,2,0,2,2,0,0,1
03018519,30,5,25,0,1,1,0,1,1
03019029,14,1,13,0,1,1,0,1,1
03019081,43,10,33,0,0,0,0,0,1
03019096,17,5,12,0,0,0,0,0,1
03019108,13,6,7,0,0,0,0,0,1
03019187,9,3,6,0,1,1,0,0,1
03019190,4,0,4,0,1,1,0,0,0
03019293,100,0,100,0,0,0,0,0,1
03019355,21,0,21,0,0,0,0,0,1
03019717,13,3,10,0,0,0,0,0,1
03019773,29,0,29,0,1,1,0,1,1
03019859,5,3,2,0,2,2,0,0,1
SC200076,38,0,38,0,1,1,0,1,1
SC200185,5,3,2,0,3,3,0,0,0
SC200212,32,4,28,0,1,1,0,1,1
SC200213,5,3,2,0,1,1,0,0,0
SC200368,7,0,7,0,0,0,0,0,0
SC200403,18,2,16,0,1,1,0,1,1
SC200436,5,0,5,0,0,0,0,0,1
SC200513,13,2,11,0,1,1,0,1,1
SC200596,12,4,8,0,1,1,0,1,1
SC200700,5,0,5,0,0,0,0,0,0
SC200777,89,39,50,1,0,0,0,0,1
SC200827,52,11,41,1,0,0,0,0,1
SC200884,5,3,2,0,1,1,0,0,1
SC200887,29,3,26,0,2,1,1,2,1
SC200911,19,3,16,0,1,1,0,0,1
SC200914,11,3,8,0,1,1,0,1,1
SC200916,19,4,15,0,1,1,0,1,1
SC201063,25,0,25,0,1,1,0,1,1
SC201105,8,7,1,0,1,1,0,1,1
SC201246,6,0,6,0,1,1,0,0,1
SC201265,5,3,2,0,0,0,0,0,0
SC201378,14,3,11,0,0,0,0,0,1
SC201401,60,11,49,0,0,0,0,0,1
SC201416,13,5,8,0,1,1,0,1,1
SC201581,7,4,3,0,2,2,0,0,1
SC201645,27,10,17,0,5,1,4,0,0
SC201649,7,5,2,0,1,1,0,1,1
SC201651,9,3,6,0,0,0,0,0,1
SC201947,18,5,13,0,1,1,0,0,0
SC201982,5,1,4,0,2,1,1,0,0
SC202026,8,0,8,0,1,1,0,1,1
SC202088,11,3,8,0,2,2,0,0,1
SC202089,4,3,1,0,2,2,0,0,1
SC202102,28,8,20,0,1,1,0,1,1
SC202142,8,0,8,0,0,0,0,0,0
SC202170,18,4,14,0,1,1,0,1,1
SC202258,13,4,9,0,1,1,0,0,1
SC202264,29,2,27,0,0,0,0,0,1
SC202394,20,2,18,0,1,1,0,1,1
SC202445,52,5,47,0,0,0,0,0,0
SC202454,10,0,10,0,0,0,0,0,0
SC202791,47,7,40,0,0,0,0,0,1
SC202909,20,3,17,1,0,0,0,0,1
SC203062,7,0,7,0,0,0,0,0,1
SC203138,4,0,4,0,0,0,0,0,1
SC203174,8,0,8,0,0,0,0,0,1
SC203223,15,5,10,0,0,0,0,0,0
SC203416,15,3,12,0,2,2,0,0,1
SC203613,47,5,42,0,0,0,0,0,1
SC203624,22,0,22,0,0,0,0,0,1
SC203728,5,3,2,0,1,1,0,0,1
SC203732,13,0,13,0,0,0,0,0,1
SC203750,34,24,10,0,1,1,0,1,1
SC203853,12,3,9,0,3,2,1,0,1
SC204326,9,0,9,0,1,1,0,0,1
SC204327,10,0,10,0,1,1,0,1,1
SC204555,35,3,32,0,0,0,0,0,0
SC204564,6,2,4,0,1,1,0,1,0
SC204637,7,5,2,0,1,1,0,0,0
SC204757,26,3,23,0,1,1,0,1,1
SC204956,12,3,9,0,3,2,1,0,1
SC205004,52,9,43,0,0,0,0,0,0
SC205070,10,2,8,0,1,1,0,0,1
SC205206,21,0,21,0,0,0,0,0,1
SC205318,10,1,9,0,1,1,0,1,1
SC205426,17,2,15,0,1,1,0,1,1
SC205475,20,0,20,0,0,0,0,0,1
SC205538,4,2,2,0,1,1,0,1,1
SC205657,11,5,6,0,1,1,0,0,0
SC205786,6,4,2,0,2,2,0,0,0
SC206005,27,0,27,1,0,0,0,0,1
SC206116,21,0,21,0,0,0,0,0,1
SC206158,23,0,23,0,0,0,0,0,1
SC206283,9,2,7,0,1,1,0,0,1
SC206477,5,0,5,0,0,0,0,0,1
SC206683,18,3,15,0,1,1,0,1,1
SC206844,33,2,31,0,1,1,0,0,1
SC206936,16,0,16,0,0,0,0,0,1
SC206994,23,5,18,0,1,1,0,0,1
SC207126,31,6,25,0,1,1,0,1,0
SC207266,7,3,4,0,1,1,0,1,1
SC207268,14,0,14,0,0,0,0,0,1
SC207274,33,5,28,0,0,0,0,0,1
SC207309,12,0,12,0,0,0,0,0,1
SC207312,22,0,22,0,0,0,0,0,1
SC207313,7,0,7,0,0,0,0,0,1
SC207315,16,7,9,0,1,1,0,1,1
SC207316,5,2,3,0,1,1,0,0,1
SC207391,33,11,22,0,0,0,0,0,1
SC207497,5,2,3,1,2,2,0,0,1
SC207756,23,0,23,0,0,0,0,0,1
SC207810,5,0,5,0,1,1,0,0,1
SC207825,5,3,2,0,1,1,0,0,0
SC207862,6,5,1,0,1,1,0,0,1
SC207926,27,6,21,0,0,0,0,0,0
SC207937,6,3,3,0,2,2,0,0,0
SC207989,24,7,17,0,0,0,0,0,1
SC208030,14,0,14,0,0,0,0,0,1
SC208201,7,5,2,0,1,1,0,0,1
SC208241,20,10,10,0,0,0,0,0,0
SC208319,6,0,6,0,0,0,0,0,1
SC208512,4,2,2,0,1,1,0,0,0
SC208635,21,2,19,0,2,1,1,2,1
SC208806,21,0,21,1,1,1,0,1,1
SC208831,33,6,27,0,2,1,1,0,0
SC208837,9,1,8,0,1,1,0,0,1
SC208840,31,0,31,0,3,3,0,3,1
SC208934,32,3,29,0,2,2,0,2,1
SC208965,11,6,5,0,0,0,0,0,0
SC209016,7,3,4,0,2,2,0,0,0
SC209017,11,5,6,0,1,1,0,1,1
SC209090,21,0,21,0,1,1,0,1,1
SC209106,40,12,28,0,0,0,0,0,0
SC209111,8,1,7,0,1,1,0,0,0
SC209148,47,0,47,1,1,1,0,1,1
SC209180,16,0,16,0,0,0,0,0,1
SC209203,11,4,7,0,1,1,0,1,1
SC209205,13,0,13,0,1,1,0,1,1
SC209206,18,6,12,0,0,0,0,0,1
SC209297,11,0,11,0,0,0,0,0,1
SC209393,13,4,9,1,3,2,1,0,1
SC209837,11,1,10,0,3,1,2,0,1
SC209936,19,5,14,0,0,0,0,0,1
SC210035,21,3,18,0,1,1,0,1,1
SC210146,15,0,15,0,1,1,0,1,0
SC210229,14,7,7,0,1,1,0,0,1
SC210231,14,6,8,1,1,1,0,1,1
SC210263,28,15,13,0,1,1,0,1,1
SC210264,36,20,16,0,1,1,0,1,1
SC210282,18,0,18,0,0,0,0,0,1
SC210361,42,5,37,0,2,1,1,2,1
SC210423,24,0,24,1,0,0,0,0,1
SC210525,11,5,6,0,1,1,0,1,1
SC210599,13,0,13,0,0,0,0,0,1
SC210686,19,4,15,0,1,1,0,1,1
SC210712,10,3,7,0,1,1,0,1,1
SC210822,50,10,40,0,0,0,0,0,0
SC211082,5,2,3,0,0,0,0,0,0
SC211181,20,0,20,0,0,0,0,0,1
SC211185,9,4,5,0,1,1,0,1,1
SC211214,22,2,20,0,1,1,0,1,1
SC211318,5,3,2,0,2,2,0,0,0
SC211429,39,7,32,0,0,0,0,0,1
SC211524,28,3,25,0,2,1,1,2,1
SC211594,25,3,22,0,3,1,2,3,1
SC211701,10,2,8,0,3,1,2,1,1
SC211971,18,0,18,0,0,0,0,0,1
SC212146,0,0,0,0,0,0,0,0,1
SC212159,27,4,23,0,1,1,0,1,1
SC212253,10,4,6,0,1,1,0,1,1
SC212334,42,7,35,0,2,1,1,0,1
SC212396,8,0,8,0,0,0,0,0,1
SC212431,10,0,10,0,0,0,0,0,1
SC212532,8,5,3,0,3,3,0,0,1
SC212590,8,2,6,0,2,2,0,2,1
SC212591,8,2,6,0,2,2,0,2,1
SC212595,17,3,14,0,1,1,0,1,1
SC212718,10,0,10,0,1,1,0,1,0
SC212855,14,3,11,0,1,1,0,1,1
SC212906,7,0,7,0,0,0,0,0,1
SC213006,7,0,7,0,1,1,0,0,0
SC213049,15,5,10,0,3,1,2,1,1
SC213050,37,14,23,0,0,0,0,0,1
SC213155,20,2,18,0,1,1,0,1,1
SC213191,4,0,4,0,0,0,0,0,1
SC213269,7,0,7,0,0,0,0,0,1
SC213282,17,4,13,0,5,2,3,2,0
SC213295,7,0,7,0,0,0,0,0,1
SC213374,38,4,34,0,1,1,0,1,1
SC213376,38,4,34,0,1,1,0,1,1
SC213377,38,4,34,0,1,1,0,1,1
SC213381,7,2,5,1,1,1,0,1,1
SC213572,6,3,3,0,1,1,0,0,1
SC213606,6,0,6,1,1,1,0,0,1
SC213607,6,0,6,1,1,1,0,0,1
SC213640,17,6,11,1,1,1,0,1,1
SC213726,12,0,12,0,0,0,0,0,1
SC213984,6,4,2,0,1,1,0,0,1
SC213985,7,4,3,0,1,1,0,0,1
SC214001,4,2,2,0,1,1,0,0,0
SC214185,6,0,6,0,0,0,0,0,1
SC214199,4,2,2,0,1,1,0,0,0
SC214204,14,4,10,0,2,2,0,2,1
SC214269,35,8,27,0,0,0,0,0,0
SC214374,4,0,4,0,0,0,0,0,1
SC214415,13,4,9,0,1,1,0,1,1
SC214482,7,2,5,0,1,1,0,0,1
SC214564,119,22,97,0,0,0,0,0,1
SC214606,4,3,1,0,1,1,0,0,1
SC214681,43,7,36,1,0,0,0,0,1
SC214719,32,4,28,0,0,0,0,0,0
SC214791,50,8,42,0,0,0,0,0,0
SC214809,8,4,4,0,1,1,0,1,1
SC214816,7,4,3,0,4,4,0,0,1
SC214851,26,3,23,0,5,5,0,2,1
SC214859,9,6,3,0,2,2,0,1,1
SC214892,25,2,23,0,2,1,1,2,1
SC214915,58,0,58,0,0,0,0,0,1
SC214919,7,0,7,1,0,0,0,0,1
SC214930,8,0,8,0,0,0,0,0,1
SC215035,12,4,8,0,1,1,0,1,1
SC215097,22,0,22,0,1,1,0,1,1
SC215165,18,0,18,0,0,0,0,0,1
SC215476,6,2,4,0,2,2,0,0,0
SC215719,8,2,6,0,2,1,1,0,0
SC215744,9,4,5,0,1,1,0,0,0
SC215951,7,0,7,0,0,0,0,0,1
SC216001,8,3,5,0,1,1,0,0,0
SC216097,11,5,6,0,2,2,0,0,0
SC216180,11,3,8,0,1,1,0,1,0
SC216290,20,3,17,0,1,1,0,1,1
SC216395,7,2,5,0,1,1,0,0,0
SC216556,9,3,6,0,3,3,0,3,0
SC216638,24,6,18,0,0,0,0,0,1
SC216691,7,1,6,1,2,2,0,0,1
SC216821,2,2,0,0,0,0,0,0,1
SC216881,11,0,11,0,1,1,0,1,1
SC216955,11,0,11,0,1,1,0,1,1
SC216956,7,0,7,0,0,0,0,0,1
SC216992,23,6,17,0,1,1,0,1,1
SC217020,26,5,21,1,1,1,0,1,1
SC217093,33,6,27,0,1,1,0,1,1
SC217115,12,0,12,0,0,0,0,0,1
SC217150,7,3,4,0,1,1,0,0,0
SC217231,17,2,15,0,1,1,0,1,1
SC217265,28,7,21,0,1,1,0,1,1
SC217314,6,0,6,0,2,2,0,0,1
SC217367,38,6,32,0,0,0,0,0,1
SC217836,12,5,7,0,0,0,0,0,1
SC217931,31,5,26,0,1,0,1,0,0
SC217976,21,3,18,0,1,1,0,1,1
SC218026,68,12,56,0,1,0,1,0,1
SC218085,18,0,18,0,1,1,0,0,0
SC218588,3,2,1,0,1,1,0,0,1
SC218691,6,0,6,0,0,0,0,0,0
SC218749,13,4,9,0,1,1,0,1,1
SC218813,78,13,65,0,1,1,0,1,1
SC219011,13,3,10,0,2,2,0,0,1
SC219163,4,2,2,0,1,1,0,0,0
SC219233,10,3,7,1,1,1,0,0,1
SC219284,33,3,30,0,1,1,0,1,1
SC219319,43,6,37,0,0,0,0,0,1
SC219347,4,3,1,0,2,2,0,0,0
SC219483,15,3,12,0,2,1,1,1,1
SC219538,6,3,3,0,2,2,0,0,1
SC219601,32,9,23,0,0,0,0,0,1
SC219714,12,3,9,0,1,1,0,0,1
SC219765,23,0,23,1,0,0,0,0,1
SC219892,8,0,8,0,1,1,0,1,1
SC220213,34,8,26,0,0,0,0,0,1
SC220221,19,2,17,0,1,1,0,1,1
SC220297,81,13,68,0,0,0,0,0,1
SC220330,10,0,10,0,0,0,0,0,1
SC220379,10,0,10,0,0,0,0,0,1
SC220469,6,2,4,0,0,0,0,0,1
SC220711,10,1,9,0,1,1,0,0,1
SC220736,18,0,18,0,0,0,0,0,1
SC220804,2,0,2,0,0,0,0,0,1
SC220836,7,0,7,1,0,0,0,0,1
SC220907,9,3,6,0,2,2,0,0,1
SC220916,9,0,9,0,2,2,0,0,1
SC220929,6,3,3,0,1,1,0,0,1
SC220986,13,4,9,0,2,2,0,2,1
SC220987,8,4,4,0,2,1,1,0,1
SC220988,9,3,6,0,2,2,0,0,1
SC221013,7,0,7,0,0,0,0,0,1
SC221071,51,10,41,0,0,0,0,0,0
SC221093,8,4,4,0,2,1,1,0,1
SC221191,8,2,6,1,4,3,1,1,1
SC221240,4,2,2,1,1,1,0,0,1
SC221290,24,4,20,0,2,1,1,2,1
SC221428,23,8,15,0,0,0,0,0,1
SC221470,13,0,13,0,0,0,0,0,1
SC221592,18,0,18,1,1,1,0,1,1
SC221668,8,5,3,0,1,1,0,0,0
SC221813,11,7,4,0,0,0,0,0,0
SC221874,22,3,19,0,2,2,0,2,1
SC221954,35,5,30,0,1,1,0,1,1
SC222092,9,3,6,0,2,2,0,0,1
SC222126,6,4,2,0,2,2,0,0,0
SC222231,16,4,12,0,1,1,0,1,1
SC222304,6,4,2,0,1,1,0,0,1
SC222309,10,3,7,0,1,1,0,0,1
SC222439,32,13,19,0,0,0,0,0,1
SC222523,17,8,9,0,1,1,0,0,0
SC222542,2,2,0,0,1,1,0,0,1
SC222585,12,7,5,0,1,1,0,0,0
SC222904,14,3,11,0,0,0,0,0,1
SC223000,8,5,3,0,1,1,0,1,1
SC223015,15,2,13,0,1,1,0,1,1
SC223049,14,0,14,0,1,1,0,1,1
SC223101,14,0,14,0,1,1,0,1,1
SC223172,9,5,4,0,1,1,0,0,1
SC223286,6,0,6,0,0,0,0,0,1
SC223296,14,4,10,0,0,0,0,0,1
SC223302,45,12,33,0,0,0,0,0,1
SC223352,13,2,11,0,1,1,0,1,1
SC223362,14,6,8,0,1,1,0,1,1
SC223363,14,6,8,0,1,1,0,1,1
SC223616,7,2,5,0,1,1,0,0,1
SC223621,9,2,7,0,1,1,0,0,0
SC223801,22,8,14,0,2,2,0,2,0
SC224009,16,6,10,0,1,1,0,1,0
SC224070,15,6,9,0,0,0,0,0,0
SC224157,4,4,0,0,2,2,0,0,1
SC224158,4,4,0,0,2,2,0,0,1
SC224189,11,3,8,0,2,2,0,0,1
SC224193,5,2,3,0,0,0,0,0,1
SC224296,11,2,9,0,1,1,0,1,0
SC224403,16,2,14,0,1,1,0,1,1
SC224404,25,5,20,0,1,1,0,1,1
SC224459,9,2,7,0,2,2,0,0,1
SC224638,6,2,4,0,1,1,0,0,0
SC224718,27,7,20,0,0,0,0,0,0
02368235,39,4,35,0,1,1,0,1,1
02368530,33,1,32,0,3,1,2,0,1
02368728,26,3,23,0,1,1,0,1,1
02368763,39,0,39,0,0,0,0,0,1
02368966,15,0,15,0,0,0,0,0,1
02368991,7,2,5,0,1,1,0,1,0
02369239,58,23,35,0,0,0,0,0,1
02369251,6,5,1,0,2,2,0,0,1
02369679,37,5,32,0,1,1,0,1,1
02369719,36,11,25,0,0,0,0,0,1
02369721,27,0,27,0,0,0,0,0,1
02369824,37,3,34,0,2,1,1,2,1
02369828,98,0,98,0,0,0,0,0,1
02369965,42,4,38,0,1,1,0,1,1
02370089,33,0,33,0,1,1,0,1,1
02370374,10,5,5,0,0,0,0,0,1
02370509,30,0,30,0,0,0,0,0,1
02370591,13,3,10,0,2,2,0,0,1
02370592,51,3,48,0,0,0,0,0,1
02370612,39,3,36,0,0,0,0,0,1
02370868,62,11,51,0,0,0,0,0,1
02370894,25,4,21,0,1,1,0,1,1
02371112,16,4,12,0,1,1,0,0,1
02371452,22,5,17,0,1,1,0,0,0
02372056,13,3,10,0,3,3,0,1,1
02372114,21,0,21,0,0,0,0,0,1
02372255,22,3,19,0,1,1,0,1,1
02372311,36,3,33,0,1,1,0,1,1
02372439,48,7,41,0,1,1,0,1,1
02372487,34,3,31,0,1,1,0,1,1
02372592,20,0,20,0,1,1,0,1,1
02372619,4,1,3,0,1,1,0,0,1
02372740,53,22,31,0,0,0,0,0,1
02372789,51,4,47,0,1,1,0,1,1
02373160,9,3,6,0,1,1,0,0,1
02373389,13,3,10,0,1,1,0,1,1
02373490,18,3,15,0,1,1,0,1,1
02373630,83,8,75,0,0,0,0,0,1
02374117,22,0,22,0,0,0,0,0,1
02374322,2,0,2,0,0,0,0,0,1
02374570,73,0,73,0,0,0,0,0,1
02374985,19,4,15,0,3,3,0,0,1
02375067,7,3,4,0,1,1,0,0,1
02375077,41,8,33,0,3,3,0,1,1
02375426,34,0,34,0,0,0,0,0,1
02375859,25,0,25,0,0,0,0,0,1
02375865,37,4,33,0,1,1,0,1,1
02375927,6,4,2,0,2,2,0,0,1
02375962,16,3,13,0,0,0,0,0,1
02375963,44,0,44,0,1,1,0,1,1
02376257,9,4,5,0,0,0,0,0,0
02376427,5,3,2,0,2,2,0,0,1
02376684,62,9,53,0,1,1,0,1,1
02376698,20,3,17,0,0,0,0,0,1
02376828,17,0,17,0,0,0,0,0,1
02376959,37,4,33,0,1,1,0,1,1
02376963,21,5,16,0,1,1,0,1,1
02377225,9,2,7,0,1,1,0,0,0
02377581,2,2,0,0,1,1,0,0,0
02378070,24,5,19,0,1,1,0,0,1
02378072,10,2,8,0,1,1,0,0,0
02378467,19,6,13,0,1,1,0,0,1
02378784,18,4,14,0,0,0,0,0,0
02379259,3,0,3,0,0,0,0,0,1
02379280,41,16,25,0,0,0,0,0,1
02379479,56,9,47,0,1,1,0,1,1
02379610,7,3,4,0,1,1,0,0,0
02379795,6,0,6,0,0,0,0,0,1
02379800,56,0,56,0,1,1,0,1,1
02379804,55,3,52,0,1,1,0,1,1
02380110,30,3,27,0,1,1,0,1,1
02380446,0,0,0,0,0,0,0,0,1
02380564,171,13,158,0,0,0,0,0,1
02380675,50,6,44,0,0,0,0,0,1
02381492,3,0,3,0,0,0,0,0,1
02381543,30,2,28,0,1,1,0,1,1
02381718,38,7,31,0,0,0,0,0,1
02381891,39,7,32,0,0,0,0,0,1
02382187,15,0,15,0,0,0,0,0,1
02382808,31,4,27,0,1,1,0,1,1
02382822,46,28,18,0,0,0,0,0,1
02382824,47,28,19,0,0,0,0,0,1
02382855,0,0,0,0,0,0,0,0,1
02382941,14,0,14,0,1,1,0,1,1
02383031,24,2,22,0,1,1,0,1,1
02383045,35,10,25,0,11,10,1,0,0
02383574,25,0,25,0,0,0,0,0,1
02383590,25,3,22,0,1,1,0,1,1
02383683,22,7,15,0,0,0,0,0,1
02383863,41,6,35,0,0,0,0,0,1
02383959,40,10,30,0,0,0,0,0,1
02384039,6,2,4,0,0,0,0,0,1
02385160,18,5,13,0,0,0,0,0,1
02385197,34,5,29,0,1,1,0,1,1
02385277,27,4,23,0,2,1,1,2,1
02385322,21,4,17,0,1,1,0,1,1
02385383,11,2,9,0,5,4,1,0,1
02385734,17,2,15,0,1,1,0,1,1
02385818,29,3,26,0,1,1,0,1,1
02385991,23,6,17,0,1,1,0,0,1
02386168,16,2,14,0,1,1,0,1,1
02386220,55,6,49,0,1,1,0,1,1
02386409,22,0,22,0,0,0,0,0,1
02386528,39,1,38,0,0,0,0,0,1
02386579,33,15,18,0,0,0,0,0,1
02387141,47,3,44,0,1,1,0,1,1
02387340,22,5,17,0,4,1,3,1,1
02387490,5,0,5,0,1,1,0,0,1
02387531,31,6,25,0,1,1,0,1,1
02387681,18,8,10,0,1,1,0,1,1
02387713,51,3,48,0,1,1,0,1,1
02387786,20,0,20,0,0,0,0,0,1
02387949,23,2,21,0,1,1,0,1,1
02388324,22,4,18,0,0,0,0,0,0
02388620,53,16,37,0,1,1,0,1,1
02388655,34,0,34,0,1,1,0,1,1
02388701,15,8,7,0,0,0,0,0,1
02388740,31,5,26,0,1,1,0,1,0
02388852,18,3,15,0,0,0,0,0,1
02389055,14,3,11,0,1,1,0,1,1
02389761,16,0,16,0,0,0,0,0,1
02389907,79,14,65,0,0,0,0,0,1
02390160,10,2,8,0,1,1,0,1,1
02390516,11,0,11,0,0,0,0,0,1
02390548,8,3,5,0,4,4,0,1,1
02390884,16,3,13,0,0,0,0,0,1
02390929,9,4,5,0,2,2,0,0,1
02390948,9,3,6,0,1,0,1,0,1
02391355,18,0,18,0,0,0,0,0,1
02391367,55,5,50,0,0,0,0,0,0
02391543,81,6,75,0,0,0,0,0,1
02391624,6,2,4,0,2,2,0,0,1
02391638,8,4,4,0,1,1,0,1,0
02392550,39,4,35,0,1,1,0,1,1
02392756,6,1,5,0,2,1,1,0,1
02392854,34,0,34,0,1,1,0,1,1
02393078,33,3,30,0,1,1,0,1,1
02393175,42,10,32,0,0,0,0,0,1
02393366,25,2,23,0,0,0,0,0,1
02393527,21,3,18,0,1,1,0,1,1
02394244,40,8,32,0,1,1,0,0,1
02394254,14,2,12,0,1,1,0,0,1
02394738,19,3,16,0,1,1,0,1,1
02395416,62,6,56,0,2,2,0,2,1
02395485,10,0,10,0,0,0,0,0,1
02396008,23,0,23,0,0,0,0,0,1
02396114,41,9,32,0,1,1,0,1,1
02396184,26,3,23,0,1,1,0,1,1
02396496,13,0,13,0,1,1,0,1,1
02396943,20,3,17,0,1,1,0,0,1
02397134,111,23,88,0,0,0,0,0,0
02397322,18,8,10,0,1,1,0,0,0
02397373,66,16,50,0,0,0,0,0,1
02397594,11,3,8,0,0,0,0,0,0
02397775,23,4,19,0,1,1,0,1,1
02398410,33,3,30,0,2,1,1,0,1
02398515,63,7,56,0,1,1,0,0,1
02398586,51,11,40,0,0,0,0,0,1
02398979,112,5,107,0,1,1,0,1,1
02398992,14,1,13,0,1,1,0,1,1
02399820,5,4,1,0,2,2,0,0,1
02400085,27,4,23,0,1,1,0,1,1
02400377,5,0,5,0,1,1,0,0,1
02400509,57,8,49,0,0,0,0,0,1
02400519,29,6,23,0,1,1,0,1,1
02400555,9,1,8,0,1,1,0,0,1
02400909,37,0,37,0,0,0,0,0,1
02400917,8,3,5,0,0,0,0,0,1
02400947,11,5,6,0,0,0,0,0,1
02400969,60,11,49,0,0,0,0,0,1
02400977,8,0,8,0,0,0,0,0,1
02401034,64,10,54,0,4,4,0,4,1
02401046,33,6,27,0,2,2,0,2,1
02401055,40,6,34,0,1,1,0,1,1
02401068,54,12,42,0,0,0,0,0,1
02401107,22,2,20,0,0,0,0,0,1
02401261,3,3,0,0,1,1,0,0,0
02401575,19,4,15,0,1,1,0,1,1
02401712,16,0,16,0,0,0,0,0,1
02402312,7,2,5,0,1,0,1,0,1
02402491,11,2,9,0,1,1,0,0,1
02402805,105,11,94,0,0,0,0,0,1
02402927,33,0,33,0,0,0,0,0,1
02403333,195,21,174,0,0,0,0,0,1
02403588,18,2,16,0,1,1,0,1,1
02403711,19,0,19,0,0,0,0,0,1
02403771,24,0,24,0,0,0,0,0,1
02403779,23,0,23,0,0,0,0,0,1
02403986,12,3,9,0,0,0,0,0,0
02404052,20,3,17,0,1,1,0,0,1
02404350,44,6,38,0,1,1,0,1,1
02404351,36,0,36,0,1,1,0,1,1
02404792,7,2,5,0,1,1,0,0,1
02404920,8,0,8,0,1,1,0,1,1
02405030,14,3,11,0,1,1,0,1,1
02405166,22,2,20,0,1,1,0,1,1
02405306,22,2,20,0,1,1,0,1,1
02405307,24,2,22,0,1,1,0,1,1
02405490,33,3,30,0,3,2,1,3,1
02405523,20,5,15,0,1,1,0,0,1
02405546,18,3,15,0,1,1,0,1,1
02405739,4,2,2,0,1,1,0,0,0
02405764,5,3,2,0,2,2,0,0,0
02405903,15,4,11,0,6,6,0,5,1
02406054,35,3,32,0,1,1,0,1,1
02406236,11,2,9,0,1,1,0,0,1
02406298,18,0,18,0,0,0,0,0,1
02407078,12,0,12,0,3,2,1,0,0
02407250,21,5,16,0,0,0,0,0,1
02407613,17,2,15,0,1,1,0,1,1
02407769,17,0,17,0,0,0,0,0,1
02407799,42,4,38,0,1,1,0,1,1
02407924,51,3,48,0,1,1,0,1,1
02407940,38,0,38,0,0,0,0,0,1
02408386,46,0,46,0,0,0,0,0,1
02408422,0,0,0,0,0,0,0,0,0
02408646,23,3,20,0,1,1,0,1,1
02408840,6,2,4,0,1,1,0,0,0
02408948,4,3,1,0,3,3,0,1,1
02409015,25,2,23,0,0,0,0,0,1
02409699,6,2,4,0,1,1,0,0,0
02409902,70,9,61,0,0,0,0,0,1
02410197,25,3,22,0,9,4,5,1,1
02410244,27,2,25,0,1,1,0,0,1
02410479,35,3,32,0,0,0,0,0,1
02410626,66,14,52,0,1,1,0,1,1
02410798,12,0,12,0,0,0,0,0,1
02410810,41,3,38,0,1,1,0,1,1
02410817,43,0,43,0,0,0,0,0,1
02410818,33,4,29,0,1,1,0,1,1
02411055,49,15,34,0,0,0,0,0,1
02411065,13,1,12,0,1,1,0,0,1
02411202,5,2,3,0,1,1,0,0,1
02411699,7,2,5,0,1,1,0,0,0
02411786,103,11,92,0,0,0,0,0,1
02411791,43,7,36,0,0,0,0,0,1
02412046,35,8,27,0,0,0,0,0,1
02412105,10,8,2,0,2,2,0,0,0
02412299,81,12,69,0,9,4,5,0,1
02412572,7,0,7,0,0,0,0,0,1
02412609,16,4,12,0,1,1,0,1,0
02412647,27,2,25,0,0,0,0,0,1
02412962,63,0,63,0,0,0,0,0,1
02413137,28,5,23,0,1,1,0,1,1
02413321,57,4,53,0,1,1,0,1,1
02413547,44,10,34,0,0,0,0,0,1
02413697,5,3,2,0,2,2,0,0,1
02413714,35,6,29,0,0,0,0,0,1
02413730,1,0,1,0,0,0,0,0,1
02414033,12,3,9,0,1,1,0,1,1
02414212,75,6,69,0,1,1,0,1,1
02414283,51,9,42,0,1,1,0,1,1
02414292,22,4,18,0,3,2,1,0,1
02414298,8,3,5,0,0,0,0,0,1
02414308,13,3,10,0,2,2,0,0,0
02414443,14,3,11,0,1,1,0,1,1
02414459,14,3,11,0,1,1,0,1,1
02414472,31,5,26,0,0,0,0,0,1
02414480,29,0,29,0,1,1,0,1,1
02414649,2,2,0,0,1,1,0,0,1
02414699,53,13,40,0,0,0,0,0,1
02414704,10,6,4,0,2,2,0,0,1
02414884,21,2,19,0,1,1,0,0,0
02414997,32,5,27,0,1,1,0,1,1
02415070,9,0,9,0,0,0,0,0,1
02415211,26,7,19,0,0,0,0,0,1
02415283,5,0,5,0,0,0,0,0,1
02415387,15,4,11,0,1,1,0,1,1
02415597,25,0,25,0,0,0,0,0,1
02415637,18,2,16,0,0,0,0,0,1
02415684,16,0,16,0,0,0,0,0,1
02415777,3,1,2,0,1,1,0,0,0
02415826,22,3,19,0,1,1,0,1,1
02415956,12,0,12,0,2,2,0,2,1
02416082,22,3,19,0,1,1,0,1,1
02416242,262,27,235,0,0,0,0,0,1
02416818,0,0,0,0,0,0,0,0,1
02416904,25,5,20,0,1,1,0,1,1
02417014,29,3,26,0,1,1,0,1,1
02417119,31,4,27,0,0,0,0,0,1
02417385,17,2,15,0,2,1,1,0,0
02417647,5,3,2,0,2,2,0,0,0
02418209,18,3,15,0,1,1,0,0,0
02418670,19,6,13,0,0,0,0,0,0
02418844,15,3,12,0,1,1,0,1,1
02418965,30,4,26,0,1,1,0,1,1
02419098,3,3,0,0,2,2,0,0,1
02419432,38,3,35,0,0,0,0,0,1
02419491,28,0,28,0,0,0,0,0,1
08330057,22,13,9,0,0,0,0,0,1
08330162,12,9,3,0,0,0,0,0,1
08330611,2,2,0,0,2,2,0,0,0
08330634,5,2,3,0,2,2,0,0,1
08330731,3,3,0,0,1,1,0,1,0
08330875,3,0,3,0,2,2,0,0,0
08331397,4,3,1,0,1,1,0,0,1
08331440,4,0,4,0,0,0,0,0,1
08331556,5,4,1,0,1,1,0,1,1
08331837,16,5,11,0,1,1,0,1,1
08331870,16,5,11,0,1,1,0,1,1
08331918,9,0,9,0,1,1,0,1,1
08331920,3,2,1,0,1,1,0,0,0
08332200,2,1,1,0,1,1,0,0,0
08332793,2,2,0,0,3,3,0,0,0
08333128,3,0,3,0,0,0,0,0,1
08333148,2,1,1,0,2,1,1,0,0
08333185,2,2,0,0,1,1,0,0,0
08333462,2,2,0,0,0,0,0,0,0
08333464,7,4,3,0,2,0,2,2,1
08334023,26,14,12,0,0,0,0,0,1
08334182,1,1,0,0,1,1,0,0,0
08334284,3,1,2,0,1,1,0,0,0
08334627,10,4,6,0,0,0,0,0,0
08334736,2,1,1,0,1,1,0,0,0
08334743,20,11,9,0,0,0,0,0,1
08334798,14,4,10,0,0,0,0,0,0
08334906,4,3,1,0,1,1,0,0,1
08334960,11,10,1,0,1,1,0,0,1
08335008,4,4,0,0,2,2,0,0,1
08335167,2,2,0,0,2,2,0,0,0
08335307,2,2,0,0,2,2,0,0,0
08335412,2,2,0,0,2,2,0,0,1
08335543,2,1,1,0,1,1,0,0,1
08335726,12,4,8,0,1,1,0,1,1
08335734,2,0,2,0,0,0,0,0,0
08336170,1,1,0,0,1,1,0,0,1
08336173,26,10,16,0,0,0,0,0,0
08336197,3,2,1,0,1,1,0,0,1
08336279,2,0,2,0,0,0,0,0,0
08336356,3,2,1,0,1,1,0,0,0
08336375,1,1,0,0,1,1,0,0,0
08336516,4,3,1,0,3,2,1,0,0
08336545,2,1,1,0,1,1,0,0,0
08336774,2,2,0,0,1,1,0,0,0
08336902,2,0,2,0,0,0,0,0,1
08337023,3,0,3,0,0,0,0,0,1
08337433,1,0,1,0,0,0,0,0,0
08337483,2,2,0,0,1,1,0,0,0
08338106,2,2,0,0,1,1,0,0,0
08338562,2,0,2,0,0,0,0,0,0
08338585,9,0,9,0,1,1,0,0,1
08338746,2,0,2,0,1,1,0,1,1
08338820,3,3,0,0,1,1,0,0,0
08338967,4,4,0,0,3,2,1,0,1
08338976,4,4,0,0,3,3,0,0,1
08338990,4,4,0,0,1,1,0,0,0
08339155,2,1,1,0,1,1,0,0,0
08339379,7,6,1,0,0,0,0,0,0
08339700,1,1,0,0,1,1,0,1,0
08339761,5,0,5,0,2,2,0,0,1
08339878,24,6,18,0,3,2,1,0,1
08340090,20,10,10,0,0,0,0,0,1
08340943,1,0,1,0,1,1,0,0,0
08341226,14,7,7,0,2,2,0,0,0
08342169,9,4,5,0,0,0,0,0,1
08342552,2,0,2,0,0,0,0,0,1
08342655,5,5,0,0,1,1,0,0,1
08343538,2,1,1,0,1,1,0,0,0
08343828,4,0,4,0,0,0,0,0,1
08345177,1,1,0,0,1,1,0,0,1
08346019,10,3,7,0,1,1,0,1,0
08346406,5,4,1,0,1,1,0,0,1
08346842,4,3,1,1,1,1,0,0,0
08347210,1,0,1,0,1,1,0,0,0
08347261,5,3,2,0,1,1,0,1,1
08347668,2,0,2,0,0,0,0,0,1
08348098,2,0,2,0,0,0,0,0,0
08349379,2,0,2,0,1,1,0,0,0
08349593,1,1,0,0,1,1,0,0,1
08349638,5,3,2,0,2,2,0,2,1
08349970,1,0,1,0,0,0,0,0,0
08350628,3,2,1,0,1,1,0,0,1
08351191,20,4,16,0,1,1,0,1,1
08351391,3,3,0,0,2,2,0,0,1
08351666,5,2,3,0,2,2,0,0,1
08351960,14,4,10,0,1,1,0,1,1
08352052,5,2,3,0,0,0,0,0,0
08352060,2,2,0,0,2,2,0,0,0
08352444,13,0,13,1,1,1,0,0,0
08352523,1,1,0,0,1,1,0,0,0
08353025,2,0,2,0,1,1,0,0,1
08353048,5,0,5,0,0,0,0,0,0
08353749,1,1,0,0,0,0,0,0,0
08353765,2,2,0,0,2,2,0,0,0
08353993,5,0,5,0,0,0,0,0,0
08354847,8,3,5,0,1,1,0,1,1
08355422,4,2,2,0,2,2,0,0,1
08355539,17,3,14,0,0,0,0,0,1
08355806,2,1,1,0,1,1,0,0,0
08355909,5,1,4,0,0,0,0,0,0
08356293,3,0,3,0,1,1,0,0,1
08356550,3,0,3,0,0,0,0,0,1
08356706,41,16,25,0,0,0,0,0,0
08357105,2,2,0,0,1,1,0,0,1
08357422,2,2,0,0,2,2,0,0,0
08357697,4,4,0,0,2,2,0,0,1
08357799,1,0,1,0,0,0,0,0,1
08358047,1,0,1,0,1,1,0,0,0
08359040,6,5,1,0,0,0,0,0,0
08359073,1,1,0,0,1,1,0,0,0
08359113,21,5,16,0,0,0,0,0,1
08359339,1,0,1,0,0,0,0,0,0
08359705,14,9,5,0,1,1,0,0,0
08359812,2,0,2,0,1,1,0,0,0
08359889,21,7,14,0,3,0,3,0,1
08359989,13,9,4,0,0,0,0,0,1
08360076,3,3,0,0,1,1,0,0,1
08360915,32,15,17,0,0,0,0,0,1
08361655,8,3,5,0,1,1,0,0,1
08362347,7,1,6,0,3,1,2,0,1
08362391,3,0,3,0,1,1,0,1,1
08362598,18,12,6,0,0,0,0,0,1
08362867,2,2,0,0,1,1,0,0,0
08362956,1,1,0,0,1,1,0,1,1
08363016,27,9,18,0,13,8,5,0,1
08363068,1,1,0,0,1,1,0,1,1
08364253,4,3,1,0,1,1,0,0,1
08364254,3,0,3,0,0,0,0,0,1
08364663,5,2,3,0,2,2,0,0,0
08364786,1,1,0,0,2,2,0,0,0
08365274,2,2,0,0,1,1,0,0,0
08365506,2,0,2,0,1,1,0,0,0
08365637,2,0,2,0,0,0,0,0,1
08365878,2,0,2,0,0,0,0,0,1
08365973,6,4,2,0,5,3,2,0,0
08366029,13,12,1,0,0,0,0,0,1
08366038,3,0,3,0,0,0,0,0,1
08366041,7,3,4,0,1,1,0,0,1
08366427,1,1,0,0,1,1,0,0,0
08366557,2,2,0,0,1,1,0,0,0
08366681,2,2,0,0,2,2,0,0,1
08366788,1,0,1,0,0,0,0,0,1
08367081,3,3,0,0,2,2,0,0,1
08367867,14,4,10,0,1,1,0,1,1
08368233,1,1,0,0,2,2,0,0,0
08368317,1,1,0,0,1,1,0,0,0
08368341,1,1,0,0,1,1,0,0,0
08368437,8,7,1,0,0,0,0,0,1
08368640,2,2,0,0,1,1,0,0,0
08368769,1,0,1,0,0,0,0,0,1
08369008,5,4,1,0,1,1,0,1,0
08369331,4,2,2,0,2,2,0,0,0
08369977,2,0,2,0,1,1,0,0,0
08370047,2,2,0,0,1,1,0,0,0
08370399,22,0,22,0,0,0,0,0,1
08370423,1,1,0,0,1,1,0,0,0
08370622,7,1,6,0,1,1,0,1,1
08370766,6,3,3,0,1,1,0,1,1
08370902,2,1,1,0,1,1,0,0,0
08371016,1,0,1,0,0,0,0,0,0
08371113,9,1,8,0,1,1,0,1,0
08371130,4,0,4,0,0,0,0,0,1
08371198,3,0,3,0,0,0,0,0,1
08371944,4,4,0,0,3,3,0,0,0
08372184,3,0,3,0,0,0,0,0,1
08372228,15,3,12,0,2,1,1,2,1
08372327,5,2,3,0,3,2,1,0,0
08372779,4,3,1,0,1,1,0,1,1
08373408,5,2,3,0,1,1,0,1,1
08373440,2,2,0,0,1,1,0,1,0
08374172,2,0,2,0,0,0,0,0,0
08374250,6,3,3,0,0,0,0,0,0
08374283,9,8,1,0,0,0,0,0,1
08374352,21,6,15,0,2,1,1,2,1
08374570,8,0,8,0,1,1,0,1,1
08374655,15,6,9,0,1,1,0,1,1
08374714,4,2,2,0,1,1,0,0,1
08375453,2,2,0,0,1,1,0,0,0
08375599,5,3,2,0,2,1,1,0,1
08375655,3,2,1,0,3,3,0,0,0
08375918,2,1,1,0,2,1,1,0,0
08376361,3,2,1,0,2,1,1,0,0
08376381,10,6,4,0,1,1,0,1,1
08377340,3,2,1,0,2,2,0,0,0
08377494,23,0,23,0,0,0,0,0,1
08378172,3,2,1,0,1,1,0,0,0
08379362,1,0,1,0,0,0,0,0,1
08379496,1,1,0,0,1,1,0,0,0
08379687,5,4,1,0,1,1,0,1,1
08379841,1,1,0,0,1,1,0,0,0
08380017,1,1,0,0,1,1,0,0,0
08380062,2,0,2,0,0,0,0,0,1
08380557,2,1,1,0,2,2,0,0,0
08380611,1,1,0,0,1,1,0,0,1
08381013,2,2,0,0,2,2,0,0,0
08381300,9,4,5,1,1,1,0,1,1
08381392,2,2,0,0,1,1,0,0,0
08381599,5,0,5,0,0,0,0,0,1
08381835,1,1,0,0,1,1,0,0,0
08382010,6,2,4,0,1,1,0,0,0
08382179,13,9,4,0,0,0,0,0,1
08382409,3,1,2,0,1,1,0,0,0
08382795,2,1,1,0,1,1,0,0,0
08383049,5,0,5,0,0,0,0,0,1
08383281,4,0,4,0,0,0,0,0,0
08383471,1,0,1,0,0,0,0,0,0
08383499,2,2,0,0,1,1,0,1,0
08383568,3,3,0,0,1,1,0,0,1
08383620,1,1,0,0,1,1,0,0,1
08384125,20,14,6,0,0,0,0,0,1
08384134,2,1,1,0,0,0,0,0,1
08384169,5,4,1,0,0,0,0,0,0
08384386,2,0,2,0,1,1,0,0,1
08384590,2,0,2,0,1,1,0,0,0
08384723,15,7,8,0,10,9,1,0,1
08384783,1,0,1,0,0,0,0,0,1
08385190,4,2,2,0,1,1,0,0,1
08385527,3,1,2,0,1,1,0,1,1
08385534,2,0,2,0,0,0,0,0,1
08385640,7,3,4,0,0,0,0,0,0
08386622,1,1,0,0,2,2,0,0,0
08387042,6,6,0,0,2,2,0,0,1
08387265,11,2,9,0,0,0,0,0,1
08387357,2,0,2,0,0,0,0,0,1
08387405,1,1,0,0,2,2,0,0,0
08387616,3,0,3,0,0,0,0,0,0
08387837,9,6,3,0,1,1,0,1,1
08387957,3,3,0,0,3,3,0,0,1
08388118,18,10,8,0,3,3,0,3,1
08388119,1,1,0,0,1,1,0,0,0
08388197,7,5,2,0,2,2,0,0,1
08388945,1,0,1,0,1,1,0,0,0
08389092,1,0,1,0,0,0,0,0,0
08389118,20,8,12,0,2,1,1,0,0
08389326,2,1,1,0,1,1,0,0,0
08389495,2,2,0,0,1,1,0,0,0
08389890,2,1,1,0,1,1,0,0,1
08389945,1,0,1,0,0,0,0,0,1
08390003,4,3,1,0,1,1,0,0,0
08390044,1,0,1,0,0,0,0,0,1
08390750,1,1,0,0,1,1,0,0,1
08390995,5,3,2,0,1,1,0,0,1
08391032,5,0,5,0,3,3,0,0,1
08391210,14,8,6,0,0,0,0,0,0
08392167,1,1,0,0,1,1,0,0,0
08392713,9,2,7,0,1,1,0,0,0
08392771,1,0,1,0,0,0,0,0,0
08392938,3,1,2,0,1,1,0,0,0
08393301,3,3,0,0,1,1,0,1,0
08393552,4,4,0,0,2,2,0,0,0
08393683,2,0,2,0,0,0,0,0,1
08393780,3,0,3,0,1,1,0,0,1
08394114,3,2,1,0,1,1,0,0,0
08394782,1,1,0,0,2,2,0,0,0
08395104,5,3,2,0,0,0,0,0,1
08395289,3,2,1,0,4,2,2,0,1
08395296,21,10,11,0,1,1,0,1,1
08395345,1,0,1,0,1,1,0,0,0
08395657,1,0,1,0,0,0,0,0,0
08395925,3,0,3,0,1,1,0,0,1
08396817,3,1,2,0,1,1,0,0,0
08397102,4,0,4,0,0,0,0,0,0
08397106,4,4,0,0,2,2,0,0,0
08397816,4,3,1,0,3,2,1,0,0
08397898,3,0,3,0,0,0,0,0,0
08398077,4,4,0,0,2,2,0,1,1
08398246,2,0,2,0,0,0,0,0,0
08398544,5,4,1,0,2,2,0,1,1
08398703,2,2,0,0,1,1,0,0,0
08398865,2,1,1,0,1,1,0,0,0
08399381,1,1,0,0,1,1,0,0,0
08399454,2,2,0,0,2,2,0,0,0
08399899,7,2,5,0,1,1,0,1,1
08399940,8,3,5,0,5,3,2,0,0
08400066,2,2,0,0,2,2,0,0,0
08400389,1,1,0,0,1,1,0,0,1
08400453,5,5,0,0,1,1,0,1,1
08400456,3,2,1,0,1,1,0,0,0
08400703,6,3,3,0,1,1,0,1,1
08400725,3,3,0,0,2,2,0,0,0
08401078,1,1,0,0,1,1,0,0,1
08401447,1,1,0,0,1,1,0,0,0
08401483,2,2,0,0,2,2,0,0,0
08401726,6,0,6,0,1,1,0,1,1
08401887,22,0,22,0,0,0,0,0,0
08401925,4,3,1,0,1,1,0,0,0
08402166,12,10,2,0,0,0,0,0,0
08402413,7,2,5,0,2,1,1,0,1
08403099,6,0,6,0,0,0,0,0,1
08403342,2,1,1,0,1,1,0,0,0
08404129,1,1,0,0,1,1,0,0,0
08404165,1,1,0,0,1,1,0,0,0
08404285,2,2,0,0,2,1,1,1,0
08404561,1,1,0,0,1,1,0,0,0
08404719,2,2,0,0,2,2,0,2,1
08405214,2,2,0,0,1,1,0,0,1
08405458,2,2,0,0,1,1,0,0,1
08405479,2,1,1,0,2,2,0,0,1
08405514,1,0,1,0,0,0,0,0,1
08405548,7,0,7,0,0,0,0,0,1
08405629,3,2,1,0,1,1,0,1,1
08405783,2,1,1,0,1,1,0,0,0
08405786,14,4,10,0,1,1,0,1,1
08405840,14,4,10,0,1,1,0,1,1
08405885,14,4,10,0,1,1,0,1,1
08406148,4,3,1,0,2,2,0,1,0
08406149,23,10,13,0,0,0,0,0,0
08406156,3,0,3,0,0,0,0,0,1
08406187,2,1,1,0,1,1,0,0,0
08406289,1,1,0,0,1,1,0,0,1
08406303,2,0,2,0,1,1,0,0,0
08407119,4,2,2,0,2,2,0,0,0
08407458,6,3,3,0,2,1,1,2,1
08407961,24,5,19,0,0,0,0,0,0
08408021,7,0,7,0,0,0,0,0,1
08408211,19,7,12,0,0,0,0,0,1
08408338,5,3,2,0,0,0,0,0,1
08408637,3,3,0,0,2,1,1,0,0
08409289,21,9,12,0,0,0,0,0,0
08409361,14,8,6,0,0,0,0,0,1
08409391,1,1,0,0,1,1,0,0,0
08409517,2,1,1,0,1,1,0,0,0
08409621,4,4,0,0,2,2,0,0,1
08409650,11,3,8,0,1,1,0,1,1
08409765,6,2,4,0,1,1,0,0,1
08409810,1,0,1,0,0,0,0,0,0
03120147,19,10,9,0,2,2,0,0,1
03120328,22,5,17,0,1,1,0,0,1
03120443,60,10,50,0,0,0,0,0,1
03120593,15,8,7,0,0,0,0,0,1
03120716,30,6,24,0,1,1,0,1,1
03120768,8,0,8,0,0,0,0,0,1
03120930,20,5,15,0,1,1,0,1,1
03120977,7,3,4,0,1,1,0,0,1
03120999,40,4,36,0,1,1,0,1,1
03121110,29,3,26,0,1,1,0,1,1
03121229,35,0,35,0,0,0,0,0,1
03121594,43,4,39,0,0,0,0,0,1
03121679,32,12,20,0,0,0,0,0,1
03121688,50,3,47,0,0,0,0,0,1
03121690,16,2,14,0,0,0,0,0,0
03121772,19,0,19,0,0,0,0,0,1
03121862,16,5,11,0,2,2,0,0,1
03121985,8,0,8,0,1,1,0,0,0
03122085,76,2,74,0,1,1,0,1,1
03122495,51,13,38,0,1,1,0,1,1
03122827,7,0,7,0,0,0,0,0,1
03123160,22,0,22,0,0,0,0,0,1
03123290,16,4,12,0,1,1,0,1,1
03123349,22,3,19,0,1,1,0,1,1
03123464,14,3,11,0,1,1,0,0,1
03123470,14,3,11,0,1,1,0,0,1
03123544,19,3,16,0,0,0,0,0,1
03123555,5,1,4,0,1,1,0,0,0
03123592,51,8,43,0,1,1,0,0,1
03123764,14,0,14,0,0,0,0,0,1
03123961,8,4,4,0,1,1,0,0,1
03124410,34,10,24,0,1,0,1,1,1
03124566,19,7,12,0,1,1,0,0,1
03124651,29,2,27,0,1,1,0,1,1
03124721,14,8,6,0,1,1,0,1,1
03124785,27,5,22,0,1,1,0,1,1
03124788,33,2,31,0,1,1,0,1,1
03125176,7,3,4,0,1,1,0,0,1
03125198,19,0,19,0,0,0,0,0,1
03125316,8,4,4,0,1,1,0,0,1
03125492,12,4,8,0,1,1,0,0,1
03125686,38,6,32,0,0,0,0,0,0
03125802,13,5,8,0,2,2,0,2,1
03125913,23,9,14,0,0,0,0,0,1
03126017,10,1,9,0,1,1,0,0,1
03126031,28,1,27,0,0,0,0,0,1
03126168,35,4,31,0,1,1,0,1,1
03126301,17,3,14,0,1,1,0,1,1
03126311,10,3,7,0,4,2,2,0,1
03126488,11,0,11,0,0,0,0,0,1
03126711,15,3,12,0,1,1,0,1,1
03126815,7,0,7,0,1,1,0,1,0
03127123,3,3,0,0,2,2,0,0,0
03127226,40,12,28,0,0,0,0,0,1
03127415,7,2,5,0,2,2,0,0,1
03127843,21,3,18,0,3,3,0,0,1
03128187,14,3,11,0,3,1,2,1,0
03128229,4,2,2,0,1,1,0,0,1
03128328,6,2,4,0,2,1,1,1,1
03128485,7,0,7,0,0,0,0,0,1
03128558,35,8,27,0,0,0,0,0,1
03128694,49,15,34,0,0,0,0,0,0
03128830,9,0,9,0,0,0,0,0,1
03128842,11,0,11,0,0,0,0,0,1
03129297,15,2,13,0,1,0,1,0,1
03129327,24,0,24,0,0,0,0,0,1
03129533,16,4,12,0,5,4,1,0,0
03129592,25,3,22,0,2,1,1,2,1
03129594,27,3,24,0,2,1,1,1,1
03129950,25,6,19,0,2,2,0,2,1
03129955,4,2,2,0,1,1,0,0,0
03130127,12,4,8,0,1,1,0,1,1
03130188,13,4,9,0,1,1,0,1,1
03130238,30,0,30,0,0,0,0,0,1
03130433,15,7,8,0,0,0,0,0,1
03130876,53,12,41,0,0,0,0,0,1
03130909,3,0,3,0,2,2,0,0,1
03131273,29,8,21,0,1,1,0,1,1
03131278,6,3,3,0,1,1,0,1,1
03131485,30,2,28,0,1,1,0,1,1
03131624,27,4,23,0,1,1,0,1,1
03131750,0,0,0,0,0,0,0,0,0
03131810,13,0,13,0,0,0,0,0,1
03132110,45,4,41,0,1,1,0,1,1
03132165,20,0,20,0,1,1,0,1,1
03132202,23,0,23,0,0,0,0,0,1
03132257,18,4,14,0,1,1,0,1,1
03132259,7,2,5,0,1,1,0,0,1
03132432,43,0,43,0,1,1,0,1,1
03132487,60,3,57,0,0,0,0,0,1
03132671,5,1,4,0,1,1,0,0,0
03132944,67,6,61,0,0,0,0,0,1
03133029,8,2,6,0,2,1,1,0,1
03133130,15,0,15,0,0,0,0,0,1
03133226,61,10,51,0,1,1,0,1,1
03133249,7,1,6,0,1,1,0,0,0
03133310,18,0,18,0,0,0,0,0,1
03133472,16,0,16,0,0,0,0,0,1
03133599,42,5,37,0,0,0,0,0,1
03133815,13,2,11,0,1,1,0,1,1
03133845,21,0,21,0,1,1,0,1,1
03133858,11,1,10,0,2,2,0,0,0
03133863,18,2,16,0,1,1,0,1,1
03133879,4,2,2,0,1,0,1,0,0
03133919,6,2,4,0,2,2,0,0,0
03134026,10,2,8,0,0,0,0,0,1
03134175,36,3,33,0,1,1,0,1,1
03134290,33,3,30,0,1,1,0,1,1
03134383,18,3,15,0,1,1,0,1,1
03134462,8,4,4,0,1,1,0,0,1
03134540,42,2,40,0,2,1,1,2,1
03135001,23,0,23,0,0,0,0,0,1
03135090,5,2,3,0,1,1,0,0,0
03135100,36,0,36,0,0,0,0,0,1
03135106,40,0,40,0,0,0,0,0,1
03135129,23,5,18,0,2,2,0,1,1
03135205,35,8,27,0,0,0,0,0,1
03135472,25,3,22,0,0,0,0,0,1
03135512,20,0,20,0,1,1,0,1,1
03135522,35,2,33,0,1,1,0,1,1
03135528,36,3,33,0,0,0,0,0,1
03135543,36,3,33,0,1,1,0,1,1
03135558,6,2,4,0,1,1,0,0,1
03135565,5,0,5,0,2,2,0,0,1
03135882,27,4,23,0,1,1,0,1,1
03135945,31,4,27,0,11,2,9,0,1
03136055,23,3,20,0,0,0,0,0,1
03136090,27,2,25,0,1,1,0,1,1
03136223,34,0,34,0,0,0,0,0,1
03136293,37,3,34,0,1,1,0,1,1
03136611,6,2,4,0,1,1,0,0,0
03136695,13,2,11,0,0,0,0,0,0
03136977,11,0,11,0,1,1,0,1,1
03137001,24,0,24,0,0,0,0,0,1
03137028,13,0,13,0,1,1,0,1,1
03137094,10,4,6,0,1,1,0,1,1
03137395,18,7,11,0,1,1,0,1,1
03137449,42,4,38,0,1,1,0,1,1
03137494,13,2,11,0,1,1,0,1,1
03137515,24,6,18,0,1,1,0,1,1
03137571,18,5,13,0,1,1,0,1,1
03137720,66,7,59,0,0,0,0,0,1
03137730,26,0,26,0,1,1,0,0,1
03137740,18,0,18,0,0,0,0,0,1
03138087,18,3,15,0,0,0,0,0,1
03138274,35,5,30,0,3,1,2,0,0
03138390,42,4,38,0,1,1,0,1,1
03138443,23,0,23,0,0,0,0,0,1
03138509,9,4,5,0,2,2,0,0,1
03138574,8,2,6,0,1,1,0,1,1
03138683,50,15,35,0,0,0,0,0,1
03138736,4,2,2,0,2,2,0,0,1
03138868,25,0,25,0,1,1,0,1,1
03138870,14,3,11,0,1,1,0,1,1
03138881,22,3,19,0,0,0,0,0,1
03138896,29,4,25,0,2,2,0,2,0
03138920,13,4,9,0,2,2,0,0,1
03139019,28,5,23,0,0,0,0,0,1
03139024,9,1,8,0,1,1,0,0,1
03139400,23,4,19,0,1,1,0,1,1
03139474,6,2,4,0,2,2,0,0,0
03139685,27,7,20,0,6,6,0,0,1
03139715,19,3,16,0,1,1,0,1,1
03139876,20,8,12,0,5,1,4,1,0
03139917,26,3,23,0,1,1,0,1,1
03139948,26,3,23,0,1,1,0,1,1
03140076,48,5,43,0,6,3,3,0,1
03140204,34,5,29,0,0,0,0,0,1
03140258,21,4,17,0,1,1,0,1,1
03140273,45,4,41,0,1,1,0,1,1
03140291,22,2,20,0,1,1,0,1,1
03140430,13,3,10,0,1,1,0,0,1
03140596,38,3,35,0,1,1,0,1,1
03140646,12,0,12,0,0,0,0,0,0
03140769,55,10,45,0,0,0,0,0,1
03140878,36,3,33,0,1,1,0,0,1
03141073,19,7,12,0,0,0,0,0,1
03141599,7,2,5,0,1,1,0,0,1
03141667,28,3,25,0,1,1,0,1,1
03141679,33,3,30,0,1,1,0,1,1
03141707,16,4,12,0,1,1,0,1,1
03141709,13,2,11,0,0,0,0,0,1
03142133,27,8,19,1,0,0,0,0,1
03142214,33,3,30,0,1,1,0,1,1
03142604,25,6,19,0,5,5,0,0,0
03142608,7,0,7,0,0,0,0,0,1
03142642,35,2,33,0,0,0,0,0,1
03142715,16,3,13,0,1,1,0,0,1
03142762,30,7,23,0,0,0,0,0,1
03143004,23,3,20,0,1,0,1,0,0
03143125,26,0,26,0,0,0,0,0,0
03143355,22,5,17,0,0,0,0,0,0
03143673,43,10,33,0,0,0,0,0,0
03143692,11,1,10,0,3,1,2,2,1
03144016,25,4,21,0,1,0,1,1,1
03144035,7,3,4,0,1,1,0,0,1
03144066,67,7,60,0,1,1,0,1,1
03144067,27,4,23,0,1,1,0,1,1
03144199,65,9,56,0,1,1,0,1,1
03144234,12,1,11,0,0,0,0,0,1
03144465,30,4,26,0,1,1,0,1,1
03145014,9,0,9,0,0,0,0,0,0
03145216,28,6,22,0,1,1,0,1,1
03145283,4,2,2,0,1,1,0,0,1
03145609,15,0,15,0,1,1,0,1,1
03145691,39,4,35,0,1,1,0,1,1
03145704,29,6,23,0,1,1,0,1,1
03145846,21,0,21,0,1,1,0,1,1
03145848,21,3,18,0,1,1,0,1,1
03146114,16,7,9,0,2,1,1,1,1
03146280,19,5,14,0,1,1,0,1,1
03146736,26,5,21,0,1,1,0,1,1
03146770,49,11,38,0,0,0,0,0,1
03147000,5,1,4,0,1,1,0,0,0
03147122,12,3,9,0,3,3,0,0,1
03147164,51,9,42,0,2,2,0,2,1
03147490,17,1,16,0,1,1,0,1,1
03147725,5,3,2,0,2,2,0,0,1
03147851,70,0,70,0,0,0,0,0,1
03147927,28,2,26,0,1,1,0,1,1
03147949,56,5,51,0,1,1,0,1,1
03148073,9,2,7,0,2,2,0,0,0
03148085,6,3,3,0,2,2,0,0,1
03148086,33,3,30,0,1,1,0,1,1
03148118,30,4,26,0,1,1,0,1,1
03148311,17,3,14,0,4,4,0,0,1
03148352,12,3,9,0,1,1,0,1,1
03148432,30,3,27,0,1,1,0,1,1
03148588,12,3,9,0,1,1,0,0,0
03148926,6,4,2,0,2,2,0,0,1
03148949,14,0,14,0,0,0,0,0,1
03149336,5,3,2,0,1,1,0,1,0
03149760,49,15,34,0,0,0,0,0,1
03149785,32,4,28,0,1,1,0,1,0
03150113,9,3,6,0,1,1,0,0,0
03150205,6,0,6,0,1,1,0,0,1
03150227,11,2,9,0,0,0,0,0,1
03150316,8,0,8,0,0,0,0,0,0
03150348,13,1,12,0,1,1,0,1,1
03150522,14,1,13,0,1,1,0,0,1
03150680,21,0,21,0,1,1,0,1,1
03150771,32,3,29,0,1,1,0,1,1
03150813,5,3,2,0,1,1,0,0,0
03150875,187,14,173,0,0,0,0,0,1
03150876,13,5,8,0,0,0,0,0,1
03151011,6,3,3,0,1,1,0,1,1
03151270,15,2,13,0,1,1,0,1,1
03151334,53,2,51,0,1,1,0,1,1
03151878,54,6,48,0,10,5,5,0,0
03152115,23,3,20,0,1,1,0,1,1
03152137,6,4,2,0,1,1,0,0,0
03152455,5,3,2,0,1,1,0,0,0
03152569,31,0,31,0,2,1,1,2,1
03152606,33,4,29,0,0,0,0,0,1
03152636,27,0,27,0,0,0,0,0,1
03152721,11,5,6,0,0,0,0,0,0
03152730,23,2,21,0,1,1,0,1,1
03152823,11,5,6,0,0,0,0,0,0
03152835,11,5,6,0,0,0,0,0,0
03152986,28,6,22,0,0,0,0,0,1
03153131,11,5,6,0,0,0,0,0,0
03153279,8,0,8,0,1,0,1,0,1
03153384,14,5,9,0,0,0,0,0,1
03153391,55,2,53,0,1,1,0,1,1
03153398,13,0,13,0,1,1,0,1,1
03153490,37,3,34,0,1,1,0,1,1
03153494,35,0,35,0,1,1,0,1,1
03153646,4,2,2,0,1,1,0,0,1
03153895,44,11,33,0,0,0,0,0,1
03154038,17,0,17,0,0,0,0,0,1
03154125,22,0,22,0,0,0,0,0,1
03154765,19,0,19,0,0,0,0,0,1
03155192,9,1,8,0,5,2,3,0,1
03155211,18,4,14,0,1,1,0,1,1
03155367,16,5,11,0,1,1,0,0,1
03155620,81,10,71,0,1,1,0,1,1
03155652,15,5,10,0,1,1,0,1,1
03155839,6,0,6,0,0,0,0,0,1
03156028,9,5,4,0,1,1,0,1,0
03156159,56,5,51,0,1,1,0,1,1
03156479,21,3,18,0,1,1,0,1,1
03156599,7,3,4,0,2,2,0,0,1
03156676,20,7,13,0,0,0,0,0,1
03156792,24,0,24,0,1,1,0,1,1
03156893,9,3,6,0,1,1,0,0,1
03156927,8,3,5,0,1,1,0,1,0
03157061,6,1,5,0,1,1,0,0,0
03157076,21,8,13,0,1,1,0,0,1
03157153,6,3,3,0,2,2,0,0,1
03157171,24,10,14,0,0,0,0,0,1
03157276,4,2,2,0,1,1,0,0,1
03157535,5,2,3,0,1,1,0,0,1
03157625,53,10,43,0,2,2,0,2,1
03157634,70,9,61,0,1,1,0,1,1
03157646,60,6,54,0,0,0,0,0,1
03157685,7,3,4,0,2,1,1,2,1
03157759,18,3,15,0,2,2,0,2,1
03157760,30,5,25,0,2,2,0,1,1
03157930,5,3,2,0,3,2,1,0,1
03157977,26,0,26,0,0,0,0,0,1
03158105,22,5,17,0,1,1,0,1,1
03158106,28,4,24,0,1,1,0,1,1
03158108,28,0,28,0,0,0,0,0,1
03158254,5,2,3,0,1,1,0,0,0
03158306,16,6,10,0,0,0,0,0,1
03158788,8,2,6,0,0,0,0,0,1
03158846,13,2,11,0,1,1,0,1,1
03158868,7,3,4,0,1,1,0,0,0
03159029,46,10,36,0,3,2,1,0,1
03159256,13,0,13,0,0,0,0,0,1
03159306,16,0,16,0,0,0,0,0,1
03159446,6,3,3,0,2,2,0,0,0
03160188,7,2,5,0,2,2,0,0,0
03160344,20,5,15,0,0,0,0,0,1
03160526,51,13,38,0,0,0,0,0,1
03160563,5,3,2,0,1,1,0,0,1
03160586,16,0,16,0,0,0,0,0,1
03160831,7,1,6,0,1,1,0,1,1
03160854,5,3,2,0,2,2,0,0,1
03160902,22,4,18,0,1,1,0,0,1
03161085,28,2,26,0,2,2,0,2,1
03161219,30,2,28,0,1,1,0,1,1
03161225,24,2,22,0,1,1,0,1,1
03161354,44,8,36,0,1,1,0,0,0
03161448,7,3,4,0,2,2,0,0,1
03161651,6,3,3,0,2,2,0,0,1
03161821,40,6,34,0,1,1,0,1,1
03161850,11,2,9,0,1,1,0,0,1
03161906,5,0,5,0,0,0,0,0,1
03162046,29,2,27,0,4,1,3,4,1
03162063,3,1,2,0,1,1,0,0,1
03162289,33,2,31,0,1,1,0,1,1
03162429,29,13,16,0,0,0,0,0,1
03162439,16,3,13,0,1,1,0,1,1
03162540,39,0,39,0,0,0,0,0,1
03162555,29,4,25,0,0,0,0,0,1
03162829,28,8,20,0,1,1,0,1,1
03162873,61,11,50,0,1,1,0,0,1
03162882,18,0,18,0,0,0,0,0,1
03162897,40,5,35,0,1,1,0,1,1
03163027,22,3,19,0,0,0,0,0,1
03163028,8,2,6,0,1,1,0,0,1
03163051,19,4,15,0,1,1,0,1,1
03163069,21,0,21,0,0,0,0,0,1
03163167,9,2,7,0,0,0,0,0,1
03163187,99,15,84,0,0,0,0,0,1
03163230,36,5,31,0,1,1,0,1,1
03163233,14,6,8,0,0,0,0,0,1
03163624,22,9,13,0,0,0,0,0,1
03163638,8,3,5,0,1,1,0,0,1
03163754,64,8,56,0,0,0,0,0,1
03164247,22,7,15,0,5,5,0,0,1
03164365,15,7,8,0,1,1,0,1,1
03164431,36,11,25,0,0,0,0,0,1
03164472,7,3,4,0,0,0,0,0,1
03164540,20,0,20,0,0,0,0,0,1
03164889,5,3,2,0,2,2,0,0,1
03164990,4,1,3,0,1,1,0,0,1
03165122,30,0,30,0,0,0,0,0,1
03165130,20,8,12,0,0,0,0,0,0
03165147,37,3,34,0,1,1,0,1,1
03165181,7,0,7,0,0,0,0,0,1
03165591,29,4,25,0,0,0,0,0,1
03165755,3,3,0,0,2,2,0,0,1
03165762,19,7,12,0,7,7,0,0,1
03165788,6,2,4,0,1,1,0,0,1
03165809,16,7,9,0,0,0,0,0,1
03165836,30,10,20,0,0,0,0,0,1
03166339,60,13,47,0,0,0,0,0,1
03166361,140,9,131,0,0,0,0,0,1
03166376,21,4,17,0,3,3,0,0,1
03166592,11,0,11,0,0,0,0,0,1
03166614,12,0,12,0,0,0,0,0,1
03166701,34,8,26,0,2,1,1,2,1
03166785,7,4,3,0,1,1,0,1,1
03167262,7,2,5,0,3,3,0,1,0
03167477,15,4,11,0,0,0,0,0,1
03167586,45,0,45,0,1,1,0,1,1
03167622,48,5,43,0,1,1,0,1,1
03167637,7,4,3,0,1,1,0,1,1
03168082,31,9,22,0,1,1,0,1,1
03168108,30,14,16,0,0,0,0,0,1
03168139,10,0,10,0,0,0,0,0,1
03168401,8,4,4,0,2,2,0,0,1
03168611,29,3,26,0,2,2,0,2,1
03168873,9,3,6,0,4,3,1,0,0
03168893,6,2,4,0,1,1,0,0,0
03168918,31,0,31,0,3,2,1,1,1
03169278,40,0,40,0,1,1,0,1,1
03169281,40,11,29,0,1,1,0,1,1
03169284,24,3,21,0,1,1,0,1,1
03169368,19,0,19,0,0,0,0,0,1
03169411,20,4,16,0,1,1,0,1,1
03169422,31,4,27,0,1,1,0,1,1
03169474,16,5,11,0,1,1,0,1,1
03169578,16,2,14,0,6,2,4,0,0
03169600,53,12,41,0,1,0,1,1,1
03169665,50,9,41,0,0,0,0,0,1
03169833,29,3,26,0,1,1,0,1,1
SC389077,9,0,9,0,2,1,1,0,0
SC389092,6,3,3,1,1,1,0,1,1
SC389127,1,1,0,0,1,1,0,0,0
SC389327,3,1,2,0,1,1,0,0,0
SC389404,10,5,5,0,0,0,0,0,0
SC389810,4,0,4,0,0,0,0,0,1
SC390019,6,3,3,0,1,1,0,0,1
SC390021,6,2,4,0,1,1,0,0,1
SC390206,4,2,2,0,2,1,1,0,1
SC390210,17,4,13,0,1,1,0,1,1
SC390229,4,3,1,0,2,0,2,0,1
SC390534,2,2,0,0,2,2,0,0,0
SC390582,3,2,1,0,2,2,0,0,0
SC390621,12,0,12,0,0,0,0,0,0
SC390655,2,2,0,0,2,2,0,0,0
SC390698,26,14,12,0,14,12,2,0,0
SC390699,4,0,4,0,0,0,0,0,1
SC390736,2,2,0,0,2,2,0,0,1
SC390738,2,2,0,0,2,2,0,0,1
SC391048,3,0,3,0,0,0,0,0,1
SC391158,5,0,5,0,0,0,0,0,1
SC391385,4,0,4,0,0,0,0,0,0
SC391468,9,0,9,0,0,0,0,0,0
SC391580,14,3,11,0,1,0,1,0,0
SC391905,7,6,1,0,1,1,0,1,1
SC392285,13,4,9,0,1,1,0,1,1
SC392291,13,5,8,0,2,2,0,2,1
SC392332,4,1,3,0,1,1,0,0,0
SC392386,10,7,3,0,0,0,0,0,0
SC392560,5,3,2,0,2,2,0,0,0
SC392759,8,0,8,0,1,1,0,1,1
SC392873,2,2,0,0,0,0,0,0,0
SC392928,4,1,3,0,4,4,0,0,0
SC393096,8,2,6,0,1,1,0,1,1
SC393097,8,0,8,0,0,0,0,0,1
SC393098,8,4,4,0,3,1,2,3,1
SC393275,7,2,5,0,1,1,0,0,0
SC393430,4,3,1,0,0,0,0,0,0
SC393459,5,2,3,1,1,1,0,1,1
SC393460,5,2,3,1,1,1,0,1,1
SC393589,9,0,9,0,0,0,0,0,0
SC393645,7,4,3,0,2,2,0,0,0
SC393648,4,2,2,0,1,1,0,0,0
SC393671,2,2,0,0,2,2,0,0,0
SC393873,5,0,5,0,1,1,0,0,1
SC393967,5,5,0,0,0,0,0,0,0
SC394126,3,0,3,0,0,0,0,0,1
SC394162,2,1,1,0,1,1,0,0,0
SC394169,3,3,0,0,2,2,0,0,0
SC394203,3,0,3,0,0,0,0,0,0
SC394389,1,0,1,0,0,0,0,0,0
SC394519,13,4,9,0,1,1,0,1,1
SC394595,1,1,0,0,1,1,0,0,0
SC394614,3,2,1,0,2,2,0,0,1
SC394622,3,3,0,0,1,1,0,1,0
SC394656,3,2,1,0,2,2,0,0,0
SC394684,1,1,0,0,1,1,0,0,0
SC394689,7,4,3,0,1,1,0,1,1
SC394690,7,4,3,0,1,1,0,1,1
SC394691,7,4,3,0,1,1,0,1,1
SC394695,3,3,0,0,3,3,0,0,1
SC394719,1,1,0,0,1,1,0,0,1
SC394794,5,0,5,0,1,1,0,0,0
SC395007,5,2,3,0,4,2,2,0,0
SC395082,13,5,8,0,0,0,0,0,0
SC395262,4,2,2,0,3,1,2,1,0
SC395396,6,4,2,0,3,0,3,0,1
SC395537,20,6,14,0,1,1,0,1,0
SC395600,12,5,7,0,1,1,0,0,0
SC395671,5,4,1,0,1,1,0,0,1
SC395787,4,2,2,0,1,1,0,1,1
SC395835,3,1,2,0,1,1,0,0,0
SC395892,5,4,1,0,3,3,0,0,1
SC395896,4,0,4,0,0,0,0,0,1
SC395973,2,1,1,0,1,1,0,0,0
SC395976,12,3,9,0,1,1,0,1,1
SC395977,19,3,16,0,1,1,0,1,1
SC396230,7,0,7,0,0,0,0,0,1
SC396516,3,2,1,0,1,1,0,0,1
SC396838,23,8,15,0,5,0,5,0,0
SC396877,6,5,1,0,2,2,0,1,1
SC397096,8,0,8,0,0,0,0,0,1
SC397174,2,2,0,0,1,1,0,0,0
SC397231,3,1,2,0,1,1,0,0,0
SC397449,7,4,3,1,2,2,0,0,1
SC397450,7,4,3,0,1,1,0,1,1
SC397527,2,1,1,0,1,1,0,0,1
SC397528,2,1,1,0,1,1,0,0,1
SC397530,1,0,1,0,0,0,0,0,1
SC397653,2,0,2,0,0,0,0,0,0
SC397710,2,0,2,0,1,1,0,0,0
SC397857,7,2,5,0,2,2,0,1,1
SC397950,23,10,13,0,0,0,0,0,0
SC398038,19,5,14,0,0,0,0,0,1
SC398044,20,13,7,0,14,12,2,0,0
SC398119,3,0,3,0,0,0,0,0,1
SC398293,6,3,3,0,1,0,1,1,1
SC398497,1,1,0,0,1,1,0,0,0
SC398548,5,3,2,0,2,2,0,0,0
SC398596,6,0,6,0,0,0,0,0,1
SC398607,6,0,6,0,0,0,0,0,1
SC398820,2,2,0,0,1,1,0,0,0
SC399121,6,0,6,0,0,0,0,0,0
SC399312,5,0,5,0,0,0,0,0,1
SC399354,12,2,10,0,1,1,0,1,1
SC399384,5,0,5,0,0,0,0,0,1
SC399582,13,8,5,0,0,0,0,0,1
SC399592,10,5,5,0,1,1,0,0,1
SC399763,6,5,1,0,0,0,0,0,0
SC399844,3,0,3,0,0,0,0,0,0
SC399862,1,0,1,0,0,0,0,0,0
SC399876,13,4,9,0,0,0,0,0,0
SC399970,2,1,1,0,1,1,0,0,0
SC399996,1,0,1,0,0,0,0,0,0
SC400171,1,1,0,0,1,1,0,0,0
SC400328,11,7,4,0,3,0,3,0,0
SC400364,2,0,2,0,0,0,0,0,0
SC400459,20,4,16,1,2,1,1,2,1
SC400486,2,0,2,0,0,0,0,0,1
SC400520,3,0,3,0,0,0,0,0,1
SC400657,35,11,24,0,1,1,0,1,0
SC400658,13,7,6,0,1,1,0,1,0
SC400714,9,6,3,0,1,1,0,0,1
SC400763,1,0,1,0,0,0,0,0,0
SC400790,2,2,0,0,1,1,0,0,0
SC400895,7,3,4,0,3,3,0,0,0
SC401121,14,8,6,0,0,0,0,0,0
SC401603,10,4,6,0,1,1,0,1,1
SC401635,2,0,2,0,0,0,0,0,1
SC401717,3,3,0,0,2,2,0,0,1
SC401843,7,2,5,0,1,1,0,1,1
SC401907,2,1,1,0,1,1,0,0,1
SC402041,2,0,2,0,0,0,0,0,0
SC402171,16,8,8,0,0,0,0,0,0
SC402242,2,2,0,0,2,2,0,0,0
SC402272,5,0,5,0,0,0,0,0,0
SC402300,1,1,0,0,1,1,0,0,0
SC402353,4,2,2,0,2,2,0,2,1
SC402378,4,0,4,0,0,0,0,0,1
SC402380,4,0,4,0,0,0,0,0,1
SC402586,9,4,5,0,1,1,0,1,1
SC402662,3,3,0,0,1,1,0,0,0
SC402708,6,3,3,0,2,1,1,1,1
SC402773,21,12,9,0,0,0,0,0,0
SC402787,2,2,0,0,1,1,0,0,0
SC402837,11,4,7,0,2,1,1,1,1
SC403283,4,0,4,0,1,1,0,0,0
SC403483,4,2,2,0,2,2,0,0,1
SC403946,9,4,5,0,1,1,0,1,1
SC404303,2,2,0,0,2,1,1,0,0
SC404362,13,0,13,0,1,1,0,1,1
SC404533,4,4,0,0,1,1,0,0,1
SC404540,2,0,2,0,2,1,1,0,1
SC404621,2,2,0,0,2,2,0,0,1
SC404678,1,1,0,0,1,1,0,0,1
SC405094,6,0,6,0,0,0,0,0,0
SC405177,1,1,0,0,1,1,0,0,1
SC405253,3,0,3,0,0,0,0,0,0
SC405298,2,2,0,0,1,1,0,0,0
SC405562,3,2,1,0,1,1,0,0,0
SC405964,14,8,6,0,0,0,0,0,1
SC405993,1,1,0,0,1,1,0,0,0
SC405995,8,6,2,0,0,0,0,0,0
SC406125,5,0,5,0,1,1,0,1,1
SC406191,5,0,5,0,0,0,0,0,1
SC406349,6,0,6,1,0,0,0,0,1
SC406352,12,6,6,0,0,0,0,0,0
SC406353,4,2,2,0,1,1,0,0,0
SC406447,10,0,10,0,0,0,0,0,1
SC406515,7,0,7,0,0,0,0,0,1
SC406603,2,2,0,0,2,2,0,0,0
SC406671,4,2,2,0,2,2,0,0,1
SC406704,4,2,2,0,2,2,0,0,1
SC406941,4,0,4,0,0,0,0,0,0
SC407233,21,11,10,0,0,0,0,0,1
SC407442,5,3,2,0,1,1,0,0,1
SC407510,6,3,3,0,2,1,1,1,1
SC407533,5,2,3,0,1,1,0,1,1
SC407876,8,5,3,0,1,1,0,1,1
SC408011,2,2,0,0,2,2,0,0,1
SC408188,12,4,8,0,1,1,0,1,1
SC408238,12,9,3,0,1,1,0,0,0
SC408525,1,1,0,0,1,1,0,0,0
SC408551,2,2,0,0,2,2,0,0,0
SC408586,3,2,1,0,1,1,0,0,0
SC408711,2,2,0,0,2,2,0,0,0
SC408886,2,0,2,0,0,0,0,0,0
SC409027,3,3,0,0,2,2,0,0,0
SC409186,4,1,3,0,1,1,0,0,0
SC409322,3,3,0,0,2,2,0,0,0
SC409380,3,1,2,0,1,1,0,0,0
SC409431,9,2,7,0,2,2,0,2,1
SC409656,3,2,1,0,2,1,1,1,1
SC409733,1,0,1,0,0,0,0,0,1
SC409777,9,4,5,0,1,1,0,1,1
SC410008,1,0,1,0,0,0,0,0,0
SC410134,1,0,1,0,0,0,0,0,0
SC410297,21,8,13,0,0,0,0,0,0
SC410426,1,0,1,0,1,1,0,0,0
SC410573,18,0,18,0,0,0,0,0,0
SC410626,3,0,3,0,0,0,0,0,0
SC410676,4,1,3,0,1,1,0,0,0
SC410732,2,2,0,0,1,1,0,0,0
SC410904,4,2,2,0,0,0,0,0,0
SC410915,4,2,2,0,1,1,0,0,0
SC410956,1,0,1,0,1,1,0,0,0
SC411036,17,6,11,0,0,0,0,0,0
SC411174,2,0,2,0,0,0,0,0,0
SC411251,1,0,1,0,0,0,0,0,1
SC411667,28,11,17,0,0,0,0,0,1
SC411831,5,0,5,0,0,0,0,0,1
SC411872,3,3,0,0,2,2,0,0,1
SC412275,33,10,23,0,0,0,0,0,0
SC412350,2,0,2,0,0,0,0,0,0
SC412355,4,2,2,0,2,2,0,2,1
SC412487,1,1,0,0,1,1,0,1,1
SC412524,3,1,2,0,1,1,0,0,0
SC412605,5,3,2,0,1,1,0,0,1
SC412641,1,1,0,0,1,1,0,0,0
SC412662,3,0,3,0,0,0,0,0,1
SC413001,3,2,1,0,0,0,0,0,0
SC413235,2,1,1,0,1,0,1,0,0
SC413268,5,3,2,0,1,1,0,0,1
SC413288,5,2,3,0,3,2,1,0,0
SC413327,2,1,1,0,1,1,0,0,0
SC413329,2,2,0,0,1,1,0,0,0
SC413390,10,6,4,0,1,1,0,1,1
SC413448,1,1,0,0,1,1,0,0,1
SC413518,5,1,4,0,1,1,0,0,0
SC413620,33,14,19,0,0,0,0,0,0
SC413672,8,3,5,0,1,1,0,1,1
01649155,23,0,23,0,0,0,0,0,1
01649615,7,2,5,0,2,2,0,0,0
01650215,22,0,22,0,1,1,0,1,1
01650657,8,2,6,0,1,1,0,0,1
01650840,25,0,25,0,0,0,0,0,1
01650846,26,4,22,0,1,1,0,1,1
01651257,9,5,4,0,1,1,0,0,0
01652047,15,0,15,0,0,0,0,0,1
01652213,21,5,16,0,1,1,0,0,1
01653116,77,12,65,0,0,0,0,0,1
01653166,17,3,14,0,1,1,0,1,1
01653185,15,0,15,0,0,0,0,0,1
01653331,42,8,34,0,1,1,0,1,1
01653359,16,3,13,0,0,0,0,0,0
01653519,37,3,34,0,1,1,0,1,1
01654125,6,4,2,0,1,1,0,0,0
01654194,21,0,21,0,0,0,0,0,1
01654220,10,0,10,0,1,1,0,1,1
01654806,44,9,35,0,0,0,0,0,1
01654989,13,1,12,0,1,0,1,0,0
01655467,64,8,56,0,0,0,0,0,1
01655888,41,0,41,0,0,0,0,0,1
01656023,13,2,11,0,1,1,0,1,1
01656361,50,4,46,0,1,1,0,1,1
01656516,54,10,44,0,0,0,0,0,1
01656728,8,2,6,0,2,1,1,0,1
01656838,38,0,38,0,0,0,0,0,1
01657022,6,2,4,0,2,2,0,0,0
01657163,16,5,11,0,1,1,0,0,0
01657318,23,5,18,0,1,1,0,1,1
01657550,6,1,5,0,1,1,0,0,0
01657562,5,4,1,0,3,3,0,0,0
01657657,17,4,13,0,1,1,0,1,1
01657717,43,17,26,0,0,0,0,0,1
01658371,32,2,30,0,2,2,0,2,0
01658599,85,0,85,0,0,0,0,0,1
01658691,7,2,5,0,0,0,0,0,0
01658699,26,4,22,0,0,0,0,0,1
01658859,96,11,85,0,2,0,2,0,1
01659028,12,0,12,0,0,0,0,0,0
01659209,37,3,34,0,1,1,0,1,1
01659504,15,0,15,0,1,1,0,1,1
01659643,5,4,1,0,1,1,0,0,1
01659656,63,5,58,0,0,0,0,0,1
01660078,37,3,34,0,1,1,0,1,1
01660249,17,3,14,0,1,0,1,0,1
01660784,48,9,39,0,1,1,0,1,1
01660786,29,0,29,0,0,0,0,0,1
01661136,5,3,2,0,5,5,0,2,1
01661173,5,1,4,0,1,1,0,0,0
01661244,7,5,2,0,2,2,0,0,1
01661686,31,17,14,0,1,1,0,1,1
01662208,49,9,40,0,0,0,0,0,0
01662228,21,5,16,0,1,1,0,0,0
01662284,33,2,31,0,1,1,0,1,1
01662332,5,2,3,0,4,2,2,0,0
01662393,4,3,1,0,1,1,0,0,1
01662682,25,4,21,0,2,1,1,2,1
01663694,49,4,45,0,0,0,0,0,1
01664296,19,4,15,0,5,4,1,1,1
01664812,58,11,47,0,0,0,0,0,1
01665074,13,5,8,0,4,4,0,0,1
01665292,6,4,2,0,2,2,0,1,0
01665648,37,4,33,0,1,1,0,1,1
01666333,40,4,36,0,1,1,0,1,1
01666751,100,8,92,0,0,0,0,0,1
01666896,21,2,19,0,1,1,0,1,1
01667171,22,1,21,0,0,0,0,0,1
01667196,21,2,19,0,1,1,0,1,1
01668014,15,0,15,0,0,0,0,0,1
01668015,8,0,8,0,0,0,0,0,1
01668204,25,0,25,0,0,0,0,0,1
01668371,9,4,5,0,0,0,0,0,0
01668457,41,6,35,0,1,1,0,1,1
01668726,8,4,4,0,3,1,2,2,0
01668892,3,3,0,0,0,0,0,0,0
01669057,50,5,45,0,1,1,0,1,1
01669296,6,2,4,0,1,1,0,1,0
01669515,17,4,13,0,6,6,0,0,1
01669693,17,0,17,0,0,0,0,0,1
01669776,4,4,0,0,1,1,0,0,1
01669978,3,2,1,0,2,2,0,0,1
01670395,4,2,2,0,1,1,0,0,0
01671114,33,4,29,0,1,1,0,1,1
01671240,5,2,3,0,2,2,0,0,0
01671347,49,14,35,0,1,1,0,0,1
01671355,25,6,19,0,1,1,0,1,1
01671730,31,0,31,0,0,0,0,0,1
01672274,23,3,20,0,1,1,0,1,1
01672983,15,2,13,0,1,1,0,0,0
01672991,58,13,45,0,0,0,0,0,1
01673012,12,2,10,0,3,2,1,0,1
01673325,22,7,15,0,0,0,0,0,1
01673457,0,0,0,0,0,0,0,0,0
01673650,24,2,22,0,0,0,0,0,1
01673720,46,13,33,0,0,0,0,0,1
01673907,30,3,27,0,1,1,0,1,1
01674688,1,1,0,0,0,0,0,0,1
01674774,16,4,12,0,0,0,0,0,1
01674944,25,3,22,0,1,1,0,0,1
01675071,26,0,26,0,1,1,0,1,1
01675552,60,14,46,0,0,0,0,0,1
01675557,13,4,9,0,0,0,0,0,1
01675656,34,3,31,0,3,3,0,1,1
01675679,18,5,13,0,0,0,0,0,1
01675735,7,0,7,0,1,1,0,0,1
01675893,7,4,3,0,3,3,0,0,0
01676618,93,14,79,0,4,3,1,0,1
01676689,29,3,26,0,1,1,0,1,1
01677155,26,10,16,0,0,0,0,0,0
01677389,21,3,18,0,1,1,0,1,1
01677787,46,18,28,0,1,1,0,1,1
01678876,13,2,11,0,2,1,1,1,1
01679043,22,2,20,0,1,1,0,1,1
01679046,46,3,43,0,1,1,0,1,1
01679166,19,2,17,0,0,0,0,0,0
01679183,5,2,3,0,3,3,0,0,1
01679424,61,4,57,0,1,1,0,1,1
01679488,41,3,38,0,1,1,0,1,1
01679530,18,3,15,0,1,1,0,1,1
01679789,4,3,1,0,2,1,1,0,1
01679912,34,3,31,0,1,1,0,1,1
01679975,16,4,12,0,1,1,0,1,1
01679995,3,3,0,0,1,1,0,0,1
01680115,17,3,14,0,1,1,0,1,1
01680796,22,5,17,0,1,1,0,0,1
01681046,10,4,6,0,4,3,1,2,1
01681278,72,10,62,0,0,0,0,0,1
01682107,15,2,13,0,1,1,0,1,1
01682230,5,5,0,0,2,2,0,0,0
01682540,27,3,24,0,0,0,0,0,1
01682771,8,2,6,0,1,1,0,1,1
01683075,14,1,13,0,0,0,0,0,1
01683477,27,0,27,0,0,0,0,0,1
01683840,30,4,26,0,1,0,1,1,1
01683936,10,2,8,0,1,1,0,0,1
01684483,45,7,38,0,0,0,0,0,1
01684525,25,0,25,0,1,1,0,1,1
01684544,4,1,3,0,1,1,0,0,0
01684636,13,0,13,0,0,0,0,0,1
01685094,23,4,19,0,1,1,0,1,1
01686116,20,4,16,0,1,1,0,1,1
01686164,92,8,84,0,0,0,0,0,1
01686341,5,3,2,0,1,1,0,0,0
01686716,23,0,23,0,0,0,0,0,1
01687154,8,0,8,0,0,0,0,0,1
01687173,13,5,8,0,4,4,0,1,1
01687590,52,5,47,0,1,1,0,1,1
01687626,31,0,31,0,0,0,0,0,1
01687652,31,0,31,0,1,1,0,1,1
01687872,6,4,2,0,2,2,0,0,0
01688036,118,38,80,0,0,0,0,0,1
01688065,31,5,26,0,5,4,1,0,1
01688075,73,7,66,0,1,1,0,1,1
01688410,118,38,80,0,0,0,0,0,1
01688879,11,0,11,0,0,0,0,0,1
01688958,10,3,7,0,1,1,0,0,1
01689098,23,0,23,0,0,0,0,0,1
01689416,40,0,40,0,1,1,0,1,1
01689619,65,10,55,0,1,1,0,0,1
01689995,41,0,41,0,1,1,0,1,1
01690003,18,2,16,0,1,1,0,1,1
01690026,73,11,62,0,2,2,0,2,1
01690525,26,4,22,0,0,0,0,0,1
01690565,36,11,25,0,1,1,0,0,1
01690572,24,4,20,0,1,1,0,1,1
01690725,35,0,35,0,0,0,0,0,1
01690758,15,5,10,0,1,1,0,1,1
01690781,30,2,28,0,1,1,0,1,1
01690871,46,13,33,0,0,0,0,0,1
01690936,24,0,24,0,1,1,0,1,1
01690975,18,0,18,0,0,0,0,0,1
01690987,16,0,16,0,0,0,0,0,1
01691431,58,5,53,0,1,1,0,1,1
01691472,59,5,54,0,1,1,0,1,1
01691818,21,5,16,0,0,0,0,0,1
01691901,23,3,20,0,1,1,0,1,1
01692341,56,13,43,0,0,0,0,0,1
01692351,19,5,14,0,1,1,0,1,1
01692482,13,4,9,0,0,0,0,0,0
01692928,61,9,52,0,0,0,0,0,1
01693088,20,4,16,0,1,1,0,1,1
01693108,34,5,29,0,1,1,0,1,1
01693212,21,4,17,0,0,0,0,0,1
01693309,8,2,6,0,3,3,0,0,1
01693426,11,3,8,0,0,0,0,0,1
01693490,13,4,9,0,2,2,0,0,1
01694712,56,9,47,0,0,0,0,0,1
01694836,28,3,25,0,3,1,2,2,1
01695085,22,5,17,0,0,0,0,0,1
01695426,13,0,13,0,0,0,0,0,1
01695813,18,6,12,0,1,1,0,1,1
01696150,88,15,73,0,0,0,0,0,1
01696899,12,6,6,0,2,2,0,1,0
01696917,20,3,17,0,1,1,0,1,1
01697096,11,5,6,0,1,1,0,0,0
01697158,10,4,6,0,5,1,4,1,1
01697225,16,0,16,0,0,0,0,0,1
01697431,14,3,11,0,0,0,0,0,1
01697461,107,13,94,0,0,0,0,0,1
01697756,47,10,37,0,0,0,0,0,1
01698056,20,2,18,0,0,0,0,0,0
01698137,10,5,5,0,0,0,0,0,1
01698349,51,11,40,0,0,0,0,0,1
01698399,41,14,27,0,0,0,0,0,1
01698409,43,11,32,0,1,1,0,1,1
01698889,6,2,4,0,1,1,0,1,1
01698962,5,3,2,0,1,1,0,1,1
01699246,24,3,21,0,1,1,0,1,1
01699296,14,0,14,0,0,0,0,0,1
01699383,9,5,4,0,2,2,0,0,1
01699434,13,2,11,0,1,1,0,1,1
01699514,19,3,16,0,1,1,0,1,1
01699784,86,11,75,0,1,1,0,1,1
01699916,7,3,4,0,1,1,0,1,1
01701035,28,4,24,0,3,1,2,0,0
01701276,4,2,2,0,2,2,0,0,0
01701605,16,4,12,0,1,1,0,1,1
01701634,11,6,5,0,1,1,0,0,1
01701757,4,3,1,0,2,2,0,0,1
01701924,80,3,77,0,0,0,0,0,1
01702378,43,4,39,0,1,1,0,1,1
01702419,5,4,1,0,2,2,0,0,0
01702426,59,11,48,0,0,0,0,0,1
01702448,17,3,14,0,1,1,0,0,1
01702727,5,5,0,0,2,2,0,0,1
01702816,75,6,69,0,0,0,0,0,1
01703066,0,0,0,0,0,0,0,0,0
01704111,36,3,33,0,1,1,0,1,1
01704270,10,4,6,0,0,0,0,0,0
01704776,36,4,32,0,0,0,0,0,0
01704931,5,4,1,0,2,2,0,0,0
01705419,21,3,18,0,0,0,0,0,0
01705520,15,5,10,0,2,1,1,0,1
01705689,28,2,26,0,1,1,0,1,0
01705868,27,4,23,0,1,1,0,0,1
01705930,38,13,25,0,0,0,0,0,0
01706358,28,6,22,0,1,1,0,0,0
01706540,20,6,14,0,0,0,0,0,1
01706670,4,2,2,0,3,2,1,0,0
01707341,35,5,30,0,1,1,0,1,1
01707442,25,3,22,0,1,1,0,1,1
01707502,9,3,6,0,1,1,0,1,0
01707581,9,5,4,0,1,1,0,0,0
01708119,4,0,4,0,1,1,0,0,1
01708850,19,6,13,0,1,1,0,1,1
01709017,20,3,17,0,1,1,0,1,1
01709310,6,0,6,0,0,0,0,0,1
01709436,29,3,26,0,1,1,0,0,1
01709532,8,5,3,0,0,0,0,0,0
01709638,14,3,11,0,1,1,0,0,1
01710313,103,10,93,0,2,1,1,0,1
01710447,31,6,25,0,0,0,0,0,1
01710669,52,7,45,0,0,0,0,0,1
01710671,15,4,11,0,1,1,0,1,1
01710695,59,16,43,0,2,0,2,0,1
01710702,5,2,3,0,1,1,0,0,1
01710736,38,9,29,0,1,1,0,1,1
01711118,37,6,31,0,1,1,0,1,1
01711151,13,5,8,0,3,3,0,1,1
01711189,9,0,9,0,0,0,0,0,1
01712157,35,0,35,0,0,0,0,0,1
01712247,15,0,15,0,0,0,0,0,1
01712307,57,4,53,0,1,1,0,1,1
01712782,10,3,7,0,1,1,0,1,1
01712914,19,4,15,0,0,0,0,0,1
01713006,6,2,4,0,1,1,0,0,1
01713124,97,9,88,0,0,0,0,0,1
01713396,13,4,9,0,4,3,1,0,1
01713578,39,4,35,0,1,1,0,1,0
01713927,38,5,33,0,1,1,0,1,1
01713997,70,10,60,0,0,0,0,0,1
01714446,30,3,27,0,1,1,0,1,1
01714796,15,4,11,0,3,3,0,0,1
01714937,63,12,51,0,0,0,0,0,1
01715389,6,0,6,0,1,1,0,0,1
01715768,22,4,18,0,1,1,0,1,1
01716035,33,4,29,0,0,0,0,0,1
01716654,3,2,1,0,2,2,0,0,1
01716719,23,8,15,0,1,1,0,0,1
01717239,84,15,69,0,1,1,0,1,1
01717446,2,2,0,0,0,0,0,0,0
01717639,61,0,61,0,0,0,0,0,1
01718016,12,5,7,0,1,1,0,0,1
01718369,16,5,11,0,0,0,0,0,1
01718430,7,3,4,0,2,2,0,1,1
01719128,30,8,22,0,0,0,0,0,1
01719314,9,1,8,0,3,1,2,2,1
01719649,38,10,28,0,1,1,0,1,1
01719860,15,5,10,0,3,3,0,0,1
OC329090,2,2,0,0,1,1,0,0,0
OC329250,4,2,2,0,1,1,0,0,1
OC329392,137,57,80,0,1,1,0,1,1
OC329609,10,3,7,0,1,1,0,0,1
OC329653,14,6,8,0,0,0,0,0,1
OC329754,18,0,18,0,0,0,0,0,1
OC329879,6,2,4,0,1,1,0,0,1
OC330011,4,3,1,0,3,3,0,0,1
OC330252,460,204,256,0,0,0,0,0,1
OC330347,25,22,3,0,1,1,0,1,1
OC330377,4,0,4,0,0,0,0,0,1
OC330384,20,0,20,0,2,2,0,2,1
OC330567,4,4,0,0,1,1,0,0,1
OC330580,27,0,27,1,0,0,0,0,1
OC330614,35,9,26,0,0,0,0,0,1
OC330889,5,2,3,0,2,1,1,0,1
OC330925,2,2,0,0,2,2,0,0,0
OC331086,14,5,9,0,2,2,0,0,1
OC331125,27,16,11,0,0,0,0,0,1
OC331458,8,4,4,0,0,0,0,0,1
OC331564,5,3,2,0,2,2,0,0,0
OC331671,7,3,4,0,0,0,0,0,0
OC331830,4,0,4,0,0,0,0,0,1
OC331918,2,2,0,2,0,0,0,0,1
OC332045,36,14,22,1,1,1,0,1,0
OC332087,4,0,4,0,0,0,0,0,1
OC332103,3,3,0,0,3,3,0,0,1
OC332129,10,3,7,0,3,3,0,0,1
OC332293,2,2,0,0,1,1,0,0,1
OC332526,17,0,17,0,0,0,0,0,1
OC332563,5,0,5,0,2,2,0,0,1
OC332605,53,31,22,0,0,0,0,0,1
OC332730,3,0,3,0,0,0,0,0,0
OC332883,4,0,4,0,0,0,0,0,0
OC333073,9,2,7,2,2,1,1,0,1
OC333278,6,3,3,0,3,2,1,0,1
OC333282,5,2,3,0,0,0,0,0,1
OC333433,19,9,10,0,0,0,0,0,1
OC333537,4,2,2,0,2,2,0,2,0
OC333653,678,398,280,0,0,0,0,0,1
OC333709,65,46,19,0,1,1,0,1,1
OC333791,8,0,8,8,0,0,0,0,1
OC334031,203,2,201,0,1,1,0,1,1
OC334289,34,13,21,0,0,0,0,0,1
OC334313,22,14,8,0,0,0,0,0,1
OC334323,302,288,14,0,4,2,2,4,1
OC334326,2,0,2,0,0,0,0,0,1
OC334333,9,3,6,0,1,1,0,0,0
OC334334,126,83,43,0,0,0,0,0,1
OC334398,68,2,66,0,5,1,4,1,1
OC334406,148,90,58,0,0,0,0,0,1
OC334430,4,0,4,0,0,0,0,0,1
OC334522,92,71,21,0,0,0,0,0,1
OC334647,5,0,5,0,0,0,0,0,1
OC334653,7,0,7,6,1,1,0,1,1
OC334677,6,2,4,6,1,1,0,0,1
OC334789,558,289,269,0,0,0,0,0,1
OC334809,4,0,4,0,3,3,0,0,1
OC334874,55,22,33,1,2,2,0,0,1
OC335029,14,14,0,0,0,0,0,0,1
OC335051,83,0,83,0,0,0,0,0,1
OC335387,7,0,7,5,0,0,0,0,1
OC335427,3,3,0,0,2,2,0,0,0
OC335451,14,0,14,0,0,0,0,0,1
OC335506,67,44,23,0,0,0,0,0,1
OC335840,33,24,9,0,0,0,0,0,0
OC335884,4,2,2,0,1,1,0,0,0
OC335981,25,0,25,0,0,0,0,0,1
OC336049,7,6,1,0,0,0,0,0,0
OC336077,66,42,24,0,0,0,0,0,1
OC336183,13,9,4,0,0,0,0,0,0
OC336385,6,0,6,4,0,0,0,0,1
OC336518,4,2,2,0,2,2,0,0,0
OC336590,4,0,4,0,0,0,0,0,1
OC336756,3,3,0,0,3,3,0,0,1
OC336943,2,0,2,0,0,0,0,0,1
OC336965,3,3,0,0,0,0,0,0,0
OC337118,5,0,5,1,0,0,0,0,1
OC337203,3,0,3,0,1,1,0,0,1
OC337226,4,2,2,0,2,2,0,0,0
OC337378,177,0,177,0,0,0,0,0,1
OC337726,6,0,6,2,0,0,0,0,0
OC337755,4,2,2,0,2,2,0,0,0
OC338112,17,4,13,0,3,2,1,0,1
OC338118,6,3,3,1,1,1,0,0,1
OC338183,63,5,58,0,0,0,0,0,1
OC338426,76,25,51,0,0,0,0,0,1
OC338681,3,0,3,0,1,1,0,0,1
OC338824,10,10,0,0,0,0,0,0,1
OC338907,2,0,2,0,0,0,0,0,1
OC339018,19,14,5,3,1,1,0,1,1
OC339048,4,0,4,0,1,1,0,0,0
OC339069,5,0,5,0,0,0,0,0,1
OC339088,5,5,0,0,4,4,0,0,1
OC339121,17,4,13,0,1,1,0,1,1
OC339122,5,2,3,0,1,1,0,0,1
OC339129,233,231,2,0,1,1,0,1,1
OC339137,5,3,2,4,1,1,0,1,1
OC339408,14,4,10,2,3,2,1,0,1
OC339470,46,32,14,0,0,0,0,0,1
OC339786,2,2,0,0,1,1,0,0,0
OC339819,2,0,2,0,0,0,0,0,1
OC339863,5,0,5,0,0,0,0,0,1
OC339900,6,0,6,0,0,0,0,0,1
OC339999,4,2,2,0,2,2,0,0,0
OC340127,4,0,4,0,0,0,0,0,0
OC340160,6,5,1,0,1,1,0,0,1
OC340239,5,2,3,0,3,1,2,0,0
OC340361,55,25,30,0,0,0,0,0,1
OC340425,27,2,25,1,1,1,0,1,1
OC340779,17,8,9,0,0,0,0,0,1
OC341044,2,0,2,0,0,0,0,0,1
OC341223,130,127,3,0,0,0,0,0,1
OC341404,5,4,1,0,4,4,0,0,1
OC341489,9,5,4,0,1,1,0,1,1
OC341717,3,3,0,0,2,1,1,1,0
OC341786,69,32,37,0,0,0,0,0,1
OC342007,124,0,124,0,0,0,0,0,1
OC342063,6,4,2,0,4,4,0,0,0
OC342174,63,0,63,0,0,0,0,0,1
OC342304,6,5,1,1,1,1,0,0,0
OC342384,4,2,2,2,0,0,0,0,1
OC342432,131,75,56,0,10,8,2,0,1
OC342504,4,2,2,0,1,1,0,0,1
OC342889,10,5,5,0,0,0,0,0,0
OC343267,26,11,15,0,6,3,3,1,1
OC343301,3,3,0,0,1,1,0,0,0
OC343448,2,2,0,0,2,2,0,0,1
OC343458,5,2,3,0,1,1,0,0,1
OC343478,24,2,22,0,2,2,0,2,1
OC343522,18,0,18,0,0,0,0,0,1
OC343563,7,3,4,6,1,1,0,1,1
OC343640,2,2,0,0,2,2,0,2,0
OC343815,51,45,6,0,0,0,0,0,1
OC343897,417,244,173,0,0,0,0,0,1
OC343916,10,7,3,0,0,0,0,0,1
OC344013,14,0,14,0,0,0,0,0,1
OC344173,15,2,13,0,2,2,0,2,1
OC344192,5,0,5,0,2,2,0,0,0
OC344209,9,2,7,0,1,1,0,1,1
OC344239,3,2,1,0,3,2,1,0,1
OC344243,4,2,2,2,0,0,0,0,1
OC344414,4,0,4,2,0,0,0,0,1
OC344553,80,51,29,0,0,0,0,0,1
OC344600,33,24,9,0,0,0,0,0,1
OC344627,6,2,4,0,2,2,0,0,1
OC344774,6,0,6,0,0,0,0,0,1
OC345220,9,5,4,0,1,1,0,0,1
OC345232,8,5,3,0,0,0,0,0,0
OC345380,8,3,5,0,1,1,0,0,1
OC345423,3,0,3,0,3,3,0,0,1
OC345558,3,3,0,0,3,3,0,0,0
OC345619,212,0,212,0,0,0,0,0,1
OC345662,2,0,2,0,2,2,0,1,1
OC345670,3,3,0,0,3,3,0,0,1
OC345717,5,0,5,0,0,0,0,0,1
OC345738,8,2,6,0,1,1,0,1,1
OC345751,4,2,2,2,0,0,0,0,1
OC346028,88,0,88,0,0,0,0,0,1
OC346126,4,2,2,0,1,1,0,0,0
OC346618,7,4,3,0,3,3,0,0,1
OC346638,22,2,20,0,2,2,0,2,1
OC346720,2,2,0,0,1,1,0,0,0
OC346767,6,0,6,0,0,0,0,0,1
OC346990,5,0,5,0,0,0,0,0,1
OC347034,28,22,6,0,2,2,0,0,1
OC347121,2,2,0,0,1,1,0,0,1
OC347127,2,0,2,0,2,2,0,0,0
OC347341,8,3,5,0,4,1,3,1,1
OC347430,9,2,7,0,2,2,0,0,0
OC347463,3,3,0,0,3,3,0,0,1
OC347559,5,2,3,3,0,0,0,0,0
OC347572,5,2,3,0,2,2,0,0,0
OC347578,2,2,0,0,2,2,0,0,1
OC347590,8,3,5,0,3,3,0,1,1
OC347897,2,2,0,0,3,3,0,0,0
OC348242,3,3,0,0,1,1,0,0,1
OC348443,4,4,0,0,5,5,0,1,1
OC348591,3,2,1,0,1,0,1,0,1
OC348736,20,0,20,0,1,1,0,0,1
OC348774,7,2,5,0,4,4,0,0,0
OC348965,32,23,9,0,0,0,0,0,1
OC348976,7,0,7,0,0,0,0,0,1
OC349012,25,12,13,0,0,0,0,0,1
OC349036,6,3,3,0,2,2,0,0,1
OC349306,4,0,4,0,0,0,0,0,1
OC349547,13,7,6,0,0,0,0,0,1
OC349617,32,29,3,1,0,0,0,0,1
OC349663,6,0,6,6,1,1,0,0,1
OC349671,5,3,2,0,0,0,0,0,1
OC349808,13,0,13,0,0,0,0,0,1
OC349822,4,0,4,0,1,1,0,0,1
OC349884,3,3,0,0,2,2,0,0,1
OC349914,2,2,0,0,2,2,0,0,0
OC350252,10,10,0,0,0,0,0,0,0
OC350716,8,6,2,0,3,3,0,0,1
OC350881,2,0,2,0,1,1,0,0,1
OC350920,5,0,5,0,0,0,0,0,1
OC351001,2,2,0,0,1,1,0,0,1
OC351102,60,53,7,0,0,0,0,0,1
OC351304,15,0,15,0,1,1,0,0,1
OC351442,2,2,0,0,0,0,0,0,0
OC351506,125,121,4,0,2,2,0,2,1
OC351574,12,5,7,0,1,1,0,0,0
OC351726,3,2,1,0,2,2,0,0,0
OC351752,4,0,4,0,0,0,0,0,1
OC351914,6,0,6,6,0,0,0,0,1
OC352041,81,60,21,0,0,0,0,0,1
OC352072,23,2,21,0,2,2,0,2,1
OC352078,5,2,3,0,1,1,0,0,0
OC352355,6,0,6,0,0,0,0,0,1
OC352463,54,41,13,0,1,1,0,1,1
OC352586,37,0,37,1,0,0,0,0,1
OC352742,3,3,0,0,0,0,0,0,1
OC353072,4,3,1,0,3,3,0,1,1
OC353077,3,0,3,0,0,0,0,0,1
OC353203,3,0,3,0,1,1,0,0,1
OC353248,2,0,2,0,0,0,0,0,1
OC353282,2,2,0,0,2,2,0,0,1
OC353475,11,11,0,0,0,0,0,0,0
OC353478,10,10,0,0,0,0,0,0,0
OC353480,16,13,3,0,0,0,0,0,0
OC353539,9,8,1,0,0,0,0,0,0
OC353588,113,0,113,0,2,2,0,0,1
OC353669,12,12,0,0,0,0,0,0,0
OC353714,3,2,1,0,2,2,0,0,1
OC353779,7,5,2,0,1,1,0,1,1
OC353953,5,3,2,0,0,0,0,0,1
OC354037,7,0,7,0,0,0,0,0,1
OC354054,2,2,0,1,3,3,0,0,0
OC354140,6,5,1,0,0,0,0,0,1
OC354187,7,6,1,0,1,1,0,0,1
OC354226,121,75,46,0,1,1,0,1,1
OC354275,15,0,15,0,0,0,0,0,1
OC354356,14,13,1,0,2,2,0,0,1
OC354703,4,0,4,4,0,0,0,0,1
OC354754,2,2,0,0,1,1,0,0,1
OC354848,6,3,3,0,4,3,1,0,1
OC355031,2,2,0,0,2,2,0,0,0
OC355051,133,11,122,0,17,11,6,2,1
OC355196,9,7,2,0,1,1,0,1,1
OC355216,3,3,0,0,2,2,0,0,1
OC355225,20,14,6,0,0,0,0,0,1
OC355231,6,0,6,0,0,0,0,0,0
OC355365,24,16,8,0,4,2,2,4,1
OC355582,11,11,0,0,0,0,0,0,1
OC355617,2,2,0,0,2,2,0,0,1
OC355641,45,40,5,0,1,1,0,1,1
OC355694,2,2,0,0,2,2,0,0,0
OC355800,9,2,7,0,3,2,1,0,1
OC355851,2,0,2,0,0,0,0,0,1
OC355869,4,3,1,0,1,1,0,0,1
OC355886,2,2,0,0,2,2,0,0,1
OC355935,9,2,7,0,3,2,1,0,1
02682106,26,0,26,0,1,1,0,1,1
02682185,30,2,28,0,1,1,0,1,1
02682207,24,0,24,0,1,1,0,1,1
02682211,26,7,19,0,1,1,0,1,1
02682306,46,0,46,0,0,0,0,0,1
02682316,49,0,49,0,0,0,0,0,1
02682322,44,0,44,0,0,0,0,0,1
02682370,13,2,11,0,2,2,0,1,1
02682464,20,2,18,0,1,1,0,1,1
02682493,19,4,15,0,2,1,1,1,1
02682696,26,0,26,0,1,1,0,1,1
02682768,32,5,27,0,1,1,0,1,1
02682786,5,3,2,0,2,1,1,0,1
02682793,15,0,15,0,0,0,0,0,1
02682865,14,3,11,0,0,0,0,0,1
02682887,11,0,11,0,0,0,0,0,1
02682984,11,0,11,0,0,0,0,0,1
02683331,13,3,10,0,1,1,0,1,1
02684004,11,2,9,0,1,1,0,0,1
02684008,24,0,24,0,0,0,0,0,1
02684045,9,4,5,0,2,2,0,0,1
02684234,34,8,26,0,1,1,0,0,0
02684378,16,3,13,0,1,1,0,1,1
02684596,43,0,43,1,0,0,0,0,1
02684628,11,2,9,0,3,3,0,1,1
02685100,7,2,5,0,1,1,0,0,0
02685210,16,1,15,0,1,1,0,0,1
02685302,23,0,23,0,1,1,0,1,1
02685309,23,0,23,0,1,1,0,1,1
02685660,14,0,14,0,0,0,0,0,1
02685674,20,5,15,0,0,0,0,0,0
02685704,7,3,4,0,1,1,0,0,1
02685707,27,3,24,0,1,1,0,1,1
02685737,12,2,10,0,1,1,0,1,1
02685888,5,0,5,0,1,1,0,1,1
02685981,32,0,32,0,0,0,0,0,1
02686473,19,3,16,0,0,0,0,0,0
02686703,9,3,6,0,0,0,0,0,1
02686778,29,8,21,0,1,1,0,0,1
02686796,26,0,26,0,0,0,0,0,1
02686884,5,0,5,0,0,0,0,0,0
02687110,6,2,4,0,1,1,0,0,0
02687137,37,3,34,0,2,1,1,0,1
02687168,26,7,19,0,1,1,0,0,1
02687360,10,0,10,0,1,1,0,1,0
02687511,7,0,7,0,0,0,0,0,1
02687523,19,3,16,0,1,1,0,0,1
02687933,33,6,27,0,0,0,0,0,1
02687939,7,2,5,0,2,2,0,0,1
02688007,31,0,31,0,1,1,0,1,1
02688108,48,9,39,0,1,1,0,1,1
02688169,5,0,5,0,0,0,0,0,1
02688377,31,7,24,0,1,1,0,0,0
02688394,39,1,38,0,2,2,0,1,1
02688399,38,3,35,0,1,1,0,1,1
02688514,43,5,38,0,0,0,0,0,1
02688597,11,3,8,0,1,1,0,1,1
02688742,38,5,33,0,0,0,0,0,1
02688814,38,3,35,0,1,1,0,1,1
02689134,29,9,20,0,1,1,0,1,1
02689453,28,3,25,0,0,0,0,0,1
02689836,28,5,23,0,2,2,0,2,1
02690018,23,3,20,0,2,1,1,2,1
02690028,12,0,12,0,0,0,0,0,1
02690161,8,2,6,0,2,2,0,0,0
02690259,16,3,13,0,0,0,0,0,1
02690319,9,3,6,0,1,1,0,1,1
02690347,18,1,17,0,1,1,0,0,1
02690459,21,2,19,0,1,1,0,1,1
02690562,25,3,22,0,1,1,0,1,1
02690792,39,4,35,0,0,0,0,0,0
02691102,25,3,22,0,1,1,0,1,1
02691122,13,2,11,0,1,1,0,1,1
02691127,31,8,23,0,0,0,0,0,0
02691430,13,0,13,0,1,1,0,1,0
02691452,29,4,25,0,0,0,0,0,1
02691456,45,0,45,0,1,1,0,1,1
02691508,10,1,9,0,1,1,0,0,1
02691516,28,2,26,0,1,1,0,1,1
02691601,28,0,28,0,0,0,0,0,1
02691636,20,0,20,0,0,0,0,0,1
02691706,16,3,13,0,1,1,0,0,1
02691718,17,4,13,0,0,0,0,0,0
02691750,19,4,15,0,0,0,0,0,1
02691752,19,5,14,0,0,0,0,0,1
02691753,15,2,13,0,0,0,0,0,1
02691818,29,2,27,0,1,1,0,1,1
02691858,17,0,17,0,0,0,0,0,1
02692155,10,4,6,0,3,3,0,0,1
02692254,4,2,2,0,1,1,0,0,1
02692890,43,0,43,0,1,1,0,1,1
02693051,9,4,5,0,1,1,0,1,0
02693175,11,2,9,0,1,1,0,1,1
02693180,30,0,30,0,0,0,0,0,1
02693396,17,3,14,0,0,0,0,0,1
02693471,21,0,21,0,0,0,0,0,1
02693490,23,4,19,0,1,1,0,1,1
02693725,71,3,68,0,1,1,0,1,1
02693774,27,5,22,0,0,0,0,0,1
02693778,33,8,25,0,0,0,0,0,1
02693876,32,2,30,0,1,1,0,1,1
02694171,44,0,44,0,0,0,0,0,1
02694718,42,10,32,0,1,1,0,1,1
02695131,17,3,14,0,1,1,0,0,1
02695296,34,4,30,0,1,1,0,1,1
02695558,11,4,7,0,1,1,0,1,1
02695596,51,2,49,0,0,0,0,0,1
02695601,13,3,10,0,1,1,0,1,1
02695836,8,3,5,0,2,2,0,0,0
02695896,11,4,7,0,1,1,0,0,0
02696223,9,3,6,0,1,1,0,0,1
02696252,25,0,25,0,0,0,0,0,1
02696296,11,4,7,0,1,1,0,0,1
02696326,18,2,16,0,1,1,0,1,1
02696736,13,4,9,0,0,0,0,0,1
02697232,7,3,4,0,2,2,0,0,0
02697436,89,6,83,0,0,0,0,0,1
02697861,13,4,9,0,1,1,0,0,1
02698100,62,6,56,0,0,0,0,0,1
02698195,18,2,16,1,1,1,0,1,0
02698223,8,2,6,0,1,1,0,0,1
02698282,87,17,70,0,0,0,0,0,0
02698321,47,12,35,0,0,0,0,0,1
02698380,50,11,39,0,1,1,0,1,1
02698638,42,7,35,0,0,0,0,0,1
02698671,43,3,40,0,1,1,0,1,1
02698759,41,2,39,0,1,1,0,1,1
02698919,72,7,65,0,0,0,0,0,1
02699171,7,1,6,0,1,1,0,0,1
02699219,56,3,53,0,1,1,0,1,1
02699264,46,7,39,0,1,1,0,1,1
02699283,60,9,51,0,0,0,0,0,0
02699428,6,2,4,0,2,1,1,0,0
02699637,25,5,20,0,1,1,0,1,1
02699651,19,4,15,0,0,0,0,0,1
02699705,19,7,12,0,1,1,0,0,1
02699839,70,8,62,0,0,0,0,0,1
02699902,48,10,38,0,0,0,0,0,1
02700052,17,6,11,0,2,1,1,2,0
02700093,26,7,19,0,1,1,0,1,1
02700408,22,2,20,0,1,1,0,1,1
02700424,79,9,70,0,0,0,0,0,1
02700516,59,15,44,0,0,0,0,0,1
02700613,24,4,20,0,0,0,0,0,0
02700769,64,5,59,0,1,1,0,1,1
02700778,57,6,51,0,0,0,0,0,1
02700788,21,0,21,0,1,1,0,1,1
02701079,22,3,19,0,0,0,0,0,0
02701171,4,2,2,0,2,2,0,0,1
02701429,24,7,17,0,0,0,0,0,1
02701475,7,3,4,0,1,1,0,1,1
02701516,25,0,25,0,0,0,0,0,1
02701557,11,3,8,0,2,2,0,0,1
02701569,23,6,17,0,1,1,0,0,0
02701742,16,4,12,0,4,1,3,2,1
02701923,28,8,20,0,2,1,1,0,1
02702189,9,2,7,0,1,1,0,1,1
02702429,16,4,12,0,1,1,0,0,1
02702612,79,13,66,0,0,0,0,0,1
02702653,152,9,143,0,1,1,0,0,1
02702795,20,4,16,0,1,1,0,0,1
02702797,19,2,17,0,0,0,0,0,1
02702992,15,4,11,0,1,1,0,0,0
02703013,23,5,18,0,4,4,0,0,1
02703063,71,10,61,0,0,0,0,0,0
02703128,42,0,42,0,0,0,0,0,1
02703244,20,3,17,0,2,1,1,2,1
02703399,30,12,18,0,0,0,0,0,1
02703466,21,2,19,0,1,1,0,0,0
02703517,16,2,14,0,1,1,0,1,1
02703566,6,0,6,0,1,1,0,0,1
02703829,5,4,1,0,3,3,0,0,0
02703856,14,2,12,0,1,1,0,1,1
02703869,33,5,28,0,1,1,0,1,1
02703926,16,0,16,0,0,0,0,0,1
02704647,6,2,4,0,1,1,0,1,0
02704700,14,3,11,0,1,1,0,1,1
02705172,52,10,42,0,0,0,0,0,1
02705354,33,0,33,0,0,0,0,0,1
02705556,33,6,27,0,1,1,0,1,1
02705558,9,3,6,0,1,1,0,0,1
02705798,15,4,11,0,1,1,0,0,1
02705821,11,3,8,0,1,1,0,0,1
02706045,43,4,39,0,2,1,1,2,1
02706178,13,4,9,0,4,4,0,1,1
02706196,9,2,7,0,1,1,0,1,1
02706273,8,3,5,0,1,1,0,0,1
02706370,10,0,10,0,0,0,0,0,1
02706450,15,3,12,0,2,2,0,2,1
02706584,33,4,29,0,0,0,0,0,1
02706861,15,4,11,0,1,1,0,1,1
02706865,15,2,13,0,0,0,0,0,0
02706969,31,2,29,0,2,2,0,2,1
02707095,23,3,20,0,0,0,0,0,1
02707096,36,4,32,0,0,0,0,0,0
02707110,26,4,22,0,0,0,0,0,0
02707298,14,2,12,0,1,1,0,0,0
02707328,27,1,26,0,1,1,0,0,1
02707376,14,5,9,0,1,1,0,1,0
02707791,6,2,4,0,1,1,0,0,1
02707792,27,1,26,0,0,0,0,0,1
02707797,28,3,25,0,1,1,0,1,1
02707944,13,3,10,0,1,1,0,1,1
02707949,19,3,16,0,1,1,0,1,1
02707998,32,3,29,0,0,0,0,0,1
02708030,42,9,33,0,0,0,0,0,1
02708129,39,0,39,0,0,0,0,0,1
02708130,36,2,34,0,1,1,0,1,1
02708158,17,3,14,0,0,0,0,0,1
02708273,13,0,13,0,0,0,0,0,0
02708334,63,11,52,0,0,0,0,0,0
02708690,28,2,26,0,2,1,1,2,1
02708693,24,0,24,0,0,0,0,0,1
02708725,11,0,11,0,0,0,0,0,1
02709001,15,6,9,0,2,2,0,0,1
02709148,16,3,13,0,2,2,0,0,1
02709302,78,8,70,0,0,0,0,0,1
02709324,101,7,94,0,0,0,0,0,1
02709399,5,2,3,0,1,1,0,0,1
02709621,34,5,29,0,1,1,0,1,1
02709932,14,4,10,0,1,1,0,1,1
02710541,10,2,8,0,0,0,0,0,1
02710557,12,0,12,0,0,0,0,0,0
02710654,43,3,40,0,1,1,0,1,1
02710768,14,0,14,0,0,0,0,0,1
02710846,39,6,33,0,1,1,0,1,1
02710955,1,0,1,0,0,0,0,0,1
02711000,45,7,38,0,0,0,0,0,1
02711006,90,13,77,0,3,1,2,3,1
02711801,10,0,10,0,0,0,0,0,0
02712350,77,7,70,0,0,0,0,0,1
02712443,33,5,28,0,2,1,1,2,1
02712492,3,0,3,0,0,0,0,0,1
02713318,35,8,27,0,2,1,1,2,1
02713373,19,3,16,0,1,1,0,1,1
02713501,8,0,8,0,0,0,0,0,1
02713513,33,6,27,0,2,1,1,2,1
02713536,34,9,25,0,6,4,2,1,1
02713749,37,3,34,0,1,1,0,1,1
02713806,52,6,46,0,0,0,0,0,1
02714146,8,2,6,0,1,1,0,1,1
02714181,47,4,43,0,0,0,0,0,1
02714217,60,10,50,0,0,0,0,0,0
02714547,7,3,4,0,2,2,0,0,1
02714750,88,7,81,0,0,0,0,0,0
02714759,13,3,10,0,2,2,0,2,1
02714911,28,0,28,0,0,0,0,0,1
02715103,28,0,28,0,1,1,0,1,1
02715255,0,0,0,0,0,0,0,0,1
02715286,14,2,12,0,3,2,1,0,1
02715989,8,3,5,0,2,2,0,0,0
02716424,31,3,28,0,1,1,0,1,1
02716476,53,8,45,0,1,1,0,1,0
02716482,9,0,9,0,0,0,0,0,0
02716917,16,4,12,0,2,2,0,0,0
02717127,11,2,9,0,1,1,0,1,1
02717340,9,1,8,0,1,1,0,0,0
02717400,26,2,24,0,1,1,0,1,1
02717692,73,11,62,0,0,0,0,0,1
02717838,14,4,10,0,3,1,2,1,1
02717897,10,3,7,0,1,1,0,1,0
02718035,15,3,12,0,0,0,0,0,1
02718442,58,6,52,0,0,0,0,0,0
02718443,13,3,10,0,0,0,0,0,1
02718458,15,4,11,0,0,0,0,0,1
02719010,11,0,11,0,1,1,0,1,1
02719047,49,7,42,0,0,0,0,0,0
02719242,45,5,40,0,1,1,0,1,1
02719326,11,0,11,0,1,1,0,1,1
02719382,25,2,23,0,0,0,0,0,1
02719456,88,10,78,0,0,0,0,0,1
02719478,42,0,42,0,1,1,0,1,1
02719480,42,4,38,0,1,1,0,1,1
02719699,17,4,13,0,0,0,0,0,1
02719828,8,3,5,0,2,2,0,0,1
02720295,38,9,29,0,2,2,0,2,1
02720382,39,3,36,0,0,0,0,0,0
02720446,18,3,15,0,1,1,0,1,0
02720630,55,14,41,0,0,0,0,0,1
02720748,57,0,57,0,0,0,0,0,1
02720809,58,4,54,0,1,1,0,1,1
02720823,17,4,13,0,1,1,0,1,1
02720881,11,6,5,0,1,1,0,0,1
02721009,15,5,10,0,1,1,0,0,0
02721508,23,0,23,0,1,1,0,1,1
02721621,43,5,38,0,0,0,0,0,1
02721642,37,4,33,0,1,1,0,1,1
02721712,23,0,23,0,0,0,0,0,1
02721765,38,24,14,0,3,2,1,0,1
02722280,18,0,18,0,0,0,0,0,1
02722282,16,2,14,0,0,0,0,0,1
02722285,26,0,26,0,0,0,0,0,1
02722343,47,4,43,0,1,1,0,1,1
02722346,19,5,14,0,0,0,0,0,0
02722384,18,3,15,0,0,0,0,0,0
02722518,0,0,0,0,0,0,0,0,1
02722646,23,5,18,0,0,0,0,0,1
02722749,18,5,13,0,0,0,0,0,0
02722754,81,8,73,0,0,0,0,0,1
02722812,10,3,7,0,0,0,0,0,1
02722984,27,5,22,0,1,1,0,1,1
02722985,29,0,29,0,0,0,0,0,1
02723173,24,0,24,0,0,0,0,0,1
02723178,8,3,5,0,2,2,0,0,1
02723259,21,0,21,0,0,0,0,0,1
02723354,22,4,18,0,1,1,0,1,1
02723420,41,8,33,0,1,1,0,1,1
02723470,13,4,9,0,0,0,0,0,1
02723472,61,11,50,0,1,1,0,1,1
02723527,47,0,47,0,0,0,0,0,1
02723534,57,12,45,0,0,0,0,0,1
02723621,23,3,20,0,1,1,0,1,0
02723797,14,3,11,0,3,3,0,3,1
02723982,9,4,5,0,2,2,0,1,1
02724503,20,0,20,0,0,0,0,0,1
02724838,14,0,14,0,0,0,0,0,1
02725147,21,0,21,0,0,0,0,0,1
02725272,8,2,6,0,2,2,0,1,1
02725709,32,4,28,0,1,1,0,1,0
02725792,15,0,15,0,0,0,0,0,1
02725830,42,4,38,0,1,1,0,1,1
02726030,118,12,106,0,0,0,0,0,1
02726164,71,11,60,0,2,2,0,2,1
02726170,29,3,26,0,1,1,0,1,1
02726408,13,0,13,0,0,0,0,0,1
02727249,20,0,20,0,0,0,0,0,1
02727262,9,4,5,0,0,0,0,0,0
02727310,5,1,4,0,3,2,1,0,0
02727383,57,5,52,0,1,0,1,1,1
02727421,13,2,11,0,1,1,0,1,1
02727514,125,13,112,0,0,0,0,0,1
02727547,17,2,15,0,1,1,0,1,1
02727560,29,3,26,0,1,1,0,1,1
02727561,22,3,19,0,1,1,0,1,1
02727815,12,3,9,0,1,1,0,1,0
02727939,24,4,20,0,1,1,0,1,1
02728021,38,10,28,0,1,1,0,1,1
02728455,29,6,23,0,2,2,0,2,1
02728491,12,4,8,0,0,0,0,0,1
02728563,36,8,28,0,3,3,0,3,0
02728593,48,9,39,0,15,9,6,0,1
02728601,14,0,14,0,0,0,0,0,1
02728849,19,2,17,0,3,3,0,0,0
02728867,23,3,20,0,1,1,0,1,1
02728920,21,3,18,0,1,1,0,1,1
02728922,19,3,16,0,1,1,0,1,1
02728994,14,1,13,0,3,1,2,1,1
02729260,50,6,44,0,2,1,1,2,1
02729513,31,3,28,0,1,1,0,1,1
02729688,13,5,8,0,2,1,1,2,0
02730427,45,4,41,0,1,1,0,1,1
02730503,7,1,6,0,1,1,0,0,1
02730611,133,14,119,0,0,0,0,0,0
02730618,64,14,50,0,0,0,0,0,1
02731014,15,0,15,0,0,0,0,0,1
02731197,21,4,17,0,3,3,0,1,1
02731948,10,1,9,0,1,1,0,0,1
02732244,89,6,83,0,0,0,0,0,1
02732245,56,9,47,0,0,0,0,0,1
02732254,5,2,3,0,3,2,1,0,1
02732441,37,0,37,0,0,0,0,0,1
02732747,8,0,8,0,0,0,0,0,1
02732784,9,4,5,0,2,2,0,0,1
02733039,21,0,21,0,0,0,0,0,1
02733070,29,3,26,0,1,1,0,1,1
02733119,41,4,37,0,1,1,0,1,1
02733136,79,11,68,0,0,0,0,0,1
02733559,13,5,8,0,1,1,0,1,1
02733595,33,5,28,0,1,1,0,1,1
02733701,33,0,33,0,0,0,0,0,1
02733787,12,3,9,0,1,1,0,1,0
02733932,46,10,36,0,0,0,0,0,1
02734125,28,7,21,0,0,0,0,0,0
02734611,3,3,0,0,1,1,0,0,0
02734652,64,6,58,0,0,0,0,0,1
02734658,7,0,7,0,0,0,0,0,1
02734677,30,3,27,0,1,1,0,1,1
02734722,54,0,54,0,0,0,0,0,1
02734730,18,3,15,0,0,0,0,0,1
02734789,16,3,13,0,1,1,0,1,1
02734927,10,4,6,0,1,1,0,1,0
02734955,22,3,19,0,0,0,0,0,1
02735226,9,0,9,0,0,0,0,0,1
02735431,24,5,19,0,1,1,0,0,1
02735633,91,9,82,0,0,0,0,0,0
02735825,19,0,19,0,0,0,0,0,1
02735861,19,0,19,0,0,0,0,0,1
02736127,27,3,24,0,1,1,0,1,1
02736925,12,4,8,0,1,1,0,1,1
02737370,39,4,35,0,1,1,0,1,1
02737396,51,7,44,0,1,1,0,1,1
02737458,13,5,8,0,1,1,0,0,1
02737706,16,3,13,0,1,1,0,0,1
02737866,8,3,5,0,1,1,0,0,0
02737974,24,7,17,0,1,1,0,1,1
02738000,33,0,33,0,0,0,0,0,1
02738034,12,2,10,0,1,1,0,1,1
02738210,19,2,17,0,1,1,0,1,1
02738413,76,5,71,0,1,1,0,0,0
02738761,16,1,15,0,2,1,1,1,1
02739107,5,3,2,0,0,0,0,0,0
02739471,18,4,14,0,4,3,1,0,1
02739563,35,5,30,0,1,1,0,1,1
06120395,12,2,10,0,1,1,0,1,1
06120444,18,4,14,0,1,1,0,1,1
06120751,6,3,3,0,2,2,0,0,1
06121539,23,4,19,0,1,1,0,1,1
06122534,13,0,13,0,3,3,0,1,1
06122711,15,3,12,0,1,1,0,1,1
06124302,15,0,15,0,0,0,0,0,1
06124685,3,0,3,0,1,1,0,0,1
06124779,41,10,31,0,1,1,0,0,1
06124783,21,3,18,0,1,1,0,1,1
06124828,40,17,23,0,0,0,0,0,1
06124923,11,0,11,0,1,1,0,1,1
06124960,14,3,11,0,2,2,0,2,1
06124979,4,3,1,0,1,1,0,0,0
06125274,17,11,6,0,0,0,0,0,1
06125504,4,2,2,0,1,1,0,1,1
06125615,22,2,20,0,2,2,0,2,1
06125726,8,0,8,0,0,0,0,0,0
06125830,7,0,7,0,1,1,0,0,0
06125927,32,13,19,0,0,0,0,0,1
06126480,8,1,7,0,2,2,0,0,0
06126670,6,1,5,0,2,1,1,0,0
06126855,8,0,8,0,1,1,0,0,1
06126900,8,4,4,0,1,1,0,0,1
06127199,3,2,1,0,2,2,0,0,0
06127293,4,2,2,0,1,1,0,1,0
06127353,4,0,4,0,0,0,0,0,1
06127361,7,3,4,0,0,0,0,0,0
06127421,3,3,0,0,2,2,0,0,0
06127433,4,2,2,0,2,2,0,0,0
06127529,3,0,3,0,0,0,0,0,1
06128149,3,3,0,0,2,2,0,0,0
06128774,2,2,0,0,1,1,0,0,0
06129852,13,3,10,0,1,1,0,1,0
06129936,31,18,13,0,0,0,0,0,1
06130181,15,2,13,0,1,1,0,1,1
06130205,6,2,4,0,0,0,0,0,0
06130476,4,0,4,0,0,0,0,0,1
06130530,13,0,13,0,0,0,0,0,1
06130932,13,1,12,0,1,1,0,1,1
06130943,13,1,12,0,1,1,0,1,1
06131084,14,5,9,0,1,1,0,0,1
06131380,8,2,6,0,2,2,0,0,1
06131579,9,2,7,0,1,1,0,1,1
06131647,2,2,0,0,1,1,0,0,0
06132297,14,4,10,0,0,0,0,0,1
06132425,39,0,39,0,1,1,0,1,1
06132562,16,6,10,0,2,2,0,2,1
06132783,5,0,5,0,2,2,0,0,0
06133168,16,0,16,0,0,0,0,0,1
06133397,13,2,11,0,2,2,0,0,1
06133495,4,0,4,0,0,0,0,0,1
06133901,7,0,7,0,0,0,0,0,1
06133937,7,0,7,0,0,0,0,0,1
06133979,38,7,31,0,0,0,0,0,1
06134203,4,3,1,0,1,1,0,1,1
06134256,4,4,0,0,1,1,0,1,0
06134500,4,2,2,0,1,1,0,0,0
06134823,59,9,50,0,0,0,0,0,1
06134948,17,2,15,0,0,0,0,0,0
06134957,8,0,8,0,2,2,0,0,1
06135492,2,2,0,0,1,1,0,0,0
06135534,8,5,3,0,1,1,0,1,1
06135586,17,4,13,0,1,1,0,1,1
06135639,19,4,15,0,0,0,0,0,1
06135683,3,3,0,0,2,2,0,0,1
06135692,5,0,5,0,0,0,0,0,0
06135832,8,0,8,0,4,4,0,0,0
06135889,5,0,5,0,0,0,0,0,1
06135904,20,7,13,0,0,0,0,0,1
06135939,7,3,4,0,1,1,0,1,1
06135971,10,5,5,0,5,0,5,0,1
06136032,16,3,13,0,0,0,0,0,1
06136043,33,9,24,0,0,0,0,0,1
06136174,4,0,4,0,0,0,0,0,1
06136498,3,3,0,0,1,1,0,0,0
06136521,9,2,7,0,4,3,1,1,1
06137039,6,3,3,0,3,3,0,0,1
06137198,4,1,3,0,1,1,0,0,1
06137221,6,0,6,0,0,0,0,0,0
06137288,5,0,5,0,0,0,0,0,1
06138214,16,4,12,0,0,0,0,0,1
06138264,4,2,2,0,1,1,0,0,0
06138337,11,0,11,0,0,0,0,0,1
06138360,11,6,5,0,1,1,0,1,1
06138551,4,3,1,0,1,1,0,0,0
06138577,6,6,0,0,1,1,0,1,1
06138618,5,0,5,0,1,1,0,1,1
06138640,5,0,5,0,0,0,0,0,1
06139077,18,6,12,0,1,1,0,1,1
06139121,22,5,17,0,1,1,0,0,1
06139132,10,1,9,0,1,1,0,1,1
06139244,7,3,4,0,1,1,0,0,1
06140223,5,0,5,0,0,0,0,0,0
06140568,9,3,6,0,1,1,0,1,1
06140742,5,2,3,0,1,1,0,0,1
06140882,7,2,5,0,2,1,1,0,0
06141036,3,0,3,0,0,0,0,0,1
06141077,18,3,15,0,1,1,0,1,1
06141156,4,1,3,0,1,1,0,0,0
06141518,3,3,0,0,2,2,0,0,1
06141603,23,8,15,0,0,0,0,0,1
06141698,5,2,3,0,3,3,0,0,0
06141708,3,0,3,0,0,0,0,0,1
06141973,43,14,29,0,0,0,0,0,1
06142007,42,15,27,0,0,0,0,0,1
06142617,3,3,0,0,1,1,0,0,0
06143426,2,2,0,0,1,1,0,0,1
06143649,14,4,10,0,1,1,0,1,1
06144430,6,0,6,0,1,1,0,0,1
06144813,20,0,20,0,0,0,0,0,0
06144857,6,4,2,0,0,0,0,0,1
06145147,19,2,17,0,3,1,2,3,1
06145280,3,1,2,0,1,1,0,0,1
06145342,8,0,8,0,1,1,0,0,1
06147104,8,3,5,0,1,1,0,1,1
06147572,20,10,10,0,0,0,0,0,1
06148029,39,8,31,0,1,1,0,1,1
06149589,4,2,2,0,2,2,0,0,0
06149607,10,1,9,0,1,1,0,0,0
06149825,9,0,9,0,0,0,0,0,1
06150067,14,2,12,0,1,1,0,0,0
06150106,6,0,6,0,0,0,0,0,1
06150174,16,0,16,0,0,0,0,0,1
06150438,5,0,5,0,0,0,0,0,1
06151247,4,2,2,0,1,1,0,0,1
06153577,10,5,5,0,1,1,0,1,0
06153771,10,0,10,0,0,0,0,0,1
06154034,7,3,4,0,1,1,0,1,1
06154186,4,1,3,0,3,1,2,1,0
06155287,4,2,2,0,2,2,0,0,0
06155726,4,2,2,0,1,1,0,0,1
06156274,9,3,6,0,2,2,0,0,0
06156553,15,5,10,0,1,1,0,1,1
06156661,18,3,15,1,1,1,0,1,1
06157074,5,0,5,0,0,0,0,0,1
06158015,5,2,3,0,0,0,0,0,1
06158066,2,1,1,0,1,1,0,0,0
06158076,11,6,5,0,0,0,0,0,1
06158085,10,0,10,0,0,0,0,0,1
06158097,2,2,0,0,1,1,0,0,0
06158790,15,3,12,0,1,1,0,1,1
06159017,18,3,15,1,1,1,0,1,1
06159302,6,2,4,0,2,2,0,1,1
06159670,5,4,1,0,2,2,0,0,1
06160934,5,0,5,0,2,2,0,0,0
06161101,24,7,17,0,1,1,0,1,1
06161443,5,3,2,0,1,1,0,1,0
06161828,4,2,2,0,1,1,0,0,1
06162462,12,0,12,0,1,1,0,1,1
06163147,8,3,5,0,1,1,0,1,1
06163501,4,2,2,0,2,2,0,0,0
06163579,10,4,6,0,1,1,0,0,1
06163673,10,1,9,0,3,2,1,3,1
06163728,18,2,16,0,1,1,0,1,1
06163846,5,2,3,0,4,1,3,1,0
06163890,3,2,1,0,1,1,0,0,0
06163893,10,5,5,0,3,2,1,0,0
06164128,12,4,8,0,1,1,0,1,1
06164788,29,7,22,0,1,1,0,1,1
06165540,17,7,10,0,0,0,0,0,1
06165859,19,7,12,0,1,1,0,1,1
06166023,6,0,6,0,0,0,0,0,1
06166047,6,2,4,0,2,1,1,1,1
06166068,11,6,5,0,1,1,0,0,1
06166092,15,4,11,0,0,0,0,0,0
06166109,7,1,6,0,2,1,1,1,1
06166349,5,0,5,0,0,0,0,0,1
06166397,13,6,7,1,0,0,0,0,1
06166544,3,0,3,0,0,0,0,0,1
06166785,10,2,8,0,1,1,0,1,1
06166786,8,3,5,0,0,0,0,0,0
06166872,7,4,3,0,1,1,0,0,1
06166899,5,3,2,0,3,3,0,0,1
06166968,13,4,9,0,0,0,0,0,0
06167204,6,0,6,0,1,1,0,0,0
06167537,3,2,1,0,1,1,0,0,1
06167580,5,3,2,0,1,1,0,0,1
06167585,3,0,3,0,1,1,0,0,1
06167793,10,0,10,0,0,0,0,0,1
06167797,10,0,10,0,0,0,0,0,1
06167839,4,2,2,0,1,1,0,0,0
06167928,13,4,9,0,2,2,0,2,1
06167991,13,0,13,0,0,0,0,0,1
06168151,7,2,5,0,0,0,0,0,1
06168333,7,2,5,0,1,1,0,0,1
06169591,8,0,8,0,0,0,0,0,1
06169712,8,4,4,0,3,3,0,0,0
06169738,15,3,12,0,1,1,0,1,1
06169938,20,4,16,0,2,2,0,2,1
06170096,5,0,5,0,0,0,0,0,1
06170277,4,0,4,0,0,0,0,0,1
06170611,32,7,25,0,1,1,0,1,1
06170884,3,3,0,0,2,2,0,0,0
06171056,2,2,0,0,1,1,0,0,0
06172154,6,0,6,0,0,0,0,0,1
06172239,27,6,21,0,0,0,0,0,1
06172534,23,3,20,0,0,0,0,0,1
06172724,2,2,0,0,1,1,0,0,1
06172876,3,1,2,0,1,1,0,0,0
06172930,2,1,1,0,1,1,0,0,1
06173021,2,0,2,0,0,0,0,0,0
06173090,5,1,4,0,2,2,0,0,0
06173344,35,16,19,0,1,1,0,0,1
06175954,13,2,11,0,0,0,0,0,1
06176697,5,0,5,0,0,0,0,0,1
06176778,8,0,8,0,0,0,0,0,1
06176780,8,0,8,0,0,0,0,0,1
06176876,4,4,0,0,3,3,0,0,0
06177143,2,0,2,0,1,1,0,0,0
06178578,6,0,6,0,0,0,0,0,1
06178729,16,5,11,0,1,1,0,0,0
06179061,12,3,9,0,3,1,2,1,0
06179375,7,0,7,0,0,0,0,0,1
06179972,14,0,14,0,1,1,0,1,1
06180177,8,4,4,0,1,1,0,1,1
06180720,4,2,2,0,2,2,0,0,0
06181070,4,1,3,0,1,1,0,0,1
06181286,4,4,0,0,3,3,0,0,0
06181313,7,2,5,0,2,1,1,0,1
06181912,18,1,17,0,1,1,0,1,1
06182106,18,4,14,0,3,3,0,3,1
06182748,31,6,25,0,1,1,0,0,1
06182923,5,3,2,0,2,2,0,0,1
06182982,37,8,29,0,0,0,0,0,0
06183315,4,0,4,0,0,0,0,0,1
06183910,6,3,3,0,0,0,0,0,1
06184084,10,5,5,0,0,0,0,0,1
06184455,7,5,2,0,0,0,0,0,0
06184603,6,4,2,0,2,2,0,0,0
06184771,18,5,13,0,1,1,0,1,1
06184929,10,4,6,0,0,0,0,0,0
06185898,5,3,2,0,1,1,0,1,1
06186090,3,0,3,0,1,1,0,0,0
06186766,3,0,3,0,0,0,0,0,0
06187598,12,4,8,0,1,1,0,1,1
06187654,2,2,0,0,2,2,0,0,0
06187783,5,3,2,0,2,2,0,0,1
06188085,5,3,2,0,1,1,0,1,0
06188580,3,0,3,0,0,0,0,0,1
06188662,4,0,4,0,0,0,0,0,1
06188668,5,3,2,0,1,1,0,0,1
06188983,10,5,5,0,5,5,0,1,1
06188985,9,5,4,0,5,5,0,1,1
06189455,11,3,8,0,1,1,0,1,1
06189958,3,0,3,0,0,0,0,0,1
06190079,4,0,4,0,0,0,0,0,1
06190267,14,0,14,0,0,0,0,0,1
06190306,27,9,18,0,0,0,0,0,1
06190393,27,9,18,0,0,0,0,0,1
06190528,10,0,10,0,0,0,0,0,1
06191044,5,3,2,0,2,2,0,0,0
06191512,4,2,2,0,1,1,0,1,0
06191598,9,4,5,0,1,1,0,0,0
06191720,3,0,3,0,1,1,0,1,1
06192005,4,0,4,0,0,0,0,0,1
06192136,7,2,5,0,2,2,0,0,1
06192161,5,2,3,0,1,1,0,0,0
06192226,6,0,6,0,0,0,0,0,1
06192479,5,0,5,0,0,0,0,0,1
06192615,23,9,14,0,0,0,0,0,0
06192832,2,1,1,0,1,1,0,0,1
06193621,5,0,5,0,0,0,0,0,1
06194070,25,5,20,0,0,0,0,0,0
06194411,12,6,6,0,0,0,0,0,0
06194826,8,4,4,0,1,1,0,1,1
06194953,3,3,0,0,2,2,0,0,1
06195438,7,4,3,0,1,1,0,1,1
06195648,9,0,9,0,0,0,0,0,1
06195779,16,3,13,0,1,1,0,1,1
06195812,14,6,8,0,1,1,0,1,1
06195816,38,15,23,0,1,1,0,0,1
06195985,34,12,22,0,15,11,4,0,1
06196036,6,0,6,0,4,4,0,0,0
06196200,10,5,5,0,0,0,0,0,1
06197518,2,0,2,0,0,0,0,0,1
06197703,13,2,11,0,4,3,1,2,1
06197727,9,1,8,0,3,3,0,1,1
06197739,3,1,2,0,1,1,0,0,0
06198255,14,1,13,0,0,0,0,0,1
06198281,15,1,14,0,1,1,0,1,1
06198327,15,0,15,0,0,0,0,0,1
06198378,15,0,15,0,0,0,0,0,1
06198400,15,0,15,0,0,0,0,0,1
06198404,16,0,16,0,1,1,0,1,1
06198447,20,4,16,0,0,0,0,0,1
06198627,3,1,2,0,2,2,0,0,0
06198944,8,2,6,0,2,1,1,1,0
06198959,7,0,7,0,2,2,0,0,1
06198978,6,3,3,0,1,1,0,0,1
06199118,5,2,3,0,1,1,0,0,0
06199510,13,5,8,0,1,1,0,1,1
06200060,8,0,8,0,0,0,0,0,1
06200498,4,3,1,0,2,2,0,0,0
06200511,3,1,2,0,1,1,0,0,0
06201205,5,0,5,0,0,0,0,0,1
06201249,5,3,2,0,2,2,0,0,1
06201255,11,5,6,0,0,0,0,0,1
06201302,9,3,6,0,0,0,0,0,1
06201407,3,1,2,0,1,1,0,0,0
06201419,5,2,3,0,0,0,0,0,1
06201541,8,4,4,0,1,1,0,0,1
06201543,4,2,2,0,1,1,0,0,1
06201659,16,0,16,0,0,0,0,0,1
06201896,17,5,12,0,4,1,3,2,1
06202340,25,6,19,0,0,0,0,0,0
06202777,3,0,3,0,0,0,0,0,0
06202969,37,13,24,0,1,1,0,1,1
06203324,12,0,12,0,0,0,0,0,1
06203380,14,6,8,0,0,0,0,0,0
06203503,3,2,1,0,1,1,0,0,0
06203534,5,2,3,0,2,2,0,0,1
06204109,11,0,11,0,0,0,0,0,1
06204129,22,7,15,0,23,13,10,0,1
06204572,6,3,3,0,1,1,0,1,1
06204592,8,4,4,0,2,2,0,2,1
06204618,5,3,2,0,2,2,0,2,1
06204642,5,3,2,0,3,3,0,3,1
06204683,4,0,4,0,0,0,0,0,1
06205388,7,4,3,0,3,3,0,3,1
06205397,3,1,2,0,1,1,0,0,0
06205458,27,6,21,0,1,0,1,0,1
06205552,29,11,18,0,0,0,0,0,1
06205779,7,2,5,0,0,0,0,0,0
06205795,17,4,13,0,2,2,0,2,1
06205815,7,0,7,0,0,0,0,0,1
06205874,5,0,5,0,0,0,0,0,1
06206644,22,5,17,0,3,2,1,0,1
06206655,9,0,9,0,0,0,0,0,1
06206967,5,1,4,0,1,1,0,1,1
06207067,17,2,15,0,1,1,0,0,1
06207095,5,1,4,0,2,1,1,0,1
06207416,7,2,5,0,0,0,0,0,0
06207544,28,4,24,0,1,1,0,1,1
06207595,5,3,2,0,1,1,0,0,1
06208560,7,4,3,0,2,2,0,0,1
06208888,7,4,3,0,5,3,2,0,1
06209386,21,9,12,0,0,0,0,0,1
06209458,15,4,11,0,2,2,0,2,1
06209507,2,2,0,0,1,1,0,0,0
06209607,6,0,6,0,0,0,0,0,1
06210062,3,1,2,0,1,1,0,0,0
06210225,5,0,5,0,0,0,0,0,1
06210272,15,5,10,1,1,1,0,1,1
06210273,3,0,3,0,0,0,0,0,1
06210283,27,8,19,0,0,0,0,0,1
06210309,3,0,3,0,0,0,0,0,1
06210578,18,10,8,0,1,1,0,0,0
06210773,5,1,4,0,2,2,0,1,1
06210939,6,2,4,0,3,2,1,0,1
06211124,5,0,5,0,0,0,0,0,1
06211313,5,3,2,0,1,1,0,0,0
06211858,9,2,7,0,1,1,0,0,1
06211865,6,0,6,0,2,2,0,0,1
06212156,18,7,11,0,0,0,0,0,0
06212580,2,1,1,0,1,1,0,0,0
06212648,2,1,1,0,1,1,0,0,0
06212715,5,0,5,0,0,0,0,0,1
06212760,3,0,3,0,0,0,0,0,1
06212771,26,14,12,0,0,0,0,0,1
06212781,6,4,2,0,3,3,0,0,1
06212870,4,2,2,0,2,2,0,0,1
06212873,4,0,4,0,0,0,0,0,1
06213591,3,0,3,0,0,0,0,0,0
06213709,7,3,4,0,0,0,0,0,1
06213962,11,4,7,0,2,2,0,0,1
06214127,6,4,2,0,0,0,0,0,1
06214446,2,2,0,0,1,1,0,0,0
06215825,4,2,2,0,1,1,0,0,0
06216087,9,0,9,0,0,0,0,0,1
06216096,9,0,9,0,0,0,0,0,1
06216137,16,4,12,0,0,0,0,0,0
06216262,12,0,12,0,0,0,0,0,1
06216389,4,1,3,0,1,1,0,0,0
06216413,2,0,2,0,0,0,0,0,1
06216905,24,4,20,0,1,1,0,1,1
06216942,4,2,2,0,2,2,0,0,1
06217492,3,2,1,0,0,0,0,0,1
06217620,8,5,3,0,1,1,0,0,1
06218148,9,2,7,0,1,1,0,0,1
06218310,5,2,3,0,1,1,0,0,1
06218667,16,6,10,0,0,0,0,0,1
06218984,19,4,15,0,2,2,0,2,1
06219100,2,2,0,0,1,1,0,0,0
06219291,6,2,4,0,3,2,1,0,1
06219614,4,0,4,0,0,0,0,0,1
06219619,4,2,2,0,1,1,0,0,1
06219625,9,6,3,0,1,1,0,1,1
06219717,2,2,0,0,1,1,0,0,0
06219830,4,2,2,0,0,0,0,0,1
06219884,22,10,12,0,1,1,0,1,1
11979061,3,3,0,0,2,2,0,0,1
11979064,1,1,0,0,1,1,0,0,0
11979095,1,1,0,0,1,1,0,0,0
11979164,1,1,0,0,1,1,0,0,0
11979505,2,2,0,0,2,2,0,0,0
11979623,1,1,0,0,1,1,0,0,0
11979847,2,1,1,0,2,1,1,0,0
11979887,1,1,0,0,1,1,0,0,0
11979915,1,1,0,0,1,1,0,0,0
11979939,1,1,0,0,1,1,0,0,0
11980270,1,1,0,0,1,1,0,0,0
11981191,1,1,0,0,1,1,0,0,0
11981429,2,2,0,0,2,2,0,0,0
11981443,1,1,0,0,1,1,0,0,0
11981528,1,1,0,0,1,1,0,0,0
11981578,1,1,0,0,1,1,0,0,0
11981638,1,1,0,0,1,1,0,0,0
11982875,2,2,0,0,1,1,0,0,0
11983056,2,2,0,0,2,2,0,0,0
11983115,2,2,0,0,2,2,0,0,0
11983159,2,2,0,0,1,1,0,1,0
11983953,2,2,0,0,2,2,0,0,0
11984100,5,5,0,0,0,0,0,0,0
11984417,1,1,0,0,1,1,0,0,0
11984507,1,1,0,0,1,1,0,0,0
11984756,1,1,0,0,1,1,0,0,0
11985685,2,2,0,0,1,1,0,0,0
11985794,1,1,0,0,1,1,0,0,0
11986621,1,1,0,0,1,1,0,0,0
11987987,3,3,0,0,1,1,0,1,1
11988039,3,3,0,0,1,1,0,1,1
11988053,3,3,0,0,1,1,0,1,1
11988704,1,1,0,0,1,1,0,0,0
11989641,3,3,0,0,3,3,0,0,0
11990206,1,1,0,0,1,1,0,0,0
11990507,2,1,1,0,0,0,0,0,0
11990675,5,5,0,0,1,1,0,0,0
11990904,2,2,0,0,2,2,0,0,1
11991205,1,1,0,0,1,1,0,0,0
11991728,1,1,0,0,1,1,0,0,0
11991807,1,1,0,0,1,1,0,0,0
11991929,2,2,0,0,1,1,0,0,1
11992536,4,4,0,1,1,1,0,1,1
11993481,1,1,0,0,1,1,0,0,0
11993484,1,1,0,0,1,1,0,0,0
11993992,6,6,0,0,0,0,0,0,0
11994115,1,1,0,0,1,1,0,0,0
11994320,1,1,0,0,1,1,0,0,1
11994409,2,2,0,0,1,1,0,0,0
11995470,1,1,0,0,1,1,0,0,0
11995481,1,1,0,0,1,1,0,0,0
11995669,1,1,0,0,1,1,0,0,0
11995681,1,1,0,0,1,1,0,0,0
11996217,1,1,0,0,1,1,0,0,0
11996502,2,2,0,0,2,2,0,0,0
11996561,2,2,0,0,0,0,0,0,0
11996661,1,1,0,0,1,1,0,0,0
11996677,3,3,0,0,1,1,0,1,0
11997484,1,1,0,0,1,1,0,0,0
11997596,1,1,0,0,1,1,0,0,0
11997729,1,1,0,0,1,1,0,0,0
11998416,1,1,0,0,1,1,0,0,0
11998429,3,3,0,0,2,2,0,0,0
11998837,1,1,0,0,1,1,0,0,0
11999010,1,1,0,0,1,1,0,0,0
11999067,1,1,0,0,1,1,0,0,0
11999160,2,2,0,0,1,1,0,1,0
12000128,2,2,0,0,2,2,0,0,0
12000506,2,2,0,0,1,1,0,1,1
12000686,1,1,0,0,1,1,0,0,1
12001613,3,3,0,0,0,0,0,0,0
12001687,2,2,0,0,2,2,0,0,0
12001707,3,3,0,0,1,1,0,1,0
12001711,2,2,0,0,1,1,0,1,1
12002014,2,2,0,0,2,2,0,0,0
12002069,7,7,0,0,7,7,0,0,1
12002501,1,1,0,0,1,1,0,0,0
12003192,1,1,0,0,1,1,0,0,0
12004008,1,1,0,0,1,1,0,0,0
12004123,2,2,0,0,1,1,0,0,0
12004430,1,1,0,0,1,1,0,0,1
12004706,1,1,0,0,1,1,0,0,0
12004740,3,3,0,0,1,1,0,1,0
12005376,2,2,0,0,2,2,0,0,0
12005662,1,1,0,0,1,1,0,0,0
12006063,4,4,0,0,1,1,0,0,0
12006132,2,2,0,0,3,3,0,0,0
12006347,1,1,0,0,1,1,0,0,0
12006595,2,2,0,0,1,1,0,0,0
12006631,1,1,0,0,1,1,0,0,0
12006980,2,2,0,0,2,2,0,0,1
12007205,1,1,0,0,1,1,0,0,0
12007589,1,1,0,0,1,1,0,0,0
12008536,2,2,0,0,1,1,0,1,1
12008548,2,2,0,0,1,1,0,1,1
12008984,1,1,0,0,1,1,0,1,0
12009077,1,1,0,0,1,1,0,0,0
12009420,1,1,0,0,1,1,0,0,0
12009902,1,1,0,0,1,1,0,0,0
12009986,3,3,0,0,1,1,0,1,0
12010136,1,1,0,0,1,1,0,0,0
12010286,1,1,0,0,1,1,0,0,0
12010568,1,1,0,0,1,1,0,0,0
12011573,2,2,0,0,2,2,0,0,0
12011875,1,1,0,0,1,1,0,0,0
12012502,1,1,0,0,1,1,0,0,0
12012994,2,2,0,0,2,2,0,0,0
12013156,2,2,0,0,1,1,0,0,0
12013423,1,1,0,0,1,1,0,0,0
12013655,1,1,0,0,1,1,0,0,0
12013686,1,1,0,0,1,1,0,0,0
12014042,1,1,0,0,1,1,0,0,0
12014501,2,2,0,0,2,2,0,0,0
12014608,2,2,0,0,2,2,0,0,0
12014883,4,4,0,0,0,0,0,0,0
12015046,2,2,0,0,1,1,0,0,0
12015083,5,5,0,0,2,2,0,0,1
12015327,1,1,0,0,1,1,0,0,0
12015439,2,2,0,0,0,0,0,0,0
12016741,1,1,0,0,1,1,0,0,1
12017360,2,2,0,0,1,1,0,1,1
12017366,1,1,0,0,1,1,0,0,0
12017421,3,3,0,0,1,1,0,1,1
12017696,1,1,0,0,1,1,0,0,0
12019298,2,2,0,0,2,2,0,0,0
12019605,1,1,0,0,1,1,0,0,0
12019687,1,1,0,0,1,1,0,0,0
12020237,9,9,0,0,0,0,0,0,0
12020481,3,3,0,0,3,3,0,0,0
12021098,1,1,0,0,0,0,0,0,0
12021276,1,1,0,0,1,1,0,0,0
12021667,1,1,0,0,1,1,0,1,0
12022415,2,2,0,0,2,2,0,0,0
12022780,2,2,0,0,2,2,0,0,0
12023241,2,2,0,0,2,2,0,0,0
12023330,2,2,0,0,2,2,0,0,0
12023394,1,1,0,0,1,1,0,0,0
12023402,2,2,0,0,1,1,0,0,0
12024080,3,3,0,0,2,2,0,0,0
12024096,1,1,0,0,1,1,0,0,0
12026219,2,2,0,0,2,2,0,0,0
12026572,1,1,0,0,1,1,0,0,0
12026834,1,1,0,0,1,1,0,0,0
12027039,1,1,0,0,1,1,0,0,0
12027515,1,1,0,0,1,1,0,0,0
AC001105,0,0,0,0,0,0,0,0,0
AC001134,0,0,0,0,0,0,0,0,0
AC001137,0,0,0,0,0,0,0,0,0
AC001146,0,0,0,0,0,0,0,0,0
AC001157,0,0,0,0,0,0,0,0,0
BR000031,0,0,0,0,0,0,0,0,0
BR002238,0,0,0,0,0,0,0,0,0
BR003203,0,0,0,0,0,0,0,0,0
BR004475,0,0,0,0,0,0,0,0,0
BR005036,0,0,0,0,0,0,0,0,0
BR005136,0,0,0,0,0,0,0,0,0
BR007635,0,0,0,0,0,0,0,0,0
BR008039,0,0,0,0,0,0,0,0,0
BR008146,0,0,0,0,0,0,0,0,0
BR008383,0,0,0,0,0,0,0,0,0
BR008575,0,0,0,0,0,0,0,0,0
BR008912,0,0,0,0,0,0,0,0,0
BR009305,0,0,0,0,0,0,0,0,0
BR009388,0,0,0,0,0,0,0,0,0
BR009549,0,0,0,0,0,0,0,0,0
BR009550,0,0,0,0,0,0,0,0,0
BR010000,0,0,0,0,0,0,0,0,0
BR010778,0,0,0,0,0,0,0,0,0
BR010964,0,0,0,0,0,0,0,0,0
BR011937,0,0,0,0,0,0,0,0,0
BR011974,0,0,0,0,0,0,0,0,0
BR012204,0,0,0,0,0,0,0,0,0
BR012383,0,0,0,0,0,0,0,0,0
BR012928,0,0,0,0,0,0,0,0,0
BR012948,0,0,0,0,0,0,0,0,0
BR012950,0,0,0,0,0,0,0,0,0
BR012974,0,0,0,0,0,0,0,0,0
BR012979,0,0,0,0,0,0,0,0,0
BR012980,0,0,0,0,0,0,0,0,0
BR013011,0,0,0,0,0,0,0,0,0
BR014871,0,0,0,0,0,0,0,0,0
BR015127,0,0,0,0,0,0,0,0,0
BR015180,0,0,0,0,0,0,0,0,0
BR015262,0,0,0,0,0,0,0,0,0
BR016752,0,0,0,0,0,0,0,0,0
BR016778,0,0,0,0,0,0,0,0,0
BR016862,0,0,0,0,0,0,0,0,0
BR018186,0,0,0,0,0,0,0,0,0
BR018265,0,0,0,0,0,0,0,0,0
BR018267,0,0,0,0,0,0,0,0,0
BR019113,0,0,0,0,0,0,0,0,0
BR019722,0,0,0,0,0,0,0,0,0
BR019791,0,0,0,0,0,0,0,0,0
CE000025,0,0,0,0,0,0,0,0,0
CE000033,0,0,0,0,0,0,0,0,0
CE000042,0,0,0,0,0,0,0,0,0
CE000049,0,0,0,0,0,0,0,0,0
CE000098,0,0,0,0,0,0,0,0,0
CE000107,0,0,0,0,0,0,0,0,0
CE000125,0,0,0,0,0,0,0,0,0
CE000154,0,0,0,0,0,0,0,0,0
CE000164,0,0,0,0,0,0,0,0,0
CE000169,0,0,0,0,0,0,0,0,0
CE000178,0,0,0,0,0,0,0,0,0
CE000237,0,0,0,0,0,0,0,0,0
CE000244,0,0,0,0,0,0,0,0,0
CE000267,0,0,0,0,0,0,0,0,0
CE000276,0,0,0,0,0,0,0,0,0
CE000337,0,0,0,0,0,0,0,0,0
CE000400,0,0,0,0,0,0,0,0,0
CE000416,0,0,0,0,0,0,0,0,0
CE000448,0,0,0,0,0,0,0,0,0
CE000466,0,0,0,0,0,0,0,0,0
CS003001,0,0,0,0,0,0,0,0,0
CS003002,0,0,0,0,0,0,0,0,0
CS003010,0,0,0,0,0,0,0,0,0
CS003026,0,0,0,0,0,0,0,0,0
CS003029,0,0,0,0,0,0,0,0,0
CS003035,0,0,0,0,0,0,0,0,0
CS003062,0,0,0,0,0,0,0,0,0
CS003064,0,0,0,0,0,0,0,0,0
CS003067,0,0,0,0,0,0,0,0,0
CS003073,0,0,0,0,0,0,0,0,0
CS003082,0,0,0,0,0,0,0,0,0
CS003097,0,0,0,0,0,0,0,0,0
CS003099,0,0,0,0,0,0,0,0,0
CS003117,0,0,0,0,0,0,0,0,0
CS003119,0,0,0,0,0,0,0,0,0
CS003120,0,0,0,0,0,0,0,0,0
CS003146,0,0,0,0,0,0,0,0,0
CS003177,0,0,0,0,0,0,0,0,0
CS003190,0,0,0,0,0,0,0,0,0
CS003205,0,0,0,0,0,0,0,0,0
CS003216,0,0,0,0,0,0,0,0,0
CS003223,0,0,0,0,0,0,0,0,0
CS003231,0,0,0,0,0,0,0,0,0
CS003233,0,0,0,0,0,0,0,0,0
CS003255,0,0,0,0,0,0,0,0,0
CS003266,0,0,0,0,0,0,0,0,0
CS003271,0,0,0,0,0,0,0,0,0
CS003272,0,0,0,0,0,0,0,0,0
CS003278,0,0,0,0,0,0,0,0,0
CS003282,0,0,0,0,0,0,0,0,0
CS003304,0,0,0,0,0,0,0,0,0
CS003313,0,0,0,0,0,0,0,0,0
CS003316,0,0,0,0,0,0,0,0,0
CS003334,0,0,0,0,0,0,0,0,0
CS003344,0,0,0,0,0,0,0,0,0
CS003348,0,0,0,0,0,0,0,0,0
CS003349,0,0,0,0,0,0,0,0,0
CS003365,0,0,0,0,0,0,0,0,0
CS003375,0,0,0,0,0,0,0,0,0
CS003392,0,0,0,0,0,0,0,0,0
CS003402,0,0,0,0,0,0,0,0,0
CS003407,0,0,0,0,0,0,0,0,0
CS003437,0,0,0,0,0,0,0,0,0
CS003442,0,0,0,0,0,0,0,0,0
CS003452,0,0,0,0,0,0,0,0,0
CS003456,0,0,0,0,0,0,0,0,0
CS003458,0,0,0,0,0,0,0,0,0
CS003474,0,0,0,0,0,0,0,0,0
CS003477,0,0,0,0,0,0,0,0,0
CS003485,0,0,0,0,0,0,0,0,0
CS003514,0,0,0,0,0,0,0,0,0
CS003542,0,0,0,0,0,0,0,0,0
CS003562,0,0,0,0,0,0,0,0,0
CS003566,0,0,0,0,0,0,0,0,0
CS003590,0,0,0,0,0,0,0,0,0
CS003596,0,0,0,0,0,0,0,0,0
CS003597,0,0,0,0,0,0,0,0,0
CS003598,0,0,0,0,0,0,0,0,0
CS003604,0,0,0,0,0,0,0,0,0
CS003633,0,0,0,0,0,0,0,0,0
CS003643,0,0,0,0,0,0,0,0,0
CS003645,0,0,0,0,0,0,0,0,0
CS003659,0,0,0,0,0,0,0,0,0
CS003667,0,0,0,0,0,0,0,0,0
CS003668,0,0,0,0,0,0,0,0,0
CS003674,0,0,0,0,0,0,0,0,0
CS003687,0,0,0,0,0,0,0,0,0
CS003699,0,0,0,0,0,0,0,0,0
CS003718,0,0,0,0,0,0,0,0,0
CS003737,0,0,0,0,0,0,0,0,0
CS003752,0,0,0,0,0,0,0,0,0
CS003780,0,0,0,0,0,0,0,0,0
CS003816,0,0,0,0,0,0,0,0,0
CS003845,0,0,0,0,0,0,0,0,0
CS003852,0,0,0,0,0,0,0,0,0
CS003859,0,0,0,0,0,0,0,0,0
CS003860,0,0,0,0,0,0,0,0,0
CS003861,0,0,0,0,0,0,0,0,0
CS003872,0,0,0,0,0,0,0,0,0
CS003877,0,0,0,0,0,0,0,0,0
CS003937,0,0,0,0,0,0,0,0,0
CS003947,0,0,0,0,0,0,0,0,0
CS003949,0,0,0,0,0,0,0,0,0
CS003962,0,0,0,0,0,0,0,0,0
CS003966,0,0,0,0,0,0,0,0,0
CS003982,0,0,0,0,0,0,0,0,0
CS004002,0,0,0,0,0,0,0,0,0
CS004010,0,0,0,0,0,0,0,0,0
CS004011,0,0,0,0,0,0,0,0,0
CS004024,0,0,0,0,0,0,0,0,0
CS004027,0,0,0,0,0,0,0,0,0
FC000011,72,15,57,0,0,0,0,0,1
FC000298,65,17,48,0,0,0,0,0,1
FC000365,61,16,45,0,0,0,0,0,1
FC002451,20,20,0,0,0,0,0,0,1
FC003748,42,18,24,0,0,0,0,0,1
FC003950,64,13,51,0,0,0,0,0,1
FC004891,99,13,86,0,0,0,0,0,1
FC005059,37,16,21,0,0,0,0,0,1
FC005586,44,1,43,0,0,0,0,0,1
FC007776,15,0,15,0,0,0,0,0,1
FC009467,7,7,0,0,0,0,0,0,0
FC010020,37,0,37,0,0,0,0,0,1
FC010036,56,12,44,0,0,0,0,0,1
FC010256,18,6,12,0,0,0,0,0,1
FC010559,43,5,38,0,0,0,0,0,1
FC010617,126,18,108,0,0,0,0,0,1
FC010666,10,0,10,0,0,0,0,0,1
FC011130,41,5,36,0,0,0,0,0,1
FC011257,20,4,16,0,0,0,0,0,1
FC011299,11,0,11,0,0,0,0,0,1
FC011396,3,3,0,0,0,0,0,0,0
FC011723,16,0,16,0,0,0,0,0,1
FC011727,15,6,9,0,0,0,0,0,1
FC012245,9,4,5,0,0,0,0,0,1
FC012246,11,4,7,0,0,0,0,0,1
FC012400,8,2,6,0,0,0,0,0,1
FC013069,17,14,3,0,0,0,0,0,1
FC013519,8,8,0,0,0,0,0,0,0
FC013727,9,0,9,0,0,0,0,0,1
FC014055,4,4,0,0,0,0,0,0,0
FC014415,3,3,0,0,0,0,0,0,0
FC014598,45,0,45,0,0,0,0,0,1
FC014611,109,0,109,0,0,0,0,0,1
FC015201,38,5,33,1,0,0,0,0,1
FC015234,19,0,19,0,0,0,0,0,1
FC015558,4,0,4,0,0,0,0,0,1
FC015650,4,1,3,0,0,0,0,0,1
FC015811,9,0,9,0,0,0,0,0,1
FC015868,10,10,0,0,0,0,0,0,1
FC016009,47,13,34,0,0,0,0,0,1
FC016329,12,4,8,0,0,0,0,0,1
FC016500,5,0,5,0,0,0,0,0,1
FC016594,10,0,10,0,0,0,0,0,1
FC016957,5,5,0,0,0,0,0,0,1
FC017057,10,5,5,0,0,0,0,0,0
FC017117,55,12,43,0,0,0,0,0,1
FC017124,24,4,20,0,0,0,0,0,1
FC017421,21,0,21,0,0,0,0,0,1
FC017612,17,4,13,0,0,0,0,0,1
FC017793,10,5,5,0,0,0,0,0,1
FC018124,26,0,26,0,0,0,0,0,1
FC018207,24,0,24,0,0,0,0,0,1
FC018645,30,4,26,0,0,0,0,0,1
FC018866,21,6,15,0,0,0,0,0,1
FC018908,10,6,4,0,0,0,0,0,0
FC019036,2,2,0,0,0,0,0,0,0
FC019099,25,3,22,1,0,0,0,0,1
FC019216,2,2,0,0,0,0,0,0,1
FC019412,25,0,25,0,0,0,0,0,1
FC019485,23,4,19,0,0,0,0,0,1
FC019554,11,3,8,0,0,0,0,0,1
FC019556,11,3,8,0,0,0,0,0,1
FC019567,11,3,8,0,0,0,0,0,1
FC019591,11,3,8,0,0,0,0,0,1
FC019600,9,4,5,0,0,0,0,0,1
FC019633,11,3,8,0,0,0,0,0,0
FC019756,7,0,7,0,0,0,0,0,1
FC019777,10,3,7,0,0,0,0,0,0
FC019783,8,4,4,0,0,0,0,0,0
FC019797,10,3,7,0,0,0,0,0,0
FC019816,8,3,5,0,0,0,0,0,0
FC019917,10,3,7,0,0,0,0,0,0
FC019951,39,3,36,0,0,0,0,0,1
FC019957,9,5,4,0,0,0,0,0,1
FC020051,4,4,0,0,0,0,0,0,1
FC020152,25,4,21,0,0,0,0,0,1
FC020569,5,2,3,0,0,0,0,0,1
FC020642,30,10,20,0,0,0,0,0,1
FC020689,14,0,14,0,0,0,0,0,1
FC021021,12,0,12,0,0,0,0,0,1
FC021022,12,0,12,0,0,0,0,0,1
FC021074,3,3,0,0,0,0,0,0,0
FC021101,9,3,6,0,0,0,0,0,1
FC021105,40,0,40,0,0,0,0,0,1
FC021437,7,0,7,0,0,0,0,0,1
FC021495,11,3,8,0,0,0,0,0,1
FC021570,11,4,7,0,0,0,0,0,1
FC021571,11,4,7,0,0,0,0,0,1
FC021700,47,5,42,0,0,0,0,0,1
FC021730,16,0,16,0,0,0,0,0,1
FC021846,9,0,9,0,0,0,0,0,1
FC021864,28,9,19,0,0,0,0,0,1
FC021891,4,4,0,0,0,0,0,0,0
FC021994,13,0,13,0,0,0,0,0,1
FC022008,4,4,0,0,0,0,0,0,0
FC022143,15,0,15,0,0,0,0,0,0
FC022335,6,2,4,0,0,0,0,0,1
FC022337,4,0,4,0,0,0,0,0,1
FC022973,5,0,5,0,0,0,0,0,1
FC023055,17,0,17,0,0,0,0,0,1
FC023131,11,3,8,0,0,0,0,0,1
FC023222,16,4,12,0,0,0,0,0,1
FC023246,15,3,12,0,0,0,0,0,1
FC023557,9,0,9,0,0,0,0,0,1
FC023558,7,0,7,0,0,0,0,0,1
FC023846,15,2,13,0,0,0,0,0,1
FC023847,14,1,13,0,0,0,0,0,1
FC023961,5,0,5,0,0,0,0,0,1
FC024113,14,0,14,0,0,0,0,0,1
FC024177,18,0,18,0,0,0,0,0,1
FC024178,18,0,18,0,0,0,0,0,1
FC024293,11,3,8,0,0,0,0,0,1
FC024345,12,0,12,0,0,0,0,0,1
FC024436,8,2,6,0,0,0,0,0,1
FC024446,3,1,2,0,0,0,0,0,1
FC024447,11,3,8,0,0,0,0,0,1
FC024458,18,4,14,0,0,0,0,0,1
FC024459,19,4,15,0,0,0,0,0,1
FC024469,0,0,0,0,0,0,0,0,1
FC024515,12,0,12,0,0,0,0,0,1
FC024767,13,2,11,0,0,0,0,0,1
FC024817,16,5,11,0,0,0,0,0,1
FC024818,16,5,11,0,0,0,0,0,1
FC024819,16,5,11,0,0,0,0,0,1
FC024871,8,0,8,0,0,0,0,0,1
FC024874,5,2,3,0,0,0,0,0,1
FC025110,9,0,9,0,0,0,0,0,1
FC025176,17,4,13,1,0,0,0,0,1
FC025245,11,5,6,0,0,0,0,0,1
FC025279,9,0,9,0,0,0,0,0,0
FC025566,3,0,3,0,0,0,0,0,1
FC025589,9,3,6,0,0,0,0,0,1
FC025591,7,0,7,0,0,0,0,0,1
FC025605,16,4,12,0,0,0,0,0,1
FC025634,7,2,5,0,0,0,0,0,1
FC025635,9,2,7,0,0,0,0,0,1
FC025679,6,0,6,0,0,0,0,0,1
FC025700,87,14,73,0,0,0,0,0,1
FC025808,16,4,12,1,0,0,0,0,1
FC025861,8,0,8,0,0,0,0,0,1
FC025862,8,0,8,0,0,0,0,0,1
FC025898,2,1,1,0,0,0,0,0,0
FC026160,3,3,0,0,0,0,0,0,1
FC026254,14,5,9,0,0,0,0,0,1
FC026519,5,0,5,0,0,0,0,0,1
FC026581,6,0,6,0,0,0,0,0,1
FC026682,5,0,5,0,0,0,0,0,1
FC026860,18,4,14,0,0,0,0,0,1
FC026864,5,0,5,0,0,0,0,0,1
FC026865,5,0,5,0,0,0,0,0,1
FC026866,5,0,5,0,0,0,0,0,1
SC513090,1,1,0,0,1,1,0,0,0
SC513326,1,1,0,0,1,1,0,0,0
SC513436,4,4,0,0,1,1,0,0,0
SC513633,5,2,3,0,1,1,0,0,1
SC513701,1,0,1,0,1,1,0,0,1
SC513792,1,1,0,0,2,2,0,0,0
SC513914,2,2,0,0,2,2,0,0,0
SC513938,1,0,1,0,0,0,0,0,0
SC513955,1,0,1,0,0,0,0,0,0
SC513979,7,5,2,1,2,2,0,1,1
SC514037,1,1,0,0,0,0,0,0,0
SC514076,3,2,1,0,2,1,1,0,0
SC514201,2,0,2,0,0,0,0,0,1
SC514326,1,0,1,0,0,0,0,0,1
SC514678,1,0,1,0,0,0,0,0,0
SC514737,1,0,1,0,1,1,0,0,0
SC514819,1,1,0,0,1,1,0,0,0
SC514934,1,1,0,0,1,1,0,0,0
SC514988,2,1,1,0,1,1,0,0,0
SC515059,2,2,0,0,1,1,0,0,0
SC515093,1,1,0,0,1,1,0,0,0
SC515116,8,6,2,0,5,5,0,0,1
SC515472,2,2,0,0,2,2,0,0,0
SC515554,1,1,0,0,1,1,0,0,0
SC515694,2,1,1,0,1,1,0,0,0
SC515698,4,4,0,0,2,1,1,1,1
SC515702,1,1,0,0,1,1,0,0,0
SC516358,1,1,0,0,1,1,0,0,0
SC516464,2,0,2,0,1,1,0,0,0
SC516488,2,0,2,0,0,0,0,0,0
SC516913,2,2,0,0,2,2,0,0,0
SC517288,2,2,0,0,1,1,0,0,0
SC517339,1,1,0,0,1,1,0,1,0
SC517350,1,1,0,0,2,1,1,0,0
SC517396,1,0,1,0,1,1,0,0,0
SC517772,1,0,1,0,1,1,0,0,0
SC518242,1,1,0,0,1,1,0,0,0
SC518625,2,1,1,0,2,1,1,0,0
SC518643,2,2,0,0,2,2,0,0,1
SC518761,1,0,1,0,0,0,0,0,0
SC518939,1,0,1,0,0,0,0,0,0
SC519013,1,1,0,0,1,1,0,0,0
SC519021,1,1,0,0,1,1,0,0,0
SC519076,3,3,0,0,1,1,0,0,1
SC519144,4,0,4,0,1,1,0,0,0
SC519202,3,0,3,0,1,0,1,0,0
SC519210,2,0,2,0,1,1,0,0,0
SC519349,2,2,0,0,1,1,0,0,0
SC519434,4,0,4,0,3,3,0,0,0
SC519907,1,1,0,0,1,1,0,0,0
SC519982,1,1,0,0,1,1,0,0,0
SC520020,3,3,0,0,2,2,0,0,0
SC520112,3,3,0,0,2,2,0,0,0
SC520383,6,5,1,0,1,1,0,1,1
SC520429,2,2,0,0,2,2,0,2,1
SC520770,1,0,1,0,1,1,0,0,0
SC520801,2,0,2,0,2,2,0,0,1
SC520816,1,1,0,0,1,1,0,0,0
SC520883,5,0,5,0,1,1,0,1,0
SC521153,6,3,3,1,1,1,0,1,0
SC521188,1,1,0,0,0,0,0,0,0
SC521270,6,3,3,1,1,1,0,1,0
SC521276,1,1,0,0,1,1,0,1,0
SC521565,2,2,0,0,1,1,0,0,0
SC521636,1,0,1,0,1,1,0,0,0
SC521679,6,4,2,0,0,0,0,0,1
SC521682,3,0,3,0,1,1,0,0,0
SC521830,4,3,1,0,2,2,0,0,1
SC522070,1,1,0,0,1,1,0,0,0
SC522242,7,6,1,0,4,3,1,0,1
SC522272,3,3,0,0,3,3,0,0,0
SC522583,3,2,1,0,3,3,0,1,1
SC522712,2,1,1,0,2,1,1,0,1
SC522719,2,1,1,0,2,1,1,1,1
SC522767,2,0,2,0,0,0,0,0,0
SC522785,4,3,1,0,2,1,1,1,1
SC522831,11,7,4,0,0,0,0,0,0
SC523007,2,2,0,0,0,0,0,0,0
SC523283,2,2,0,0,2,2,0,0,1
SC523341,14,9,5,0,0,0,0,0,0
SC523574,2,2,0,0,1,1,0,0,0
SC523672,1,0,1,0,1,1,0,0,0
SC523809,3,2,1,0,2,2,0,0,0
SC523818,3,3,0,0,1,1,0,0,0
SC523936,3,3,0,0,2,2,0,0,0
SC523966,2,2,0,0,0,0,0,0,0
SC524008,1,1,0,0,1,1,0,0,0
SC524086,4,3,1,0,3,3,0,1,0
SC524122,3,3,0,0,2,2,0,0,0
SC524806,3,0,3,0,1,1,0,0,0
SC524981,6,6,0,0,1,1,0,0,0
SC525012,4,1,3,0,2,2,0,0,0
SC525084,10,8,2,0,0,0,0,0,0
SC525242,14,10,4,0,0,0,0,0,0
SC525513,4,4,0,0,1,1,0,1,1
SC525544,2,2,0,0,2,2,0,0,0
SC525726,2,2,0,0,1,1,0,0,0
SC525851,2,1,1,0,1,1,0,0,0
SC525948,6,4,2,0,0,0,0,0,0
SC525961,2,2,0,0,2,2,0,0,0
SC525982,1,1,0,0,1,1,0,0,1
SC526187,3,0,3,0,1,1,0,0,0
SC526265,1,1,0,0,1,1,0,0,0
SC526321,4,1,3,0,1,1,0,0,0
SC526387,1,0,1,0,0,0,0,0,0
SC526681,1,1,0,0,1,1,0,0,0
SC526986,2,1,1,0,2,1,1,0,0
SC527069,1,1,0,0,1,1,0,0,0
SC527459,2,2,0,0,2,2,0,0,0
SC527465,2,0,2,0,0,0,0,0,0
SC527474,2,0,2,0,3,2,1,0,0
SC527639,4,4,0,0,0,0,0,0,1
SC528053,1,1,0,0,1,1,0,0,0
SC528131,3,3,0,0,2,2,0,0,0
SC528200,1,1,0,0,1,1,0,0,0
SC528261,1,1,0,0,1,1,0,0,0
SC528522,3,0,3,0,1,1,0,0,1
SC528612,11,9,2,0,0,0,0,0,0
SC528756,1,1,0,0,1,1,0,0,0
SC528781,4,4,0,0,1,1,0,0,1
SC529255,1,1,0,0,1,1,0,0,0
SC529309,1,0,1,0,0,0,0,0,0
SC529374,2,2,0,0,1,1,0,0,0
SC529375,2,0,2,0,1,1,0,0,0
SC529495,2,2,0,0,2,2,0,0,0
SC529524,3,2,1,0,2,2,0,0,1
SC529612,1,0,1,0,1,1,0,0,0
SC529898,3,0,3,0,0,0,0,0,0
SC530080,2,2,0,0,2,2,0,0,0
SC530473,2,2,0,0,1,1,0,0,0
SC530534,3,3,0,0,3,3,0,0,1
SC530678,6,2,4,0,4,1,3,0,0
SC530700,2,2,0,0,2,2,0,0,0
SC530718,2,0,2,0,0,0,0,0,0
SC530852,2,2,0,0,2,2,0,0,1
SC530980,3,2,1,0,1,1,0,1,0
SC530988,1,1,0,0,2,2,0,0,0
SC531126,1,1,0,0,1,1,0,0,0
SC531290,2,2,0,0,2,2,0,0,0
SC531320,3,0,3,0,0,0,0,0,0
SC531331,1,1,0,0,1,1,0,0,0
SC531379,4,4,0,0,2,2,0,0,0
SC531385,17,9,8,0,0,0,0,0,0
SC531402,1,0,1,0,0,0,0,0,0
SC531454,1,0,1,0,0,0,0,0,1
SC531606,1,1,0,0,1,1,0,0,0
SC531696,3,2,1,0,2,2,0,0,0
SC532098,2,2,0,0,1,1,0,0,0
SC532200,4,4,0,0,3,3,0,0,1
SC532304,3,0,3,0,0,0,0,0,1
SC532518,5,2,3,0,1,1,0,1,0
SC532676,2,2,0,0,2,2,0,0,0
SC533110,2,0,2,0,1,1,0,0,1
SC533169,2,2,0,0,1,1,0,0,0
SC533192,2,0,2,0,0,0,0,0,1
SC533257,2,1,1,0,1,1,0,0,0
SC533338,1,1,0,0,0,0,0,0,0
SC533564,1,1,0,0,1,1,0,0,0
SC533614,2,2,0,0,4,4,0,0,1
SC533685,1,1,0,0,1,1,0,0,0
SC533786,1,1,0,0,0,0,0,0,0
SC533886,14,11,3,0,0,0,0,0,0
SC534018,1,1,0,0,1,1,0,0,0
SC534299,1,1,0,0,1,1,0,0,0
SC534609,2,2,0,0,2,2,0,0,0
SC534827,1,1,0,0,1,1,0,0,0
SC534840,1,1,0,0,1,1,0,0,0
SC535036,1,1,0,0,1,1,0,0,0
SC535054,1,0,1,0,0,0,0,0,0
SC535077,2,1,1,0,3,1,2,1,0
SC535126,2,2,0,0,2,2,0,0,0
SC535413,3,0,3,0,2,2,0,0,1
SC536073,1,0,1,0,0,0,0,0,0
SC536415,3,3,0,0,1,1,0,0,0
SC536664,2,1,1,0,2,1,1,0,0
SC536670,2,1,1,0,2,1,1,0,0
SC536768,3,3,0,0,2,2,0,0,1
SC536931,4,2,2,0,2,2,0,0,0
SC536935,2,1,1,0,1,1,0,0,1
SC536937,1,0,1,0,0,0,0,0,1
SC536975,3,2,1,0,1,1,0,0,1
SC537035,1,0,1,0,1,1,0,0,0
SC537597,1,0,1,0,1,1,0,0,0
SC537670,1,1,0,0,1,1,0,0,0
SC537674,1,1,0,0,1,1,0,0,0
SC537675,1,1,0,0,1,1,0,0,0
SC537678,2,2,0,0,2,2,0,0,0
SC537939,1,1,0,0,1,1,0,0,0
SC537959,1,1,0,0,1,1,0,0,0
SC538370,3,2,1,0,2,2,0,1,1
SC538528,2,2,0,0,1,1,0,0,0
SC538529,1,1,0,0,1,1,0,0,0
SC538540,4,4,0,0,1,1,0,0,0
SC538580,2,2,0,0,2,2,0,0,0
SC538729,2,2,0,0,1,1,0,0,0
SC538888,2,1,1,0,1,1,0,0,0
SC538909,10,6,4,0,0,0,0,0,0
SC539055,2,0,2,0,2,2,0,0,0
SC539105,1,0,1,0,0,0,0,0,1
SC539284,1,1,0,0,1,1,0,0,0
SC539876,5,2,3,0,4,2,2,0,0
SC540171,1,1,0,0,1,1,0,1,0
SC540331,1,0,1,0,1,1,0,0,0
SC540405,1,0,1,0,1,1,0,0,0
SC540655,2,2,0,0,2,2,0,0,0
SC540846,2,0,2,0,1,0,1,0,0
SC541152,3,3,0,0,1,1,0,0,0
SC541464,1,1,0,0,0,0,0,0,0
SC541634,1,1,0,0,1,1,0,0,1
SC541925,8,8,0,0,0,0,0,0,0
SC542402,3,1,2,0,1,0,1,0,0
SC542843,14,10,4,0,0,0,0,0,0
SC542881,3,3,0,0,2,2,0,0,1
SC542967,1,1,0,0,0,0,0,0,0
SC543001,4,0,4,0,0,0,0,0,0
SC543101,1,0,1,0,1,1,0,0,0
SC543140,1,0,1,0,1,1,0,0,0
SC543197,1,1,0,0,1,1,0,0,0
SC543272,2,2,0,0,1,1,0,0,0
SC543372,8,4,4,0,3,0,3,0,0
SC543470,7,4,3,0,3,1,2,1,0
SC543595,3,2,1,0,2,2,0,0,0
SC543655,3,3,0,0,1,1,0,1,0
SC543681,3,3,0,0,1,1,0,1,0
SC543910,2,2,0,0,1,1,0,0,0
SC544097,5,2,3,0,3,1,2,1,1
SC544114,3,3,0,0,2,2,0,0,0
SC544542,2,2,0,0,2,2,0,0,0
SC544689,2,1,1,0,1,1,0,0,0
SC544948,1,0,1,0,1,1,0,0,1
SC545198,1,1,0,0,1,1,0,0,0
SC545271,2,2,0,0,2,2,0,0,0
SC545331,1,1,0,0,1,1,0,0,0
SC545389,4,4,0,0,0,0,0,0,0
SC545543,3,3,0,0,1,1,0,0,1
SC545788,1,1,0,0,1,1,0,0,0
SC545791,5,0,5,0,1,0,1,0,0
SC545895,2,1,1,0,3,2,1,1,0
SC546068,6,4,2,0,5,2,3,4,1
SC546217,1,1,0,0,1,1,0,0,0
SC546223,2,2,0,0,1,1,0,0,1
SC546322,4,4,0,0,0,0,0,0,1
SC546564,7,7,0,0,1,1,0,0,1
SC546572,1,0,1,0,1,0,1,0,0
SC546594,2,2,0,0,1,1,0,1,1
SC546618,6,4,2,0,1,1,0,1,1
SC546719,3,3,0,1,1,1,0,1,1
SC546762,5,3,2,0,5,3,2,2,1
SC546966,1,0,1,0,1,1,0,0,0
SC547008,2,0,2,0,1,1,0,1,1
SC547009,2,0,2,0,1,1,0,1,1
SC547010,2,0,2,0,1,1,0,1,1
SC547071,7,4,3,0,3,2,1,1,1
SC547318,2,2,0,0,1,1,0,0,0
SC547441,8,4,4,0,1,1,0,0,1
SC547499,2,2,0,0,1,1,0,0,0
SC547510,2,1,1,0,2,1,1,0,0
SC547970,4,4,0,0,2,2,0,0,0
SC548014,2,2,0,0,1,1,0,0,1
SC548023,4,3,1,0,0,0,0,0,0
SC548464,1,0,1,0,1,1,0,0,0
SC548682,1,1,0,0,1,1,0,0,0
SC548716,2,2,0,0,2,2,0,0,0
SC548806,1,0,1,0,1,1,0,0,0
SC549024,10,7,3,0,0,0,0,0,0
SC549144,1,1,0,0,1,1,0,0,0
SC549340,2,2,0,0,1,1,0,0,0
SC549405,2,0,2,0,1,1,0,0,0
SC549628,1,1,0,0,1,1,0,0,0
SC549676,5,3,2,0,3,2,1,2,1
SC549861,2,0,2,0,1,1,0,0,0
SC549911,8,8,0,0,2,1,1,1,1
SC549979,1,1,0,0,1,1,0,0,0
SC413980,14,3,11,1,1,1,0,1,1
SC413998,4,3,1,0,1,1,0,1,1
SC414239,8,6,2,0,1,1,0,0,0
SC414258,1,0,1,0,0,0,0,0,0
SC414274,2,2,0,0,2,2,0,0,1
SC414329,5,0,5,0,0,0,0,0,1
SC414528,2,0,2,0,0,0,0,0,1
SC414776,3,1,2,0,2,2,0,0,0
SC414845,2,0,2,0,0,0,0,0,0
SC415053,3,2,1,0,1,1,0,0,1
SC415849,6,3,3,0,1,0,1,0,1
SC416246,1,1,0,0,0,0,0,0,0
SC416345,1,1,0,0,1,1,0,0,0
SC416394,9,0,9,0,0,0,0,0,1
SC417202,8,3,5,0,2,2,0,0,1
SC417227,2,0,2,0,2,2,0,0,0
SC417310,1,0,1,0,0,0,0,0,0
SC417428,2,0,2,0,0,0,0,0,1
SC417637,8,4,4,1,1,1,0,1,1
SC417641,12,0,12,0,0,0,0,0,1
SC417669,3,3,0,0,2,2,0,0,0
SC417703,2,1,1,0,1,1,0,0,1
SC417888,9,2,7,2,2,1,1,1,0
SC418160,20,8,12,0,1,1,0,1,0
SC418393,4,0,4,0,0,0,0,0,1
SC418395,4,2,2,0,1,1,0,0,0
SC418522,7,0,7,0,0,0,0,0,1
SC418783,1,1,0,0,1,1,0,0,0
SC418838,13,5,8,0,1,1,0,1,1
SC418969,1,0,1,0,0,0,0,0,1
SC419377,5,3,2,0,1,1,0,1,0
SC419421,9,0,9,0,1,1,0,1,1
SC419562,4,0,4,0,1,1,0,1,1
SC419593,1,1,0,0,1,1,0,0,0
SC419663,10,7,3,0,0,0,0,0,1
SC419728,4,1,3,0,2,1,1,1,1
SC419852,20,8,12,0,2,2,0,0,0
SC419871,1,0,1,0,0,0,0,0,0
SC420127,6,1,5,0,4,1,3,1,1
SC420393,26,11,15,0,0,0,0,0,0
SC420459,4,3,1,0,2,2,0,0,0
SC420531,6,3,3,0,1,1,0,0,1
SC420608,3,3,0,0,1,1,0,0,1
SC420663,4,0,4,0,0,0,0,0,0
SC420719,2,2,0,0,2,2,0,0,0
SC420722,2,2,0,0,2,2,0,0,1
SC420803,9,4,5,0,3,3,0,0,0
SC420857,2,2,0,0,1,1,0,0,0
SC421056,4,2,2,0,2,2,0,0,1
SC421072,10,7,3,0,1,1,0,1,1
SC421652,3,2,1,0,1,1,0,0,0
SC421749,5,0,5,0,0,0,0,0,1
SC421764,14,11,3,0,0,0,0,0,0
SC421804,1,0,1,0,0,0,0,0,0
SC421841,6,3,3,0,3,3,0,0,1
SC421935,4,3,1,0,2,2,0,0,1
SC422051,5,2,3,0,1,1,0,0,0
SC422180,2,2,0,0,1,1,0,0,0
SC422365,5,2,3,0,2,2,0,0,0
SC422611,1,0,1,0,1,1,0,0,1
SC422707,3,1,2,0,3,1,2,0,0
SC422708,2,0,2,0,0,0,0,0,1
SC422871,1,1,0,0,1,1,0,0,0
SC422878,3,0,3,0,0,0,0,0,1
SC422966,5,4,1,0,0,0,0,0,1
SC423125,4,0,4,0,0,0,0,0,1
SC423161,1,0,1,0,0,0,0,0,0
SC423292,3,3,0,0,2,2,0,0,0
SC423330,3,3,0,0,2,2,0,0,0
SC423551,2,0,2,0,2,2,0,0,1
SC423575,4,3,1,0,1,1,0,0,1
SC423813,2,2,0,0,2,2,0,0,0
SC423927,5,0,5,0,0,0,0,0,1
SC423965,2,1,1,0,0,0,0,0,0
SC423969,8,6,2,0,1,1,0,1,1
SC424008,1,0,1,0,1,1,0,0,0
SC424066,3,3,0,0,2,2,0,0,1
SC424177,2,2,0,0,2,2,0,0,0
SC424227,1,1,0,0,1,1,0,0,0
SC424232,4,2,2,0,1,1,0,1,1
SC424282,2,0,2,0,0,0,0,0,1
SC425069,2,2,0,0,1,1,0,0,0
SC425241,3,0,3,0,0,0,0,0,1
SC425281,9,0,9,0,0,0,0,0,1
SC425339,1,1,0,0,1,1,0,0,0
SC425404,2,1,1,0,2,2,0,0,0
SC425419,11,4,7,1,1,1,0,1,0
SC425560,3,1,2,0,1,1,0,0,0
SC425799,1,0,1,0,0,0,0,0,0
SC425808,36,10,26,0,0,0,0,0,1
SC425938,3,0,3,0,0,0,0,0,1
SC426144,2,2,0,0,1,1,0,0,0
SC426172,3,0,3,0,0,0,0,0,0
SC426291,1,0,1,0,1,1,0,0,1
SC426525,12,9,3,0,1,1,0,1,1
SC426667,8,5,3,0,0,0,0,0,1
SC426789,1,1,0,0,1,1,0,0,0
SC426815,6,4,2,0,1,1,0,0,0
SC427011,13,0,13,0,0,0,0,0,0
SC427013,6,2,4,0,0,0,0,0,0
SC427156,12,2,10,0,1,1,0,1,1
SC427253,3,2,1,0,2,2,0,0,1
SC427340,1,0,1,0,0,0,0,0,0
SC427401,3,3,0,0,2,2,0,0,1
SC427583,5,3,2,0,1,1,0,1,1
SC427652,12,4,8,1,2,2,0,0,1
SC427653,3,0,3,0,0,0,0,0,0
SC427879,48,11,37,0,0,0,0,0,0
SC427906,2,0,2,0,1,1,0,0,0
SC428029,1,0,1,0,0,0,0,0,0
SC428031,4,2,2,0,2,2,0,0,1
SC428034,3,0,3,0,0,0,0,0,1
SC428036,1,1,0,0,1,1,0,0,0
SC428080,7,0,7,0,0,0,0,0,1
SC428085,5,0,5,0,4,1,3,2,1
SC428112,3,3,0,0,2,2,0,0,1
SC428206,11,3,8,0,5,1,4,5,1
SC428382,4,1,3,0,1,1,0,0,1
SC428384,3,3,0,0,2,1,1,0,0
SC428478,6,5,1,0,1,1,0,1,1
SC428588,4,0,4,0,1,1,0,0,1
SC428623,1,0,1,0,0,0,0,0,0
SC428628,1,0,1,0,0,0,0,0,1
SC428676,1,1,0,0,1,1,0,0,0
SC429039,2,0,2,0,2,1,1,2,0
SC429355,2,0,2,0,0,0,0,0,0
SC429394,1,1,0,0,1,1,0,0,0
SC429507,2,0,2,0,0,0,0,0,0
SC429595,1,1,0,0,1,1,0,0,1
SC429705,6,0,6,0,0,0,0,0,1
SC429763,5,0,5,0,0,0,0,0,1
SC429898,2,2,0,0,1,1,0,0,0
SC429941,3,1,2,0,1,1,0,0,0
SC430077,1,1,0,0,1,1,0,0,0
SC430118,7,4,3,0,1,1,0,1,1
SC430241,2,0,2,0,0,0,0,0,1
SC430512,11,6,5,1,1,1,0,0,1
SC430556,2,1,1,0,1,1,0,0,0
SC430766,5,2,3,0,1,0,1,1,1
SC430847,12,2,10,0,1,1,0,0,1
SC430893,1,1,0,0,1,1,0,0,1
SC430922,2,2,0,0,2,2,0,0,1
SC431138,5,3,2,0,4,4,0,0,1
SC431161,4,0,4,0,1,1,0,1,1
SC431397,2,0,2,0,0,0,0,0,1
SC431469,5,1,4,0,2,1,1,0,1
SC431485,11,5,6,0,2,1,1,2,1
SC431522,1,0,1,0,0,0,0,0,0
SC431541,2,0,2,0,0,0,0,0,1
SC431557,6,4,2,0,2,1,1,1,1
SC431779,1,0,1,0,0,0,0,0,1
SC431870,1,1,0,0,2,2,0,0,0
SC431906,1,1,0,0,1,1,0,0,0
SC431989,2,2,0,0,1,1,0,0,1
SC432099,1,0,1,0,0,0,0,0,0
SC432119,12,6,6,0,0,0,0,0,0
SC432209,2,0,2,0,0,0,0,0,1
SC432216,2,2,0,0,2,2,0,0,0
SC432605,2,2,0,0,1,1,0,0,0
SC432748,2,2,0,0,1,1,0,0,1
SC432755,3,3,0,0,2,2,0,0,1
SC432787,3,3,0,0,1,1,0,0,0
SC432912,3,0,3,0,0,0,0,0,0
SC433110,3,3,0,0,1,1,0,0,1
SC433164,1,1,0,0,1,1,0,0,0
SC433176,11,4,7,0,1,1,0,1,1
SC433439,1,0,1,0,0,0,0,0,0
SC433625,7,3,4,0,1,1,0,1,0
SC433842,2,2,0,0,1,1,0,0,0
SC433844,5,3,2,0,1,1,0,1,1
SC433845,6,4,2,0,1,1,0,1,1
SC433857,31,9,22,0,0,0,0,0,0
SC433949,2,0,2,0,0,0,0,0,1
SC433950,2,0,2,0,0,0,0,0,1
SC433952,2,0,2,0,0,0,0,0,1
SC434246,10,4,6,0,0,0,0,0,1
SC434350,2,2,0,0,2,2,0,0,0
SC434756,28,9,19,0,1,1,0,0,1
SC434794,3,3,0,0,1,1,0,0,1
SC434990,5,0,5,0,2,2,0,0,1
SC435128,2,2,0,0,2,2,0,0,0
SC435274,28,10,18,0,0,0,0,0,0
SC435506,5,0,5,0,0,0,0,0,1
SC435553,3,0,3,0,0,0,0,0,1
SC435579,1,1,0,0,2,2,0,0,0
SC435687,3,0,3,0,0,0,0,0,1
SC435949,1,0,1,0,0,0,0,0,0
SC436187,2,0,2,0,0,0,0,0,0
SC436334,1,1,0,0,1,1,0,0,1
SC436491,2,2,0,0,2,2,0,0,0
SC436779,2,1,1,0,1,1,0,0,0
SC436827,10,4,6,1,1,1,0,1,1
SC437055,3,2,1,0,1,1,0,0,0
SC437105,1,0,1,0,0,0,0,0,0
SC437333,11,2,9,0,1,1,0,1,1
SC437346,11,2,9,0,9,1,8,1,1
SC437540,5,2,3,0,1,1,0,0,1
SC437641,7,2,5,0,1,1,0,1,0
SC437955,2,2,0,0,1,1,0,0,1
SC437967,2,2,0,0,1,1,0,1,0
SC438035,2,0,2,0,1,1,0,1,0
SC438125,1,1,0,0,1,1,0,0,1
SC438148,3,0,3,0,0,0,0,0,1
SC438149,4,0,4,0,0,0,0,0,1
SC438150,3,0,3,0,0,0,0,0,1
SC438168,1,0,1,0,1,1,0,0,0
SC438195,19,6,13,0,0,0,0,0,1
SC438223,10,5,5,0,1,1,0,0,1
SC438225,14,6,8,0,1,1,0,1,1
SC438313,3,0,3,0,0,0,0,0,1
SC438595,9,0,9,0,0,0,0,0,0
SC438711,2,0,2,0,0,0,0,0,0
SC438863,2,2,0,0,2,2,0,0,0
SC438886,10,6,4,0,0,0,0,0,1
SC438972,2,2,0,0,2,2,0,0,0
SC439109,2,2,0,0,2,2,0,0,0
SC439204,1,1,0,0,1,1,0,0,0
SC439231,11,2,9,0,1,1,0,1,1
SC439430,4,2,2,0,2,1,1,0,1
SC439603,11,3,8,0,1,1,0,0,0
SC439627,2,0,2,0,0,0,0,0,1
SC439900,2,1,1,0,2,2,0,0,0
SC439976,6,0,6,0,0,0,0,0,1
09720182,10,1,9,0,5,1,4,0,0
09720235,13,7,6,0,1,1,0,1,1
09720523,6,1,5,0,2,1,1,0,0
09720557,3,0,3,0,1,1,0,1,1
09720590,1,1,0,0,1,1,0,0,0
09720758,6,3,3,0,1,1,0,1,1
09720899,2,2,0,0,2,2,0,0,0
09721163,1,0,1,0,1,1,0,0,0
09721260,3,2,1,0,1,1,0,0,0
09721912,4,3,1,0,1,1,0,0,0
09722902,8,0,8,0,0,0,0,0,1
09723299,2,2,0,0,2,2,0,0,0
09723437,2,0,2,0,2,2,0,0,1
09723783,7,5,2,0,1,1,0,1,1
09723820,2,2,0,0,2,2,0,0,0
09724156,2,0,2,0,2,2,0,0,0
09724294,3,0,3,0,1,1,0,0,1
09724853,3,0,3,0,0,0,0,0,1
09725003,7,3,4,0,2,1,1,2,1
09725240,1,1,0,0,1,1,0,0,0
09725560,7,4,3,0,1,1,0,1,1
09725563,8,4,4,0,1,1,0,1,1
09725642,4,4,0,0,1,1,0,1,1
09726606,5,2,3,0,0,0,0,0,0
09726612,1,1,0,0,1,1,0,0,0
09726852,8,1,7,0,5,1,4,0,0
09726879,4,1,3,0,2,1,1,0,0
09727051,3,3,0,0,1,1,0,0,0
09727234,1,1,0,0,1,1,0,0,0
09727301,10,1,9,0,5,1,4,0,0
09727477,2,2,0,0,2,2,0,0,0
09728352,5,4,1,0,1,1,0,1,1
09728547,10,3,7,0,1,1,0,1,1
09728614,12,8,4,0,5,4,1,0,1
09728708,3,2,1,0,2,1,1,0,1
09728750,4,2,2,0,2,2,0,0,1
09728765,1,0,1,0,1,1,0,0,0
09729218,6,4,2,0,2,2,0,0,1
09729815,1,0,1,0,1,1,0,0,1
09730615,1,1,0,0,1,1,0,0,0
09730704,1,1,0,0,0,0,0,0,0
09730860,1,1,0,0,1,1,0,0,0
09730948,2,2,0,0,2,2,0,0,1
09731994,1,1,0,0,1,1,0,0,0
09732210,17,11,6,0,0,0,0,0,1
09732324,11,9,2,0,0,0,0,0,0
09732367,8,7,1,0,0,0,0,0,0
09732439,16,7,9,0,2,1,1,0,1
09732495,2,2,0,0,1,1,0,0,1
09732644,2,2,0,0,1,1,0,0,0
09733231,3,0,3,0,2,2,0,0,0
09733479,2,0,2,0,1,1,0,0,1
09733703,6,6,0,0,0,0,0,0,1
09734068,2,2,0,0,2,2,0,0,1
09734231,4,4,0,0,1,1,0,0,1
09734488,4,2,2,0,2,1,1,0,0
09734578,3,3,0,0,2,2,0,0,0
09734698,7,5,2,0,0,0,0,0,0
09735004,4,3,1,0,2,2,0,0,0
09735057,1,1,0,0,1,1,0,0,0
09735068,7,6,1,0,0,0,0,0,0
09735235,3,2,1,0,2,2,0,0,0
09735340,6,5,1,0,1,1,0,0,0
09735357,3,1,2,0,3,1,2,0,0
09735528,1,1,0,0,1,1,0,0,0
09735896,2,0,2,0,0,0,0,0,1
09736134,5,5,0,0,1,1,0,0,1
09737004,1,0,1,0,1,1,0,0,0
09737065,2,1,1,0,0,0,0,0,0
09737463,1,1,0,0,1,1,0,0,0
09737712,1,1,0,0,1,1,0,0,1
09738135,5,3,2,0,4,2,2,0,1
09738511,11,3,8,0,3,1,2,1,1
09739450,4,2,2,0,2,2,0,0,1
09739607,7,0,7,0,2,1,1,2,1
09739719,1,1,0,0,1,1,0,0,0
09739893,8,2,6,0,1,1,0,1,1
09740029,13,3,10,0,1,1,0,1,1
09740073,7,2,5,0,2,1,1,2,1
09740322,20,9,11,0,2,1,1,2,1
09740498,5,4,1,0,1,1,0,1,0
09740550,1,1,0,0,1,1,0,0,0
09740664,14,3,11,0,1,1,0,1,1
09740754,3,0,3,0,0,0,0,0,0
09740763,6,6,0,0,2,2,0,0,1
09740986,2,2,0,0,2,2,0,0,0
09741110,2,2,0,0,2,2,0,0,1
09741214,9,0,9,0,2,2,0,2,1
09741888,1,1,0,0,1,1,0,0,0
09741928,10,6,4,0,2,2,0,1,1
09741951,2,2,0,0,2,2,0,0,0
09742278,2,2,0,0,1,1,0,0,1
09742540,13,9,4,0,13,9,4,0,0
09742555,3,3,0,0,1,1,0,1,1
09742580,1,1,0,0,1,1,0,0,0
09742902,7,5,2,0,6,2,4,2,1
09743047,6,3,3,0,1,1,0,1,1
09743406,7,3,4,0,1,1,0,1,1
09743459,1,1,0,0,1,1,0,0,0
09743513,6,3,3,0,0,0,0,0,0
09743746,2,1,1,0,1,1,0,0,1
09743796,1,1,0,0,1,1,0,0,1
09743797,6,2,4,0,0,0,0,0,1
09743833,5,2,3,0,1,1,0,0,1
09743895,1,1,0,0,1,1,0,0,0
09744207,4,4,0,0,2,2,0,0,1
09744354,3,3,0,0,1,1,0,1,0
09744409,14,8,6,0,0,0,0,0,1
09744499,2,1,1,0,1,1,0,0,0
09744505,3,3,0,0,2,2,0,0,1
09744541,4,3,1,0,0,0,0,0,0
09744826,2,2,0,0,2,2,0,0,0
09744830,1,0,1,0,1,1,0,0,0
09744905,2,1,1,0,2,1,1,0,0
09744971,1,1,0,0,1,1,0,0,0
09745212,2,1,1,0,2,2,0,0,1
09745282,10,4,6,0,1,0,1,1,0
09745294,1,1,0,0,1,1,0,0,0
09745346,1,1,0,0,1,1,0,0,0
09745569,1,1,0,0,1,1,0,0,1
09745670,11,6,5,0,1,1,0,0,0
09745740,2,2,0,0,2,2,0,0,1
09745805,1,1,0,0,1,1,0,0,0
09746035,2,1,1,0,1,1,0,0,0
09746748,3,3,0,0,3,3,0,0,0
09747033,3,1,2,0,2,1,1,0,0
09747371,2,1,1,0,1,1,0,0,0
09747515,5,4,1,0,4,4,0,0,0
09748002,1,1,0,0,1,1,0,0,0
09748604,1,0,1,0,0,0,0,0,1
09749251,2,2,0,0,2,2,0,0,0
09749513,7,1,6,0,1,1,0,1,1
09749615,8,1,7,0,1,1,0,1,1
09749678,4,0,4,0,0,0,0,0,1
09750587,3,2,1,0,1,1,0,1,1
09750832,4,3,1,0,2,1,1,2,1
09750890,17,16,1,0,0,0,0,0,0
09750946,9,6,3,0,0,0,0,0,1
09751151,4,0,4,0,0,0,0,0,0
09751326,5,3,2,0,1,1,0,1,1
09751345,5,4,1,0,0,0,0,0,0
09751395,1,1,0,0,1,1,0,0,0
09751521,1,1,0,0,1,1,0,0,0
09751644,7,6,1,0,1,1,0,1,1
09751671,2,2,0,0,2,2,0,0,0
09751720,7,6,1,0,1,1,0,1,1
09751875,8,0,8,0,1,1,0,1,1
09751889,6,0,6,0,2,1,1,2,1
09752013,2,1,1,0,1,1,0,0,0
09752273,6,3,3,0,2,1,1,2,1
09752302,4,4,0,0,1,0,1,0,0
09752452,19,10,9,0,0,0,0,0,1
09752499,1,1,0,0,1,1,0,0,0
09752717,3,0,3,0,3,3,0,0,1
09754098,1,1,0,0,1,1,0,0,0
09754554,1,1,0,0,1,1,0,0,0
09754752,8,3,5,0,2,2,0,0,0
09755311,2,0,2,0,0,0,0,0,0
09755529,2,1,1,0,2,1,1,0,0
09757399,1,1,0,0,1,1,0,0,0
09757456,1,1,0,0,1,1,0,0,0
09757470,1,1,0,0,1,1,0,0,0
09757652,3,3,0,0,3,2,1,1,1
09757696,3,2,1,0,1,1,0,0,1
09757729,2,2,0,0,1,1,0,0,0
09757740,1,1,0,0,1,1,0,0,0
09757868,1,1,0,0,1,1,0,0,0
09757960,1,1,0,0,2,2,0,0,0
09758309,7,4,3,0,0,0,0,0,1
09758793,9,7,2,0,1,1,0,1,1
09758964,1,1,0,0,1,1,0,0,1
09759029,1,1,0,0,2,1,1,0,0
09759126,9,0,9,0,4,4,0,1,0
09760010,6,5,1,0,0,0,0,0,0
09760192,1,1,0,0,1,1,0,0,0
09760296,2,2,0,0,2,2,0,0,0
09760807,6,2,4,0,2,2,0,0,1
09760850,14,8,6,0,0,0,0,0,1
09760951,2,2,0,0,2,2,0,0,0
09761005,24,14,10,0,0,0,0,0,0
09761115,4,4,0,0,1,1,0,0,1
09761415,3,3,0,0,1,1,0,0,1
09761603,4,4,0,0,0,0,0,0,1
09761646,12,8,4,0,0,0,0,0,1
09761671,6,3,3,0,0,0,0,0,1
09762041,7,0,7,0,0,0,0,0,1
09762160,2,1,1,0,1,1,0,0,0
09762574,3,0,3,0,0,0,0,0,1
09762854,2,0,2,0,2,1,1,0,1
09763160,3,0,3,0,0,0,0,0,1
09763403,2,2,0,0,2,1,1,1,1
09764024,2,2,0,0,2,2,0,0,1
09764161,7,4,3,0,0,0,0,0,0
09764164,1,1,0,0,1,1,0,0,0
09764538,3,0,3,0,3,3,0,0,0
09764553,4,3,1,0,1,1,0,1,1
09764840,1,1,0,0,1,1,0,0,0
09764869,1,0,1,0,0,0,0,0,0
09764969,1,1,0,0,1,1,0,0,0
09765350,1,1,0,0,1,1,0,0,0
09765515,7,5,2,0,2,1,1,0,1
09765525,6,4,2,0,1,1,0,1,1
09766859,1,1,0,0,1,1,0,0,0
09766887,3,0,3,0,0,0,0,0,1
09767343,1,1,0,0,3,2,1,2,0
09767583,1,1,0,0,1,1,0,0,0
09768505,1,1,0,0,2,2,0,0,0
09768573,1,0,1,0,1,1,0,0,1
09768780,1,0,1,0,0,0,0,0,0
09769075,2,0,2,0,1,1,0,0,0
09769423,4,4,0,0,3,3,0,0,0
09769455,6,2,4,0,1,1,0,0,0
09769779,10,6,4,0,1,1,0,1,1
05480069,5,2,3,0,1,1,0,0,0
05480115,2,2,0,0,1,1,0,0,0
05480338,5,1,4,0,1,1,0,0,1
05480340,35,4,31,0,1,1,0,1,1
05480367,5,0,5,0,0,0,0,0,0
05480730,6,4,2,0,1,1,0,0,1
05481374,8,3,5,0,1,1,0,0,1
05481377,10,1,9,0,0,0,0,0,1
05481386,10,0,10,0,0,0,0,0,1
05481495,9,2,7,0,0,0,0,0,1
05481900,4,2,2,0,1,1,0,0,0
05482383,6,1,5,0,1,1,0,0,1
05482421,6,3,3,0,0,0,0,0,1
05482646,14,0,14,0,0,0,0,0,1
05483058,9,3,6,0,1,1,0,1,1
05483060,9,3,6,0,2,1,1,1,1
05483375,6,3,3,0,1,1,0,1,1
05483483,3,0,3,0,0,0,0,0,1
05483806,11,4,7,0,1,1,0,1,1
05483950,23,10,13,0,0,0,0,0,1
05484062,4,0,4,0,1,1,0,0,1
05484125,97,11,86,0,0,0,0,0,0
05484221,9,0,9,0,0,0,0,0,1
05484760,4,3,1,0,1,1,0,0,1
05484988,5,4,1,0,3,3,0,0,0
05484990,4,3,1,0,4,2,2,1,0
05485219,3,3,0,0,2,2,0,0,1
05485349,30,10,20,0,0,0,0,0,0
05485651,29,4,25,1,0,0,0,0,0
05485678,28,6,22,0,1,1,0,1,1
05485879,3,2,1,0,1,1,0,0,1
05485932,22,7,15,0,0,0,0,0,0
05485961,29,10,19,0,1,1,0,1,0
05486114,6,0,6,0,0,0,0,0,1
05486638,20,5,15,0,1,1,0,1,1
05486645,7,0,7,0,0,0,0,0,1
05486647,16,0,16,0,0,0,0,0,1
05486671,7,0,7,0,0,0,0,0,1
05486992,4,0,4,0,1,1,0,0,0
05487505,6,3,3,0,2,2,0,0,0
05488651,18,8,10,0,1,1,0,1,1
05489010,3,2,1,0,1,1,0,0,0
05489355,7,0,7,0,0,0,0,0,1
05489727,2,2,0,0,1,1,0,1,0
05489767,27,6,21,0,1,1,0,1,1
05489775,31,2,29,0,0,0,0,0,1
05490074,4,0,4,0,1,1,0,0,1
05490114,7,2,5,0,3,3,0,0,0
05490129,3,2,1,0,2,2,0,0,1
05490182,6,0,6,0,0,0,0,0,1
05490276,0,0,0,0,0,0,0,0,1
05490390,10,0,10,0,0,0,0,0,1
05490420,18,1,17,0,0,0,0,0,0
05490737,10,0,10,0,0,0,0,0,1
05490738,6,3,3,0,1,1,0,0,1
05491198,32,0,32,0,1,1,0,1,1
05491200,34,0,34,0,1,1,0,1,1
05491588,25,8,17,0,0,0,0,0,1
05491604,8,5,3,0,3,3,0,0,1
05491635,30,4,26,0,3,2,1,1,1
05491668,30,4,26,0,3,2,1,1,1
05492468,6,2,4,0,1,1,0,0,0
05492628,3,0,3,0,0,0,0,0,1
05492673,29,4,25,0,3,2,1,1,1
05492674,28,4,24,0,3,2,1,1,1
05492798,4,2,2,0,2,2,0,0,0
05493152,4,0,4,0,0,0,0,0,0
05493384,78,19,59,0,3,2,1,0,1
05493387,19,2,17,0,1,1,0,1,1
05493800,5,3,2,0,1,1,0,0,0
05493819,22,3,19,0,0,0,0,0,0
05494031,5,2,3,0,2,1,1,0,1
05494070,4,2,2,0,2,2,0,0,0
05494083,5,3,2,0,2,2,0,0,0
05494336,6,0,6,0,0,0,0,0,1
05494740,5,3,2,0,2,2,0,0,0
05494748,16,0,16,0,0,0,0,0,1
05494795,9,0,9,0,0,0,0,0,1
05494867,10,0,10,0,0,0,0,0,1
05495096,10,6,4,0,0,0,0,0,1
05495293,33,3,30,0,2,1,1,2,1
05495731,13,8,5,0,1,0,1,0,1
05496466,23,5,18,0,1,1,0,1,1
05496468,23,5,18,0,1,1,0,1,1
05496469,28,6,22,0,1,1,0,1,1
05496623,4,2,2,0,1,1,0,0,1
05496635,5,1,4,0,1,1,0,0,1
05496869,13,5,8,0,0,0,0,0,1
05496952,16,2,14,0,2,1,1,1,1
05496954,16,2,14,0,2,1,1,1,1
05496958,16,2,14,0,2,1,1,1,1
05497253,6,1,5,0,1,1,0,0,1
05497310,29,0,29,0,1,1,0,0,0
05497663,5,0,5,0,2,2,0,0,1
05497706,7,3,4,0,1,1,0,0,1
05497774,12,0,12,0,0,0,0,0,1
05497802,15,0,15,0,0,0,0,0,1
05498489,45,0,45,0,0,0,0,0,1
05498655,11,7,4,0,1,1,0,0,1
05498724,10,7,3,0,0,0,0,0,0
05498803,16,8,8,0,0,0,0,0,1
05499009,5,3,2,0,1,1,0,0,1
05499298,4,2,2,0,1,1,0,0,1
05499369,12,5,7,0,1,1,0,0,1
05499435,18,0,18,0,0,0,0,0,1
05499870,12,0,12,0,0,0,0,0,1
05499905,12,2,10,0,0,0,0,0,1
05500404,10,3,7,0,0,0,0,0,0
05500663,21,6,15,0,1,1,0,1,1
05500885,6,0,6,0,0,0,0,0,1
05501054,9,3,6,0,0,0,0,0,0
05501089,4,0,4,0,0,0,0,0,0
05501116,11,2,9,0,1,1,0,0,1
05501257,17,8,9,0,0,0,0,0,1
05501389,3,1,2,0,1,1,0,0,0
05501651,8,0,8,0,0,0,0,0,1
05501979,3,0,3,0,0,0,0,0,1
05502209,17,7,10,0,1,1,0,1,1
05503274,11,3,8,0,1,1,0,1,1
05503535,3,2,1,0,1,1,0,0,0
05504373,10,0,10,0,0,0,0,0,1
05504412,12,3,9,0,1,1,0,1,1
05504517,24,5,19,0,0,0,0,0,0
05504624,4,3,1,0,2,2,0,0,1
05504660,7,1,6,0,0,0,0,0,1
05504699,6,2,4,0,2,2,0,0,0
05504750,9,2,7,0,0,0,0,0,1
05504758,4,1,3,0,1,1,0,0,0
05504760,6,2,4,0,1,1,0,0,1
05504806,26,9,17,0,0,0,0,0,1
05505149,3,0,3,0,2,2,0,0,0
05505173,3,1,2,0,2,2,0,0,0
05505189,16,0,16,0,0,0,0,0,1
05505317,6,2,4,0,1,1,0,1,1
05505577,11,5,6,0,1,1,0,0,0
05505587,4,2,2,0,1,1,0,0,0
05505639,13,0,13,0,0,0,0,0,1
05505743,7,3,4,0,2,2,0,0,0
05505763,15,3,12,0,2,1,1,2,1
05505985,11,4,7,0,0,0,0,0,1
05506168,9,0,9,0,0,0,0,0,1
05506268,5,3,2,0,2,2,0,0,0
05506731,13,0,13,0,0,0,0,0,1
05506903,32,6,26,0,0,0,0,0,1
05507324,4,0,4,0,1,1,0,0,0
05507325,14,5,9,0,2,1,1,0,0
05507344,24,3,21,0,1,1,0,1,1
05507387,14,4,10,0,1,1,0,1,1
05507628,5,0,5,0,0,0,0,0,1
05507947,2,2,0,0,1,1,0,0,1
05508378,7,0,7,0,0,0,0,0,1
05508735,38,15,23,0,2,1,1,0,0
05508872,5,2,3,0,3,3,0,0,1
05508991,7,2,5,0,1,1,0,0,0
05509039,14,3,11,0,0,0,0,0,1
05509079,8,3,5,0,1,1,0,1,1
05509082,8,3,5,0,1,1,0,1,1
05509086,57,9,48,0,0,0,0,0,0
05509092,8,3,5,0,1,1,0,1,1
05509109,10,0,10,0,0,0,0,0,1
05509127,4,0,4,0,0,0,0,0,1
05509194,6,1,5,0,0,0,0,0,1
05509521,11,5,6,0,1,1,0,1,1
05510012,3,3,0,0,2,2,0,0,0
05510321,4,2,2,0,1,1,0,0,1
05510593,5,2,3,0,3,3,0,0,1
05510674,4,2,2,0,1,1,0,0,0
05510783,5,2,3,0,1,1,0,0,0
05510985,4,2,2,0,2,2,0,0,0
05511147,16,5,11,0,0,0,0,0,1
05511195,16,0,16,0,0,0,0,0,1
05511220,16,7,9,0,1,1,0,0,0
05511314,6,4,2,0,1,1,0,0,1
05511495,26,0,26,0,0,0,0,0,1
05511798,4,1,3,0,0,0,0,0,0
05511848,19,4,15,0,2,2,0,0,1
05511850,13,5,8,0,1,1,0,1,1
05511851,13,5,8,0,1,1,0,1,1
05512161,5,0,5,0,0,0,0,0,1
05512174,2,2,0,0,1,1,0,0,1
05512199,4,2,2,0,1,1,0,0,0
05512322,7,2,5,0,1,1,0,0,0
05512432,8,1,7,0,1,1,0,1,1
05512541,14,0,14,0,0,0,0,0,1
05512559,12,4,8,0,0,0,0,0,1
05512796,4,2,2,0,2,2,0,0,0
05512942,8,0,8,0,0,0,0,0,1
05512987,33,6,27,0,0,0,0,0,1
05513508,8,2,6,0,0,0,0,0,0
05513839,5,3,2,0,2,2,0,0,1
05514274,13,7,6,0,2,1,1,2,1
05514488,36,2,34,0,3,1,2,3,1
05514761,4,4,0,0,3,3,0,0,0
05514819,18,0,18,0,0,0,0,0,1
05514964,18,6,12,0,0,0,0,0,1
05515278,7,5,2,0,1,1,0,0,1
05515591,5,0,5,0,0,0,0,0,1
05515745,8,4,4,0,0,0,0,0,0
05515857,17,4,13,0,1,1,0,0,1
05516170,3,1,2,0,1,1,0,0,1
05516385,7,0,7,0,1,1,0,0,0
05516463,28,8,20,0,11,1,10,1,1
05516864,4,3,1,0,1,1,0,0,0
05516928,10,0,10,0,0,0,0,0,1
05516931,4,0,4,0,2,2,0,0,1
05517228,31,9,22,0,0,0,0,0,1
05517384,6,0,6,0,0,0,0,0,0
05517733,14,5,9,0,1,1,0,1,1
05518335,18,4,14,0,1,1,0,0,1
05518340,14,5,9,0,1,1,0,1,1
05518392,9,3,6,0,2,2,0,0,0
05518662,15,0,15,0,0,0,0,0,1
05519022,7,0,7,0,0,0,0,0,1
05519131,26,0,26,0,1,1,0,1,1
05519277,13,4,9,0,1,1,0,1,1
05519663,7,3,4,0,2,2,0,0,0
05519729,4,2,2,0,1,1,0,0,0
03200051,30,5,25,0,5,5,0,1,1
03200055,30,3,27,0,1,1,0,1,1
03200175,7,3,4,0,2,2,0,0,0
03200414,17,0,17,0,0,0,0,0,1
03200496,32,2,30,0,1,1,0,1,1
03200517,41,5,36,0,0,0,0,0,1
03200571,15,0,15,0,0,0,0,0,1
03200669,9,0,9,0,0,0,0,0,1
03201640,28,6,22,0,1,1,0,1,1
03201873,9,0,9,0,0,0,0,0,1
03201894,37,0,37,0,0,0,0,0,1
03201959,110,13,97,0,0,0,0,0,1
03202481,4,2,2,0,1,1,0,0,1
03202544,0,0,0,0,0,0,0,0,1
03202609,4,1,3,0,0,0,0,0,1
03202645,13,0,13,0,0,0,0,0,1
03203003,45,7,38,0,0,0,0,0,1
03203080,33,5,28,0,2,1,1,1,1
03203220,22,3,19,0,2,1,1,2,1
03203234,14,4,10,0,1,1,0,0,1
03203701,14,3,11,0,0,0,0,0,1
03203702,20,9,11,0,0,0,0,0,0
03203812,21,8,13,0,0,0,0,0,1
03203842,8,1,7,0,1,1,0,0,1
03203923,23,3,20,0,1,1,0,1,0
03204093,40,0,40,0,0,0,0,0,1
03204400,14,3,11,0,1,1,0,1,1
03204452,31,0,31,0,0,0,0,0,1
03204613,27,3,24,0,1,1,0,1,1
03204631,37,0,37,0,1,1,0,1,1
03204655,25,0,25,0,1,1,0,1,1
03204743,13,2,11,0,1,1,0,1,1
03204761,22,6,16,0,1,1,0,1,1
03204919,42,9,33,0,0,0,0,0,1
03205080,12,7,5,0,0,0,0,0,0
03205246,38,7,31,0,0,0,0,0,1
03205310,12,0,12,0,0,0,0,0,1
03205334,11,2,9,0,4,2,2,0,1
03205768,43,9,34,0,1,1,0,1,1
03205806,34,3,31,0,1,1,0,1,1
03205808,20,6,14,0,0,0,0,0,1
03205893,56,3,53,0,0,0,0,0,1
03206120,19,3,16,0,1,1,0,1,1
03206406,13,0,13,0,0,0,0,0,1
03206792,39,9,30,0,1,1,0,1,1
03206943,25,0,25,0,0,0,0,0,1
03206948,30,5,25,0,1,1,0,1,1
03207200,17,5,12,0,1,1,0,0,1
03207203,21,5,16,0,2,2,0,0,1
03208243,5,3,2,0,2,2,0,0,1
03208792,23,5,18,0,1,1,0,1,1
03208864,38,5,33,0,6,6,0,0,1
03209030,19,3,16,0,0,0,0,0,1
03209036,17,5,12,0,1,1,0,0,1
03209209,23,3,20,0,1,1,0,1,1
03209596,12,3,9,0,1,1,0,1,0
03209823,41,4,37,0,1,1,0,1,1
03210072,31,3,28,0,1,1,0,1,1
03210105,14,5,9,0,1,1,0,1,0
03210130,12,3,9,0,1,1,0,1,0
03210149,16,2,14,0,0,0,0,0,1
03210172,32,2,30,0,1,1,0,1,1
03210452,25,1,24,0,1,1,0,1,1
03210561,6,3,3,0,1,1,0,0,1
03210634,47,7,40,0,0,0,0,0,1
03211164,6,2,4,0,1,1,0,1,1
03211337,9,8,1,0,0,0,0,0,0
03211446,30,11,19,0,0,0,0,0,1
03211467,26,4,22,0,1,1,0,1,1
03211487,9,1,8,0,1,1,0,0,1
03211657,56,4,52,0,2,1,1,2,1
03211760,54,11,43,0,2,2,0,2,1
03211815,43,12,31,0,0,0,0,0,1
03212142,31,4,27,0,1,1,0,1,1
03212428,7,0,7,0,0,0,0,0,0
03212452,8,3,5,0,2,2,0,0,0
03212832,27,4,23,0,2,1,1,1,1
03213006,29,0,29,0,0,0,0,0,1
03213316,18,0,18,0,0,0,0,0,1
03213394,6,3,3,0,1,1,0,1,1
03213553,18,0,18,0,0,0,0,0,1
03213600,25,4,21,0,1,1,0,1,1
03213827,7,3,4,0,2,2,0,0,0
03213927,33,6,27,0,1,1,0,1,1
03213958,26,0,26,0,0,0,0,0,1
03214010,22,3,19,0,1,1,0,1,1
03214121,5,2,3,0,1,1,0,0,1
03214248,6,3,3,0,1,1,0,0,1
03214761,12,3,9,0,0,0,0,0,0
03214787,8,5,3,0,0,0,0,0,0
03214895,5,2,3,0,1,1,0,1,1
03214932,15,2,13,0,1,1,0,1,1
03215084,47,7,40,0,1,1,0,1,1
03215195,15,2,13,0,1,1,0,1,1
03215228,37,4,33,0,1,1,0,1,1
03215318,29,8,21,0,3,2,1,0,0
03215320,23,5,18,0,1,1,0,1,1
03215484,13,0,13,0,0,0,0,0,1
03215486,21,8,13,0,0,0,0,0,1
03215507,18,2,16,0,1,1,0,1,1
03215737,12,2,10,0,1,1,0,1,1
03215874,32,4,28,0,1,1,0,1,1
03215930,9,3,6,0,2,2,0,2,1
03216059,30,3,27,0,1,1,0,1,1
03216219,6,3,3,0,1,1,0,0,0
03216271,140,18,122,0,0,0,0,0,1
03216286,4,3,1,0,0,0,0,0,1
03216528,4,0,4,0,0,0,0,0,1
03216892,51,9,42,0,1,1,0,0,1
03216897,57,16,41,0,0,0,0,0,1
03217059,7,0,7,0,0,0,0,0,0
03217225,8,2,6,0,1,1,0,0,0
03217771,12,2,10,0,2,1,1,1,1
03217772,19,3,16,0,2,2,0,0,1
03217775,26,7,19,0,0,0,0,0,1
03217813,17,5,12,0,0,0,0,0,1
03217859,20,6,14,0,0,0,0,0,1
03218033,26,2,24,0,1,1,0,1,1
03218036,24,5,19,0,1,1,0,1,1
03218068,7,3,4,0,2,1,1,1,0
03218119,9,0,9,0,0,0,0,0,1
03218452,12,6,6,0,1,1,0,0,1
03218526,7,5,2,0,4,4,0,2,1
03218612,12,0,12,0,2,1,1,2,1
03218743,14,0,14,0,0,0,0,0,1
03218803,7,2,5,0,2,1,1,0,0
03218948,26,2,24,0,3,1,2,3,1
03218952,6,3,3,0,2,2,0,0,1
03219347,8,4,4,0,1,1,0,0,1
03219554,18,2,16,0,1,1,0,1,1
03219692,18,2,16,0,1,1,0,1,1
03219705,34,4,30,0,1,1,0,1,1
03219710,5,2,3,0,1,1,0,0,0
03219976,33,4,29,0,1,1,0,1,1
03220183,5,2,3,0,1,1,0,0,1
03220373,87,6,81,0,1,1,0,1,1
03220428,11,4,7,0,1,1,0,0,1
03220526,13,4,9,0,0,0,0,0,0
03220841,4,3,1,0,1,1,0,0,1
03220850,4,3,1,0,1,1,0,0,1
03221000,38,7,31,0,0,0,0,0,1
03221116,31,9,22,0,8,6,2,0,1
03221140,12,7,5,0,0,0,0,0,0
03221693,34,4,30,0,0,0,0,0,1
03221787,20,6,14,0,1,1,0,1,1
03221924,60,11,49,0,2,2,0,2,1
03221933,31,6,25,0,3,1,2,1,1
03222165,56,4,52,0,2,1,1,0,0
03222242,7,0,7,0,0,0,0,0,1
03222541,25,4,21,0,1,1,0,1,1
03222647,15,3,12,0,1,1,0,1,1
03223012,5,3,2,0,1,1,0,0,1
03223155,6,2,4,0,1,1,0,0,1
03223198,31,4,27,0,1,1,0,1,1
03223879,8,3,5,0,2,1,1,0,1
03224187,11,3,8,0,1,1,0,0,1
03224226,39,7,32,0,1,1,0,1,1
03224237,9,1,8,0,1,1,0,1,0
03224254,39,9,30,0,0,0,0,0,0
03224406,31,2,29,0,1,1,0,1,1
03224646,6,3,3,0,2,2,0,0,1
03224870,40,3,37,0,1,1,0,1,1
03224889,22,4,18,0,1,1,0,1,1
03225144,6,0,6,0,2,2,0,0,1
03225245,6,0,6,0,0,0,0,0,1
03225338,20,5,15,0,5,5,0,0,1
03225352,8,2,6,0,2,1,1,2,1
03225381,12,0,12,0,0,0,0,0,1
03225433,22,1,21,0,1,1,0,1,1
03225580,10,2,8,0,2,2,0,0,1
03225584,12,4,8,0,2,2,0,0,1
03225605,11,2,9,0,1,1,0,0,1
03225754,11,2,9,0,1,1,0,1,1
03225797,7,0,7,0,0,0,0,0,1
03225820,62,13,49,0,0,0,0,0,1
03225840,28,5,23,0,1,1,0,1,1
03226004,27,8,19,0,1,1,0,1,1
03226091,19,3,16,0,2,0,2,2,1
03226191,41,22,19,0,1,1,0,0,1
03226261,5,0,5,0,0,0,0,0,0
03226377,39,4,35,0,0,0,0,0,1
03226394,39,4,35,0,0,0,0,0,1
03226403,33,5,28,0,2,1,1,0,1
03226406,16,2,14,0,1,1,0,1,1
03226651,14,1,13,0,0,0,0,0,0
03226782,10,3,7,0,1,1,0,0,1
03226805,28,7,21,0,1,1,0,1,0
03226867,10,3,7,0,0,0,0,0,0
03226910,37,2,35,0,1,1,0,1,1
03226960,24,4,20,0,1,1,0,1,1
03227027,30,7,23,0,1,1,0,1,1
03227137,13,4,9,0,1,1,0,1,1
03227242,26,4,22,0,1,1,0,1,1
03227336,46,6,40,0,0,0,0,0,0
03227432,32,4,28,0,1,1,0,1,1
03227453,31,4,27,0,1,1,0,1,1
03228456,66,15,51,0,0,0,0,0,1
03228478,20,0,20,0,0,0,0,0,1
03228640,3,0,3,0,0,0,0,0,1
03228837,4,2,2,0,2,2,0,0,0
03228954,12,2,10,0,1,1,0,1,1
03228960,7,3,4,0,2,2,0,0,1
03228963,6,1,5,0,3,1,2,0,1
03229039,12,3,9,0,2,1,1,1,1
03229262,13,1,12,0,1,1,0,0,1
03229304,36,0,36,0,0,0,0,0,1
03229417,16,3,13,0,1,1,0,1,1
03229526,12,0,12,0,0,0,0,0,1
03229596,19,0,19,0,1,1,0,0,1
03229737,36,0,36,0,1,1,0,1,1
03229755,44,3,41,0,1,1,0,1,1
03968160,8,0,8,0,0,0,0,0,1
03968279,17,10,7,0,0,0,0,0,0
03968392,9,2,7,0,1,1,0,1,1
03968425,8,3,5,0,1,1,0,0,1
03968441,52,13,39,0,0,0,0,0,1
03968610,9,2,7,0,1,1,0,1,1
03968807,10,1,9,0,1,1,0,0,1
03968822,8,2,6,0,1,1,0,0,1
03969280,31,4,27,0,2,1,1,2,1
03969379,42,7,35,0,1,1,0,0,1
03969380,9,4,5,0,2,2,0,0,1
03969447,0,0,0,0,0,0,0,0,1
03969450,11,0,11,0,1,1,0,1,1
03969688,30,9,21,0,0,0,0,0,1
03969689,10,3,7,0,1,1,0,0,0
03969879,4,0,4,0,1,1,0,0,0
03969886,16,0,16,0,1,1,0,1,1
03969979,12,4,8,0,1,1,0,0,0
03970046,30,0,30,0,0,0,0,0,1
03970089,49,6,43,0,1,1,0,1,1
03970279,9,2,7,0,1,1,0,1,1
03970336,13,0,13,0,0,0,0,0,1
03970339,9,2,7,0,1,1,0,1,1
03970537,18,5,13,0,1,1,0,1,1
03970800,24,0,24,0,0,0,0,0,1
03970806,11,0,11,0,0,0,0,0,1
03971055,6,0,6,0,0,0,0,0,1
03971079,40,0,40,0,3,1,2,3,1
03971514,16,0,16,0,1,1,0,1,1
03971670,13,3,10,0,1,1,0,1,1
03971694,35,10,25,0,0,0,0,0,0
03971723,8,3,5,0,1,1,0,1,1
03971914,29,0,29,0,1,1,0,1,1
03972355,14,3,11,0,1,1,0,1,1
03972550,12,1,11,0,2,1,1,1,1
03972991,6,2,4,0,3,2,1,0,1
03973405,25,0,25,0,0,0,0,0,1
03973434,20,4,16,0,1,1,0,0,1
03973442,22,4,18,0,1,1,0,1,1
03973490,12,6,6,0,2,1,1,2,1
03973614,9,3,6,0,1,1,0,1,1
03973619,10,3,7,0,2,2,0,0,1
03973716,6,0,6,0,0,0,0,0,1
03973827,19,4,15,0,1,1,0,1,1
03973957,22,4,18,0,0,0,0,0,1
03974231,6,3,3,0,1,1,0,0,1
03974519,21,2,19,0,1,1,0,1,0
03974835,6,2,4,0,1,1,0,0,0
03974892,10,3,7,0,0,0,0,0,1
03975065,30,8,22,0,1,1,0,0,0
03975193,20,3,17,1,1,1,0,1,1
03975288,7,3,4,0,1,1,0,1,1
03975492,13,4,9,0,1,1,0,1,1
03975616,16,0,16,0,0,0,0,0,1
03975621,6,3,3,0,2,2,0,0,0
03975672,6,2,4,0,1,1,0,0,1
03975719,23,4,19,0,1,1,0,1,1
03975782,15,3,12,0,0,0,0,0,0
03975999,31,4,27,0,1,1,0,1,1
03976076,24,0,24,0,0,0,0,0,1
03976350,7,4,3,0,1,1,0,0,0
03976531,58,0,58,0,0,0,0,0,1
03976533,10,4,6,0,1,1,0,0,1
03976655,10,3,7,0,1,1,0,0,0
03976759,9,4,5,0,1,1,0,0,1
03976837,4,0,4,0,0,0,0,0,1
03977028,5,2,3,0,1,1,0,0,0
03977289,28,0,28,0,0,0,0,0,1
03977318,51,6,45,0,1,1,0,1,1
03977373,48,4,44,0,0,0,0,0,1
03977431,6,2,4,0,0,0,0,0,1
03977461,4,0,4,0,1,1,0,0,0
03977597,8,3,5,0,1,1,0,1,0
03977695,5,3,2,0,2,2,0,0,0
03977837,8,2,6,0,2,2,0,0,1
03977841,7,0,7,0,0,0,0,0,1
03977896,9,0,9,0,0,0,0,0,1
03977902,17,3,14,0,1,1,0,1,1
03977909,6,2,4,0,2,1,1,0,1
03977982,9,2,7,0,2,2,0,0,1
03977986,6,2,4,0,1,1,0,0,1
03978092,21,2,19,0,1,1,0,1,1
03978157,14,0,14,0,0,0,0,0,1
03978176,7,2,5,0,1,1,0,0,1
03978196,5,2,3,0,1,1,0,0,1
03978221,28,6,22,0,1,1,0,1,1
03978344,48,5,43,0,1,1,0,0,1
03978346,32,3,29,0,1,1,0,1,1
03978759,20,5,15,0,1,1,0,1,1
03979398,12,0,12,0,0,0,0,0,1
03979419,10,2,8,0,1,1,0,0,0
03979454,24,3,21,0,1,1,0,1,1
03979467,24,3,21,0,1,1,0,1,1
03979736,18,4,14,0,1,1,0,1,1
03979913,9,2,7,0,2,2,0,0,1
03980108,12,2,10,0,0,0,0,0,0
03980266,15,0,15,0,0,0,0,0,1
03980594,26,9,17,0,3,2,1,3,1
03980770,49,2,47,0,3,1,2,2,1
03980783,7,3,4,0,1,1,0,0,1
03980813,15,3,12,0,1,1,0,1,1
03981542,12,0,12,0,0,0,0,0,1
03981646,40,0,40,0,0,0,0,0,1
03982057,16,0,16,0,0,0,0,0,1
03982225,26,0,26,0,0,0,0,0,1
03982361,6,2,4,0,1,1,0,0,1
03982820,23,3,20,0,1,1,0,1,1
03982959,13,6,7,0,1,1,0,0,1
03983125,15,3,12,0,1,1,0,1,1
03983137,15,0,15,0,0,0,0,0,1
03983523,5,2,3,0,1,1,0,0,0
03983615,12,0,12,0,0,0,0,0,1
03984014,9,0,9,0,0,0,0,0,1
03984035,5,3,2,0,2,2,0,2,1
03984054,31,0,31,0,0,0,0,0,1
03984070,30,7,23,0,0,0,0,0,1
03984117,5,3,2,0,2,2,0,2,1
03984214,4,0,4,0,1,1,0,0,1
03984289,8,0,8,0,0,0,0,0,1
03984464,29,4,25,0,1,1,0,1,1
03984470,16,0,16,0,0,0,0,0,1
03984492,16,0,16,0,0,0,0,0,1
03984669,5,3,2,0,2,2,0,0,1
03985370,27,0,27,0,0,0,0,0,1
03985376,10,0,10,0,0,0,0,0,1
03985379,23,4,19,0,4,1,3,1,1
03985507,5,1,4,0,1,1,0,0,0
03985540,37,8,29,0,1,0,1,0,1
03985580,21,3,18,0,1,1,0,1,0
03985751,7,4,3,0,1,1,0,0,0
03985873,24,3,21,0,0,0,0,0,1
03986603,12,5,7,0,2,2,0,0,1
03986626,8,0,8,0,0,0,0,0,1
03986667,11,1,10,0,1,1,0,0,0
03986675,5,3,2,0,2,2,0,0,1
03987061,33,5,28,0,2,1,1,2,1
03987132,7,0,7,0,0,0,0,0,1
03987576,4,0,4,0,0,0,0,0,1
03987700,23,0,23,0,0,0,0,0,1
03987762,15,3,12,0,1,1,0,1,1
03987835,4,2,2,0,2,2,0,0,0
03987955,20,5,15,0,1,1,0,1,1
03988189,6,3,3,0,1,1,0,0,0
03988503,19,5,14,0,1,1,0,1,1
03988724,5,2,3,0,1,1,0,0,1
03988903,56,6,50,0,0,0,0,0,1
03989030,4,0,4,0,0,0,0,0,1
03989137,26,8,18,0,0,0,0,0,1
03989460,8,3,5,0,1,1,0,1,1
03990060,3,2,1,0,1,1,0,0,0
03990416,6,3,3,0,2,2,0,0,1
03990538,5,2,3,0,1,1,0,0,1
03990586,5,1,4,0,2,2,0,0,1
03990677,32,4,28,0,1,1,0,1,1
03990680,12,5,7,0,1,1,0,1,1
03990682,5,2,3,0,1,1,0,0,1
03991016,9,4,5,0,1,1,0,1,1
03991305,13,3,10,0,2,2,0,0,1
03991358,15,3,12,0,0,0,0,0,1
03991383,10,3,7,0,0,0,0,0,0
03991397,31,4,27,0,1,1,0,1,0
03991541,7,2,5,0,1,1,0,0,1
03991603,6,2,4,0,1,1,0,0,1
03991620,3,0,3,0,0,0,0,0,1
03991838,42,0,42,0,0,0,0,0,1
03991840,12,6,6,0,2,2,0,0,1
03993081,19,3,16,0,1,1,0,1,1
03993146,5,0,5,0,0,0,0,0,1
03993250,5,5,0,0,4,4,0,0,0
03993256,5,3,2,0,2,2,0,0,1
03993572,6,3,3,0,1,1,0,0,0
03994409,18,4,14,0,1,1,0,0,1
03994691,4,2,2,0,1,1,0,0,1
03994715,5,2,3,0,2,2,0,0,1
03994943,39,11,28,0,0,0,0,0,1
03995173,18,3,15,0,1,1,0,1,1
03995308,5,3,2,0,2,2,0,0,0
03995412,42,10,32,0,0,0,0,0,0
03995638,12,0,12,0,0,0,0,0,1
03996307,4,0,4,0,0,0,0,0,1
03996688,8,0,8,0,0,0,0,0,1
03996691,8,0,8,0,0,0,0,0,1
03996694,5,3,2,0,2,2,0,0,0
03996970,23,4,19,0,1,1,0,0,0
03997525,5,2,3,0,2,2,0,0,1
03997592,27,0,27,0,0,0,0,0,1
03997639,11,4,7,0,0,0,0,0,1
03997901,10,3,7,0,2,2,0,0,1
03997920,20,5,15,0,0,0,0,0,1
03998049,12,0,12,0,0,0,0,0,0
03998108,7,0,7,0,1,1,0,0,0
03998136,14,4,10,0,1,1,0,1,1
03998141,9,5,4,0,1,1,0,0,0
03998216,27,7,20,0,0,0,0,0,1
03998296,6,3,3,0,1,1,0,0,1
03998314,22,0,22,0,0,0,0,0,1
03998355,7,1,6,0,1,1,0,0,1
03998464,8,3,5,0,0,0,0,0,1
03998496,29,5,24,0,0,0,0,0,1
03998819,9,0,9,0,0,0,0,0,1
03998820,8,0,8,0,0,0,0,0,1
03998833,17,3,14,0,2,2,0,2,1
03998881,17,4,13,0,1,1,0,1,1
03998951,7,0,7,0,0,0,0,0,0
03999077,26,8,18,0,1,1,0,0,1
03999194,23,3,20,0,1,1,0,1,1
03999286,16,3,13,0,0,0,0,0,1
03999390,8,3,5,0,1,1,0,1,1
03999493,7,1,6,0,1,1,0,0,1
03999510,14,5,9,0,1,1,0,1,0
03999577,25,5,20,0,1,1,0,1,1
03999579,13,5,8,0,0,0,0,0,1
03999759,4,0,4,0,0,0,0,0,1
03999896,22,5,17,0,0,0,0,0,1
00149013,73,4,69,0,1,1,0,1,1
00149461,13,4,9,0,1,1,0,0,1
00149834,12,3,9,0,2,2,0,0,1
00149999,117,25,92,0,0,0,0,0,1
00150396,25,4,21,0,1,1,0,1,1
00150494,17,9,8,0,0,0,0,0,1
00150515,12,2,10,0,2,1,1,1,1
00150832,35,4,31,0,2,2,0,2,1
00150856,237,48,189,0,0,0,0,0,1
00151289,9,5,4,0,4,4,0,0,1
00151360,88,0,88,0,0,0,0,0,1
00151537,38,3,35,0,1,1,0,1,1
00151618,22,10,12,0,0,0,0,0,1
00151621,84,11,73,0,0,0,0,0,1
00151665,31,4,27,0,1,1,0,1,1
00151731,58,3,55,0,1,1,0,1,1
00152298,49,5,44,0,2,1,1,2,1
00152305,24,3,21,0,0,0,0,0,1
00152385,8,1,7,0,1,1,0,1,1
00152477,24,2,22,0,1,1,0,1,1
00153009,48,4,44,0,1,1,0,1,1
00153026,19,10,9,0,0,0,0,0,1
00153088,31,0,31,0,1,1,0,1,1
00153331,22,4,18,0,1,1,0,1,1
00153360,89,11,78,0,0,0,0,0,1
00154121,66,11,55,0,0,0,0,0,1
00154522,26,6,20,0,1,1,0,1,1
00155224,34,0,34,0,0,0,0,0,0
00155374,45,6,39,0,1,1,0,1,1
00155455,19,4,15,0,1,1,0,1,1
00155840,63,10,53,0,0,0,0,0,1
00155936,22,3,19,0,1,1,0,1,0
00156243,128,17,111,0,0,0,0,0,1
00156261,15,5,10,0,1,1,0,1,0
00156289,33,0,33,0,0,0,0,0,0
00156368,15,4,11,0,1,1,0,0,1
00156617,35,0,35,0,1,1,0,1,1
00156641,39,3,36,0,1,1,0,1,1
00157048,22,6,16,0,1,1,0,1,1
00157345,17,4,13,0,1,1,0,1,1
00157426,11,4,7,0,1,1,0,0,0
00157660,33,2,31,0,1,1,0,0,1
00157833,29,11,18,0,0,0,0,0,0
00157888,33,11,22,0,0,0,0,0,1
00158447,39,5,34,0,1,1,0,1,1
00158900,34,0,34,0,0,0,0,0,1
00159031,54,9,45,0,1,1,0,1,1
00159189,62,5,57,0,1,1,0,1,1
00159926,38,3,35,0,1,1,0,1,1
00160308,8,2,6,0,1,1,0,1,1
00160881,19,3,16,0,1,1,0,1,1
00160988,20,5,15,0,1,1,0,1,1
00160996,20,8,12,0,0,0,0,0,1
00161312,93,5,88,0,0,0,0,0,0
00161443,37,3,34,0,1,1,0,1,1
00161676,127,8,119,0,0,0,0,0,1
00162165,99,18,81,0,0,0,0,0,1
00162175,132,7,125,0,1,1,0,1,1
00162301,49,5,44,0,0,0,0,0,1
00162308,19,3,16,0,1,1,0,1,1
00162457,10,3,7,0,0,0,0,0,1
00162786,21,4,17,0,1,1,0,1,1
00162828,19,0,19,0,0,0,0,0,1
00162966,29,6,23,0,2,1,1,2,1
00163096,18,4,14,0,2,2,0,2,1
00163198,12,0,12,0,0,0,0,0,1
00163210,23,0,23,0,0,0,0,0,1
00163908,19,3,16,0,0,0,0,0,1
00164062,21,3,18,0,1,1,0,1,1
00164206,33,4,29,0,1,1,0,1,1
00164213,22,3,19,0,0,0,0,0,1
00164251,69,10,59,0,0,0,0,0,1
00164291,35,0,35,0,0,0,0,0,1
00164740,13,2,11,0,1,1,0,1,1
00164770,6,5,1,0,1,1,0,1,1
00165100,41,0,41,0,0,0,0,0,1
00165381,31,4,27,0,0,0,0,0,0
00165445,22,5,17,0,1,1,0,1,1
00165453,22,3,19,0,2,2,0,2,1
00165672,14,5,9,0,2,2,0,2,1
00165678,34,3,31,0,1,1,0,1,1
00166023,57,6,51,0,1,1,0,1,1
00166055,45,7,38,0,1,1,0,1,1
00166242,19,3,16,0,1,1,0,1,1
00166244,16,0,16,0,0,0,0,0,1
00166250,97,12,85,0,0,0,0,0,0
00166396,36,3,33,0,0,0,0,0,1
00166427,7,4,3,0,1,1,0,0,1
00166431,66,5,61,0,0,0,0,0,1
00166771,14,4,10,0,1,1,0,1,1
00166772,128,2,126,0,0,0,0,0,1
00167031,23,3,20,0,1,1,0,0,1
00167370,32,5,27,0,1,1,0,1,1
00167469,9,2,7,0,2,2,0,0,1
00167591,43,12,31,0,0,0,0,0,1
00167604,30,8,22,0,0,0,0,0,0
00167635,39,5,34,0,1,1,0,0,1
00167657,25,2,23,0,1,1,0,1,1
00168127,16,0,16,0,0,0,0,0,1
00168783,30,7,23,0,2,1,1,1,0
00168824,8,0,8,0,0,0,0,0,1
00168831,44,12,32,0,2,2,0,1,0
00169090,16,2,14,0,1,1,0,1,1
00169392,72,9,63,0,0,0,0,0,1
00169714,14,2,12,0,0,0,0,0,1
00169796,22,4,18,0,0,0,0,0,1
00170133,28,8,20,0,0,0,0,0,1
00170454,30,7,23,0,0,0,0,0,1
00170466,40,3,37,0,1,1,0,1,1
00170887,42,8,34,0,7,7,0,0,1
00170944,96,12,84,0,0,0,0,0,1
00171179,29,7,22,0,0,0,0,0,1
00171270,19,3,16,0,1,1,0,1,1
00171309,15,3,12,0,0,0,0,0,1
00171402,143,14,129,0,0,0,0,0,1
00171417,8,2,6,0,0,0,0,0,1
00171729,26,4,22,0,1,1,0,1,1
00171831,116,3,113,0,1,1,0,1,1
00171912,58,6,52,0,1,1,0,1,1
00172091,22,12,10,0,0,0,0,0,0
00172105,23,5,18,0,0,0,0,0,1
00172178,119,3,116,0,2,1,1,0,1
00172413,12,6,6,0,0,0,0,0,0
00172415,42,3,39,0,3,3,0,0,0
00172928,4,3,1,0,0,0,0,0,1
00173178,20,2,18,0,0,0,0,0,0
00173179,23,10,13,0,1,1,0,0,0
00173199,69,11,58,0,0,0,0,0,1
00173421,9,3,6,0,0,0,0,0,1
00173485,45,3,42,0,0,0,0,0,1
00173565,97,8,89,0,0,0,0,0,1
00173834,126,14,112,0,0,0,0,0,0
00174142,26,3,23,0,1,1,0,1,1
00174262,31,9,22,0,0,0,0,0,1
00174297,78,0,78,0,0,0,0,0,1
00174333,46,5,41,0,8,4,4,0,0
00174692,41,6,35,0,2,2,0,1,1
00174695,112,0,112,0,0,0,0,0,1
00174706,52,4,48,0,1,1,0,1,1
00174990,0,0,0,0,0,0,0,0,1
00175014,24,0,24,0,0,0,0,0,1
00175064,27,2,25,0,1,1,0,1,1
00175280,47,5,42,0,1,1,0,1,1
00175447,12,3,9,0,1,1,0,1,1
00175642,39,5,34,0,3,3,0,0,0
00176197,23,6,17,0,1,1,0,0,1
00176204,70,7,63,0,0,0,0,0,0
00176333,53,5,48,0,1,1,0,0,0
00176420,50,6,44,0,0,0,0,0,0
00176447,22,3,19,0,3,3,0,1,1
00176518,13,3,10,0,2,2,0,2,1
00176672,10,6,4,0,14,14,0,0,0
00176992,30,10,20,0,1,1,0,1,1
00177204,57,16,41,0,1,1,0,0,1
00177322,25,0,25,0,0,0,0,0,1
00177366,37,10,27,0,11,11,0,0,0
00177433,26,0,26,0,0,0,0,0,1
00177566,70,0,70,0,0,0,0,0,0
00177670,125,21,104,0,0,0,0,0,1
00177682,9,3,6,0,1,1,0,1,1
00177932,8,4,4,0,0,0,0,0,0
00177991,35,8,27,0,0,0,0,0,1
00178159,103,13,90,0,0,0,0,0,1
00178456,128,8,120,0,1,1,0,1,1
00178711,20,8,12,0,1,1,0,1,1
00179412,9,2,7,0,1,1,0,0,0
00179495,11,2,9,0,1,1,0,0,1
00180277,35,0,35,0,0,0,0,0,1
00180398,48,6,42,0,0,0,0,0,1
00180516,16,6,10,0,0,0,0,0,1
00180834,24,4,20,0,1,1,0,1,1
00181002,15,6,9,0,1,1,0,1,1
00181581,209,9,200,0,0,0,0,0,1
00181585,43,4,39,0,1,1,0,1,1
00181866,196,5,191,0,1,1,0,1,1
00181967,6,3,3,0,2,2,0,0,0
00182180,16,4,12,0,1,1,0,1,1
00183035,57,6,51,0,1,1,0,1,1
00183129,12,4,8,0,0,0,0,0,0
00183184,18,5,13,0,0,0,0,0,1
00184594,45,13,32,0,6,5,1,0,1
00184915,69,8,61,0,3,1,2,3,1
00185445,133,13,120,0,0,0,0,0,1
00185645,113,0,113,0,0,0,0,0,1
00185647,58,11,47,0,0,0,0,0,1
00185672,11,2,9,0,3,1,2,1,0
00185691,33,5,28,0,1,1,0,1,1
00185733,7,3,4,0,2,2,0,1,0
00185931,44,6,38,0,0,0,0,0,0
00186162,62,6,56,0,1,1,0,1,0
00186174,61,3,58,0,0,0,0,0,1
00186479,25,3,22,0,0,0,0,0,1
00186538,24,2,22,0,1,1,0,1,1
00187052,204,20,184,0,0,0,0,0,1
00187091,19,2,17,0,1,1,0,0,1
00187153,34,0,34,0,0,0,0,0,1
00187251,73,20,53,0,1,1,0,1,1
00187255,33,3,30,0,1,1,0,1,1
00187700,8,5,3,0,0,0,0,0,0
00187961,31,4,27,0,1,1,0,1,1
00188027,11,4,7,0,3,3,0,0,1
00188307,46,5,41,0,1,1,0,1,1
00188532,89,4,85,0,1,1,0,0,1
00188598,41,4,37,0,1,1,0,1,1
00188624,57,6,51,0,0,0,0,0,0
00188626,46,17,29,0,0,0,0,0,0
00189241,108,7,101,0,0,0,0,0,1
00189717,22,5,17,0,2,2,0,0,1
09316194,2,2,0,0,1,1,0,0,1
09316706,2,0,2,0,1,1,0,0,0
09316729,2,1,1,0,1,1,0,0,0
09316752,1,1,0,0,1,1,0,0,1
09316861,2,2,0,0,1,1,0,0,0
09316983,2,0,2,0,0,0,0,0,1
09317178,5,3,2,1,0,0,0,0,0
09317374,6,1,5,0,3,1,2,0,0
09317510,5,1,4,0,3,1,2,0,0
09318045,5,5,0,0,1,1,0,0,1
09318533,2,0,2,0,2,2,0,0,0
09318697,6,0,6,0,0,0,0,0,1
09318755,26,14,12,0,4,3,1,0,0
09318834,9,5,4,0,2,1,1,1,1
09318844,1,0,1,0,0,0,0,0,0
09318958,4,0,4,0,2,2,0,0,1
09318966,1,1,0,0,1,1,0,0,0
09318972,2,0,2,0,0,0,0,0,1
09319103,4,0,4,0,2,2,0,0,1
09319289,3,3,0,0,1,1,0,0,0
09319340,6,5,1,0,3,3,0,0,0
09319495,1,1,0,0,1,1,0,0,1
09319682,4,0,4,0,2,2,0,0,1
09319841,9,1,8,0,2,1,1,0,0
09319917,4,0,4,0,2,2,0,0,1
09319928,1,1,0,0,1,1,0,1,0
09320460,1,1,0,0,1,1,0,0,0
09320540,7,2,5,0,0,0,0,0,1
09320655,2,2,0,0,1,1,0,0,1
09320859,6,0,6,0,0,0,0,0,1
09321041,1,1,0,0,1,1,0,0,0
09321132,4,2,2,0,1,1,0,0,1
09321277,2,2,0,0,2,2,0,0,0
09321418,4,0,4,0,2,2,0,0,1
09321538,5,3,2,0,2,2,0,0,1
09321580,2,0,2,0,1,1,0,1,1
09321703,4,0,4,0,2,2,0,0,1
09321725,4,0,4,0,2,2,0,0,1
09321977,3,2,1,0,1,1,0,0,0
09322211,3,2,1,0,2,1,1,1,1
09322543,2,0,2,0,1,1,0,0,1
09322561,8,0,8,0,3,0,3,0,0
09322568,7,6,1,0,0,0,0,0,0
09322806,2,0,2,0,1,1,0,1,1
09322916,2,0,2,0,0,0,0,0,1
09322938,2,0,2,0,1,1,0,1,1
09322942,3,1,2,0,1,1,0,1,1
09323011,3,1,2,0,1,1,0,1,1
09323017,2,0,2,0,1,1,0,1,1
09323065,5,3,2,0,1,1,0,0,1
09323530,2,0,2,0,1,1,0,1,1
09324649,3,0,3,0,1,1,0,1,0
09324825,4,0,4,0,2,2,0,0,1
09324883,3,0,3,0,2,2,0,0,0
09324927,2,2,0,0,1,1,0,0,1
09325665,30,14,16,0,0,0,0,0,1
09325718,3,2,1,0,1,1,0,0,0
09325765,1,0,1,0,0,0,0,0,1
09325855,1,1,0,0,1,1,0,0,0
09326141,2,2,0,0,1,1,0,0,0
09326862,2,0,2,0,0,0,0,0,1
09327722,4,4,0,0,2,1,1,1,1
09328132,2,1,1,0,3,2,1,0,0
09328206,2,1,1,0,2,1,1,0,0
09328997,3,3,0,0,1,1,0,0,0
09329369,10,6,4,0,0,0,0,0,0
09329574,1,1,0,0,1,1,0,0,0
09329700,6,4,2,0,0,0,0,0,0
09330209,2,2,0,0,2,2,0,0,0
09330301,1,1,0,0,1,1,0,0,0
09330902,5,5,0,0,0,0,0,0,0
09331085,9,4,5,0,1,1,0,1,1
09331538,7,2,5,0,1,1,0,0,1
09332186,1,1,0,0,1,1,0,0,1
09332213,1,1,0,0,1,1,0,0,0
09332237,4,0,4,0,2,1,1,0,0
09332411,4,0,4,0,1,1,0,0,1
09332669,1,1,0,0,1,1,0,0,0
09332738,10,6,4,0,1,1,0,1,1
09332914,11,0,11,0,0,0,0,0,0
09333055,3,3,0,0,3,3,0,0,0
09333290,13,9,4,0,0,0,0,0,1
09333326,3,3,0,0,2,2,0,0,0
09334024,9,5,4,0,2,2,0,1,1
09334026,23,7,16,0,4,3,1,0,0
09334057,1,1,0,0,1,1,0,0,0
09334096,4,2,2,0,2,1,1,2,0
09335383,6,0,6,0,0,0,0,0,1
09335831,1,1,0,0,1,1,0,0,0
09335907,4,1,3,0,3,3,0,0,0
09336185,2,1,1,0,1,1,0,0,0
09336261,4,3,1,0,0,0,0,0,0
09336310,3,0,3,0,2,2,0,1,0
09336743,2,1,1,0,2,2,0,1,1
09337011,1,0,1,0,0,0,0,0,0
09337263,3,2,1,0,2,2,0,0,0
09337418,1,1,0,0,1,1,0,0,0
09337513,5,3,2,0,5,4,1,1,1
09338010,2,0,2,0,1,1,0,0,0
09338074,1,1,0,0,1,1,0,0,0
09338686,1,1,0,0,1,1,0,0,0
09338705,2,2,0,1,1,1,0,1,0
09338724,20,11,9,0,2,2,0,0,1
09338747,3,1,2,0,1,1,0,0,0
09339457,1,1,0,0,1,1,0,1,0
09339503,1,1,0,0,1,1,0,0,1
09339706,1,0,1,0,0,0,0,0,0
09339729,8,3,5,0,0,0,0,0,1
09339740,4,3,1,0,1,1,0,1,1
09340417,3,3,0,0,2,2,0,0,1
09340687,3,3,0,0,2,1,1,0,1
09340851,1,0,1,0,0,0,0,0,1
09340934,1,0,1,0,1,1,0,0,0
09341143,6,5,1,0,1,1,0,0,1
09341365,2,2,0,0,2,2,0,0,1
09341374,18,10,8,0,3,3,0,3,1
09341468,2,2,0,0,1,1,0,1,0
09341741,3,3,0,0,1,1,0,0,0
09341795,2,1,1,0,1,1,0,1,0
09341813,7,7,0,0,0,0,0,0,0
09341865,5,5,0,0,1,1,0,0,0
09341963,1,1,0,0,1,1,0,0,1
09341989,11,3,8,0,0,0,0,0,0
09342002,5,2,3,0,1,1,0,1,1
09342517,2,2,0,0,1,1,0,0,0
09342601,1,0,1,0,1,1,0,0,0
09342621,5,4,1,0,3,3,0,0,0
09342684,2,1,1,0,1,1,0,1,0
09342926,5,3,2,1,1,1,0,1,1
09342948,1,1,0,0,2,2,0,0,1
09343544,2,1,1,0,1,1,0,0,1
09343573,4,3,1,0,4,3,1,1,1
09343926,1,1,0,0,1,1,0,0,0
09344398,4,3,1,0,1,1,0,1,1
09345035,3,3,0,0,2,2,0,0,1
09345317,2,0,2,0,1,1,0,0,0
09345489,4,3,1,0,1,1,0,1,1
09345602,1,1,0,0,1,1,0,0,0
09345723,1,1,0,0,1,1,0,0,0
09346151,2,2,0,0,1,1,0,0,1
09346227,1,0,1,0,0,0,0,0,1
09346256,1,0,1,0,1,1,0,0,0
09346290,11,6,5,0,3,1,2,1,1
09346363,20,10,10,0,1,1,0,1,1
09346804,2,0,2,0,0,0,0,0,1
09346822,2,2,0,0,2,2,0,0,1
09347618,2,2,0,0,2,2,0,0,1
09347886,21,10,11,0,0,0,0,0,0
09347924,1,0,1,0,0,0,0,0,1
09348481,2,0,2,0,1,1,0,1,1
09348505,3,1,2,0,2,1,1,0,0
09348820,1,1,0,0,2,1,1,0,0
09349299,8,4,4,0,0,0,0,0,1
09349327,2,1,1,0,1,1,0,0,1
09349353,2,2,0,0,2,2,0,0,0
09349408,5,0,5,0,0,0,0,0,0
09349428,14,5,9,0,0,0,0,0,0
09349520,1,1,0,0,1,1,0,0,0
09349614,1,0,1,0,0,0,0,0,0
09349619,7,4,3,0,3,3,0,1,1
09349623,2,2,0,0,1,1,0,0,0
09349641,1,1,0,0,1,1,0,0,0
09349667,2,1,1,0,2,2,0,0,0
09349921,5,3,2,0,4,1,3,0,1
09349929,7,5,2,0,2,2,0,2,1
09350361,4,0,4,0,0,0,0,0,1
09350516,1,1,0,0,2,2,0,0,0
09351158,2,1,1,0,1,1,0,0,0
09351485,9,0,9,0,1,1,0,1,1
09351773,13,3,10,0,2,2,0,0,1
09351779,1,1,0,0,1,1,0,1,1
09351791,1,0,1,0,1,1,0,1,1
09351849,3,2,1,0,2,2,0,0,0
09351963,7,4,3,0,1,0,1,1,1
09352159,6,4,2,0,1,1,0,1,1
09352392,1,1,0,0,1,1,0,0,0
09352450,1,1,0,0,1,1,0,0,0
09352454,1,1,0,0,1,1,0,0,0
09352674,16,5,11,2,1,1,0,1,1
09353005,2,2,0,0,1,1,0,0,1
09353567,1,0,1,0,0,0,0,0,0
09353760,4,1,3,0,1,1,0,0,0
09354260,6,3,3,0,0,0,0,0,0
09354356,1,1,0,0,1,1,0,0,0
09354430,3,3,0,0,1,1,0,1,1
09354603,1,1,0,0,1,1,0,0,0
09354792,3,0,3,0,0,0,0,0,1
09354859,3,0,3,0,0,0,0,0,0
09355351,2,2,0,0,3,3,0,1,0
09355378,3,3,0,0,1,0,1,1,0
09356243,1,1,0,0,1,1,0,0,0
09356353,2,1,1,0,2,1,1,0,1
09356356,3,3,0,0,1,1,0,0,0
09357041,2,1,1,0,1,1,0,0,0
09357163,11,6,5,0,1,1,0,1,1
09357207,22,13,9,0,0,0,0,0,1
09357273,6,4,2,0,0,0,0,0,0
09357525,1,1,0,0,1,1,0,0,0
09357596,1,0,1,0,0,0,0,0,1
09357635,1,1,0,0,1,1,0,0,0
09357914,1,0,1,0,0,0,0,0,1
09358015,6,5,1,0,1,1,0,1,1
09358769,3,0,3,0,0,0,0,0,1
09358845,1,1,0,0,1,1,0,0,0
09359021,2,1,1,0,1,1,0,0,0
09359046,2,2,0,0,3,3,0,1,0
09359107,6,5,1,0,1,1,0,0,1
09359200,1,1,0,0,2,2,0,0,1
09359207,7,5,2,0,2,2,0,0,0
09359398,6,5,1,0,0,0,0,0,0
09359428,1,1,0,0,1,1,0,0,0
03640177,3,3,0,0,2,2,0,0,0
03640314,41,9,32,0,0,0,0,0,1
03640548,6,3,3,0,2,2,0,0,1
03640736,33,0,33,0,1,1,0,1,1
03640846,4,0,4,0,0,0,0,0,1
03640915,53,12,41,0,1,1,0,1,1
03641363,18,2,16,0,0,0,0,0,1
03641392,16,6,10,0,6,6,0,0,0
03641584,22,4,18,0,2,1,1,2,1
03641947,56,3,53,0,1,1,0,1,1
03642212,8,0,8,0,0,0,0,0,1
03642245,30,13,17,0,0,0,0,0,1
03642312,9,0,9,0,0,0,0,0,1
03642327,42,9,33,0,1,1,0,0,0
03642372,16,6,10,0,2,1,1,1,1
03642634,14,0,14,0,0,0,0,0,1
03643088,56,15,41,0,0,0,0,0,1
03643205,24,3,21,0,0,0,0,0,1
03643347,17,3,14,0,1,1,0,1,1
03643358,76,0,76,0,0,0,0,0,1
03643599,20,6,14,0,0,0,0,0,0
03643620,12,4,8,0,2,2,0,0,1
03643638,20,0,20,0,0,0,0,0,1
03643681,10,1,9,0,1,1,0,0,1
03643833,11,2,9,0,1,1,0,0,0
03643848,6,3,3,0,1,1,0,0,1
03643899,8,4,4,0,1,1,0,1,1
03644509,13,3,10,0,2,2,0,0,1
03644723,104,17,87,0,0,0,0,0,1
03645379,3,2,1,0,1,1,0,0,0
03645792,29,7,22,0,0,0,0,0,0
03645978,28,6,22,0,1,1,0,1,1
03646114,22,4,18,0,0,0,0,0,1
03646202,29,10,19,0,0,0,0,0,0
03646321,8,2,6,0,1,1,0,0,1
03646427,29,8,21,0,0,0,0,0,1
03646457,42,11,31,0,1,1,0,0,1
03646570,40,11,29,0,0,0,0,0,1
03646575,4,1,3,0,1,1,0,0,0
03647301,23,6,17,0,0,0,0,0,0
03647309,22,0,22,0,0,0,0,0,1
03647343,37,5,32,0,2,1,1,2,1
03647452,8,0,8,0,1,1,0,0,1
03647591,129,16,113,0,1,1,0,1,1
03647670,11,4,7,0,1,1,0,0,0
03647915,14,0,14,0,0,0,0,0,1
03647928,40,8,32,0,0,0,0,0,1
03648143,5,2,3,0,2,2,0,0,0
03648410,24,6,18,0,2,2,0,0,1
03648926,12,0,12,0,0,0,0,0,1
03649118,14,5,9,0,2,1,1,2,1
03649149,10,4,6,0,4,1,3,2,0
03649535,54,0,54,0,1,1,0,1,1
03649653,59,0,59,0,0,0,0,0,1
03649669,21,5,16,0,0,0,0,0,1
03650083,5,2,3,0,1,1,0,0,0
03650129,13,5,8,0,2,1,1,0,1
03650220,52,6,46,0,0,0,0,0,1
03650238,32,5,27,0,1,1,0,1,1
03650333,2,2,0,0,1,1,0,0,0
03650457,25,3,22,0,1,1,0,1,1
03650459,26,3,23,0,1,1,0,1,1
03650647,4,0,4,0,0,0,0,0,0
03650686,23,2,21,0,1,1,0,0,1
03650688,17,3,14,0,0,0,0,0,1
03650692,23,0,23,0,1,1,0,1,1
03650739,7,0,7,0,2,2,0,0,1
03650877,3,1,2,0,1,1,0,0,1
03651122,15,5,10,0,0,0,0,0,1
03651213,21,5,16,0,0,0,0,0,1
03651655,4,1,3,0,2,2,0,0,0
03652059,31,2,29,0,1,1,0,1,1
03652559,43,13,30,0,0,0,0,0,1
03653506,40,10,30,0,0,0,0,0,1
03653606,29,3,26,0,3,1,2,3,1
03653626,18,9,9,0,1,1,0,0,1
03653995,21,2,19,0,2,2,0,0,1
03654271,73,0,73,0,0,0,0,0,1
03654576,33,6,27,0,3,2,1,0,1
03654675,45,3,42,0,1,1,0,1,1
03654887,10,4,6,0,1,1,0,0,1
03655012,7,2,5,0,1,1,0,0,0
03655014,19,4,15,0,3,3,0,0,1
03655220,33,0,33,0,0,0,0,0,1
03655231,23,2,21,0,1,1,0,1,1
03655247,15,2,13,0,0,0,0,0,1
03655704,27,8,19,0,1,1,0,1,1
03655815,15,2,13,0,1,1,0,1,1
03656746,13,4,9,0,0,0,0,0,1
03656798,30,6,24,0,1,1,0,1,1
03656832,16,3,13,0,1,1,0,1,1
03657767,23,4,19,0,1,1,0,1,1
03657811,5,1,4,0,1,1,0,0,0
03657921,4,2,2,0,1,1,0,0,0
03658022,20,3,17,0,1,1,0,0,1
03658165,23,5,18,0,0,0,0,0,1
03658378,53,10,43,0,0,0,0,0,1
03658619,9,0,9,0,0,0,0,0,1
03658772,40,17,23,0,1,1,0,0,1
03659361,52,11,41,0,0,0,0,0,1
03659692,13,5,8,0,1,1,0,1,1
03659707,5,1,4,0,1,1,0,0,1
03659957,6,2,4,0,2,2,0,0,0
03659970,32,8,24,0,1,1,0,1,1
03660222,28,0,28,0,1,1,0,1,1
03660475,6,3,3,0,0,0,0,0,0
03660903,41,6,35,0,0,0,0,0,1
03661446,32,9,23,0,1,1,0,0,1
03662414,47,0,47,0,0,0,0,0,1
03662515,19,1,18,0,0,0,0,0,1
03663181,62,12,50,0,0,0,0,0,1
03663182,12,0,12,0,0,0,0,0,1
03663454,11,0,11,0,0,0,0,0,1
03663563,31,3,28,0,1,1,0,1,1
03663661,41,7,34,0,0,0,0,0,0
03663818,3,3,0,0,2,2,0,0,0
03663823,52,11,41,0,1,1,0,0,0
03664008,63,9,54,0,0,0,0,0,1
03664488,10,0,10,0,0,0,0,0,1
03664571,57,11,46,0,1,1,0,1,1
03664614,31,4,27,0,3,1,2,3,1
03664881,11,0,11,0,0,0,0,0,1
03665545,9,4,5,0,4,4,0,0,1
03665770,34,2,32,0,1,1,0,1,1
03665797,15,6,9,0,0,0,0,0,1
03665803,9,3,6,0,2,2,0,0,1
03665996,46,7,39,0,1,1,0,0,1
03666198,7,0,7,0,1,1,0,0,1
03666242,9,3,6,0,2,2,0,0,1
03666347,19,0,19,0,0,0,0,0,1
03666441,15,3,12,0,1,1,0,1,1
03666449,13,0,13,0,1,1,0,1,1
03666799,9,3,6,0,1,1,0,0,1
03666981,11,2,9,0,0,0,0,0,1
03667015,6,3,3,0,1,1,0,1,1
03667290,48,9,39,0,0,0,0,0,1
03667408,19,0,19,0,0,0,0,0,0
03667688,13,0,13,0,0,0,0,0,1
03667753,46,4,42,0,1,1,0,1,1
03667800,25,3,22,0,1,1,0,1,1
03667927,10,3,7,0,2,2,0,0,1
03667930,7,2,5,0,1,1,0,1,1
03668014,4,0,4,0,0,0,0,0,1
03668521,7,4,3,0,1,1,0,0,0
03668663,27,6,21,0,1,1,0,1,1
03668828,70,7,63,0,2,1,1,2,1
03669086,10,2,8,0,1,1,0,0,1
03669198,13,3,10,0,1,1,0,1,0
03669269,11,4,7,0,1,1,0,0,1
03669676,19,0,19,0,1,0,1,0,0
03669744,7,2,5,0,1,1,0,1,1
03669957,9,3,6,0,0,0,0,0,0
03670081,6,0,6,0,0,0,0,0,1
03670360,11,6,5,0,4,3,1,0,1
03671093,27,6,21,0,1,1,0,1,1
03671207,13,0,13,0,0,0,0,0,1
03671215,7,3,4,0,2,2,0,0,1
03671286,7,0,7,0,1,1,0,0,1
03671320,15,2,13,0,1,1,0,1,1
03671447,10,4,6,0,1,1,0,0,1
03671688,13,0,13,0,0,0,0,0,1
03671867,15,0,15,0,0,0,0,0,1
03671925,7,0,7,0,1,1,0,0,0
03672268,7,4,3,0,1,1,0,0,1
03672291,15,4,11,0,2,1,1,0,1
03672399,23,7,16,0,0,0,0,0,1
03672924,34,6,28,0,1,1,0,1,1
03672926,19,0,19,0,1,1,0,1,1
03673168,32,10,22,0,0,0,0,0,0
03673220,21,0,21,0,0,0,0,0,1
03673223,8,5,3,0,1,1,0,0,0
03673852,5,3,2,0,2,2,0,0,1
03673978,28,7,21,0,1,1,0,0,1
03674453,15,2,13,0,1,1,0,1,1
03674534,6,4,2,0,2,2,0,0,0
03674691,8,3,5,0,2,2,0,0,1
03674827,27,5,22,0,2,2,0,2,1
03674842,23,4,19,0,1,1,0,1,1
03674956,10,1,9,0,1,1,0,1,1
03674960,6,0,6,0,0,0,0,0,1
03674979,35,1,34,0,1,1,0,1,1
03674999,25,7,18,0,0,0,0,0,1
03675048,5,3,2,0,2,2,0,0,0
03675362,22,9,13,0,1,1,0,0,1
03675676,25,1,24,0,2,2,0,1,1
03675755,10,0,10,0,0,0,0,0,1
03675858,4,3,1,0,1,1,0,0,1
03675994,4,3,1,0,1,1,0,0,1
03676533,9,0,9,0,0,0,0,0,1
03676547,6,0,6,0,0,0,0,0,1
03676780,20,0,20,0,0,0,0,0,1
03677048,9,3,6,0,1,1,0,1,1
03677186,83,10,73,0,2,1,1,0,1
03677276,10,4,6,0,1,1,0,1,1
03677311,33,4,29,0,1,1,0,1,1
03677627,28,5,23,0,1,1,0,1,1
03678507,48,7,41,0,1,1,0,1,1
03678984,14,2,12,0,2,2,0,0,1
03679085,11,3,8,0,1,1,0,1,1
03679187,10,4,6,0,0,0,0,0,0
03679198,6,3,3,0,1,1,0,0,0
03679270,6,2,4,0,1,1,0,0,0
03679284,24,10,14,0,2,2,0,2,1
03679296,55,12,43,0,1,1,0,1,1
03679711,14,2,12,0,0,0,0,0,1
03679758,7,4,3,0,4,4,0,1,1
03679828,53,4,49,0,1,1,0,1,1
03679951,6,3,3,0,2,2,0,0,1
