Company number,Total number of officers,Number of active officers,Number of inactive officers,Number of non-persons officers,Total number of person with significant control,Number of active persons with significant control,Number of ceased persons with significant control,Number of non-persons with significant control,Good/Bad
00001955,8,7,1,0,2,2,0,0,0
00011717,28,9,19,0,0,0,0,0,0
00012886,22,4,18,0,1,1,0,0,0
00013101,25,0,25,0,0,0,0,0,1
00014172,47,7,40,0,1,1,0,1,1
00014283,5,0,5,0,0,0,0,0,0
00017877,111,4,107,0,1,1,0,0,0
00019739,43,4,39,0,1,1,0,1,1
00021401,136,0,136,0,0,0,0,0,1
00023273,3,2,1,0,1,1,0,0,0
00024084,103,20,83,0,0,0,0,0,1
00024499,23,2,21,0,1,1,0,1,1
00024511,43,9,34,0,0,0,0,0,1
00024722,36,5,31,0,1,1,0,1,1
00025088,72,7,65,0,1,1,0,1,1
00025090,44,2,42,0,1,1,0,1,1
00025579,18,5,13,0,1,1,0,1,1
00025932,130,12,118,0,1,1,0,1,1
00026306,63,6,57,0,2,2,0,2,1
00029356,28,11,17,0,0,0,0,0,0
00030129,41,0,41,0,0,0,0,0,1
00030705,15,3,12,0,1,1,0,1,1
00031114,22,9,13,0,0,0,0,0,1
00031438,24,9,15,0,8,8,0,0,0
00031799,24,7,17,0,0,0,0,0,0
00032965,38,6,32,0,0,0,0,0,1
00033881,11,5,6,0,1,1,0,0,0
00033886,28,5,23,0,1,1,0,1,1
00035025,20,5,15,0,1,1,0,1,1
00035990,58,4,54,0,1,1,0,1,1
00036137,23,3,20,0,0,0,0,0,0
00036443,20,5,15,0,1,1,0,1,1
00038252,106,8,98,0,1,1,0,0,0
00038357,15,6,9,0,2,1,1,0,0
00039811,17,7,10,0,0,0,0,0,1
00040901,43,2,41,0,1,1,0,1,1
00040987,20,6,14,0,0,0,0,0,0
00043649,8,4,4,0,1,1,0,1,0
00043885,9,5,4,0,0,0,0,0,0
00045690,39,3,36,0,1,1,0,1,1
00046833,91,8,83,0,0,0,0,0,0
00048760,30,5,25,0,2,1,1,2,1
00049714,13,4,9,0,1,1,0,1,0
00050484,44,4,40,0,2,2,0,2,1
00052665,47,3,44,0,0,0,0,0,1
00053171,31,7,24,0,0,0,0,0,1
00053220,25,2,23,0,1,1,0,1,1
00053237,40,4,36,0,1,1,0,1,1
00053317,37,4,33,0,1,1,0,1,1
00053723,51,13,38,0,0,0,0,0,1
00055603,49,4,45,0,1,1,0,1,1
00057024,36,5,31,0,1,1,0,1,1
00057395,15,0,15,0,0,0,0,0,0
00057545,39,2,37,0,1,1,0,1,1
00057968,35,3,32,0,1,1,0,1,1
00058093,64,15,49,0,2,2,0,2,1
00058207,36,0,36,0,0,0,0,0,1
00059713,18,4,14,0,0,0,0,0,1
00061140,10,5,5,0,1,1,0,0,0
00061407,31,3,28,0,1,1,0,1,1
00062065,44,4,40,0,1,1,0,1,1
00062367,17,7,10,0,1,1,0,1,0
00062423,24,5,19,0,1,1,0,1,1
00063932,17,3,14,0,3,3,0,0,0
00064884,28,4,24,0,1,1,0,1,1
00065192,10,6,4,0,0,0,0,0,0
00066045,32,5,27,0,1,1,0,1,1
00069666,36,5,31,0,1,1,0,1,1
00070527,312,16,296,0,0,0,0,0,1
00074416,20,3,17,0,0,0,0,0,1
00075219,156,9,147,0,0,0,0,0,0
00075831,14,0,14,0,1,1,0,1,1
00076676,22,0,22,0,0,0,0,0,0
00077922,18,5,13,0,1,1,0,1,1
00078931,44,10,34,0,1,1,0,0,1
00079308,40,4,36,0,1,1,0,1,1
00079310,12,2,10,0,1,1,0,1,0
00081035,39,7,32,0,0,0,0,0,0
00081177,98,5,93,0,0,0,0,0,0
00083575,18,9,9,0,0,0,0,0,0
00083618,29,6,23,0,0,0,0,0,0
00086641,205,29,176,0,1,1,0,0,1
00087634,63,4,59,0,0,0,0,0,0
00087911,33,3,30,0,1,1,0,1,1
00087997,25,5,20,0,1,1,0,1,1
00088380,29,5,24,0,2,1,1,2,1
00091106,30,5,25,0,1,1,0,1,1
00093447,66,8,58,0,1,1,0,1,1
00096093,107,4,103,0,1,1,0,0,1
00096263,34,5,29,0,1,1,0,1,1
00097122,64,7,57,0,0,0,0,0,0
00098220,29,4,25,0,1,1,0,1,1
00099998,37,13,24,0,0,0,0,0,0
00100316,20,4,16,0,1,1,0,1,0
00103844,47,3,44,0,1,1,0,1,1
00103858,44,10,34,0,12,9,3,1,0
00103941,43,3,40,0,1,1,0,1,0
00104194,39,4,35,0,1,1,0,1,0
00105486,21,3,18,0,1,1,0,1,1
00105511,136,3,133,0,0,0,0,0,1
00105819,51,11,40,0,0,0,0,0,0
00106966,24,3,21,0,1,1,0,1,1
00107021,16,10,6,0,0,0,0,0,0
00107582,43,3,40,0,1,1,0,1,1
00110768,27,5,22,0,1,1,0,1,1
00111019,32,6,26,0,0,0,0,0,0
00111524,21,2,19,0,1,1,0,1,1
00111982,51,13,38,0,0,0,0,0,1
00113882,19,3,16,0,1,1,0,1,1
00116476,21,8,13,0,0,0,0,0,0
00117289,37,7,30,0,0,0,0,0,1
00118047,26,8,18,0,0,0,0,0,0
00120936,70,9,61,0,0,0,0,0,0
00121299,42,4,38,0,1,1,0,1,1
00122164,23,0,23,0,0,0,0,0,1
00122230,15,7,8,0,3,3,0,0,0
00124723,47,4,43,0,2,2,0,2,1
00128058,28,4,24,0,0,0,0,0,1
00132492,28,7,21,0,1,1,0,1,1
00132792,37,3,34,0,1,1,0,1,1
00134550,127,4,123,0,0,0,0,0,0
00135063,25,4,21,0,1,1,0,1,1
00135234,36,11,25,0,0,0,0,0,0
00137013,53,11,42,0,0,0,0,0,1
00138006,21,4,17,0,1,1,0,1,1
00143439,20,4,16,0,1,1,0,0,1
00143447,213,2,211,0,1,1,0,1,1
00144888,58,7,51,0,0,0,0,0,1
00145205,30,5,25,0,1,1,0,1,1
00145670,17,4,13,0,0,0,0,0,0
00148449,61,14,47,0,0,0,0,0,1
00152298,49,5,44,0,2,1,1,2,1
00152477,24,2,22,0,1,1,0,1,1
00153026,19,10,9,0,0,0,0,0,1
00155374,45,6,39,0,1,1,0,1,1
00156261,15,5,10,0,1,1,0,1,0
00156641,39,3,36,0,1,1,0,1,1
00157426,11,4,7,0,1,1,0,0,0
00159926,38,3,35,0,1,1,0,1,1
00160881,19,3,16,0,1,1,0,1,1
00161312,93,5,88,0,0,0,0,0,0
00162457,10,3,7,0,0,0,0,0,1
00164213,22,3,19,0,0,0,0,0,1
00165381,31,4,27,0,0,0,0,0,0
00167370,32,5,27,0,1,1,0,1,1
00167604,30,8,22,0,0,0,0,0,0
00167635,39,5,34,0,1,1,0,0,1
00168127,16,0,16,0,0,0,0,0,1
00169090,16,2,14,0,1,1,0,1,1
00170887,42,8,34,0,7,7,0,0,1
00170944,96,12,84,0,0,0,0,0,1
00171402,143,14,129,0,0,0,0,0,1
00173178,20,2,18,0,0,0,0,0,0
00173485,45,3,42,0,0,0,0,0,1
00176204,70,7,63,0,0,0,0,0,0
00176333,53,5,48,0,1,1,0,0,0
00176420,50,6,44,0,0,0,0,0,0
00176992,30,10,20,0,1,1,0,1,1
00177433,26,0,26,0,0,0,0,0,1
00180516,16,6,10,0,0,0,0,0,1
00181866,196,5,191,0,1,1,0,1,1
00185691,33,5,28,0,1,1,0,1,1
00185931,44,6,38,0,0,0,0,0,0
00187153,34,0,34,0,0,0,0,0,1
00188598,41,4,37,0,1,1,0,1,1
00190626,13,6,7,0,0,0,0,0,0
00190717,28,3,25,0,1,1,0,1,1
00191201,16,3,13,0,0,0,0,0,0
00192460,55,4,51,0,1,1,0,1,1
00192795,33,4,29,0,1,1,0,1,1
00195581,20,3,17,0,1,1,0,1,1
00195732,24,5,19,0,5,2,3,0,1
00196206,33,5,28,0,1,1,0,1,1
00199120,67,9,58,0,1,1,0,1,1
00199193,35,4,31,0,2,2,0,2,1
00200575,43,0,43,0,0,0,0,0,1
00200794,33,5,28,0,2,2,0,2,1
00202872,3,2,1,0,1,1,0,0,0
00203742,40,5,35,0,1,1,0,1,1
00208991,109,13,96,0,0,0,0,0,0
00209335,23,5,18,0,0,0,0,0,1
00209905,60,6,54,0,1,1,0,1,1
00210144,9,5,4,0,0,0,0,0,0
00213026,30,5,25,0,1,1,0,1,1
00216055,14,6,8,0,0,0,0,0,1
00217506,69,8,61,0,2,2,0,0,0
00217768,30,2,28,0,0,0,0,0,1
00218277,18,6,12,0,1,1,0,0,0
00218497,38,0,38,0,2,2,0,1,1
00218550,27,4,23,0,1,1,0,1,1
00218826,50,5,45,0,2,2,0,2,1
00219173,5,0,5,0,0,0,0,0,1
00220596,6,3,3,0,0,0,0,0,0
00221321,29,7,22,0,1,1,0,0,0
00221623,31,3,28,0,1,1,0,1,0
00221722,42,3,39,0,1,1,0,1,1
00224411,33,10,23,0,1,1,0,0,1
00224705,21,8,13,0,0,0,0,0,0
00227550,16,0,16,0,0,0,0,0,1
00227669,38,3,35,0,1,1,0,1,1
00228812,5,4,1,0,2,2,0,0,0
00229231,50,4,46,0,1,1,0,1,1
00231961,20,5,15,0,1,1,0,1,1
00232646,13,3,10,0,0,0,0,0,1
00235384,17,8,9,0,0,0,0,0,0
00235874,11,5,6,0,1,1,0,0,0
00236040,25,0,25,0,0,0,0,0,1
00237095,36,0,36,0,0,0,0,0,1
00237558,48,6,42,0,1,1,0,1,1
00238567,32,5,27,0,1,1,0,1,1
00239652,27,5,22,0,1,1,0,1,1
00240613,49,9,40,0,0,0,0,0,0
00241973,25,6,19,0,1,1,0,1,1
00242372,41,8,33,0,1,1,0,1,1
00243708,43,7,36,0,2,2,0,2,1
00243952,28,5,23,0,1,1,0,1,1
00244415,49,9,40,0,2,2,0,2,1
00245156,30,3,27,0,1,1,0,1,1
00245550,21,10,11,0,13,9,4,0,0
00247806,88,9,79,0,0,0,0,0,0
00248343,80,11,69,0,0,0,0,0,1
00248751,36,5,31,0,1,1,0,1,1
00249071,20,4,16,0,1,1,0,1,1
00249974,0,0,0,0,0,0,0,0,0
00249996,7,0,7,0,1,1,0,0,0
00252860,13,4,9,0,1,1,0,0,1
00253366,5,4,1,0,4,3,1,0,0
00255427,0,0,0,0,0,0,0,0,0
00255852,29,5,24,0,1,1,0,1,1
00259345,51,3,48,0,1,1,0,1,1
00263047,34,4,30,0,2,2,0,2,1
00269238,8,3,5,0,1,1,0,0,0
00269422,41,0,41,0,0,0,0,0,1
00270903,42,4,38,0,1,1,0,1,1
00272562,20,2,18,0,1,1,0,1,1
00275642,16,5,11,0,1,1,0,1,1
00275947,24,5,19,0,1,1,0,1,1
00276180,46,1,45,0,1,1,0,1,1
00281055,39,1,38,0,1,1,0,1,1
00281992,28,7,21,0,1,1,0,1,1
00283556,55,3,52,0,1,1,0,1,1
00284340,30,4,26,0,1,1,0,1,1
00285257,23,5,18,0,1,1,0,1,1
00285519,34,3,31,0,1,1,0,1,1
00288008,26,5,21,0,2,1,1,2,1
00290029,14,6,8,0,1,1,0,0,0
00290076,26,2,24,0,1,1,0,1,1
00291686,46,5,41,0,1,1,0,1,1
00292254,32,8,24,0,1,1,0,0,0
00292689,220,5,215,0,1,1,0,1,1
00293671,6,4,2,0,1,1,0,0,0
00294490,36,5,31,0,1,1,0,1,1
00295894,117,11,106,0,0,0,0,0,0
00296531,12,4,8,0,0,0,0,0,1
00297895,3,0,3,0,0,0,0,0,0
00298761,8,3,5,0,2,1,1,0,0
00299435,16,5,11,0,1,1,0,1,1
00300000,20,3,17,0,1,1,0,1,0
00300002,66,10,56,0,1,1,0,1,1
00300433,185,17,168,0,0,0,0,0,0
00300714,20,5,15,0,1,1,0,1,1
00301188,21,2,19,0,1,1,0,1,1
00301291,28,3,25,0,0,0,0,0,0
00301641,0,0,0,0,0,0,0,0,0
00305430,32,1,31,0,1,1,0,1,1
00307291,31,5,26,0,1,1,0,1,1
00307468,32,7,25,0,1,1,0,1,1
00308066,10,6,4,0,1,1,0,0,0
00308632,66,11,55,0,0,0,0,0,1
00308999,12,4,8,0,0,0,0,0,1
00309463,0,0,0,0,0,0,0,0,0
00309615,7,4,3,0,1,1,0,0,0
00311950,9,3,6,0,2,2,0,1,0
00312076,21,2,19,0,1,1,0,1,1
00312083,30,3,27,0,1,1,0,1,1
00313430,31,3,28,0,1,1,0,1,1
00314205,53,8,45,0,1,1,0,1,1
00314534,16,3,13,0,1,1,0,0,0
00315671,33,0,33,0,0,0,0,0,1
00316584,14,7,7,0,0,0,0,0,0
00318460,29,4,25,0,1,1,0,1,1
00319704,37,4,33,0,1,1,0,1,1
00321992,45,4,41,0,1,1,0,1,1
00322305,5,3,2,0,2,2,0,0,0
00323204,147,19,128,0,0,0,0,0,1
00332450,18,7,11,0,1,1,0,0,0
00333313,29,6,23,0,1,1,0,0,1
00334594,9,2,7,0,3,1,2,1,1
00335444,33,4,29,0,1,1,0,1,1
00335659,24,9,15,0,0,0,0,0,1
00337803,16,4,12,0,2,1,1,2,1
00338515,34,0,34,0,1,1,0,1,1
00338786,38,0,38,0,0,0,0,0,1
00339590,39,0,39,0,0,0,0,0,1
00341010,89,14,75,0,0,0,0,0,1
00345218,65,2,63,0,2,2,0,0,0
00347453,40,3,37,0,1,1,0,1,1
00349367,8,4,4,0,1,1,0,0,0
00350164,39,4,35,0,1,1,0,1,0
00351295,27,5,22,0,1,1,0,1,1
00353278,21,7,14,0,0,0,0,0,0
00355318,4,2,2,0,0,0,0,0,1
00357357,10,4,6,0,3,3,0,0,0
00358003,5,5,0,0,0,0,0,0,0
00362847,47,4,43,0,2,2,0,2,1
00367135,32,5,27,0,1,1,0,1,1
00367180,17,5,12,0,1,1,0,1,1
00368248,21,4,17,0,2,2,0,2,1
00371217,39,5,34,0,1,1,0,1,1
00371601,29,5,24,0,1,1,0,1,1
00371602,27,5,22,0,2,2,0,2,1
00371825,6,0,6,0,0,0,0,0,0
00372862,31,1,30,0,0,0,0,0,1
00373894,10,3,7,0,0,0,0,0,1
00373964,23,3,20,0,1,1,0,1,1
00375770,61,10,51,0,1,1,0,1,1
00377015,21,3,18,0,1,1,0,1,1
00377936,34,5,29,0,1,1,0,1,1
06058014,6,1,5,0,5,3,2,2,1
06058030,4,1,3,0,1,1,0,0,1
06058058,4,1,3,0,1,1,0,0,1
06058164,6,2,4,0,1,1,0,1,1
06058205,4,0,4,0,0,0,0,0,1
06058217,5,1,4,0,2,2,0,0,1
06058259,4,0,4,0,0,0,0,0,1
06058499,4,0,4,0,0,0,0,0,1
06058722,4,2,2,0,1,1,0,0,1
06058728,8,2,6,0,0,0,0,0,1
06058751,10,1,9,0,1,1,0,0,1
06058793,6,2,4,0,1,1,0,0,0
06058841,4,1,3,0,1,1,0,0,1
06058902,4,1,3,0,1,1,0,0,1
06058931,7,5,2,0,4,4,0,0,1
06058985,5,0,5,0,1,1,0,0,1
06059203,10,4,6,0,1,0,1,0,0
06059392,4,2,2,0,1,1,0,0,1
06059413,4,2,2,0,1,1,0,0,1
06059717,14,4,10,0,0,0,0,0,1
06060026,25,5,20,0,1,1,0,1,1
06060432,5,1,4,0,0,0,0,0,1
06060931,5,3,2,0,1,1,0,0,1
06061140,6,4,2,0,2,2,0,0,1
06061537,10,3,7,0,4,3,1,1,0
06061984,21,8,13,0,0,0,0,0,1
06062118,4,2,2,0,1,1,0,0,1
06062171,5,0,5,0,0,0,0,0,1
06062201,5,3,2,0,2,2,0,0,1
06062308,7,1,6,0,3,1,2,2,1
06062472,9,4,5,0,1,1,0,0,1
06062760,5,3,2,0,2,2,0,0,1
06063380,4,2,2,0,1,1,0,0,1
06064113,4,1,3,0,1,1,0,0,1
06064129,5,2,3,0,0,0,0,0,1
06064138,7,2,5,1,1,1,0,0,1
06064158,7,5,2,0,1,1,0,0,1
06064375,23,4,19,0,2,2,0,2,1
06064666,6,2,4,0,1,1,0,0,1
06064905,6,4,2,0,3,3,0,0,1
06065000,7,0,7,0,0,0,0,0,1
06065064,6,0,6,0,0,0,0,0,1
06065089,5,0,5,0,0,0,0,0,1
06065109,4,2,2,0,1,1,0,0,1
06065280,5,3,2,0,0,0,0,0,1
06065376,4,2,2,0,1,1,0,0,1
06065393,5,3,2,0,1,1,0,0,1
06066288,6,1,5,0,1,1,0,0,1
06066418,7,3,4,0,1,1,0,0,1
06066720,4,2,2,0,2,2,0,0,1
06066725,4,2,2,0,1,1,0,0,1
06067288,4,1,3,0,1,1,0,0,1
06067357,15,0,15,0,0,0,0,0,1
06067375,15,0,15,0,0,0,0,0,1
06067421,5,0,5,0,0,0,0,0,1
06067422,10,4,6,0,1,1,0,0,1
06067579,7,3,4,0,1,1,0,0,1
06067905,10,4,6,0,1,1,0,1,1
06068171,8,1,7,0,1,1,0,0,1
06068620,8,1,7,0,1,1,0,0,1
06068895,4,2,2,0,1,1,0,0,1
06068931,6,2,4,0,1,1,0,0,1
06068952,2,1,1,0,0,0,0,0,1
06069174,4,2,2,0,2,2,0,0,1
06069869,26,0,26,0,1,1,0,1,1
06069882,4,2,2,0,1,1,0,0,1
06069892,4,0,4,0,1,1,0,0,1
06070000,23,5,18,0,2,2,0,2,1
06070096,4,3,1,0,1,1,0,1,1
06070437,4,1,3,0,3,3,0,0,1
06070478,6,2,4,0,1,1,0,0,1
06070488,5,3,2,0,2,2,0,0,1
06070500,4,1,3,0,1,1,0,0,1
06070514,8,3,5,0,1,1,0,1,1
06070625,5,2,3,0,0,0,0,0,1
06070846,4,1,3,0,2,2,0,0,1
06071227,4,0,4,0,0,0,0,0,1
06071685,8,4,4,0,0,0,0,0,1
06071981,4,2,2,0,1,1,0,0,1
06072022,4,2,2,0,1,1,0,0,1
06072025,11,5,6,0,1,1,0,0,1
06072068,6,0,6,0,0,0,0,0,1
06072070,5,3,2,0,0,0,0,0,1
06072298,4,2,2,0,1,1,0,0,1
06072317,5,3,2,0,2,2,0,0,1
06072918,9,1,8,0,1,1,0,1,1
06072929,5,0,5,0,0,0,0,0,1
06072971,5,0,5,0,0,0,0,0,1
06073134,6,0,6,0,3,3,0,0,1
06073690,29,4,25,0,2,2,0,2,1
06073803,6,0,6,0,0,0,0,0,1
06073955,5,2,3,0,1,1,0,0,1
06073962,26,5,21,0,0,0,0,0,1
06073971,6,1,5,0,1,1,0,0,1
06074479,8,5,3,0,0,0,0,0,1
06074684,3,1,2,0,1,1,0,0,0
06075780,6,2,4,0,1,1,0,0,1
06076014,4,2,2,0,2,2,0,0,1
06076177,7,3,4,0,2,2,0,0,1
06076187,5,0,5,0,0,0,0,0,1
06076188,5,3,2,0,2,2,0,0,1
06076220,7,2,5,0,1,1,0,1,1
06076697,4,2,2,0,1,1,0,0,1
06076701,5,3,2,0,1,1,0,0,1
06076995,12,3,9,0,0,0,0,0,1
06076999,9,3,6,0,1,1,0,0,1
06077003,12,3,9,0,1,1,0,1,1
06077024,6,2,4,0,2,2,0,0,1
06077217,4,2,2,0,1,1,0,0,1
06077223,18,4,14,0,1,1,0,1,1
06077377,4,1,3,0,1,1,0,0,1
06077784,4,2,2,0,3,3,0,0,1
06077852,8,4,4,0,3,3,0,0,0
06077922,24,12,12,0,1,1,0,0,1
06078132,7,5,2,0,1,1,0,0,1
06078143,6,1,5,0,1,1,0,0,1
06078196,2,0,2,0,0,0,0,0,1
06078286,5,3,2,0,1,1,0,1,1
06078444,6,3,3,0,2,2,0,0,1
06078449,5,3,2,0,1,1,0,0,1
06078455,5,3,2,0,1,1,0,0,1
06078832,6,2,4,0,1,1,0,0,1
06079021,4,2,2,0,2,2,0,0,1
06079459,6,2,4,0,2,2,0,0,1
06079523,4,1,3,0,2,1,1,0,1
06079837,5,0,5,0,2,2,0,0,1
06079867,4,0,4,0,0,0,0,0,1
06080056,5,3,2,0,2,2,0,0,1
06080199,8,5,3,0,1,1,0,1,1
06080277,12,2,10,0,0,0,0,0,1
06080283,6,3,3,0,2,2,0,0,1
06080353,5,3,2,0,2,2,0,0,1
06080432,6,0,6,0,0,0,0,0,1
06080856,4,2,2,0,1,1,0,0,1
06080904,5,3,2,0,1,1,0,0,1
06080921,5,3,2,0,2,2,0,0,1
06081010,4,2,2,0,1,1,0,0,1
06081055,10,5,5,0,2,2,0,0,1
06081107,12,4,8,0,5,3,2,0,1
06081150,4,3,1,0,1,1,0,1,1
06082363,2,2,0,0,1,1,0,0,0
06082865,16,3,13,0,3,3,0,0,1
06083408,20,10,10,0,1,1,0,0,0
06084249,4,1,3,0,1,1,0,0,0
06085861,5,3,2,0,2,2,0,0,0
06090404,2,2,0,0,1,1,0,0,0
06090608,7,6,1,0,0,0,0,0,0
06092971,12,5,7,0,0,0,0,0,0
06093157,4,1,3,0,1,1,0,0,1
06098580,3,1,2,0,3,2,1,0,0
06099690,3,0,3,0,0,0,0,0,0
06105016,5,2,3,0,1,1,0,0,0
06106457,5,3,2,0,2,2,0,0,0
06109435,8,4,4,0,1,1,0,0,0
06113654,12,2,10,0,0,0,0,0,0
06116121,15,4,11,0,2,1,1,1,1
06116357,21,3,18,0,2,2,0,2,1
06117418,7,3,4,0,4,1,3,1,0
06119036,48,10,38,0,1,1,0,1,1
06124828,40,17,23,0,0,0,0,0,1
06124960,14,3,11,0,2,2,0,2,1
06124979,4,3,1,0,1,1,0,0,0
06125726,8,0,8,0,0,0,0,0,0
06125830,7,0,7,0,1,1,0,0,0
06126480,8,1,7,0,2,2,0,0,0
06128149,3,3,0,0,2,2,0,0,0
06129852,13,3,10,0,1,1,0,1,0
06130476,4,0,4,0,0,0,0,0,1
06131579,9,2,7,0,1,1,0,1,1
06131647,2,2,0,0,1,1,0,0,0
06133397,13,2,11,0,2,2,0,0,1
06134948,17,2,15,0,0,0,0,0,0
06135492,2,2,0,0,1,1,0,0,0
06135683,3,3,0,0,2,2,0,0,1
06135971,10,5,5,0,5,0,5,0,1
06137039,6,3,3,0,3,3,0,0,1
06139077,18,6,12,0,1,1,0,1,1
06140568,9,3,6,0,1,1,0,1,1
06141518,3,3,0,0,2,2,0,0,1
06141603,23,8,15,0,0,0,0,0,1
06142617,3,3,0,0,1,1,0,0,0
06143426,2,2,0,0,1,1,0,0,1
06144857,6,4,2,0,0,0,0,0,1
06145342,8,0,8,0,1,1,0,0,1
06147104,8,3,5,0,1,1,0,1,1
06149589,4,2,2,0,2,2,0,0,0
06150438,5,0,5,0,0,0,0,0,1
06154034,7,3,4,0,1,1,0,1,1
06155726,4,2,2,0,1,1,0,0,1
06156661,18,3,15,1,1,1,0,1,1
06158076,11,6,5,0,0,0,0,0,1
06159017,18,3,15,1,1,1,0,1,1
06160934,5,0,5,0,2,2,0,0,0
06162462,12,0,12,0,1,1,0,1,1
06163147,8,3,5,0,1,1,0,1,1
06163846,5,2,3,0,4,1,3,1,0
06165859,19,7,12,0,1,1,0,1,1
06166092,15,4,11,0,0,0,0,0,0
06166349,5,0,5,0,0,0,0,0,1
06166544,3,0,3,0,0,0,0,0,1
06166872,7,4,3,0,1,1,0,0,1
06166899,5,3,2,0,3,3,0,0,1
06167580,5,3,2,0,1,1,0,0,1
06167585,3,0,3,0,1,1,0,0,1
06167839,4,2,2,0,1,1,0,0,0
06167928,13,4,9,0,2,2,0,2,1
06168151,7,2,5,0,0,0,0,0,1
06169938,20,4,16,0,2,2,0,2,1
06170611,32,7,25,0,1,1,0,1,1
06172154,6,0,6,0,0,0,0,0,1
06176778,8,0,8,0,0,0,0,0,1
06176780,8,0,8,0,0,0,0,0,1
06179375,7,0,7,0,0,0,0,0,1
06179972,14,0,14,0,1,1,0,1,1
06182982,37,8,29,0,0,0,0,0,0
06185898,5,3,2,0,1,1,0,1,1
06186766,3,0,3,0,0,0,0,0,0
06189455,11,3,8,0,1,1,0,1,1
06190306,27,9,18,0,0,0,0,0,1
06190393,27,9,18,0,0,0,0,0,1
06191044,5,3,2,0,2,2,0,0,0
06191598,9,4,5,0,1,1,0,0,0
06192136,7,2,5,0,2,2,0,0,1
06192615,23,9,14,0,0,0,0,0,0
06194411,12,6,6,0,0,0,0,0,0
06195648,9,0,9,0,0,0,0,0,1
06195812,14,6,8,0,1,1,0,1,1
06196036,6,0,6,0,4,4,0,0,0
06197703,13,2,11,0,4,3,1,2,1
06198255,14,1,13,0,0,0,0,0,1
06198281,15,1,14,0,1,1,0,1,1
06198327,15,0,15,0,0,0,0,0,1
06198378,15,0,15,0,0,0,0,0,1
06198400,15,0,15,0,0,0,0,0,1
06198404,16,0,16,0,1,1,0,1,1
06198627,3,1,2,0,2,2,0,0,0
06201302,9,3,6,0,0,0,0,0,1
06201407,3,1,2,0,1,1,0,0,0
06201419,5,2,3,0,0,0,0,0,1
06205779,7,2,5,0,0,0,0,0,0
06205795,17,4,13,0,2,2,0,2,1
06207095,5,1,4,0,2,1,1,0,1
06208888,7,4,3,0,5,3,2,0,1
06209458,15,4,11,0,2,2,0,2,1
06211124,5,0,5,0,0,0,0,0,1
06212648,2,1,1,0,1,1,0,0,0
06212760,3,0,3,0,0,0,0,0,1
06214446,2,2,0,0,1,1,0,0,0
06215825,4,2,2,0,1,1,0,0,0
06216137,16,4,12,0,0,0,0,0,0
06216389,4,1,3,0,1,1,0,0,0
06216905,24,4,20,0,1,1,0,1,1
06218984,19,4,15,0,2,2,0,2,1
06219625,9,6,3,0,1,1,0,1,1
03880267,8,0,8,0,0,0,0,0,1
03880306,29,0,29,0,0,0,0,0,1
03880363,4,2,2,0,1,1,0,0,1
03880908,5,3,2,0,1,1,0,1,0
03881286,4,2,2,0,2,2,0,0,0
03881406,10,3,7,0,1,1,0,1,1
03882115,9,3,6,0,3,3,0,0,1
03882134,11,2,9,0,1,1,0,1,1
03882652,5,0,5,0,0,0,0,0,1
03882663,5,3,2,0,2,2,0,0,1
03882679,9,1,8,0,1,1,0,0,1
03882927,7,2,5,0,1,1,0,0,0
03883492,5,3,2,0,2,2,0,0,1
03883677,15,5,10,0,2,2,0,0,0
03884659,36,10,26,0,0,0,0,0,0
03884737,5,3,2,0,1,1,0,0,0
03884933,8,4,4,0,1,1,0,0,1
03884981,26,2,24,0,1,1,0,1,1
03885293,3,1,2,0,2,2,0,0,0
03885838,20,4,16,0,0,0,0,0,0
03886084,12,3,9,0,1,1,0,1,1
03886106,7,4,3,0,0,0,0,0,0
03886236,40,14,26,0,0,0,0,0,0
03886811,6,0,6,0,2,2,0,0,0
03888219,8,0,8,0,0,0,0,0,1
03888636,24,4,20,0,0,0,0,0,1
03888770,8,0,8,0,0,0,0,0,1
03889425,10,0,10,0,0,0,0,0,1
03889552,38,7,31,0,1,1,0,1,1
03890301,7,0,7,0,0,0,0,0,1
03891123,29,5,24,0,0,0,0,0,0
03892047,5,2,3,0,1,1,0,1,1
03893656,4,0,4,0,0,0,0,0,0
03894136,5,0,5,0,1,1,0,0,0
03894827,11,3,8,0,1,1,0,0,1
03894828,11,3,8,0,1,1,0,0,1
03895063,24,3,21,0,1,1,0,1,1
03895376,4,0,4,0,0,0,0,0,1
03895701,4,2,2,0,1,1,0,0,1
03896007,5,1,4,0,2,2,0,0,1
03896584,34,0,34,0,0,0,0,0,1
03896734,16,8,8,0,0,0,0,0,1
03897745,20,3,17,1,1,1,0,1,1
03897926,34,0,34,0,0,0,0,0,1
03898093,24,4,20,0,0,0,0,0,0
03898246,7,3,4,0,2,2,0,0,1
03898338,18,3,15,0,3,1,2,1,1
03898509,4,2,2,0,3,3,0,0,1
03898843,7,4,3,0,0,0,0,0,0
03900397,7,3,4,0,3,2,1,0,0
03900836,29,0,29,0,1,1,0,1,1
03901706,5,0,5,0,0,0,0,0,1
03902325,7,2,5,0,1,1,0,0,0
03902880,23,6,17,0,1,1,0,1,1
03902912,6,2,4,0,0,0,0,0,1
03902965,20,0,20,0,0,0,0,0,1
03904023,8,0,8,0,0,0,0,0,1
03904153,13,0,13,0,0,0,0,0,1
03906241,28,2,26,0,1,1,0,1,1
03907036,11,6,5,0,1,1,0,1,1
03907048,7,2,5,0,1,1,0,0,1
03907182,5,1,4,0,1,1,0,0,1
03907429,16,4,12,0,1,1,0,0,0
03908435,22,9,13,0,0,0,0,0,1
03909772,14,0,14,0,0,0,0,0,1
03911256,35,3,32,0,3,1,2,1,1
03911278,36,3,33,0,1,1,0,1,1
03911991,9,0,9,0,0,0,0,0,0
03912300,18,2,16,0,0,0,0,0,1
03913072,5,3,2,0,2,2,0,0,1
03913873,18,4,14,0,0,0,0,0,0
03913912,19,0,19,0,0,0,0,0,1
03914773,19,5,14,0,1,1,0,0,1
03914814,41,3,38,0,2,1,1,1,1
03915388,10,0,10,0,1,1,0,1,1
03915417,10,4,6,0,1,1,0,1,1
03915442,8,4,4,0,1,1,0,1,1
03915447,10,0,10,0,0,0,0,0,1
03916560,13,1,12,0,1,1,0,1,1
03918227,16,4,12,0,1,1,0,0,1
03919619,16,4,12,0,1,1,0,1,1
03920198,22,0,22,0,0,0,0,0,1
03920217,35,6,29,0,2,2,0,1,1
03920626,11,2,9,0,2,1,1,1,0
03920946,56,14,42,0,0,0,0,0,1
03921089,28,2,26,0,1,1,0,1,1
03921701,11,3,8,0,1,1,0,1,1
03922093,7,1,6,0,1,1,0,0,0
03922227,4,3,1,0,1,1,0,0,0
03922468,19,0,19,0,1,1,0,1,1
03923096,6,2,4,0,0,0,0,0,1
03923275,5,2,3,0,1,1,0,0,1
03923324,20,0,20,0,0,0,0,0,1
03923336,17,0,17,0,0,0,0,0,1
03923561,16,0,16,0,0,0,0,0,1
03924469,14,2,12,0,1,1,0,1,1
03924932,15,4,11,0,2,2,0,2,1
03926686,17,3,14,4,1,1,0,1,1
03927557,4,1,3,0,1,1,0,0,0
03927594,9,5,4,0,1,1,0,1,0
03927610,4,2,2,0,2,2,0,0,0
03927635,17,3,14,0,1,1,0,1,1
03927994,7,3,4,0,0,0,0,0,0
03928315,9,3,6,0,1,1,0,0,0
03928932,16,5,11,0,1,1,0,1,0
03929879,8,4,4,0,1,1,0,1,1
03929939,6,2,4,0,2,1,1,0,0
03930321,17,6,11,0,2,1,1,2,1
03931048,5,0,5,0,0,0,0,0,1
03931507,47,11,36,0,0,0,0,0,0
03932731,8,4,4,0,2,2,0,1,1
03932840,20,3,17,0,2,1,1,2,1
03933096,12,3,9,0,1,1,0,1,1
03933291,14,3,11,0,1,1,0,1,1
03933986,15,0,15,0,1,1,0,1,1
03934314,11,0,11,0,0,0,0,0,1
03934326,11,0,11,0,0,0,0,0,1
03934339,9,2,7,0,1,1,0,1,1
03934732,20,3,17,0,2,2,0,1,1
03934744,14,0,14,0,0,0,0,0,1
03934747,8,0,8,0,1,1,0,0,1
03934750,24,4,20,0,1,1,0,1,1
03934761,22,5,17,0,1,1,0,1,1
03934790,15,0,15,0,0,0,0,0,1
03934831,24,0,24,0,0,0,0,0,1
03934833,5,3,2,0,1,1,0,1,1
03936571,21,3,18,0,1,1,0,1,1
03936713,7,2,5,0,2,2,0,0,1
03937377,6,2,4,0,1,1,0,0,1
03940587,4,2,2,0,1,1,0,0,0
03942183,42,7,35,0,1,1,0,1,1
03946280,57,15,42,0,2,2,0,0,0
03946731,76,16,60,0,2,1,1,0,0
03946785,16,3,13,0,0,0,0,0,1
03949250,7,3,4,0,2,2,0,0,0
03949697,21,2,19,0,1,1,0,1,1
03949707,31,5,26,0,2,2,0,0,1
03949824,7,2,5,0,1,1,0,0,0
03949843,28,4,24,0,1,1,0,1,1
03951260,34,7,27,0,1,1,0,1,1
03951306,22,5,17,0,1,1,0,1,1
03951895,11,2,9,0,1,1,0,0,1
03952910,10,3,7,0,3,1,2,0,0
03953195,47,11,36,0,0,0,0,0,0
03954514,6,3,3,0,2,2,0,0,0
03955861,41,4,37,0,1,1,0,1,1
03957249,12,5,7,0,0,0,0,0,0
03957322,14,2,12,0,2,2,0,0,1
03958363,9,3,6,0,3,3,0,0,0
03958448,4,1,3,0,1,1,0,0,0
03958793,30,13,17,0,0,0,0,0,0
03959835,7,2,5,0,1,1,0,1,0
03962001,24,4,20,0,2,1,1,2,1
03962410,36,2,34,0,1,1,0,1,1
03963921,20,3,17,1,1,1,0,1,1
03964238,6,4,2,0,2,2,0,0,0
03964274,6,1,5,0,1,1,0,0,1
03964469,8,0,8,0,0,0,0,0,0
03964578,4,1,3,0,2,2,0,0,0
03964835,9,0,9,0,1,1,0,1,1
03964960,4,2,2,0,2,2,0,0,0
03966333,28,4,24,0,1,1,0,1,1
03966743,11,3,8,0,1,1,0,0,1
03967275,8,4,4,0,1,1,0,0,1
03967680,21,5,16,0,5,3,2,1,1
03967878,25,0,25,0,0,0,0,0,1
03967882,26,0,26,0,0,0,0,0,1
03967914,16,0,16,0,0,0,0,0,1
03967922,16,0,16,0,0,0,0,0,1
03968160,8,0,8,0,0,0,0,0,1
03968279,17,10,7,0,0,0,0,0,0
03968392,9,2,7,0,1,1,0,1,1
03968610,9,2,7,0,1,1,0,1,1
03968807,10,1,9,0,1,1,0,0,1
03969447,0,0,0,0,0,0,0,0,1
03970279,9,2,7,0,1,1,0,1,1
03970339,9,2,7,0,1,1,0,1,1
03971723,8,3,5,0,1,1,0,1,1
03973434,20,4,16,0,1,1,0,0,1
03973716,6,0,6,0,0,0,0,0,1
03974519,21,2,19,0,1,1,0,1,0
03974835,6,2,4,0,1,1,0,0,0
03975193,20,3,17,1,1,1,0,1,1
03975288,7,3,4,0,1,1,0,1,1
03976076,24,0,24,0,0,0,0,0,1
03976655,10,3,7,0,1,1,0,0,0
03977028,5,2,3,0,1,1,0,0,0
03977289,28,0,28,0,0,0,0,0,1
03977431,6,2,4,0,0,0,0,0,1
03977597,8,3,5,0,1,1,0,1,0
03977837,8,2,6,0,2,2,0,0,1
03977841,7,0,7,0,0,0,0,0,1
03977902,17,3,14,0,1,1,0,1,1
03977909,6,2,4,0,2,1,1,0,1
03977982,9,2,7,0,2,2,0,0,1
03978346,32,3,29,0,1,1,0,1,1
03980266,15,0,15,0,0,0,0,0,1
03982057,16,0,16,0,0,0,0,0,1
03982225,26,0,26,0,0,0,0,0,1
03982959,13,6,7,0,1,1,0,0,1
03984214,4,0,4,0,1,1,0,0,1
03984464,29,4,25,0,1,1,0,1,1
03984470,16,0,16,0,0,0,0,0,1
03984492,16,0,16,0,0,0,0,0,1
03985507,5,1,4,0,1,1,0,0,0
03986603,12,5,7,0,2,2,0,0,1
03987132,7,0,7,0,0,0,0,0,1
03989137,26,8,18,0,0,0,0,0,1
03990682,5,2,3,0,1,1,0,0,1
03991383,9,5,4,0,0,0,0,0,0
03991620,3,0,3,0,0,0,0,0,1
03991838,42,0,42,0,0,0,0,0,1
03993146,5,0,5,0,0,0,0,0,1
03993250,5,5,0,0,4,4,0,0,0
03996307,4,0,4,0,0,0,0,0,1
03997525,5,2,3,0,2,2,0,0,1
03998049,12,0,12,0,0,0,0,0,0
03998136,14,4,10,0,1,1,0,1,1
03998296,6,3,3,0,1,1,0,0,1
03998820,8,0,8,0,0,0,0,0,1
03998833,17,3,14,0,2,2,0,2,1
03998881,17,4,13,0,1,1,0,1,1
03999510,14,5,9,0,1,1,0,1,0
08800236,3,1,2,0,2,1,1,0,0
08800259,3,1,2,0,2,1,1,0,0
08800341,3,0,3,0,2,2,0,0,0
08800358,2,0,2,0,0,0,0,0,1
08800898,2,0,2,0,0,0,0,0,1
08801406,1,1,0,0,2,2,0,0,0
08802965,3,1,2,0,2,1,1,0,0
08803782,8,3,5,0,1,1,0,1,1
08803796,2,2,0,0,1,1,0,0,0
08804155,8,0,8,0,0,0,0,0,1
08805073,4,2,2,0,2,1,1,0,0
08808394,3,2,1,0,3,1,2,3,0
08811042,2,2,0,0,2,2,0,0,0
08811158,2,0,2,0,0,0,0,0,0
08812271,3,0,3,0,1,1,0,0,0
08812638,1,0,1,0,0,0,0,0,0
08812879,1,0,1,0,0,0,0,0,1
08814472,3,3,0,0,1,1,0,0,0
08814637,3,3,0,0,1,1,0,0,0
08814847,2,2,0,0,2,2,0,0,0
08816625,2,1,1,0,1,1,0,0,0
08817057,2,2,0,0,2,2,0,0,0
08819564,5,3,2,0,1,1,0,1,1
08819748,15,6,9,0,0,0,0,0,0
08821395,1,1,0,0,1,1,0,0,0
08824446,4,4,0,0,3,3,0,2,1
08824509,9,7,2,0,0,0,0,0,0
08827951,1,1,0,0,1,1,0,0,0
08828425,2,2,0,0,2,2,0,0,0
08828467,4,4,0,0,1,1,0,0,0
08828704,4,3,1,0,3,3,0,0,1
08829933,11,4,7,0,2,2,0,2,1
08830833,3,0,3,0,0,0,0,0,0
08830928,9,5,4,0,1,1,0,1,1
08832956,9,6,3,0,2,2,0,2,1
08834686,2,2,0,0,2,2,0,0,0
08835913,1,1,0,0,1,1,0,0,0
08836495,2,0,2,0,0,0,0,0,0
08837501,2,2,0,0,2,2,0,0,0
08837699,3,3,0,0,1,1,0,0,0
08839155,1,1,0,0,1,1,0,0,0
08839834,1,1,0,0,1,1,0,0,0
08840047,9,2,7,2,1,1,0,1,0
08840773,1,1,0,0,1,1,0,0,0
08841445,2,2,0,0,1,1,0,0,1
08841720,2,0,2,0,0,0,0,0,0
08842594,6,5,1,0,3,3,0,0,0
08842980,10,0,10,0,0,0,0,0,0
08845266,2,1,1,0,2,2,0,0,1
08845846,2,0,2,0,1,1,0,0,0
08846138,2,2,0,0,1,1,0,0,1
08846148,2,2,0,0,2,2,0,0,0
08846557,2,0,2,0,0,0,0,0,0
08847971,3,2,1,0,1,1,0,1,1
08848738,8,5,3,0,0,0,0,0,0
08848753,1,1,0,0,1,1,0,0,0
08849493,5,2,3,0,2,2,0,0,1
08849598,1,1,0,0,1,1,0,0,0
08850123,3,2,1,0,1,1,0,0,0
08850428,7,5,2,0,1,1,0,1,1
08850869,2,2,0,0,1,1,0,0,0
08851564,1,1,0,0,1,1,0,0,0
08851741,1,1,0,0,2,2,0,0,0
08853063,1,1,0,0,1,1,0,0,0
08853943,3,2,1,0,0,0,0,0,0
08853972,2,2,0,0,2,2,0,0,0
08854932,2,2,0,0,1,1,0,1,0
08857241,2,1,1,0,1,1,0,0,0
08858935,8,5,3,0,0,0,0,0,0
08861931,4,3,1,0,5,5,0,1,0
08863890,3,2,1,0,2,2,0,0,0
08864987,2,2,0,0,2,2,0,0,0
08866406,1,1,0,0,1,1,0,0,0
08866592,2,1,1,0,2,1,1,1,1
08866734,2,1,1,0,2,1,1,1,1
08867311,3,0,3,0,1,1,0,0,1
08867452,3,3,0,0,2,2,0,0,0
08867556,1,1,0,0,1,1,0,0,0
08868033,1,0,1,0,0,0,0,0,0
08871790,9,3,6,0,3,3,0,3,1
08872061,11,9,2,0,2,1,1,2,1
08872858,1,1,0,0,1,1,0,0,0
08874829,3,2,1,0,2,2,0,0,0
08876534,5,2,3,0,2,2,0,0,1
08878036,2,2,0,0,1,1,0,0,0
08878363,2,0,2,0,0,0,0,0,0
08878604,11,10,1,0,0,0,0,0,0
08878754,1,1,0,0,1,1,0,0,0
08879090,1,0,1,0,0,0,0,0,1
08880174,10,8,2,0,0,0,0,0,0
08880841,25,13,12,0,0,0,0,0,0
08881335,1,0,1,0,0,0,0,0,0
08882579,4,2,2,0,4,1,3,4,0
08883490,2,1,1,0,1,1,0,1,0
08885547,2,1,1,0,1,1,0,0,0
08885952,3,3,0,0,1,1,0,0,0
08886023,1,1,0,0,1,1,0,0,0
08888347,2,2,0,0,2,2,0,0,0
08889125,5,4,1,0,1,1,0,0,0
08889291,2,1,1,0,1,1,0,0,0
08889294,4,3,1,0,0,0,0,0,1
08890445,2,1,1,0,2,1,1,1,0
08892572,2,0,2,0,0,0,0,0,0
08892706,1,0,1,0,1,1,0,0,0
08893018,2,0,2,0,1,1,0,0,0
08893826,5,1,4,0,2,1,1,0,0
08894099,1,0,1,0,0,0,0,0,0
08895146,5,3,2,0,5,3,2,1,1
08895166,6,2,4,0,0,0,0,0,1
08898768,11,3,8,1,1,1,0,0,1
08899616,2,1,1,0,1,1,0,0,0
08899625,2,0,2,0,0,0,0,0,0
08899644,2,0,2,0,0,0,0,0,0
08899697,2,0,2,0,1,1,0,0,0
08899705,2,0,2,0,0,0,0,0,0
08899712,2,0,2,0,0,0,0,0,0
08899754,2,0,2,0,0,0,0,0,0
08900140,15,7,8,0,1,0,1,0,1
08902599,22,13,9,0,2,2,0,0,1
08902783,1,1,0,0,1,1,0,0,0
08903140,1,1,0,0,1,1,0,0,0
08903841,1,1,0,0,1,1,0,0,0
08904327,14,11,3,0,0,0,0,0,0
08904550,3,3,0,0,2,2,0,0,1
08904577,7,6,1,0,1,1,0,1,1
08904842,1,1,0,0,1,1,0,0,0
08905610,3,0,3,0,0,0,0,0,0
08906211,3,3,0,0,2,2,0,0,0
08906420,7,3,4,0,0,0,0,0,0
08906586,1,1,0,0,1,1,0,0,0
08906619,4,2,2,0,4,4,0,0,0
08906820,5,4,1,0,0,0,0,0,0
08906954,7,4,3,0,1,1,0,1,1
08907045,1,1,0,0,1,1,0,0,0
08907789,2,2,0,0,2,2,0,0,0
08909066,1,1,0,0,1,1,0,0,0
08909973,3,0,3,0,0,0,0,0,0
08911246,4,0,4,0,0,0,0,0,1
08911931,1,1,0,0,1,1,0,0,0
08913874,2,1,1,0,2,1,1,0,0
08915084,2,1,1,0,2,2,0,0,0
08915230,1,1,0,0,1,1,0,0,0
08915668,2,0,2,0,0,0,0,0,1
08916300,3,2,1,0,2,2,0,0,0
08917595,3,3,0,0,1,1,0,0,0
08917869,6,4,2,0,2,1,1,1,0
08918060,1,0,1,0,2,2,0,0,0
08920125,2,1,1,0,2,1,1,0,0
08920806,23,10,13,0,1,1,0,0,0
08921324,15,7,8,0,0,0,0,0,0
08922189,3,2,1,0,1,1,0,1,1
08922328,8,2,6,0,1,1,0,1,1
08923988,3,3,0,0,1,1,0,0,0
08924161,2,0,2,0,0,0,0,0,1
08924483,2,1,1,0,1,1,0,0,0
08924618,7,3,4,0,1,1,0,1,0
08924655,6,5,1,0,3,0,3,0,1
08925107,2,1,1,0,1,1,0,0,0
08925150,6,0,6,0,1,1,0,1,1
08925849,3,3,0,0,6,6,0,0,0
08925951,3,3,0,0,1,1,0,0,0
08925996,2,0,2,0,0,0,0,0,1
08926562,3,3,0,0,1,1,0,0,0
08926941,3,0,3,0,0,0,0,0,1
08927373,2,2,0,0,1,1,0,0,0
08928805,2,2,0,0,1,1,0,0,0
08928991,6,4,2,0,0,0,0,0,0
08929105,3,1,2,0,1,1,0,1,0
08929307,2,2,0,0,1,1,0,0,0
08929558,2,2,0,0,1,1,0,0,0
08930634,1,1,0,0,1,1,0,0,0
08932302,2,2,0,0,2,2,0,0,0
08933793,3,3,0,0,0,0,0,0,0
08933821,9,2,7,0,1,1,0,1,1
08933991,1,0,1,0,0,0,0,0,1
08934544,8,7,1,0,1,1,0,1,1
08934739,2,2,0,0,1,1,0,0,0
08936739,1,1,0,0,1,1,0,0,0
08938249,4,3,1,0,0,0,0,0,0
08938369,2,1,1,0,0,0,0,0,0
08940850,2,2,0,0,2,2,0,0,0
08941161,1,1,0,0,2,2,0,0,0
08941641,1,1,0,0,1,1,0,0,0
08941652,1,1,0,0,1,1,0,0,0
08943545,7,1,6,0,4,1,3,0,0
08943621,1,0,1,0,0,0,0,0,0
08946648,1,0,1,0,0,0,0,0,1
08947176,1,1,0,0,1,1,0,0,0
08947897,2,1,1,0,1,1,0,0,0
08947927,7,1,6,0,3,1,2,0,0
08947958,6,0,6,0,2,1,1,0,0
08948015,7,0,7,0,2,1,1,0,0
08948040,2,2,0,0,2,2,0,0,0
08948625,13,3,10,0,2,2,0,2,1
08949771,1,1,0,0,1,1,0,0,0
08949803,6,3,3,0,5,1,4,1,1
08949994,10,0,10,0,3,1,2,0,0
08950018,5,0,5,0,3,1,2,0,0
08950471,5,0,5,0,3,1,2,0,0
08951791,2,2,0,0,1,1,0,0,1
08951798,2,2,0,0,1,1,0,0,1
08952126,20,8,12,0,0,0,0,0,0
08952407,1,1,0,0,1,1,0,0,0
08953356,3,0,3,0,0,0,0,0,1
08953385,1,1,0,0,1,1,0,0,0
08954053,3,1,2,0,1,1,0,0,0
08954358,3,2,1,0,2,1,1,0,0
08955328,8,5,3,0,2,2,0,2,0
08957792,3,3,0,0,1,1,0,0,0
08958574,10,7,3,0,1,1,0,1,1
08958580,10,7,3,0,1,1,0,1,1
08959230,4,2,2,0,1,1,0,0,0
08959244,12,1,11,0,4,1,3,0,0
08959675,2,1,1,0,1,1,0,0,0
08959704,4,2,2,0,1,1,0,0,0
08959772,2,2,0,0,2,2,0,0,0
08960430,17,10,7,0,1,1,0,1,1
08960635,12,7,5,0,0,0,0,0,0
08960905,11,4,7,0,1,1,0,0,0
08961063,4,1,3,0,1,1,0,0,0
08961108,3,3,0,0,1,1,0,0,0
08961147,10,5,5,0,1,1,0,1,1
08961986,2,2,0,0,1,1,0,0,0
08962562,2,2,0,0,1,1,0,0,0
08962626,4,0,4,0,2,1,1,0,0
08962671,2,1,1,0,1,1,0,0,0
08965580,3,3,0,0,2,2,0,0,0
08966229,1,0,1,0,0,0,0,0,0
08966580,2,2,0,0,2,2,0,0,0
08970203,2,0,2,0,0,0,0,0,0
08971147,2,0,2,0,0,0,0,0,0
08971665,2,0,2,0,0,0,0,0,0
08971731,2,0,2,0,0,0,0,0,0
08972062,2,0,2,0,0,0,0,0,0
08973734,2,0,2,0,0,0,0,0,0
08973882,2,0,2,0,0,0,0,0,0
08973926,1,1,0,0,1,1,0,0,0
08974356,1,1,0,0,1,1,0,0,0
08974595,12,11,1,0,0,0,0,0,0
08974704,2,0,2,0,0,0,0,0,0
08975108,6,2,4,0,2,1,1,0,0
08975211,10,1,9,0,5,1,4,0,0
08975654,2,0,2,0,0,0,0,0,0
08975740,2,0,2,0,0,0,0,0,0
08975796,2,0,2,0,0,0,0,0,0
08976317,2,0,2,0,0,0,0,0,0
08976336,2,0,2,0,1,1,0,0,0
08976428,6,0,6,0,1,1,0,0,0
08976888,5,4,1,0,1,1,0,1,1
08977002,1,1,0,0,1,1,0,0,0
08977238,2,0,2,0,0,0,0,0,0
08977452,1,1,0,0,1,1,0,0,0
08977527,1,1,0,0,1,1,0,1,0
08978200,2,0,2,0,0,0,0,0,0
08978871,6,1,5,0,3,1,2,0,0
08979649,5,4,1,0,2,2,0,2,1
08980328,2,0,2,0,0,0,0,0,0
08980495,1,0,1,0,0,0,0,0,0
08980776,2,0,2,0,0,0,0,0,0
08980979,2,0,2,0,0,0,0,0,0
08980998,2,0,2,0,0,0,0,0,0
08981096,2,0,2,0,0,0,0,0,0
08981138,2,0,2,0,0,0,0,0,0
08982069,4,2,2,0,3,1,2,1,1
08982139,1,1,0,0,1,1,0,0,0
08982705,4,1,3,0,1,1,0,0,0
08983000,7,0,7,0,1,1,0,0,0
08983138,2,0,2,0,0,0,0,0,0
08983360,7,5,2,0,1,1,0,1,1
08983608,4,0,4,0,1,1,0,0,1
08983669,2,0,2,0,0,0,0,0,0
08983681,3,3,0,0,2,2,0,0,0
08983982,2,0,2,0,0,0,0,0,0
08984010,2,0,2,0,0,0,0,0,0
08984012,2,0,2,0,0,0,0,0,0
08984051,2,0,2,0,0,0,0,0,0
08984328,2,0,2,0,0,0,0,0,0
08984379,2,0,2,0,0,0,0,0,0
08984393,2,0,2,0,0,0,0,0,0
08984438,3,3,0,0,2,2,0,0,0
08984444,2,0,2,0,0,0,0,0,0
08984474,2,0,2,0,0,0,0,0,0
08984568,2,0,2,0,0,0,0,0,0
08984571,2,0,2,0,0,0,0,0,0
08984679,2,0,2,0,0,0,0,0,0
08984750,2,0,2,0,0,0,0,0,0
08984842,2,0,2,0,0,0,0,0,0
08984901,2,0,2,0,0,0,0,0,0
08985624,2,0,2,0,0,0,0,0,0
08985746,2,0,2,0,0,0,0,0,0
08985865,2,0,2,0,0,0,0,0,0
08985872,2,0,2,0,0,0,0,0,0
08985933,2,0,2,0,0,0,0,0,0
08985937,2,0,2,0,0,0,0,0,0
08985950,2,0,2,0,0,0,0,0,0
08986034,2,0,2,0,0,0,0,0,0
08986110,1,1,0,0,1,1,0,0,1
08986157,8,0,8,0,2,1,1,0,0
08986224,2,0,2,0,0,0,0,0,0
08986266,7,6,1,0,1,1,0,0,1
08986416,2,0,2,0,0,0,0,0,0
08986593,2,2,0,0,1,1,0,1,0
08986641,7,1,6,1,1,1,0,0,1
08986661,7,1,6,1,1,1,0,0,1
08987048,2,2,0,0,2,2,0,0,0
08987865,2,2,0,0,2,2,0,0,0
08987876,1,1,0,0,1,1,0,0,0
08988965,2,1,1,0,1,1,0,0,0
08990313,7,1,6,0,3,1,2,0,0
08990532,2,1,1,0,1,1,0,0,0
08991117,4,0,4,0,0,0,0,0,1
08991827,8,6,2,0,1,1,0,1,1
08991829,3,0,3,0,0,0,0,0,1
08992064,1,1,0,0,1,1,0,0,0
08992129,6,5,1,0,1,1,0,1,1
08992161,7,6,1,0,1,1,0,1,1
08992719,8,1,7,0,2,1,1,0,0
08994227,2,2,0,0,2,2,0,0,0
08996011,2,2,0,0,2,2,0,0,0
08996103,10,5,5,0,1,1,0,1,1
08997863,7,0,7,0,3,1,2,0,0
08998436,3,3,0,0,1,1,0,0,0
08998445,10,5,5,0,0,0,0,0,0
09000390,6,4,2,0,1,1,0,1,1
09002688,4,4,0,0,1,1,0,1,0
09003422,2,2,0,0,1,1,0,0,0
09006258,1,1,0,0,1,1,0,0,0
09008935,2,0,2,0,0,0,0,0,0
09009007,9,8,1,0,0,0,0,0,0
09011897,2,2,0,0,1,1,0,0,0
09013327,2,0,2,0,0,0,0,0,1
09016279,3,1,2,0,1,1,0,0,0
09018228,5,5,0,0,3,3,0,2,1
09018944,4,4,0,0,2,2,0,0,0
09019045,2,0,2,0,0,0,0,0,1
09019450,10,7,3,0,1,0,1,0,0
09020143,3,3,0,0,3,3,0,0,0
09020678,1,1,0,0,1,1,0,0,0
09020955,1,1,0,0,1,1,0,0,0
09021380,1,0,1,0,0,0,0,0,0
09021630,2,2,0,0,2,2,0,0,1
09021886,1,1,0,0,1,1,0,1,0
09022406,1,1,0,0,1,1,0,0,0
09026506,2,1,1,0,3,1,2,1,0
09026542,4,3,1,1,0,0,0,0,0
09026938,2,1,1,0,1,1,0,0,0
09027198,1,1,0,0,1,1,0,0,0
09027723,4,4,0,0,2,2,0,0,0
05071322,15,4,11,0,1,1,0,0,1
05071468,5,3,2,0,2,2,0,0,1
05072577,5,3,2,0,2,2,0,0,0
05072592,6,2,4,0,2,2,0,0,0
05072796,13,0,13,0,0,0,0,0,1
05072809,13,0,13,0,0,0,0,0,1
05073733,9,4,5,0,1,1,0,1,1
05073811,4,1,3,0,1,1,0,0,0
05075088,26,3,23,0,3,3,0,0,1
05075251,6,3,3,0,2,2,0,0,0
05076702,3,1,2,0,1,1,0,0,1
05076818,14,2,12,0,1,1,0,1,1
05077475,19,2,17,0,1,1,0,1,1
05079275,4,2,2,0,1,1,0,0,0
05079538,8,0,8,0,0,0,0,0,1
05079583,17,7,10,0,2,2,0,0,1
05079594,11,2,9,0,1,1,0,1,1
05079921,4,3,1,0,2,2,0,0,0
05081805,11,0,11,0,0,0,0,0,1
05082340,7,2,5,0,2,1,1,1,1
05083390,27,8,19,0,0,0,0,0,1
05085239,4,0,4,0,0,0,0,0,1
05085699,11,1,10,0,1,1,0,0,1
05085925,12,3,9,0,1,1,0,1,1
05086060,8,2,6,0,1,1,0,0,1
05086393,5,3,2,0,1,1,0,1,0
05086763,4,2,2,0,1,1,0,0,1
05088708,15,1,14,0,2,1,1,2,1
05088770,23,2,21,0,1,1,0,1,1
05088791,5,2,3,0,1,1,0,1,1
05089372,9,2,7,0,2,2,0,2,1
05089859,25,0,25,0,1,1,0,1,1
05089874,22,4,18,0,1,1,0,1,1
05091128,13,3,10,0,1,1,0,1,1
05091663,13,3,10,0,1,1,0,1,1
05091695,18,3,15,0,1,1,0,1,1
05091841,7,3,4,0,2,2,0,0,0
05091944,24,5,19,0,1,1,0,1,1
05093159,7,3,4,0,3,1,2,1,1
05093179,17,8,9,0,0,0,0,0,1
05093595,17,3,14,0,1,1,0,1,0
05093734,5,3,2,0,1,1,0,0,0
05095737,4,2,2,0,1,1,0,0,0
05096469,20,3,17,0,1,1,0,0,1
05097119,3,2,1,0,1,1,0,0,0
05097517,6,2,4,0,3,1,2,0,0
05097618,5,2,3,0,1,1,0,0,0
05098911,8,0,8,0,0,0,0,0,1
05100810,17,4,13,0,1,1,0,1,0
05101064,9,3,6,0,1,1,0,1,1
05103250,10,5,5,0,0,0,0,0,0
05104452,4,1,3,0,1,1,0,0,0
05104527,2,2,0,0,1,1,0,0,0
05104884,20,0,20,0,0,0,0,0,0
05107951,9,2,7,0,1,1,0,0,0
05108266,5,2,3,0,1,1,0,0,0
05108751,3,2,1,0,1,1,0,0,0
05109386,6,3,3,0,1,1,0,0,0
05110081,7,2,5,0,1,1,0,0,0
05111013,17,5,12,0,1,1,0,1,1
05111357,4,2,2,0,0,0,0,0,1
05111442,7,0,7,0,0,0,0,0,1
05111446,8,0,8,0,0,0,0,0,1
05111475,8,0,8,0,0,0,0,0,1
05113965,8,4,4,0,2,2,0,0,0
05114661,29,14,15,0,0,0,0,0,0
05115495,7,1,6,0,1,1,0,0,1
05115584,9,7,2,0,3,1,2,1,0
05115594,33,0,33,0,0,0,0,0,1
05115635,9,7,2,0,3,1,2,1,0
05115684,8,0,8,0,0,0,0,0,1
05116596,6,0,6,0,0,0,0,0,1
05117575,5,3,2,0,1,1,0,0,0
05117876,6,2,4,0,2,2,0,0,1
05118218,5,3,2,0,2,2,0,0,0
05119310,54,9,45,0,4,3,1,4,1
05121092,2,0,2,0,0,0,0,0,1
05121391,15,4,11,0,1,1,0,1,1
05121502,29,8,21,0,1,1,0,1,0
05121529,5,3,2,0,2,2,0,0,0
05122186,4,0,4,0,0,0,0,0,1
05122287,12,0,12,0,2,0,2,0,0
05122555,10,1,9,0,3,1,2,0,0
05122793,7,3,4,0,1,1,0,0,1
05122834,4,1,3,0,1,1,0,0,1
05123265,7,2,5,0,1,1,0,1,0
05124078,13,3,10,0,1,1,0,0,1
05126247,4,0,4,0,0,0,0,0,0
05127468,5,1,4,0,1,1,0,0,0
05127683,18,4,14,0,1,1,0,1,1
05128281,7,5,2,0,4,4,0,0,0
05128627,19,0,19,0,0,0,0,0,1
05129325,6,4,2,0,1,1,0,0,0
05131356,10,4,6,0,2,2,0,0,0
05132981,20,3,17,0,2,1,1,2,1
05133090,13,4,9,0,0,0,0,0,0
05133939,29,12,17,0,0,0,0,0,0
05134829,20,9,11,0,0,0,0,0,1
05137619,48,0,48,0,0,0,0,0,1
05137814,9,0,9,0,0,0,0,0,1
05138008,13,0,13,0,0,0,0,0,1
05138114,8,2,6,0,0,0,0,0,1
05138140,23,2,21,0,1,1,0,1,1
05139004,33,4,29,1,1,1,0,1,1
05139988,11,2,9,0,0,0,0,0,1
05140764,10,0,10,0,1,1,0,1,1
05140766,23,4,19,0,2,2,0,2,1
05142355,9,0,9,0,0,0,0,0,1
05143203,18,2,16,0,1,1,0,1,1
05143224,3,0,3,0,0,0,0,0,1
05143769,7,3,4,0,2,2,0,0,0
05144256,40,14,26,0,1,1,0,0,1
05144467,17,5,12,0,1,1,0,1,1
05144611,4,2,2,0,1,1,0,1,1
05145240,25,7,18,0,5,5,0,5,1
05145504,7,1,6,0,1,1,0,0,1
05145603,10,5,5,0,0,0,0,0,1
05146644,19,2,17,0,1,1,0,1,1
05147637,17,2,15,0,1,1,0,1,1
05148203,14,3,11,0,1,1,0,1,1
05148298,22,4,18,0,1,1,0,1,1
05148744,12,4,8,0,0,0,0,0,0
05149681,7,4,3,0,1,1,0,1,1
05149731,11,2,9,0,1,1,0,1,1
05149739,14,3,11,0,1,1,0,1,1
05149751,16,5,11,0,3,1,2,1,1
05149773,7,4,3,0,1,1,0,1,1
05150847,16,3,13,0,1,1,0,1,1
05151151,6,2,4,0,1,1,0,0,0
05151487,5,3,2,0,1,1,0,0,0
05151558,7,0,7,0,0,0,0,0,1
05152645,14,3,11,0,1,1,0,1,1
05152976,7,4,3,0,2,2,0,0,1
05153358,5,3,2,0,1,1,0,0,0
05153381,2,1,1,0,1,1,0,0,0
05153583,12,2,10,0,1,1,0,0,0
05155035,4,2,2,0,1,1,0,1,0
05155389,7,1,6,0,1,1,0,1,0
05155508,13,3,10,0,1,1,0,1,1
05156855,4,1,3,0,1,1,0,0,1
05158573,14,4,10,0,0,0,0,0,0
05159152,4,2,2,0,1,1,0,0,0
05160439,7,1,6,0,1,1,0,1,0
05161044,8,4,4,0,1,1,0,0,0
05161119,4,1,3,0,1,1,0,0,1
05161606,11,3,8,0,0,0,0,0,1
05162680,8,4,4,0,1,1,0,1,1
05163481,2,1,1,0,1,1,0,0,0
05163588,5,0,5,0,0,0,0,0,1
05166410,9,0,9,0,1,1,0,0,1
05167995,14,0,14,0,1,1,0,0,0
05169972,6,3,3,0,2,2,0,0,0
05170251,25,4,21,0,3,2,1,0,0
05173584,5,3,2,0,1,1,0,0,1
05174294,23,0,23,0,0,0,0,0,1
05174395,11,6,5,0,0,0,0,0,1
05175320,5,3,2,0,2,2,0,0,0
05176330,18,4,14,0,2,2,0,2,1
05178040,22,7,15,0,0,0,0,0,0
05178759,23,2,21,0,1,1,0,1,1
05180282,9,4,5,0,2,2,0,2,0
05180585,21,6,15,0,0,0,0,0,1
05181323,7,0,7,0,0,0,0,0,1
05181808,17,3,14,0,2,1,1,2,1
05182086,5,0,5,0,0,0,0,0,1
05182899,4,1,3,0,4,1,3,0,0
05184035,11,3,8,0,0,0,0,0,1
05184553,5,3,2,0,2,2,0,0,1
05185107,15,9,6,0,0,0,0,0,0
05185762,7,5,2,0,1,1,0,0,0
05185814,5,3,2,0,2,2,0,0,1
05186518,21,0,21,0,1,1,0,1,1
05186877,21,7,14,0,2,2,0,2,1
05187411,4,2,2,0,2,1,1,1,0
05187913,9,4,5,0,1,1,0,1,1
05188348,4,3,1,0,1,1,0,0,1
05188770,22,0,22,0,1,1,0,1,1
05188771,25,0,25,0,1,1,0,1,1
05190828,7,3,4,0,1,1,0,1,1
05190861,7,3,4,0,1,1,0,1,1
05192834,5,3,2,0,2,2,0,0,0
05193927,9,0,9,0,1,1,0,0,1
05194610,33,3,30,0,1,1,0,1,1
05195125,18,0,18,0,1,1,0,1,1
05195577,8,0,8,0,0,0,0,0,1
05200155,7,4,3,0,0,0,0,0,0
05201291,9,7,2,0,2,2,0,0,1
05201828,5,1,4,0,2,1,1,0,1
05203432,2,2,0,0,2,2,0,0,0
05204228,3,2,1,0,1,1,0,0,0
05206425,12,5,7,0,0,0,0,0,1
05207664,11,2,9,0,1,1,0,1,1
05207665,15,4,11,0,1,1,0,1,1
05207666,14,0,14,0,0,0,0,0,1
05207667,12,2,10,0,2,2,0,2,1
05207668,14,2,12,0,2,1,1,2,1
05207670,16,3,13,0,2,1,1,2,1
05210542,27,6,21,0,0,0,0,0,1
05210563,10,5,5,0,3,2,1,2,1
05211370,11,3,8,0,0,0,0,0,1
05211560,15,0,15,0,1,1,0,1,0
05211996,20,4,16,0,1,1,0,1,1
05213586,9,4,5,0,1,1,0,1,1
05216570,14,2,12,0,1,1,0,0,1
05216950,8,6,2,0,0,0,0,0,0
05217617,5,2,3,0,2,2,0,0,0
05224482,19,5,14,0,1,1,0,0,0
05225192,7,0,7,0,0,0,0,0,1
05225211,28,14,14,0,1,1,0,0,1
05225314,16,0,16,0,0,0,0,0,1
05225439,16,0,16,0,0,0,0,0,1
05225440,16,0,16,0,0,0,0,0,1
05225780,5,0,5,0,0,0,0,0,1
05225819,20,8,12,0,1,1,0,1,1
05225905,17,0,17,0,0,0,0,0,1
05226723,4,1,3,0,1,1,0,1,0
05226811,16,0,16,0,0,0,0,0,1
05227040,6,1,5,0,1,1,0,0,1
05228545,9,2,7,0,1,1,0,1,1
05229468,24,4,20,0,1,1,0,1,1
05229687,24,4,20,0,2,1,1,2,1
05229765,24,4,20,0,2,1,1,2,1
05229768,5,0,5,0,0,0,0,0,1
05229770,4,0,4,0,0,0,0,0,1
05230854,19,5,14,0,3,3,0,3,1
05232890,24,0,24,0,1,1,0,1,1
05233429,12,9,3,0,0,0,0,0,1
05234082,28,4,24,0,6,1,5,2,1
05234095,60,17,43,0,0,0,0,0,1
05234259,6,2,4,0,1,1,0,0,0
05234332,17,6,11,0,1,1,0,0,1
05234651,21,5,16,0,1,1,0,1,1
05234939,21,5,16,0,1,1,0,1,1
05235579,7,0,7,0,0,0,0,0,1
05235592,12,0,12,0,0,0,0,0,1
05236108,16,3,13,0,1,1,0,1,1
05236567,20,2,18,0,1,1,0,1,1
05236810,3,2,1,0,1,1,0,0,0
05238748,22,6,16,0,1,1,0,1,1
05239725,17,5,12,0,0,0,0,0,0
05240457,5,3,2,0,1,1,0,0,0
05241025,16,2,14,0,1,1,0,0,0
05242901,10,4,6,0,1,1,0,0,0
05244343,4,1,3,0,2,2,0,1,1
05244685,2,2,0,0,1,1,0,0,0
05246163,5,3,2,0,1,1,0,0,0
05247101,11,2,9,0,1,1,0,1,1
05247998,28,4,24,0,1,1,0,1,1
05249358,5,3,2,0,2,2,0,0,0
05250284,18,4,14,0,2,1,1,2,1
05256970,11,2,9,0,1,1,0,1,1
05258129,5,0,5,0,0,0,0,0,1
05259232,7,0,7,0,0,0,0,0,1
05260592,15,0,15,0,1,1,0,1,1
05261025,5,3,2,0,2,2,0,0,0
05264114,4,0,4,0,0,0,0,0,1
05264271,6,0,6,1,1,1,0,0,0
05266436,20,5,15,0,1,1,0,1,1
05266449,28,2,26,0,1,1,0,1,1
05267358,15,0,15,0,0,0,0,0,1
05269182,14,3,11,0,3,1,2,1,1
05269215,4,2,2,0,1,1,0,0,1
05270698,11,4,7,0,5,4,1,0,0
05271123,6,0,6,0,1,1,0,0,1
05272464,19,4,15,0,1,1,0,1,1
05274981,10,3,7,0,0,0,0,0,0
05276910,3,3,0,0,2,2,0,0,0
05276984,4,1,3,0,1,1,0,0,0
05277571,13,5,8,0,0,0,0,0,0
05277649,12,3,9,0,2,2,0,0,0
05277786,6,0,6,0,0,0,0,0,0
05278138,5,3,2,0,2,2,0,0,1
05278844,5,3,2,0,2,2,0,0,0
05278856,10,2,8,0,2,2,0,0,1
05279270,6,0,6,0,0,0,0,0,0
05280247,7,0,7,0,0,0,0,0,1
05281104,5,4,1,0,2,2,0,0,0
05282071,24,2,22,0,2,1,1,2,1
05283913,8,0,8,0,0,0,0,0,1
05284218,11,4,7,0,3,3,0,0,0
05284717,7,3,4,0,2,2,0,0,1
05284920,14,2,12,0,1,1,0,1,1
05285052,8,0,8,0,0,0,0,0,1
05288067,29,7,22,0,0,0,0,0,0
05288364,5,3,2,0,1,1,0,0,1
05288826,19,4,15,0,2,2,0,2,1
05289086,27,10,17,0,2,1,1,0,1
05291078,13,2,11,0,1,1,0,0,1
05291229,25,2,23,0,1,1,0,1,1
05291386,3,2,1,0,1,1,0,1,0
05292091,5,3,2,0,3,3,0,0,0
05293119,4,0,4,0,1,1,0,0,0
05293864,18,0,18,0,0,0,0,0,1
05294258,12,4,8,0,4,4,0,0,1
05294526,18,5,13,0,1,1,0,1,1
05295689,5,2,3,0,1,1,0,0,0
05297541,7,2,5,0,1,1,0,0,0
05298094,6,2,4,0,1,1,0,1,1
05298702,5,3,2,0,1,1,0,0,0
05300885,5,3,2,0,3,1,2,1,0
05301758,18,5,13,0,1,1,0,1,1
05301920,28,9,19,0,0,0,0,0,0
05302374,7,5,2,0,1,1,0,0,1
05302708,17,0,17,0,0,0,0,0,1
05303594,4,0,4,0,2,2,0,0,0
05304411,7,0,7,0,0,0,0,0,1
05304412,10,0,10,0,0,0,0,0,1
05306239,5,1,4,0,2,1,1,0,0
05306974,12,0,12,0,0,0,0,0,1
05307852,6,3,3,0,1,1,0,0,1
05307860,6,3,3,0,1,1,0,1,1
05310778,5,1,4,0,0,0,0,0,0
05311990,15,8,7,0,0,0,0,0,0
05312114,5,2,3,0,1,1,0,0,0
05312467,13,0,13,0,1,1,0,1,1
05312868,3,1,2,0,0,0,0,0,1
05313008,4,0,4,0,0,0,0,0,1
05313087,11,4,7,0,0,0,0,0,1
05314362,4,3,1,0,1,1,0,0,1
05315087,7,3,4,0,1,1,0,0,0
05315911,17,4,13,0,1,1,0,1,1
05316172,6,3,3,0,1,1,0,0,1
05316463,2,1,1,0,2,2,0,0,0
05316589,7,1,6,0,1,1,0,1,1
05316930,6,0,6,0,0,0,0,0,1
05317433,7,4,3,0,0,0,0,0,0
05317612,21,0,21,0,0,0,0,0,1
05317618,20,1,19,0,1,1,0,0,1
05318138,11,6,5,0,0,0,0,0,1
05318176,23,4,19,0,3,3,0,0,0
05322623,4,2,2,0,1,1,0,0,0
05323828,6,2,4,0,1,1,0,1,0
05324546,10,5,5,0,0,0,0,0,0
05325983,4,2,2,0,1,1,0,0,0
05327520,4,0,4,0,1,1,0,0,0
05328246,14,0,14,0,0,0,0,0,1
05329371,2,1,1,0,1,1,0,0,0
05331237,5,3,2,0,1,1,0,0,0
05332012,25,9,16,0,0,0,0,0,0
05332361,14,3,11,0,2,1,1,2,1
05333270,3,3,0,0,1,1,0,0,0
05333733,3,3,0,0,2,2,0,0,0
05334057,5,2,3,0,0,0,0,0,0
05334580,34,5,29,3,1,1,0,0,1
05336078,50,13,37,0,0,0,0,0,0
05338120,17,3,14,0,1,1,0,1,1
05338707,12,0,12,0,0,0,0,0,1
05338710,10,0,10,0,0,0,0,0,1
05338824,2,2,0,0,2,2,0,0,0
05340180,9,2,7,0,1,1,0,0,1
05343261,3,3,0,0,0,0,0,0,0
05344517,14,4,10,0,1,1,0,1,1
05345693,7,3,4,0,1,1,0,1,1
05346608,3,0,3,0,0,0,0,0,1
05347441,26,0,26,0,0,0,0,0,1
05347937,6,3,3,0,1,1,0,0,0
05348311,6,0,6,0,0,0,0,0,0
05348373,6,3,3,0,1,1,0,0,0
05350666,4,2,2,0,1,1,0,0,0
05351618,22,2,20,0,1,1,0,1,1
05352166,5,4,1,0,2,2,0,0,0
05352638,4,2,2,0,1,1,0,0,0
05353085,14,5,9,0,0,0,0,0,1
05354203,12,0,12,0,1,1,0,0,0
05354227,10,6,4,0,3,1,2,1,1
05354994,5,3,2,0,2,2,0,0,1
05355303,19,0,19,0,0,0,0,0,1
05357259,21,1,20,0,1,1,0,1,1
05360223,4,2,2,0,1,1,0,0,0
05361660,19,2,17,0,1,1,0,1,0
05361760,14,0,14,0,0,0,0,0,1
05362736,8,4,4,0,2,2,0,0,0
05363415,5,3,2,0,0,0,0,0,0
05366034,6,2,4,0,1,1,0,0,0
05366077,26,8,18,0,1,1,0,1,1
05366115,6,4,2,0,1,1,0,0,1
05366164,5,0,5,0,0,0,0,0,1
05369193,14,8,6,0,0,0,0,0,1
02503062,15,4,11,0,2,1,1,2,1
02503153,10,0,10,0,0,0,0,0,1
02504043,22,4,18,0,4,4,0,0,1
02504173,43,5,38,0,2,1,1,2,1
02504868,37,3,34,0,1,1,0,1,1
02506366,8,3,5,0,1,1,0,1,1
02508698,17,2,15,0,1,1,0,1,1
02508811,10,3,7,0,1,1,0,1,0
02511824,7,3,4,0,2,2,0,0,0
02514554,13,3,10,0,0,0,0,0,0
02515504,20,4,16,0,0,0,0,0,0
02515820,45,10,35,0,0,0,0,0,1
02518717,23,3,20,0,1,1,0,1,1
02518720,31,5,26,0,1,1,0,1,1
02518749,11,0,11,0,0,0,0,0,1
02519552,67,1,66,0,1,1,0,1,1
02522939,18,4,14,0,1,1,0,1,1
02524157,28,0,28,0,0,0,0,0,1
02524573,21,2,19,0,1,1,0,1,1
02525001,15,1,14,0,1,1,0,1,1
02525240,13,5,8,0,1,1,0,0,1
02525368,26,4,22,0,1,1,0,1,0
02526194,13,2,11,0,0,0,0,0,0
02526751,25,0,25,0,0,0,0,0,1
02528538,32,5,27,0,1,1,0,1,1
02531054,32,4,28,0,1,1,0,1,1
02531268,30,4,26,0,0,0,0,0,0
02532789,24,0,24,0,0,0,0,0,1
02534049,6,5,1,0,0,0,0,0,0
02535093,27,5,22,0,1,1,0,1,1
02535199,67,12,55,0,0,0,0,0,1
02538908,122,13,109,0,0,0,0,0,1
02539543,34,13,21,0,1,1,0,0,0
02539817,7,3,4,0,1,1,0,0,0
02541231,3,1,2,0,2,2,0,0,1
02542925,5,3,2,0,2,2,0,0,1
02543818,21,4,17,0,1,1,0,1,1
02544103,20,5,15,0,3,1,2,3,1
02544334,27,0,27,0,0,0,0,0,1
02547379,15,2,13,0,0,0,0,0,0
02547380,10,2,8,0,0,0,0,0,0
02547384,16,2,14,0,0,0,0,0,0
02547387,12,2,10,0,0,0,0,0,0
02547573,24,0,24,0,0,0,0,0,1
02548079,36,8,28,0,1,1,0,1,1
02549040,23,0,23,0,0,0,0,0,1
02549212,25,5,20,0,1,1,0,1,1
02549484,36,5,31,0,0,0,0,0,1
02550739,11,5,6,0,0,0,0,0,1
02552767,35,5,30,0,1,1,0,1,1
02553780,45,4,41,0,2,2,0,2,1
02554241,33,2,31,0,1,1,0,1,1
02554243,29,0,29,0,0,0,0,0,1
02554729,6,3,3,0,2,2,0,0,1
02554733,37,0,37,0,1,1,0,1,1
02555621,10,3,7,0,1,1,0,1,1
02556517,13,2,11,0,0,0,0,0,1
02557203,28,9,19,0,1,1,0,0,0
02557363,50,3,47,0,3,1,2,3,1
02557730,77,11,66,0,0,0,0,0,1
02558883,28,4,24,0,2,2,0,2,1
02559004,21,5,16,0,0,0,0,0,0
02559097,7,4,3,0,1,1,0,1,1
02559861,19,3,16,0,1,1,0,1,0
02560460,14,8,6,0,1,1,0,0,0
02560679,25,5,20,0,2,1,1,1,1
02560737,2,1,1,0,0,0,0,0,1
02561045,9,2,7,0,1,1,0,0,0
02562504,26,0,26,0,0,0,0,0,1
02562550,7,2,5,0,1,1,0,0,0
02565390,29,5,24,0,1,1,0,1,1
02566317,28,0,28,0,1,1,0,1,1
02566762,17,4,13,0,5,1,4,1,1
02568564,37,8,29,0,0,0,0,0,0
02571606,14,2,12,0,0,0,0,0,1
02571923,17,1,16,0,1,1,0,1,1
02571967,7,2,5,0,1,1,0,1,0
02572345,23,2,21,0,1,1,0,1,1
02572439,9,3,6,0,0,0,0,0,0
02576495,59,6,53,0,10,6,4,0,0
02576548,5,3,2,0,1,1,0,0,1
02576833,25,6,19,0,0,0,0,0,0
02578528,16,1,15,0,4,2,2,1,1
02579305,29,0,29,0,0,0,0,0,1
02579308,33,4,29,0,1,1,0,1,1
02579637,19,0,19,0,0,0,0,0,1
02580953,65,9,56,0,0,0,0,0,0
02581633,15,5,10,0,1,1,0,0,1
02582323,29,0,29,0,1,1,0,1,1
02582818,25,5,20,0,1,1,0,1,1
02582859,19,0,19,0,1,1,0,1,1
02585114,7,2,5,0,1,1,0,0,0
02587294,13,0,13,0,0,0,0,0,1
02590676,14,3,11,0,1,1,0,0,1
02591474,206,20,186,0,24,20,4,0,1
02592715,26,0,26,0,1,1,0,1,1
02592742,0,0,0,0,0,0,0,0,1
02594188,25,3,22,0,1,1,0,1,1
02595189,45,3,42,0,0,0,0,0,1
02597050,41,6,35,0,2,2,0,2,1
02598317,11,0,11,0,0,0,0,0,0
02598772,78,0,78,0,0,0,0,0,1
02600483,50,4,46,0,1,1,0,1,1
02600590,80,7,73,0,1,1,0,0,1
02601741,28,7,21,0,0,0,0,0,1
02601874,11,4,7,0,1,1,0,1,1
02602523,66,0,66,0,1,1,0,0,1
02604188,20,0,20,0,0,0,0,0,1
02604256,12,0,12,0,1,1,0,0,1
02605209,12,4,8,0,1,1,0,1,1
02606691,12,3,9,0,0,0,0,0,1
02608585,11,3,8,0,2,2,0,0,1
02608610,19,2,17,0,1,1,0,0,1
02608858,5,3,2,0,1,1,0,0,0
02609100,52,9,43,0,1,1,0,1,1
02609486,32,0,32,0,0,0,0,0,1
02610689,17,2,15,0,1,1,0,1,1
02611343,26,0,26,0,0,0,0,0,1
02612286,26,2,24,0,2,1,1,2,1
02613042,13,3,10,0,1,1,0,1,1
02613862,28,6,22,0,0,0,0,0,1
02615001,16,7,9,0,1,1,0,0,1
02618338,21,0,21,0,0,0,0,0,1
02618412,28,2,26,0,0,0,0,0,1
02618618,18,2,16,0,0,0,0,0,1
02619094,28,0,28,0,1,1,0,1,1
02622660,89,14,75,0,1,1,0,0,0
02623799,32,6,26,0,1,1,0,0,1
02624904,6,5,1,0,1,1,0,0,1
02625753,14,1,13,0,2,1,1,0,1
02626128,32,9,23,0,0,0,0,0,1
02627434,7,0,7,0,0,0,0,0,1
02628803,20,5,15,0,0,0,0,0,1
02628835,12,3,9,0,3,3,0,0,0
02629347,160,15,145,0,2,0,2,0,1
02630261,13,0,13,0,0,0,0,0,1
02630556,8,2,6,0,1,1,0,1,1
02631386,45,6,39,0,1,0,1,1,1
02632984,19,3,16,0,0,0,0,0,1
02633245,24,3,21,0,0,0,0,0,0
02633594,21,7,14,0,0,0,0,0,0
02635107,27,5,22,0,1,1,0,1,1
02635684,17,1,16,0,4,2,2,1,1
02636560,13,7,6,0,1,1,0,1,1
02636705,31,7,24,0,0,0,0,0,0
02636842,30,3,27,0,1,1,0,1,1
02638677,40,4,36,0,1,1,0,1,1
02639466,16,3,13,0,1,1,0,1,1
02640211,8,1,7,0,1,1,0,0,0
02641475,25,0,25,0,0,0,0,0,1
02641804,10,0,10,0,0,0,0,0,1
02642331,44,5,39,0,0,0,0,0,1
02642738,29,2,27,0,1,1,0,1,1
02644237,6,3,3,0,0,0,0,0,0
02644430,144,0,144,0,1,1,0,1,1
02645285,27,10,17,0,1,1,0,0,0
02645493,1,0,1,0,0,0,0,0,1
02645931,22,5,17,0,0,0,0,0,1
02646325,14,0,14,0,0,0,0,0,1
02646511,51,3,48,0,1,1,0,1,1
02649419,32,0,32,0,0,0,0,0,1
02649883,9,2,7,0,1,1,0,0,1
02652253,59,6,53,0,1,1,0,1,1
02652843,20,0,20,0,1,1,0,1,1
02653890,16,2,14,0,1,1,0,0,1
02654938,7,2,5,0,1,1,0,1,0
02655110,59,11,48,0,0,0,0,0,1
02656690,20,0,20,0,0,0,0,0,1
02658043,16,0,16,0,0,0,0,0,1
02658067,21,5,16,0,1,1,0,1,1
02660001,6,4,2,0,1,1,0,0,1
02660403,46,10,36,0,2,2,0,2,0
02660615,31,4,27,0,1,1,0,1,1
02660917,17,3,14,0,3,1,2,3,1
02661356,9,5,4,0,0,0,0,0,0
02661832,12,3,9,0,1,1,0,1,1
02661969,31,5,26,0,1,1,0,1,1
02663027,12,5,7,1,1,1,0,0,1
02665899,21,3,18,0,1,1,0,1,1
02665997,14,2,12,0,2,2,0,0,0
02666793,65,4,61,0,2,1,1,2,1
02666957,21,3,18,0,1,1,0,1,1
02667206,25,5,20,0,1,1,0,1,0
02669437,36,3,33,0,1,1,0,1,1
02669673,18,0,18,0,0,0,0,0,1
02669716,14,3,11,0,0,0,0,0,1
02670270,10,4,6,0,1,1,0,1,1
02670273,14,8,6,0,2,2,0,0,1
02670290,9,4,5,0,1,1,0,1,1
02670582,61,5,56,0,1,1,0,1,1
02671052,49,5,44,0,1,1,0,1,1
02671608,33,10,23,0,1,1,0,0,0
02672334,76,17,59,0,0,0,0,0,1
02672659,30,5,25,0,1,1,0,1,1
02674046,23,3,20,0,1,1,0,0,0
02674177,5,3,2,0,0,0,0,0,0
02674910,33,4,29,0,0,0,0,0,1
02675115,20,2,18,0,1,1,0,1,1
02675952,53,8,45,0,1,1,0,1,1
02677166,5,0,5,0,2,2,0,0,1
02677871,9,0,9,0,0,0,0,0,0
02678394,22,4,18,0,2,1,1,2,0
02678465,30,3,27,0,2,1,1,2,1
02678467,23,4,19,0,1,1,0,1,1
02678829,17,0,17,0,1,1,0,1,1
02679053,5,1,4,0,1,1,0,0,1
02679236,8,3,5,0,0,0,0,0,0
02679478,20,3,17,0,2,2,0,2,1
02681072,32,4,28,0,0,0,0,0,1
02682464,20,2,18,0,1,1,0,1,1
02682768,32,5,27,0,1,1,0,1,1
02683331,13,3,10,0,1,1,0,1,1
02684045,9,4,5,0,2,2,0,0,1
02685707,27,3,24,0,1,1,0,1,1
02685888,5,0,5,0,1,1,0,1,1
02686473,19,3,16,0,0,0,0,0,0
02688394,39,1,38,0,2,2,0,1,1
02690319,9,3,6,0,1,1,0,1,1
02692155,10,4,6,0,3,3,0,0,1
02692890,43,0,43,0,1,1,0,1,1
02693051,9,4,5,0,1,1,0,1,0
02693175,11,2,9,0,1,1,0,1,1
02693180,30,0,30,0,0,0,0,0,1
02693396,17,3,14,0,0,0,0,0,1
02694171,44,0,44,0,0,0,0,0,1
02695558,11,4,7,0,1,1,0,1,1
02695836,8,3,5,0,2,2,0,0,0
02695896,11,4,7,0,1,1,0,0,0
02696296,11,4,7,0,1,1,0,0,1
02697232,7,3,4,0,2,2,0,0,0
02697861,13,4,9,0,1,1,0,0,1
02698195,18,2,16,1,1,1,0,1,0
02698321,47,12,35,0,0,0,0,0,1
02698759,41,2,39,0,1,1,0,1,1
02699637,25,5,20,0,1,1,0,1,1
02700613,24,4,20,0,0,0,0,0,0
02702189,9,2,7,0,1,1,0,1,1
02705798,15,4,11,0,1,1,0,0,1
02706370,10,0,10,0,0,0,0,0,1
02706450,15,3,12,0,2,2,0,2,1
02706865,15,2,13,0,0,0,0,0,0
02707328,27,1,26,0,1,1,0,0,1
02707376,14,5,9,0,1,1,0,1,0
02708129,39,0,39,0,0,0,0,0,1
02708693,24,0,24,0,0,0,0,0,1
02708725,11,0,11,0,0,0,0,0,1
02709621,34,5,29,0,1,1,0,1,1
02709932,14,4,10,0,1,1,0,1,1
02710557,12,0,12,0,0,0,0,0,0
02710846,39,6,33,0,1,1,0,1,1
02711000,45,7,38,0,0,0,0,0,1
02711801,10,0,10,0,0,0,0,0,0
02713501,8,0,8,0,0,0,0,0,1
02714146,8,2,6,0,1,1,0,1,1
02714181,47,4,43,0,0,0,0,0,1
02716917,16,4,12,0,2,2,0,0,0
02717127,11,2,9,0,1,1,0,1,1
02719480,42,4,38,0,1,1,0,1,1
02720809,58,4,54,0,1,1,0,1,1
02721009,15,5,10,0,1,1,0,0,0
02721621,43,5,38,0,0,0,0,0,1
02722384,18,3,15,0,0,0,0,0,0
02723173,24,0,24,0,0,0,0,0,1
02723259,21,0,21,0,0,0,0,0,1
02723527,47,0,47,0,0,0,0,0,1
02723534,57,12,45,0,0,0,0,0,1
02724838,14,0,14,0,0,0,0,0,1
02725147,21,0,21,0,0,0,0,0,1
02727262,9,4,5,0,0,0,0,0,0
02727310,5,1,4,0,3,2,1,0,0
02727421,13,2,11,0,1,1,0,1,1
02728849,19,2,17,0,3,3,0,0,0
02728920,21,3,18,0,1,1,0,1,1
02728922,19,3,16,0,1,1,0,1,1
02730503,7,1,6,0,1,1,0,0,1
02730611,133,14,119,0,0,0,0,0,0
02734658,7,0,7,0,0,0,0,0,1
02734927,10,4,6,0,1,1,0,1,0
02735633,91,9,82,0,0,0,0,0,0
02737396,51,7,44,0,1,1,0,1,1
02737974,24,7,17,0,1,1,0,1,1
02739563,35,5,30,0,1,1,0,1,1
03400161,37,6,31,0,0,0,0,0,1
03400238,19,3,16,0,1,1,0,1,1
03400684,20,4,16,0,2,1,1,2,1
03400776,24,4,20,0,0,0,0,0,0
03401010,70,14,56,0,6,4,2,0,1
03402292,5,2,3,0,1,1,0,0,1
03402421,29,5,24,0,3,3,0,0,1
03402928,22,5,17,0,0,0,0,0,0
03403434,8,1,7,0,1,1,0,0,1
03403550,26,0,26,0,0,0,0,0,1
03404304,4,2,2,0,1,1,0,0,1
03404450,56,14,42,0,26,0,26,0,1
03405217,29,4,25,0,1,1,0,1,1
03406335,27,2,25,0,1,1,0,1,1
03406513,22,0,22,0,0,0,0,0,1
03407383,7,2,5,0,1,1,0,1,1
03407991,33,6,27,0,0,0,0,0,1
03408672,4,3,1,0,2,2,0,0,0
03416346,26,5,21,0,1,1,0,0,1
03417162,15,3,12,0,0,0,0,0,0
03417335,5,3,2,0,2,2,0,0,1
03417873,24,3,21,0,1,1,0,1,1
03417875,15,2,13,0,0,0,0,0,1
03418103,10,1,9,0,1,1,0,0,1
03420004,17,6,11,0,1,1,0,1,1
03420143,19,8,11,0,0,0,0,0,0
03422041,7,1,6,0,1,1,0,0,0
03422696,9,4,5,0,1,1,0,0,1
03422948,27,5,22,0,1,1,0,1,0
03424396,5,1,4,0,1,1,0,0,0
03424706,17,3,14,0,1,1,0,0,0
03426365,31,7,24,0,0,0,0,0,1
03426890,4,1,3,0,1,1,0,0,1
03427084,16,3,13,0,1,1,0,1,1
03429380,25,2,23,0,4,1,3,2,1
03429608,26,9,17,0,1,1,0,0,1
03429905,18,5,13,0,2,1,1,1,1
03430288,24,5,19,0,1,1,0,1,1
03430418,27,5,22,0,2,2,0,2,1
03430894,41,0,41,0,0,0,0,0,1
03431945,3,3,0,0,2,2,0,0,0
03432378,16,3,13,0,0,0,0,0,0
03432845,5,3,2,0,1,1,0,0,0
03433043,81,11,70,0,0,0,0,0,0
03433441,14,3,11,0,2,1,1,2,1
03433544,15,3,12,0,1,1,0,1,1
03434029,5,4,1,0,2,2,0,0,0
03435665,6,0,6,0,1,1,0,0,1
03437075,5,1,4,0,3,1,2,1,0
03439041,20,3,17,0,1,1,0,1,1
03441449,7,0,7,0,0,0,0,0,1
03441969,32,0,32,0,1,1,0,1,1
03441997,8,2,6,0,2,2,0,1,0
03442643,48,6,42,0,10,6,4,0,0
03443003,7,2,5,0,1,1,0,0,0
03444656,10,5,5,0,0,0,0,0,1
03446734,10,4,6,0,4,3,1,0,1
03446785,18,0,18,0,0,0,0,0,1
03447836,41,3,38,0,2,2,0,2,1
03447944,6,3,3,0,1,1,0,0,0
03450521,15,0,15,0,2,2,0,2,1
03451803,5,3,2,0,1,1,0,0,0
03452384,8,0,8,0,0,0,0,0,1
03452911,4,1,3,0,2,2,0,0,0
03453392,9,0,9,0,0,0,0,0,1
03455027,51,8,43,0,0,0,0,0,0
03456240,21,4,17,0,0,0,0,0,0
03459102,35,3,32,0,1,1,0,1,1
03459300,42,3,39,0,2,1,1,1,1
03459334,23,3,20,0,1,1,0,1,1
03459919,9,2,7,0,2,2,0,0,0
03460068,7,0,7,0,2,2,0,0,1
03460716,42,8,34,0,0,0,0,0,0
03461277,43,3,40,0,2,1,1,2,1
03461748,24,0,24,0,0,0,0,0,1
03461992,42,3,39,0,1,1,0,1,1
03462121,18,4,14,0,1,1,0,1,1
03462378,16,6,10,0,1,1,0,0,1
03462654,24,4,20,0,1,1,0,1,1
03462673,21,2,19,0,1,1,0,1,1
03463149,8,0,8,0,0,0,0,0,1
03464985,25,0,25,0,0,0,0,0,1
03465066,28,14,14,0,0,0,0,0,0
03466135,16,2,14,0,1,1,0,1,1
03467317,19,0,19,0,0,0,0,0,1
03468774,28,0,28,0,0,0,0,0,1
03469107,14,4,10,0,0,0,0,0,1
03469632,5,1,4,0,1,1,0,0,1
03470398,54,12,42,0,0,0,0,0,1
03470406,12,2,10,0,1,1,0,0,0
03474881,47,2,45,0,1,1,0,1,1
03474959,22,5,17,1,0,0,0,0,1
03475085,25,6,19,0,0,0,0,0,0
03475619,8,4,4,0,1,1,0,0,1
03476115,38,2,36,0,1,1,0,1,1
03476711,19,1,18,0,1,1,0,1,1
03476816,31,11,20,0,0,0,0,0,1
03477664,39,3,36,0,2,1,1,2,1
03478440,7,0,7,0,1,1,0,0,0
03478918,14,0,14,0,0,0,0,0,1
03479072,5,3,2,0,2,2,0,0,0
03479261,13,3,10,0,1,1,0,1,1
03479984,32,4,28,0,1,1,0,1,1
03480520,41,2,39,0,1,1,0,1,1
03481024,11,2,9,0,1,1,0,1,1
03481651,20,0,20,0,0,0,0,0,1
03481703,7,4,3,0,1,1,0,1,1
03481728,4,2,2,0,1,1,0,0,1
03482081,25,4,21,0,1,1,0,1,1
03482322,30,3,27,0,1,1,0,1,1
03482521,17,4,13,0,1,1,0,1,1
03483322,16,4,12,0,5,3,2,0,1
03483402,14,0,14,0,0,0,0,0,1
03484232,14,3,11,0,1,1,0,1,1
03484391,19,2,17,0,1,1,0,1,1
03484622,3,3,0,0,1,1,0,0,0
03485113,15,2,13,0,1,1,0,1,1
03486063,12,3,9,0,2,1,1,2,1
03486806,35,8,27,0,1,1,0,1,1
03486926,26,7,19,0,3,2,1,0,1
03487323,19,0,19,0,0,0,0,0,1
03489572,13,0,13,0,1,1,0,1,1
03489629,28,0,28,0,1,1,0,1,1
03489655,17,6,11,0,0,0,0,0,1
03490333,20,5,15,0,1,1,0,1,1
03490345,4,2,2,0,1,1,0,0,0
03490687,6,2,4,0,1,1,0,0,1
03491141,15,0,15,0,0,0,0,0,1
03491158,8,4,4,0,4,3,1,0,1
03491248,15,0,15,0,0,0,0,0,1
03492505,47,5,42,0,1,1,0,1,1
03492630,20,2,18,0,1,1,0,1,1
03492713,20,0,20,0,0,0,0,0,1
03494165,12,3,9,0,1,1,0,1,1
03494452,18,3,15,0,1,1,0,1,1
03495725,24,0,24,0,0,0,0,0,1
03497127,16,0,16,0,1,1,0,1,1
03498607,28,0,28,0,0,0,0,0,1
03498791,29,4,25,0,0,0,0,0,1
03498959,20,3,17,0,1,1,0,1,1
03500852,17,4,13,0,1,1,0,1,1
03501364,31,7,24,0,0,0,0,0,0
03501510,9,5,4,0,0,0,0,0,0
03501815,14,0,14,0,1,1,0,0,0
03502087,9,2,7,0,2,2,0,0,1
03502693,20,0,20,0,0,0,0,0,1
03502708,23,3,20,0,1,1,0,1,1
03502782,15,2,13,0,1,1,0,0,1
03503415,7,2,5,0,2,1,1,0,1
03504043,25,4,21,0,1,1,0,1,1
03504177,5,0,5,0,3,3,0,1,1
03504214,21,5,16,0,0,0,0,0,1
03504679,10,3,7,0,1,1,0,0,1
03504705,34,3,31,0,1,1,0,1,1
03506579,19,4,15,1,0,0,0,0,1
03506757,9,0,9,0,0,0,0,0,1
03506989,22,0,22,0,1,1,0,1,1
03507468,20,5,15,0,1,1,0,1,1
03508522,16,0,16,0,0,0,0,0,1
03511192,4,2,2,0,1,1,0,0,0
03512598,41,3,38,0,1,1,0,1,1
03512877,24,3,21,0,0,0,0,0,1
03514158,16,0,16,0,0,0,0,0,1
03515427,15,0,15,0,0,0,0,0,1
03517809,7,1,6,0,1,1,0,0,0
03518282,6,4,2,0,1,1,0,0,0
03518746,5,2,3,0,1,1,0,0,1
03521327,23,5,18,0,0,0,0,0,0
03522472,9,1,8,0,1,1,0,0,1
03522889,25,4,21,0,2,1,1,2,1
03523004,15,7,8,0,1,1,0,0,0
03523419,17,0,17,0,0,0,0,0,1
03523583,12,3,9,0,4,1,3,0,1
03523928,12,0,12,0,0,0,0,0,1
03524099,25,3,22,0,0,0,0,0,0
03524532,12,0,12,0,0,0,0,0,1
03524593,26,0,26,0,0,0,0,0,1
03524909,45,4,41,0,1,1,0,1,1
03524915,18,0,18,0,0,0,0,0,1
03524920,32,2,30,0,1,1,0,1,1
03525789,9,3,6,0,2,2,0,0,0
03526821,6,2,4,0,1,1,0,0,0
03527034,23,1,22,0,2,1,1,1,1
03527762,3,2,1,0,1,1,0,0,0
03528387,20,3,17,0,1,1,0,1,1
03529026,24,2,22,0,1,1,0,1,1
03530244,8,0,8,0,0,0,0,0,1
03530632,5,2,3,0,2,2,0,0,1
03532841,18,5,13,0,1,1,0,1,1
03533536,14,4,10,0,1,1,0,0,0
03533639,27,0,27,0,0,0,0,0,1
03533651,17,0,17,0,0,0,0,0,1
03533990,6,1,5,0,1,1,0,0,1
03534827,27,4,23,0,1,1,0,1,1
03534972,10,3,7,0,1,1,0,1,1
03535168,37,11,26,0,1,1,0,0,0
03535423,13,3,10,0,0,0,0,0,1
03535585,21,3,18,0,1,1,0,1,1
03536062,15,3,12,0,1,1,0,1,1
03536595,30,0,30,0,0,0,0,0,1
03536672,8,4,4,0,1,1,0,0,0
03538785,50,3,47,0,1,1,0,1,1
03539284,6,3,3,0,1,1,0,0,1
03539298,4,2,2,0,2,2,0,0,1
03539413,53,5,48,0,0,0,0,0,1
03540104,12,2,10,0,1,1,0,0,1
03540118,7,0,7,0,2,2,0,0,1
03540680,42,7,35,0,2,2,0,2,1
03541335,8,2,6,0,2,1,1,2,1
03541400,5,2,3,0,1,1,0,1,1
03542871,36,4,32,0,1,1,0,1,1
03543140,6,0,6,0,0,0,0,0,1
03543772,11,0,11,0,0,0,0,0,1
03544774,11,4,7,0,5,3,2,0,0
03545600,22,0,22,0,1,1,0,1,1
03545604,59,10,49,0,1,1,0,1,1
03545685,11,1,10,0,1,1,0,1,1
03545908,24,3,21,0,0,0,0,0,1
03546920,20,3,17,0,1,1,0,1,1
03548212,17,0,17,0,0,0,0,0,1
03548215,15,5,10,0,1,1,0,1,1
03548262,17,0,17,0,0,0,0,0,1
03548572,41,5,36,0,1,1,0,1,1
03550280,61,8,53,0,0,0,0,0,0
03551945,13,2,11,0,1,1,0,1,1
03552198,18,4,14,0,1,1,0,1,1
03552572,5,2,3,0,2,2,0,0,0
03553609,0,0,0,0,0,0,0,0,1
03553625,19,0,19,0,0,0,0,0,1
03554200,5,2,3,0,1,1,0,0,0
03554364,4,2,2,0,1,1,0,0,0
03554368,13,0,13,0,1,1,0,1,1
03554422,20,9,11,0,0,0,0,0,0
03556978,8,2,6,0,2,2,0,0,1
03557633,23,1,22,0,1,1,0,1,1
03557956,6,3,3,0,2,2,0,0,1
03558169,18,4,14,0,1,1,0,1,1
03558409,17,0,17,0,1,1,0,1,1
03558882,22,4,18,0,1,1,0,1,1
03561304,32,1,31,0,1,1,0,1,1
03561328,32,1,31,0,1,1,0,1,1
03561900,24,0,24,0,0,0,0,0,1
03562342,16,4,12,0,1,1,0,1,1
03562938,14,3,11,0,2,2,0,0,0
03562965,13,0,13,0,0,0,0,0,0
03563870,15,3,12,0,1,1,0,1,1
03564134,10,3,7,0,3,1,2,0,1
03564867,23,9,14,0,0,0,0,0,0
03565249,12,3,9,0,1,1,0,1,1
03565539,6,1,5,0,4,2,2,1,0
03566048,15,4,11,0,0,0,0,0,0
03566236,9,3,6,0,2,2,0,0,1
03567041,24,0,24,0,0,0,0,0,1
03567943,9,3,6,0,4,1,3,1,0
03568680,28,5,23,0,1,1,0,1,1
03568684,25,5,20,0,1,1,0,1,1
03568686,40,5,35,0,1,1,0,1,1
03569213,7,2,5,0,1,1,0,1,0
03569518,5,1,4,0,2,2,0,0,1
03570520,6,3,3,0,1,1,0,0,1
03571769,9,1,8,0,1,1,0,0,1
03572487,15,0,15,0,0,0,0,0,1
03572968,4,3,1,0,1,1,0,0,0
03574664,16,0,16,0,0,0,0,0,1
03574707,15,0,15,0,4,4,0,0,1
03574824,17,0,17,0,2,2,0,0,1
03574834,15,0,15,0,0,0,0,0,1
03574841,26,10,16,0,0,0,0,0,1
03574866,12,3,9,0,1,1,0,1,0
03575989,6,1,5,0,1,1,0,1,1
03576057,22,5,17,0,1,1,0,1,1
03576579,92,14,78,0,0,0,0,0,1
03577168,38,3,35,0,2,1,1,2,1
03577404,10,0,10,0,0,0,0,0,1
03578294,22,2,20,0,1,1,0,1,1
03578810,13,2,11,0,1,1,0,0,1
03579363,23,3,20,0,1,1,0,1,1
03579928,7,3,4,0,1,1,0,0,1
03580755,4,0,4,0,0,0,0,0,1
03581541,37,7,30,0,0,0,0,0,1
03581962,11,4,7,0,1,1,0,0,0
03582571,13,3,10,0,0,0,0,0,0
03584059,4,3,1,0,1,1,0,0,0
03584938,5,3,2,0,2,2,0,0,1
03584961,7,5,2,0,2,2,0,0,1
03585779,6,2,4,0,1,1,0,1,1
03586503,16,4,12,1,0,0,0,0,1
03586877,7,3,4,0,1,1,0,0,1
03587396,17,0,17,0,0,0,0,0,1
03587572,6,0,6,0,0,0,0,0,1
03587584,7,1,6,0,1,1,0,0,1
03587592,9,2,7,0,1,1,0,0,0
03588221,30,5,25,0,1,1,0,1,1
03588915,14,3,11,0,1,1,0,1,1
03590343,6,0,6,0,1,1,0,1,1
03590460,6,0,6,0,1,1,0,1,1
03591559,50,4,46,0,1,1,0,1,1
03591572,26,4,22,0,2,1,1,2,1
03591675,21,0,21,0,0,0,0,0,1
03591684,16,0,16,0,0,0,0,0,1
03592324,10,2,8,0,1,1,0,1,1
03592326,9,2,7,0,1,1,0,1,1
03592722,11,4,7,0,0,0,0,0,0
03592960,15,0,15,0,0,0,0,0,1
03593060,15,0,15,0,0,0,0,0,1
03593074,10,3,7,0,1,1,0,1,1
03593082,10,3,7,0,1,1,0,1,1
03593238,24,4,20,0,1,1,0,1,1
03593272,8,2,6,0,1,1,0,1,0
03593461,5,1,4,0,0,0,0,0,0
03595352,17,4,13,0,1,1,0,1,1
03596837,17,0,17,0,0,0,0,0,1
03597184,57,4,53,0,1,1,0,1,1
03599550,4,0,4,0,0,0,0,0,1
03601069,25,1,24,0,1,1,0,0,0
03603261,12,3,9,0,1,1,0,1,1
03603264,12,3,9,0,1,1,0,1,1
03603878,8,1,7,0,1,1,0,1,0
03604110,22,3,19,0,3,2,1,3,0
03604601,5,1,4,0,4,2,2,0,1
03605059,46,8,38,0,2,2,0,2,1
03605247,13,2,11,0,1,1,0,1,1
03605293,13,2,11,0,1,1,0,1,1
03605570,9,0,9,0,0,0,0,0,0
03605698,9,2,7,0,4,1,3,1,1
03607077,6,4,2,0,0,0,0,0,1
03607835,12,4,8,0,2,1,1,1,1
03607854,5,3,2,0,1,1,0,0,0
03608496,49,17,32,0,0,0,0,0,1
03608555,8,0,8,0,1,1,0,0,1
03608886,17,0,17,0,0,0,0,0,1
03609558,16,0,16,0,0,0,0,0,1
03609582,15,2,13,0,1,1,0,1,1
03610185,8,0,8,0,0,0,0,0,1
03611802,9,3,6,0,2,2,0,0,1
03612017,18,0,18,0,0,0,0,0,1
03613935,32,4,28,0,3,1,2,3,1
03615141,28,6,22,0,0,0,0,0,0
03616635,9,3,6,0,1,1,0,1,1
03618736,40,9,31,0,0,0,0,0,1
03619054,11,2,9,0,1,1,0,0,1
03619811,10,5,5,1,2,1,1,0,1
03619867,7,3,4,0,2,1,1,2,1
03619869,10,5,5,1,1,1,0,1,1
03620981,5,2,3,0,1,1,0,0,1
03621443,12,3,9,0,1,1,0,1,0
03621552,5,2,3,0,3,3,0,0,0
03622770,25,2,23,0,1,1,0,1,1
03623292,6,2,4,0,1,1,0,0,1
03623704,5,3,2,0,2,2,0,2,1
03624029,9,3,6,0,1,1,0,1,1
03625138,41,6,35,0,1,1,0,1,1
03625145,33,4,29,0,1,1,0,1,1
03625281,9,8,1,0,3,3,0,0,1
03625708,5,5,0,0,3,3,0,0,1
03626135,28,3,25,0,1,1,0,1,1
03627264,9,2,7,0,2,2,0,0,1
03627794,16,4,12,0,0,0,0,0,0
03628231,51,10,41,0,0,0,0,0,0
03629046,6,1,5,0,2,2,0,0,1
03629729,7,2,5,0,2,2,0,0,1
03631109,6,2,4,0,1,1,0,0,1
03632315,7,3,4,0,1,1,0,0,1
03635172,5,3,2,0,2,2,0,0,1
03635563,7,1,6,0,1,1,0,0,1
03635787,5,2,3,0,1,1,0,0,0
03635879,14,0,14,2,1,1,0,0,1
03636028,9,0,9,0,1,1,0,1,1
03636230,17,4,13,0,0,0,0,0,1
03636406,6,1,5,0,0,0,0,0,1
03641363,18,2,16,0,0,0,0,0,1
03642312,9,0,9,0,0,0,0,0,1
03643205,24,3,21,0,0,0,0,0,1
03643599,20,6,14,0,0,0,0,0,0
03643620,12,4,8,0,2,2,0,0,1
03646457,42,11,31,0,1,1,0,0,1
03647309,22,0,22,0,0,0,0,0,1
03647915,14,0,14,0,0,0,0,0,1
03648926,12,0,12,0,0,0,0,0,1
03649149,10,4,6,0,4,1,3,2,0
03650083,5,2,3,0,1,1,0,0,0
03650333,2,2,0,0,1,1,0,0,0
03650739,7,0,7,0,2,2,0,0,1
03651122,15,5,10,0,0,0,0,0,1
03652059,31,2,29,0,1,1,0,1,1
03655231,23,2,21,0,1,1,0,1,1
03655815,15,2,13,0,1,1,0,1,1
03657811,5,1,4,0,1,1,0,0,0
03659692,13,5,8,0,1,1,0,1,1
03659957,6,2,4,0,2,2,0,0,0
03660475,6,3,3,0,0,0,0,0,0
03663818,3,3,0,0,2,2,0,0,0
03666198,7,0,7,0,1,1,0,0,1
03667015,6,3,3,0,1,1,0,1,1
03669086,10,2,8,0,1,1,0,0,1
03669676,19,0,19,0,1,0,1,0,0
03669744,7,2,5,0,1,1,0,1,1
03669957,9,3,6,0,0,0,0,0,0
03671093,27,6,21,0,1,1,0,1,1
03671207,13,0,13,0,0,0,0,0,1
03671215,7,3,4,0,2,2,0,0,1
03671286,7,0,7,0,1,1,0,0,1
03671447,10,4,6,0,1,1,0,0,1
03673223,8,5,3,0,1,1,0,0,0
03674534,6,4,2,0,2,2,0,0,0
03674827,27,5,22,0,2,2,0,2,1
03674842,23,4,19,0,1,1,0,1,1
03674960,6,0,6,0,0,0,0,0,1
03675048,5,3,2,0,2,2,0,0,0
03675755,10,0,10,0,0,0,0,0,1
03676533,9,0,9,0,0,0,0,0,1
03676780,20,0,20,0,0,0,0,0,1
03677048,9,3,6,0,1,1,0,1,1
03678507,48,7,41,0,1,1,0,1,1
03679085,11,3,8,0,1,1,0,1,1
03679270,6,2,4,0,1,1,0,0,0
03679758,7,4,3,0,4,4,0,1,1
03679828,53,4,49,0,1,1,0,1,1
06700653,17,11,6,0,2,2,0,0,0
06701335,15,4,11,0,1,1,0,0,0
06701645,2,0,2,0,0,0,0,0,1
06703755,1,1,0,0,1,1,0,0,0
06704560,7,0,7,0,1,1,0,0,1
06710925,23,10,13,0,0,0,0,0,1
06711102,3,2,1,0,1,1,0,0,0
06711225,14,3,11,0,4,0,4,0,1
06711749,6,2,4,0,3,1,2,3,0
06711930,16,6,10,0,1,1,0,1,1
06713506,2,0,2,0,0,0,0,0,1
06720456,4,2,2,0,1,1,0,0,0
06722025,12,2,10,0,1,1,0,1,1
06722290,8,1,7,0,1,1,0,0,0
06723644,11,4,7,0,1,1,0,1,1
06723882,1,1,0,0,1,1,0,0,0
06724838,8,3,5,0,0,0,0,0,1
06725947,5,0,5,0,0,0,0,0,0
06726943,4,1,3,0,2,2,0,1,1
06727738,13,4,9,0,2,2,0,2,1
06730545,21,2,19,0,1,1,0,1,1
06731252,5,1,4,0,1,1,0,0,0
06731528,30,10,20,0,1,1,0,1,0
06731552,5,1,4,0,1,1,0,0,0
06732032,16,7,9,0,0,0,0,0,0
06733688,2,2,0,0,1,1,0,0,0
06734354,24,10,14,0,0,0,0,0,1
06735135,1,1,0,0,1,1,0,1,1
06735652,5,5,0,0,1,1,0,1,0
06735944,1,1,0,0,1,1,0,0,0
06736181,14,4,10,0,0,0,0,0,0
06736821,14,7,7,0,1,1,0,1,1
06737175,4,0,4,0,1,1,0,0,0
06739020,4,3,1,0,1,1,0,1,1
06739147,5,2,3,0,1,1,0,0,1
06739687,3,3,0,0,2,2,0,0,0
06739904,3,2,1,0,1,1,0,0,1
06741705,14,8,6,0,4,1,3,0,0
06744379,19,11,8,0,0,0,0,0,0
06744955,4,1,3,0,0,0,0,0,1
06746840,3,3,0,0,1,1,0,0,0
06748266,30,11,19,0,0,0,0,0,0
06748582,2,2,0,0,1,1,0,0,0
06751266,4,0,4,0,0,0,0,0,1
06752206,2,0,2,0,0,0,0,0,1
06752784,1,1,0,0,1,1,0,0,0
06753891,12,4,8,0,1,1,0,0,0
06757727,5,0,5,0,0,0,0,0,1
06758203,24,8,16,0,1,1,0,0,0
06760790,5,0,5,0,1,1,0,1,1
06761513,4,1,3,0,1,1,0,1,1
06761676,4,0,4,0,0,0,0,0,1
06763298,1,1,0,0,1,1,0,0,0
06764256,5,0,5,0,1,1,0,1,1
06764335,33,12,21,0,1,0,1,1,1
06765090,2,1,1,0,2,1,1,0,0
06765575,11,5,6,0,1,1,0,0,0
06765625,7,0,7,0,0,0,0,0,1
06766416,6,2,4,0,2,2,0,0,0
06766839,6,0,6,0,0,0,0,0,1
06766852,6,0,6,0,0,0,0,0,1
06766859,6,0,6,0,0,0,0,0,1
06766882,6,0,6,0,0,0,0,0,1
06766885,6,0,6,0,0,0,0,0,1
06768742,6,2,4,0,1,1,0,1,1
06769237,7,4,3,0,0,0,0,0,1
06769239,7,2,5,0,0,0,0,0,1
06769448,2,1,1,0,1,1,0,0,0
06769484,4,2,2,0,0,0,0,0,0
06770500,3,0,3,0,0,0,0,0,0
06771358,1,1,0,0,1,1,0,1,0
06771999,6,2,4,0,1,1,0,1,1
06772190,5,3,2,0,1,1,0,0,1
06772474,16,8,8,0,2,1,1,1,1
06772821,2,2,0,0,2,2,0,0,0
06773501,7,3,4,0,2,2,0,2,1
06773610,24,3,21,0,1,1,0,1,1
06773809,4,3,1,0,1,1,0,1,1
06773901,3,3,0,0,2,2,0,0,0
06774011,5,3,2,0,1,1,0,0,0
06775727,15,4,11,0,1,1,0,1,1
06776868,18,7,11,0,0,0,0,0,0
06777542,2,2,0,0,1,1,0,0,0
06777559,7,5,2,0,2,2,0,0,1
06777602,7,5,2,0,2,2,0,0,1
06777793,9,4,5,0,2,2,0,0,1
06779873,20,6,14,0,0,0,0,0,0
06781654,5,3,2,0,2,2,0,0,0
06784998,6,0,6,0,0,0,0,0,0
06785641,6,2,4,0,2,2,0,0,0
06785724,21,5,16,0,1,1,0,0,0
06786448,23,6,17,0,2,1,1,0,0
06786693,5,2,3,0,1,1,0,0,0
06789187,13,4,9,0,0,0,0,0,1
06789606,17,4,13,0,2,2,0,2,1
06790494,5,1,4,0,0,0,0,0,0
06791684,2,2,0,0,2,2,0,0,0
06792261,2,0,2,0,0,0,0,0,1
06792572,14,4,10,0,0,0,0,0,0
06793041,6,0,6,0,0,0,0,0,1
06793262,9,3,6,0,0,0,0,0,1
06793272,9,3,6,0,0,0,0,0,1
06793290,9,3,6,0,0,0,0,0,1
06793302,9,3,6,0,0,0,0,0,1
06793328,9,3,6,0,0,0,0,0,1
06793345,9,3,6,0,0,0,0,0,1
06793351,9,3,6,0,0,0,0,0,1
06793354,9,3,6,0,0,0,0,0,1
06793355,9,3,6,0,0,0,0,0,1
06793356,9,2,7,0,0,0,0,0,1
06794152,4,2,2,0,1,1,0,0,1
06794157,6,3,3,0,1,1,0,0,1
06794689,22,12,10,0,0,0,0,0,1
06797277,8,2,6,1,0,0,0,0,0
06798131,3,0,3,0,0,0,0,0,0
06799198,2,1,1,0,1,1,0,0,0
06799889,3,1,2,0,0,0,0,0,0
06800081,3,0,3,0,0,0,0,0,0
06800671,3,0,3,0,0,0,0,0,1
06801079,29,9,20,0,0,0,0,0,0
06801717,10,3,7,0,1,1,0,1,1
06806764,1,1,0,0,1,1,0,0,0
06808473,2,2,0,0,1,1,0,0,0
06808830,7,7,0,0,1,1,0,0,0
06808967,2,0,2,0,1,1,0,0,0
06815492,9,0,9,0,0,0,0,0,1
06817150,4,3,1,0,2,2,0,0,1
06817422,11,4,7,0,2,2,0,2,1
06817960,22,8,14,0,0,0,0,0,0
06819033,7,4,3,0,0,0,0,0,0
06822717,7,5,2,0,0,0,0,0,0
06823239,35,6,29,0,2,1,1,0,0
06825082,5,2,3,0,0,0,0,0,0
06827560,2,1,1,0,1,1,0,0,0
06827644,14,0,14,0,1,1,0,1,1
06828864,10,3,7,0,1,1,0,1,0
06829417,15,2,13,0,1,1,0,1,1
06831578,8,2,6,0,1,1,0,0,1
06832208,13,7,6,0,0,0,0,0,0
06832761,11,0,11,0,0,0,0,0,0
06833014,3,0,3,0,0,0,0,0,0
06833924,2,0,2,0,0,0,0,0,0
06834107,5,1,4,0,1,1,0,0,0
06835708,3,2,1,0,1,1,0,0,0
06836248,3,0,3,1,0,0,0,0,1
06837446,2,2,0,0,2,2,0,0,0
06838965,3,3,0,0,1,1,0,0,0
06841812,3,0,3,0,2,2,0,0,0
06841980,2,1,1,0,1,1,0,0,0
06843338,13,6,7,0,0,0,0,0,0
06845787,18,3,15,0,2,2,0,2,1
06847757,4,2,2,0,1,1,0,0,0
06848849,2,1,1,0,1,1,0,0,0
06849984,5,0,5,0,0,0,0,0,0
06850239,6,2,4,0,2,1,1,0,0
06852095,1,0,1,0,0,0,0,0,0
06852680,2,0,2,0,0,0,0,0,0
06853109,11,4,7,0,1,1,0,1,1
06853328,53,18,35,0,0,0,0,0,1
06854191,11,5,6,0,2,2,0,2,1
06854812,16,0,16,0,0,0,0,0,1
06856568,10,7,3,0,0,0,0,0,0
06858174,4,2,2,0,2,2,0,0,1
06860457,3,0,3,0,0,0,0,0,0
06860795,3,3,0,0,2,2,0,0,0
06861132,6,4,2,0,2,1,1,2,1
06861176,5,3,2,0,3,3,0,0,0
06861273,10,3,7,0,0,0,0,0,0
06862870,14,6,8,0,2,2,0,1,1
06862901,18,4,14,0,2,2,0,2,1
06864430,5,0,5,0,0,0,0,0,1
06864923,16,6,10,0,0,0,0,0,0
06865508,2,1,1,0,2,1,1,0,1
06867458,3,3,0,0,2,2,0,0,0
06868115,4,0,4,0,0,0,0,0,0
06869709,11,4,7,0,1,0,1,1,0
06872984,6,1,5,0,1,1,0,0,0
06873769,4,2,2,0,1,1,0,0,0
06881519,1,1,0,0,1,1,0,0,0
06885174,1,1,0,0,1,1,0,0,0
06885317,4,4,0,0,1,1,0,1,1
06888641,9,4,5,0,0,0,0,0,1
06890382,3,1,2,0,1,1,0,0,0
06890614,15,5,10,0,0,0,0,0,0
06891281,4,2,2,0,1,1,0,0,0
06892458,13,0,13,0,0,0,0,0,0
06892984,4,0,4,0,1,1,0,0,0
06893358,5,1,4,0,1,1,0,0,0
06894946,2,1,1,0,2,1,1,0,0
06896620,2,2,0,0,2,2,0,0,0
06897239,24,9,15,0,0,0,0,0,1
06897603,4,3,1,0,2,2,0,0,0
06897721,1,1,0,0,1,1,0,0,0
06898099,1,1,0,0,1,1,0,0,0
06898879,2,2,0,0,1,1,0,0,0
06899188,2,1,1,0,1,1,0,0,0
06899877,3,3,0,0,2,2,0,0,0
06899920,13,4,9,0,0,0,0,0,0
06900034,3,3,0,0,2,2,0,0,0
06900774,7,5,2,0,0,0,0,0,1
06901014,34,8,26,0,0,0,0,0,0
06901909,15,7,8,0,1,1,0,1,1
06905952,9,7,2,0,3,1,2,1,0
06906160,9,7,2,0,3,1,2,1,0
06907048,14,2,12,0,2,1,1,2,1
06908653,2,0,2,0,0,0,0,0,0
06908856,4,3,1,0,1,1,0,0,1
06909544,3,2,1,0,1,1,0,0,0
06912935,10,3,7,0,0,0,0,0,0
06913103,4,3,1,0,2,2,0,0,0
06914924,2,1,1,0,1,1,0,0,0
06915316,3,2,1,0,2,2,0,0,0
06915475,3,1,2,0,1,1,0,0,0
06915491,5,2,3,0,1,1,0,0,0
06918031,5,2,3,0,0,0,0,0,0
06919023,4,0,4,0,0,0,0,0,1
06919066,2,2,0,0,2,2,0,0,0
06921478,12,4,8,0,2,2,0,2,1
06921652,8,5,3,0,4,0,4,0,0
06921674,7,3,4,0,0,0,0,0,1
06923694,4,0,4,0,0,0,0,0,1
06923809,3,1,2,0,1,1,0,0,0
06923903,3,1,2,0,1,1,0,0,0
06924175,3,0,3,0,0,0,0,0,1
06924317,3,3,0,0,2,2,0,0,0
06927174,14,2,12,0,1,1,0,1,1
06927314,2,0,2,0,0,0,0,0,0
06927732,3,3,0,0,2,2,0,0,0
06928056,14,2,12,0,1,1,0,1,1
06928995,3,0,3,0,0,0,0,0,0
06930025,17,5,12,0,1,1,0,1,0
06930253,5,2,3,0,4,4,0,0,0
06931450,13,4,9,0,0,0,0,0,0
06931764,11,7,4,0,1,1,0,0,0
06933761,5,2,3,0,3,1,2,1,0
06934395,3,0,3,0,0,0,0,0,1
06936145,9,3,6,0,1,1,0,1,1
06938019,1,0,1,0,0,0,0,0,0
06939433,2,2,0,0,2,2,0,0,0
06939918,8,3,5,0,4,4,0,1,0
06940517,3,3,0,0,1,1,0,0,0
06941120,3,1,2,0,1,1,0,0,0
06942787,2,0,2,0,0,0,0,0,1
06943531,17,7,10,0,1,1,0,0,0
06944238,6,2,4,0,1,1,0,0,0
06944461,17,4,13,0,2,2,0,2,1
06945810,11,6,5,0,0,0,0,0,0
06946004,3,1,2,0,2,2,0,0,1
06946189,3,2,1,0,1,1,0,0,0
06949084,2,1,1,0,2,2,0,0,0
06949431,4,0,4,0,0,0,0,0,1
06950880,1,1,0,0,1,1,0,0,0
06951617,3,2,1,0,1,1,0,0,1
06951808,9,0,9,0,1,1,0,1,1
06952266,2,2,0,0,2,2,0,0,1
06953114,13,4,9,0,2,1,1,2,1
06954419,5,2,3,0,1,1,0,0,0
06954762,10,2,8,0,3,1,2,3,0
06955165,10,2,8,0,3,1,2,3,0
06956383,17,4,13,0,2,2,0,2,1
06956588,12,9,3,0,0,0,0,0,0
06957593,16,5,11,0,1,1,0,1,1
06958074,4,0,4,0,1,1,0,0,0
06958589,8,5,3,0,4,4,0,0,0
06958711,4,3,1,0,4,4,0,4,1
06959581,14,3,11,0,1,1,0,1,1
06959725,2,2,0,0,1,1,0,0,0
06959738,4,3,1,0,1,1,0,0,0
04370935,7,4,3,0,1,1,0,0,1
04371091,5,2,3,0,1,1,0,0,1
04371286,5,0,5,0,1,1,0,0,1
04371373,5,3,2,0,1,1,0,0,0
04371548,11,5,6,0,2,1,1,1,1
04371742,7,3,4,0,1,1,0,0,1
04372394,16,0,16,0,0,0,0,0,1
04372752,14,2,12,0,2,2,0,0,0
04372979,27,3,24,0,1,1,0,1,1
04373334,5,3,2,0,2,2,0,0,0
04373361,8,5,3,0,2,2,0,0,0
04373697,17,0,17,0,0,0,0,0,1
04373808,14,3,11,0,1,1,0,1,1
04374635,19,0,19,0,1,1,0,1,1
04374810,20,6,14,0,0,0,0,0,0
04375298,25,0,25,0,0,0,0,0,1
04375649,30,8,22,0,0,0,0,0,0
04375679,37,9,28,0,0,0,0,0,1
04376677,18,0,18,0,0,0,0,0,1
04376946,7,0,7,0,0,0,0,0,0
04378914,14,2,12,0,1,1,0,1,1
04379335,29,6,23,0,1,1,0,1,1
04379803,6,0,6,0,0,0,0,0,1
04380225,14,0,14,0,0,0,0,0,1
04380759,18,4,14,0,0,0,0,0,1
04380814,30,10,20,0,0,0,0,0,0
04381039,3,1,2,0,0,0,0,0,1
04383249,12,3,9,0,1,1,0,1,1
04383256,10,2,8,0,1,1,0,0,1
04383398,12,3,9,0,2,1,1,2,1
04383491,27,10,17,0,0,0,0,0,0
04383577,13,2,11,0,0,0,0,0,1
04385217,11,2,9,0,2,2,0,0,0
04385487,11,5,6,0,3,2,1,0,1
04385497,12,5,7,0,3,3,0,0,1
04385744,18,5,13,0,1,1,0,1,1
04385785,4,2,2,0,1,1,0,0,1
04385945,12,2,10,0,1,1,0,1,1
04386324,3,2,1,0,1,1,0,0,0
04388320,11,0,11,0,0,0,0,0,1
04388436,13,2,11,0,1,1,0,1,1
04388523,7,3,4,0,1,1,0,0,1
04388973,26,4,22,0,2,1,1,2,1
04388992,20,0,20,0,3,3,0,3,1
04389197,7,1,6,0,1,1,0,0,1
04389338,8,0,8,0,1,1,0,0,1
04389465,9,0,9,0,0,0,0,0,0
04390230,4,0,4,0,1,1,0,0,1
04391971,5,3,2,0,2,2,0,0,1
04392494,25,8,17,0,0,0,0,0,0
04393140,5,3,2,0,2,2,0,0,0
04393350,5,3,2,0,2,2,0,0,0
04394122,4,3,1,0,2,2,0,0,0
04394388,6,0,6,0,0,0,0,0,1
04394889,12,0,12,0,0,0,0,0,1
04394890,7,0,7,0,0,0,0,0,1
04395109,23,5,18,0,1,1,0,1,1
04395661,6,2,4,0,1,1,0,0,1
04395696,67,3,64,0,1,1,0,1,0
04396755,10,5,5,0,0,0,0,0,0
04397695,6,0,6,0,0,0,0,0,0
04397696,5,2,3,0,0,0,0,0,1
04398128,5,3,2,0,2,2,0,0,0
04398259,29,2,27,0,3,3,0,0,0
04399460,15,3,12,0,2,0,2,0,0
04400054,10,1,9,0,1,1,0,1,1
04402661,17,0,17,0,0,0,0,0,1
04402687,17,0,17,0,0,0,0,0,1
04403451,10,4,6,0,0,0,0,0,1
04403746,16,6,10,0,1,1,0,1,1
04404178,22,3,19,0,1,1,0,1,1
04404419,11,2,9,0,1,1,0,1,1
04404542,16,4,12,0,1,0,1,1,0
04404869,39,13,26,0,0,0,0,0,0
04405148,12,5,7,0,1,1,0,1,1
04405628,5,0,5,0,0,0,0,0,1
04405692,4,1,3,0,1,1,0,0,0
04405898,5,3,2,0,2,2,0,0,0
04405950,7,0,7,0,0,0,0,0,1
04406576,7,0,7,0,0,0,0,0,1
04409265,4,2,2,0,2,2,0,0,0
04409886,40,11,29,0,0,0,0,0,1
04410204,11,5,6,0,1,1,0,1,1
04410862,5,0,5,0,0,0,0,0,1
04411253,42,11,31,0,0,0,0,0,0
04412405,5,0,5,0,0,0,0,0,1
04413249,2,2,0,0,2,2,0,0,0
04415647,29,4,25,0,1,1,0,1,1
04416132,6,0,6,0,0,0,0,0,1
04416151,5,1,4,0,1,1,0,0,1
04416252,35,7,28,0,1,1,0,1,1
04416359,16,4,12,0,3,2,1,3,1
04416402,10,0,10,0,0,0,0,0,1
04416722,4,3,1,0,4,4,0,0,0
04418528,4,0,4,0,1,1,0,0,0
04419586,9,0,9,0,0,0,0,0,1
04419874,17,5,12,0,0,0,0,0,1
04420002,11,3,8,0,2,1,1,2,1
04420411,11,6,5,0,1,1,0,1,1
04420519,16,10,6,0,1,1,0,0,0
04420684,29,0,29,0,0,0,0,0,1
04421472,18,0,18,0,1,1,0,1,1
04421477,23,0,23,0,0,0,0,0,1
04421656,17,0,17,0,0,0,0,0,1
04422071,15,6,9,0,0,0,0,0,1
04422206,9,4,5,0,4,3,1,0,0
04422287,32,0,32,0,0,0,0,0,1
04422293,22,0,22,0,0,0,0,0,1
04422591,2,2,0,0,1,1,0,0,1
04423445,4,2,2,0,1,1,0,0,1
04423693,5,1,4,0,1,1,0,0,0
04423718,11,3,8,0,1,1,0,1,1
04423967,13,4,9,0,0,0,0,0,1
04424125,11,2,9,0,1,1,0,1,0
04425595,14,3,11,0,1,1,0,1,1
04425892,7,3,4,0,1,1,0,1,1
04426579,5,3,2,0,3,3,0,0,0
04428083,16,3,13,0,1,1,0,1,1
04429098,6,4,2,0,2,2,0,0,0
04429814,42,9,33,0,0,0,0,0,1
04429933,10,5,5,0,1,1,0,0,1
04430818,22,3,19,0,1,1,0,1,1
04430824,21,3,18,0,1,1,0,1,1
04430828,21,3,18,0,1,1,0,1,1
04430846,19,3,16,0,1,1,0,1,1
04430927,19,3,16,0,1,1,0,1,1
04431396,4,0,4,0,1,1,0,0,0
04432581,15,6,9,0,0,0,0,0,0
04434601,12,0,12,0,0,0,0,0,1
04435420,6,2,4,0,3,2,1,0,0
04435505,4,2,2,0,1,1,0,0,1
04435975,25,3,22,0,2,1,1,2,1
04436497,7,1,6,0,1,1,0,0,1
04438082,27,3,24,0,2,1,1,2,1
04438337,7,2,5,0,1,1,0,0,1
04438887,59,14,45,0,0,0,0,0,1
04438973,4,0,4,0,0,0,0,0,1
04439363,6,2,4,0,2,2,0,0,1
04439737,15,4,11,0,1,1,0,1,1
04439855,30,0,30,0,0,0,0,0,1
04439914,7,0,7,0,0,0,0,0,1
04440240,13,1,12,0,0,0,0,0,1
04440622,10,2,8,0,1,1,0,1,1
04440625,7,0,7,0,1,1,0,0,0
04442143,9,2,7,0,1,1,0,1,1
04442665,10,2,8,0,1,1,0,0,1
04442666,10,2,8,0,1,1,0,0,1
04442702,5,0,5,0,0,0,0,0,1
04442969,24,0,24,0,0,0,0,0,1
04443341,7,4,3,0,1,1,0,1,0
04444443,11,0,11,0,1,1,0,1,1
04444664,14,4,10,0,0,0,0,0,0
04444960,4,2,2,0,1,1,0,0,1
04445552,7,3,4,0,1,1,0,0,0
04445562,7,0,7,0,0,0,0,0,1
04446148,5,1,4,0,2,2,0,0,0
04447008,26,2,24,0,1,1,0,1,1
04447594,6,3,3,0,1,1,0,1,0
04448044,6,1,5,0,3,3,0,1,0
04448062,9,3,6,0,2,2,0,0,1
04448391,9,3,6,0,1,1,0,1,1
04448756,7,2,5,0,0,0,0,0,0
04449118,5,2,3,0,2,2,0,0,0
04449208,11,0,11,0,0,0,0,0,1
04449543,20,3,17,0,0,0,0,0,1
04449627,6,0,6,0,1,1,0,0,0
04450226,8,3,5,0,2,1,1,1,0
04450788,16,5,11,0,0,0,0,0,0
04451505,9,2,7,0,1,1,0,1,1
04452442,4,1,3,0,1,1,0,0,0
04452808,30,4,26,0,1,1,0,1,1
04453584,8,3,5,0,1,0,1,0,0
04455203,6,5,1,0,1,1,0,0,0
04456380,4,2,2,0,1,1,0,0,0
04456529,4,2,2,0,1,1,0,0,1
04457280,5,2,3,0,1,1,0,0,1
04457463,5,3,2,0,1,1,0,0,1
04457859,6,2,4,0,1,1,0,0,1
04458459,9,3,6,0,2,1,1,0,1
04459443,21,3,18,0,1,1,0,1,1
04459492,4,2,2,0,1,1,0,0,1
04460625,15,0,15,0,1,1,0,1,1
04460630,5,3,2,0,2,2,0,0,1
04461275,14,5,9,0,1,1,0,1,1
04461359,7,3,4,0,1,1,0,0,1
04462587,12,3,9,0,2,2,0,0,0
04463308,5,3,2,0,2,2,0,0,1
04463786,6,2,4,0,2,2,0,0,1
04464232,8,1,7,0,1,1,0,0,1
04464547,5,3,2,0,1,1,0,0,0
04464549,6,2,4,0,1,1,0,1,1
04465503,16,2,14,0,1,1,0,1,1
04466571,26,6,20,0,1,1,0,0,1
04466911,24,3,21,0,3,3,0,3,1
04469304,8,2,6,0,0,0,0,0,1
04469487,6,3,3,0,1,1,0,0,0
04470064,57,11,46,0,0,0,0,0,0
04470699,7,0,7,0,1,1,0,0,1
04471316,21,8,13,0,0,0,0,0,0
04471593,19,1,18,0,0,0,0,0,1
04471594,16,4,12,0,1,1,0,0,1
04471823,6,0,6,0,0,0,0,0,1
04471825,17,0,17,0,0,0,0,0,1
04471826,12,3,9,0,1,1,0,1,1
04472361,3,1,2,0,1,1,0,0,1
04472442,16,2,14,0,1,1,0,1,1
04472446,18,0,18,0,1,1,0,1,1
04473379,8,4,4,0,2,2,0,0,1
04473845,5,0,5,0,1,1,0,0,0
04475393,5,3,2,0,1,1,0,0,0
04476540,17,3,14,0,1,1,0,1,1
04476558,41,14,27,0,3,2,1,0,1
04476633,6,2,4,0,1,1,0,0,0
04476843,10,1,9,0,1,1,0,1,1
04477641,10,3,7,0,2,2,0,0,1
04477725,7,3,4,0,1,1,0,0,0
04478333,5,3,2,0,2,2,0,0,0
04478534,12,0,12,0,0,0,0,0,1
04478844,19,3,16,0,0,0,0,0,1
04479600,5,3,2,0,4,4,0,0,0
04479652,6,3,3,0,1,1,0,0,0
04480074,5,3,2,0,2,2,0,0,0
04480485,42,5,37,0,6,4,2,0,0
04480729,5,3,2,0,2,2,0,0,0
04480862,4,2,2,0,1,1,0,0,0
04480920,4,0,4,0,1,1,0,0,0
04481317,12,0,12,0,0,0,0,0,1
04481334,11,0,11,0,0,0,0,0,1
04481547,2,2,0,0,0,0,0,0,1
04482195,5,0,5,0,0,0,0,0,1
04482330,5,3,2,0,0,0,0,0,0
04483634,5,2,3,0,1,1,0,0,1
04483755,35,14,21,0,0,0,0,0,0
04484761,6,3,3,0,2,2,0,0,0
04485592,15,0,15,0,0,0,0,0,1
04485855,4,2,2,0,1,1,0,0,0
04485945,24,7,17,0,11,7,4,0,0
04488255,10,4,6,0,1,1,0,0,1
04489789,7,0,7,0,0,0,0,0,1
04489884,6,2,4,0,1,1,0,0,0
04490405,11,0,11,0,0,0,0,0,0
04491006,9,2,7,0,2,2,0,0,1
04491125,15,4,11,0,2,2,0,0,1
04491145,16,4,12,0,2,2,0,0,1
04491170,15,4,11,0,2,2,0,0,1
04491178,16,4,12,0,2,2,0,0,1
04491501,5,2,3,0,2,2,0,0,0
04491717,6,0,6,0,2,2,0,0,1
04491869,10,4,6,0,1,1,0,1,1
04492893,5,2,3,0,1,1,0,1,0
04493899,4,2,2,0,1,1,0,0,0
01580284,68,4,64,0,1,1,0,1,1
01581770,41,3,38,0,0,0,0,0,0
01581935,56,5,51,0,1,1,0,1,1
01583814,25,4,21,0,1,1,0,1,1
01584188,31,4,27,0,1,1,0,1,1
01584796,19,3,16,0,1,1,0,1,1
01585283,62,0,62,0,0,0,0,0,1
01587907,18,7,11,0,0,0,0,0,1
01587922,75,7,68,0,3,2,1,0,1
01588286,41,6,35,0,1,1,0,1,1
01588900,21,4,17,0,2,1,1,2,1
01589824,18,2,16,0,1,1,0,1,1
01591100,40,5,35,0,1,1,0,1,1
01592083,20,2,18,0,1,1,0,1,1
01593332,4,4,0,0,2,2,0,0,0
01593648,20,7,13,0,1,1,0,0,1
01593981,25,2,23,0,1,1,0,1,1
01595106,13,4,9,0,0,0,0,0,0
01597315,21,3,18,0,0,0,0,0,1
01597647,12,0,12,0,0,0,0,0,1
01597931,43,4,39,0,1,1,0,1,1
01597972,12,4,8,0,1,1,0,1,0
01600480,8,2,6,0,2,2,0,0,0
01601181,16,3,13,0,1,1,0,1,1
01601297,20,3,17,0,1,1,0,1,1
01601691,22,2,20,0,1,1,0,1,1
01602662,32,6,26,0,0,0,0,0,1
01603650,0,0,0,0,0,0,0,0,0
01604930,60,10,50,0,1,1,0,1,1
01605533,5,1,4,0,1,1,0,1,1
01606391,34,3,31,0,1,1,0,1,1
01606623,28,8,20,0,0,0,0,0,0
01606737,14,3,11,0,1,1,0,1,1
01607198,16,1,15,0,1,1,0,1,1
01607372,25,0,25,0,1,1,0,1,1
01607787,22,4,18,0,1,1,0,1,1
01608727,28,3,25,0,1,1,0,1,1
01611448,22,0,22,0,0,0,0,0,1
01615593,19,6,13,0,0,0,0,0,1
01618226,12,5,7,0,2,1,1,1,1
01618677,44,3,41,0,1,1,0,1,1
01618685,43,3,40,0,1,1,0,1,1
01618825,16,1,15,0,2,1,1,0,0
01621244,4,2,2,0,1,1,0,0,0
01622531,22,6,16,0,1,1,0,1,1
01623766,60,3,57,0,1,1,0,1,1
01626190,7,3,4,0,2,2,0,0,0
01626992,12,2,10,0,1,1,0,0,0
01627471,35,3,32,0,1,1,0,1,1
01628523,25,3,22,0,1,1,0,1,1
01628541,3,3,0,0,2,2,0,0,0
01629484,32,5,27,0,3,0,3,0,0
01630349,10,0,10,0,0,0,0,0,1
01633042,39,3,36,0,1,1,0,1,1
01633951,29,6,23,0,0,0,0,0,1
01635024,47,6,41,0,4,4,0,0,1
01636136,15,0,15,0,1,1,0,1,1
01636570,16,4,12,0,1,1,0,0,1
01636921,5,3,2,0,1,1,0,0,0
01638742,14,3,11,0,1,1,0,1,1
01639557,27,4,23,0,1,1,0,1,1
01640181,16,2,14,0,1,1,0,0,1
01640958,1,1,0,0,0,0,0,0,1
01641088,40,0,40,0,0,0,0,0,1
01641968,58,9,49,0,0,0,0,0,0
01643943,13,3,10,0,3,3,0,1,0
01645444,31,0,31,0,1,1,0,1,1
01646146,32,7,25,0,0,0,0,0,1
01647162,32,0,32,0,0,0,0,0,1
01648115,17,4,13,0,2,2,0,2,1
01648208,6,3,3,0,1,1,0,0,0
01648435,29,12,17,0,0,0,0,0,0
01649615,7,2,5,0,2,2,0,0,0
01650215,22,0,22,0,1,1,0,1,1
01650657,8,2,6,0,1,1,0,0,1
01650840,25,0,25,0,0,0,0,0,1
01651257,9,5,4,0,1,1,0,0,0
01652213,21,5,16,0,1,1,0,0,1
01653331,42,8,34,0,1,1,0,1,1
01656023,13,2,11,0,1,1,0,1,1
01657022,6,2,4,0,2,2,0,0,0
01657318,23,5,18,0,1,1,0,1,1
01657550,6,1,5,0,1,1,0,0,0
01657562,5,4,1,0,3,3,0,0,0
01658371,32,2,30,0,2,2,0,2,0
01660784,48,9,39,0,1,1,0,1,1
01661244,7,5,2,0,2,2,0,0,1
01661686,31,17,14,0,1,1,0,1,1
01663694,49,4,45,0,0,0,0,0,1
01664296,19,4,15,0,5,4,1,1,1
01666333,40,4,36,0,1,1,0,1,1
01666751,100,8,92,0,0,0,0,0,1
01668014,15,0,15,0,0,0,0,0,1
01668015,8,0,8,0,0,0,0,0,1
01669515,17,4,13,0,6,6,0,0,1
01671355,25,6,19,0,1,1,0,1,1
01672983,15,2,13,0,1,1,0,0,0
01673457,0,0,0,0,0,0,0,0,0
01677155,26,10,16,0,0,0,0,0,0
01679488,41,3,38,0,1,1,0,1,1
01679995,3,3,0,0,1,1,0,0,1
01682230,5,5,0,0,2,2,0,0,0
01684544,4,1,3,0,1,1,0,0,0
01685094,23,4,19,0,1,1,0,1,1
01686164,92,8,84,0,0,0,0,0,1
01687154,8,0,8,0,0,0,0,0,1
01687590,52,5,47,0,1,1,0,1,1
01687652,31,0,31,0,1,1,0,1,1
01688958,10,3,7,0,1,1,0,0,1
01689098,23,0,23,0,0,0,0,0,1
01690525,26,4,22,0,0,0,0,0,1
01690936,24,0,24,0,1,1,0,1,1
01690975,18,0,18,0,0,0,0,0,1
01691431,58,5,53,0,1,1,0,1,1
01691472,59,5,54,0,1,1,0,1,1
01691818,21,5,16,0,0,0,0,0,1
01693088,20,4,16,0,1,1,0,1,1
01694712,56,9,47,0,0,0,0,0,1
01695813,18,6,12,0,1,1,0,1,1
01696917,20,3,17,0,1,1,0,1,1
01697461,107,13,94,0,0,0,0,0,1
01698056,20,2,18,0,0,0,0,0,0
01698399,41,14,27,0,0,0,0,0,1
01698409,43,11,32,0,1,1,0,1,1
01698962,5,3,2,0,1,1,0,1,1
01699246,24,3,21,0,1,1,0,1,1
01701276,4,2,2,0,2,2,0,0,0
01701634,11,6,5,0,1,1,0,0,1
01701757,4,3,1,0,2,2,0,0,1
01702816,75,6,69,0,0,0,0,0,1
01704111,36,3,33,0,1,1,0,1,1
01704776,36,4,32,0,0,0,0,0,0
01705520,15,5,10,0,2,1,1,0,1
01705689,28,2,26,0,1,1,0,1,0
01709017,20,3,17,0,1,1,0,1,1
01709532,8,5,3,0,0,0,0,0,0
01710702,5,2,3,0,1,1,0,0,1
01712782,10,3,7,0,1,1,0,1,1
01719860,15,5,10,0,3,3,0,0,1
01721406,21,5,16,0,1,1,0,1,1
01725755,16,3,13,0,1,1,0,1,1
01725815,23,6,17,0,0,0,0,0,0
01728967,18,2,16,0,1,1,0,1,1
01729478,51,8,43,0,0,0,0,0,1
01729710,15,0,15,0,0,0,0,0,1
01730997,28,5,23,0,1,1,0,1,1
01732518,46,4,42,0,1,1,0,1,1
01734159,3,3,0,0,1,1,0,0,0
01737587,34,3,31,0,1,1,0,1,1
01737813,19,3,16,0,1,1,0,1,1
01738249,20,5,15,0,0,0,0,0,1
01738934,36,0,36,0,0,0,0,0,1
01739581,8,2,6,0,1,1,0,1,1
01741450,9,6,3,0,1,1,0,0,1
01741741,13,6,7,0,1,1,0,0,1
01742404,25,6,19,0,1,1,0,1,1
01743307,14,2,12,0,2,2,0,1,1
01744913,26,3,23,0,1,1,0,1,1
01747066,41,8,33,0,1,1,0,0,0
01747139,6,5,1,0,1,1,0,0,0
01748848,15,5,10,0,1,1,0,0,0
01751817,8,3,5,0,2,2,0,0,1
01752109,5,3,2,0,2,2,0,0,0
01754715,12,2,10,0,1,1,0,1,0
01757157,40,5,35,0,1,1,0,1,1
01759876,59,9,50,0,1,1,0,0,0
01762083,21,4,17,0,0,0,0,0,0
01763136,3,3,0,0,1,1,0,0,0
01764397,9,3,6,0,0,0,0,0,0
01766310,38,2,36,0,1,1,0,1,1
01768014,19,4,15,0,1,1,0,1,1
01768508,34,0,34,0,0,0,0,0,1
01769664,6,3,3,0,1,1,0,1,0
01769690,26,4,22,0,1,1,0,1,1
01770170,11,2,9,0,1,1,0,0,0
01770494,15,7,8,0,0,0,0,0,0
01771172,38,3,35,0,2,2,0,2,1
01776848,38,3,35,0,1,1,0,1,1
01777297,4,2,2,0,1,1,0,0,1
01777777,49,7,42,0,2,2,0,2,1
01778189,14,4,10,0,1,1,0,1,1
01778879,53,6,47,0,0,0,0,0,0
01780264,22,0,22,0,0,0,0,0,1
01781138,16,6,10,0,1,1,0,1,1
01781246,20,5,15,0,0,0,0,0,1
01781725,28,0,28,0,0,0,0,0,1
01782132,23,6,17,0,1,1,0,0,1
01782527,23,3,20,0,1,1,0,1,1
01783300,33,3,30,0,2,2,0,2,1
01784086,24,3,21,0,4,3,1,1,1
01788531,11,5,6,0,0,0,0,0,0
01791760,93,20,73,0,0,0,0,0,1
01792921,43,9,34,0,0,0,0,0,1
01793193,78,12,66,0,0,0,0,0,0
01795123,4,3,1,0,2,2,0,0,1
01795572,43,0,43,0,0,0,0,0,1
01795732,291,4,287,0,1,1,0,1,1
01796345,73,5,68,0,0,0,0,0,0
01796367,29,5,24,0,1,0,1,1,1
01796928,78,9,69,0,0,0,0,0,1
01797055,21,0,21,0,0,0,0,0,1
01798114,35,3,32,0,1,1,0,1,1
01798992,13,1,12,0,4,2,2,1,1
01805705,28,4,24,0,4,4,0,0,0
01806047,39,14,25,0,0,0,0,0,1
01806531,27,4,23,0,1,1,0,1,1
01809098,32,0,32,0,0,0,0,0,1
01810489,15,3,12,0,1,1,0,1,1
01811310,17,0,17,0,1,1,0,1,0
01812127,49,3,46,0,1,1,0,1,1
01812169,17,5,12,0,1,1,0,1,1
01812610,32,5,27,0,1,1,0,1,1
01814110,33,6,27,0,0,0,0,0,0
01814558,14,4,10,0,1,1,0,0,1
01815730,22,3,19,0,1,1,0,1,1
01816502,13,0,13,0,0,0,0,0,1
01820528,9,0,9,0,1,1,0,1,1
01821310,28,10,18,0,1,1,0,0,0
01826136,4,3,1,0,1,1,0,0,0
01826602,94,12,82,0,0,0,0,0,0
01827284,6,4,2,0,1,1,0,1,0
01828491,6,2,4,0,1,1,0,0,0
01828642,27,3,24,0,1,1,0,1,1
01830148,12,2,10,0,2,2,0,0,1
01835021,20,9,11,0,1,1,0,1,0
01835151,27,0,27,0,0,0,0,0,1
01835691,57,11,46,0,1,1,0,1,1
01837292,24,0,24,0,1,1,0,1,1
01838229,22,3,19,0,1,1,0,1,1
01838445,23,0,23,0,1,1,0,1,1
01838522,8,0,8,0,0,0,0,0,1
01838573,20,0,20,0,1,1,0,1,1
01841697,54,5,49,0,1,1,0,1,1
01841906,16,6,10,0,0,0,0,0,1
01842252,37,3,34,0,1,1,0,1,1
01842254,56,8,48,0,1,1,0,1,1
01843811,8,2,6,0,2,2,0,1,0
01846804,25,5,20,0,1,1,0,1,1
01848309,70,10,60,0,0,0,0,0,1
01854132,48,7,41,0,1,1,0,1,1
01856580,39,7,32,0,11,6,5,0,1
01858790,52,2,50,0,3,3,0,3,1
01860027,0,0,0,0,0,0,0,0,0
01860163,31,0,31,0,1,1,0,1,1
01860196,13,0,13,0,0,0,0,0,1
01861710,12,2,10,0,1,1,0,0,0
01862328,16,3,13,0,1,1,0,1,1
01862440,22,0,22,0,1,1,0,1,1
01863660,0,0,0,0,0,0,0,0,0
01867091,5,3,2,0,1,1,0,0,0
00741624,39,5,34,0,1,1,0,1,1
00741937,8,3,5,0,1,1,0,0,0
00744369,26,3,23,0,1,1,0,1,1
00744398,6,2,4,0,1,1,0,0,0
00745398,192,34,158,0,0,0,0,0,1
00745917,41,6,35,0,1,1,0,1,1
00746571,2,1,1,0,0,0,0,0,1
00749317,33,4,29,0,1,1,0,1,1
00749645,63,6,57,0,0,0,0,0,1
00752321,3,2,1,0,1,1,0,0,0
00752569,14,7,7,0,3,3,0,0,1
00753110,25,5,20,0,1,1,0,1,1
00753340,49,5,44,0,1,1,0,1,1
00753648,53,13,40,0,0,0,0,0,0
00755944,31,5,26,0,1,1,0,1,1
00758966,35,0,35,0,0,0,0,0,1
00759241,4,0,4,0,1,1,0,0,0
00760475,8,2,6,0,0,0,0,0,0
00761149,89,0,89,0,0,0,0,0,1
00767573,3,3,0,0,1,1,0,0,0
00770086,11,4,7,0,1,1,0,0,0
00770781,9,4,5,0,3,3,0,0,0
00771335,19,8,11,0,0,0,0,0,1
00772318,279,5,274,0,0,0,0,0,1
00774062,16,0,16,0,1,1,0,1,1
00774336,15,4,11,0,3,3,0,1,0
00774883,11,5,6,0,1,1,0,1,0
00776338,29,0,29,0,1,1,0,1,1
00776582,8,2,6,0,1,1,0,1,0
00777576,7,4,3,0,2,2,0,0,0
00777705,34,0,34,0,0,0,0,0,1
00778398,46,4,42,0,1,1,0,1,1
00779528,14,4,10,0,2,2,0,0,0
00782546,44,6,38,0,0,0,0,0,1
00783757,6,5,1,0,4,4,0,0,0
00784555,2,2,0,0,1,1,0,0,0
00785488,44,0,44,0,0,0,0,0,0
00786308,6,2,4,0,1,1,0,0,0
00788617,20,5,15,0,1,1,0,1,1
00791766,132,2,130,0,0,0,0,0,1
00792220,3,2,1,0,1,1,0,1,0
00792822,3,3,0,0,2,2,0,1,0
00793447,5,2,3,0,3,3,0,0,0
00796740,23,3,20,0,2,1,1,2,1
00797195,13,3,10,0,1,1,0,1,0
00797472,3,1,2,0,2,2,0,0,0
00799179,0,0,0,0,0,0,0,0,0
00799263,23,0,23,0,1,1,0,1,1
00800311,31,5,26,0,1,1,0,1,1
00802706,11,3,8,0,1,1,0,1,0
00803059,6,2,4,0,2,2,0,0,0
00803241,36,0,36,0,1,1,0,1,1
00807834,7,5,2,0,1,1,0,1,0
00808245,25,0,25,0,0,0,0,0,1
00812470,8,0,8,0,0,0,0,0,1
00821959,4,2,2,0,1,1,0,0,0
00822558,16,0,16,0,0,0,0,0,1
00823988,97,24,73,0,0,0,0,0,1
00824422,13,4,9,0,1,1,0,0,0
00824951,31,5,26,0,1,1,0,1,1
00825154,6,2,4,0,1,1,0,0,0
00825522,4,3,1,0,3,3,0,0,0
00827389,6,3,3,0,1,1,0,0,0
00827982,140,11,129,0,1,1,0,1,1
00829109,11,5,6,0,1,1,0,0,0
00830519,11,8,3,0,0,0,0,0,0
00831817,38,0,38,0,0,0,0,0,1
00832799,7,4,3,0,2,2,0,0,0
00834213,5,3,2,0,1,1,0,0,0
00835358,4,2,2,0,2,2,0,0,0
00835372,5,3,2,0,1,1,0,1,0
00836184,8,4,4,0,5,5,0,2,0
00836481,26,3,23,0,0,0,0,0,1
00838308,32,5,27,0,1,1,0,1,1
00840520,6,4,2,0,1,1,0,0,0
00841210,6,3,3,0,1,1,0,0,0
00841421,22,2,20,0,1,1,0,1,1
00843327,131,17,114,0,0,0,0,0,0
00846150,18,0,18,0,1,1,0,1,1
00846152,8,3,5,0,1,1,0,0,0
00849435,6,3,3,0,2,2,0,1,0
00849553,33,2,31,0,2,1,1,2,1
00852647,8,3,5,0,1,1,0,0,0
00854919,1,0,1,0,0,0,0,0,0
00855389,11,3,8,0,3,3,0,1,0
00856222,36,15,21,0,1,1,0,0,1
00857498,3,0,3,0,2,2,0,0,0
00857700,49,14,35,0,0,0,0,0,0
00859087,22,5,17,0,1,1,0,1,1
00860235,21,5,16,0,1,1,0,1,1
00860702,182,9,173,0,0,0,0,0,1
00863087,28,3,25,0,2,2,0,2,1
00864925,7,3,4,0,1,1,0,1,1
00865402,39,4,35,0,2,1,1,2,1
00866396,97,5,92,0,8,4,4,0,0
00866461,6,3,3,0,0,0,0,0,0
00867637,18,4,14,0,1,0,1,1,1
00870199,50,5,45,0,1,1,0,1,1
00870262,40,6,34,0,1,1,0,1,1
00870425,20,3,17,0,2,2,0,2,1
00871669,43,7,36,0,1,1,0,1,1
00871965,22,5,17,0,1,1,0,1,1
00872828,67,13,54,0,1,1,0,1,1
00874618,26,4,22,0,2,1,1,2,1
00874639,41,5,36,0,1,1,0,1,1
00876811,33,9,24,0,0,0,0,0,1
00877991,7,5,2,0,5,5,0,0,0
00878006,29,3,26,0,1,1,0,1,1
00878611,12,3,9,0,0,0,0,0,0
00878804,118,10,108,0,0,0,0,0,0
00878934,56,21,35,0,0,0,0,0,0
00881518,18,0,18,0,0,0,0,0,1
00881605,23,0,23,0,0,0,0,0,1
00882644,16,0,16,0,1,1,0,1,1
00883021,34,5,29,0,2,2,0,2,1
00885699,32,0,32,0,0,0,0,0,1
00885913,6,0,6,0,0,0,0,0,0
00886182,0,0,0,0,0,0,0,0,0
00887808,37,4,33,0,1,1,0,1,1
00889424,50,12,38,0,0,0,0,0,1
00891935,24,6,18,0,2,1,1,2,1
00892716,6,2,4,0,1,1,0,0,0
00893197,5,3,2,0,1,1,0,0,0
00894552,13,4,9,0,1,1,0,0,0
00894638,35,3,32,0,1,1,0,1,1
00897489,7,3,4,0,1,1,0,1,1
00898166,72,6,66,0,1,1,0,1,1
00898687,22,7,15,0,1,1,0,0,0
00900529,25,3,22,0,1,1,0,1,1
00900811,15,4,11,0,0,0,0,0,1
00901063,33,14,19,0,0,0,0,0,0
00901282,33,7,26,0,1,1,0,1,1
00902624,34,6,28,0,0,0,0,0,0
00906355,106,4,102,0,1,1,0,1,1
00906511,10,6,4,0,1,1,0,1,1
00907452,8,0,8,0,0,0,0,0,1
00907949,29,4,25,0,2,1,1,0,1
00908396,57,4,53,0,1,1,0,1,1
00910355,31,5,26,0,1,1,0,1,1
00910564,6,3,3,0,2,2,0,0,0
00910829,14,3,11,0,1,1,0,1,1
00911924,79,16,63,0,0,0,0,0,1
00912022,41,10,31,0,0,0,0,0,1
00912624,42,6,36,0,2,2,0,2,1
00913062,37,10,27,0,0,0,0,0,0
00914413,6,2,4,0,1,1,0,0,0
00914422,28,0,28,0,0,0,0,0,1
00919424,19,4,15,0,1,1,0,1,1
00920943,5,3,2,0,2,2,0,0,0
00921417,36,4,32,0,0,0,0,0,1
00921909,64,18,46,0,0,0,0,0,1
00924318,33,5,28,0,1,1,0,1,1
00925279,178,9,169,0,1,1,0,1,1
00926655,40,2,38,0,1,1,0,1,1
00926785,37,1,36,0,1,1,0,1,1
00927601,9,0,9,0,2,2,0,0,1
00927680,43,7,36,0,0,0,0,0,1
00928922,25,3,22,0,1,1,0,1,1
00929139,7,4,3,0,0,0,0,0,1
00930144,12,4,8,0,1,1,0,1,1
00930931,6,3,3,0,1,1,0,0,0
00931036,2,1,1,0,0,0,0,0,1
00931322,16,5,11,0,1,1,0,1,1
00932632,0,0,0,0,0,0,0,0,0
00932738,4,3,1,0,1,1,0,1,0
00934454,9,3,6,0,0,0,0,0,0
00935048,26,4,22,0,2,2,0,2,1
00935973,6,3,3,0,3,3,0,2,1
00936052,33,0,33,0,0,0,0,0,0
00937007,5,3,2,0,2,2,0,0,0
00937964,6,3,3,0,0,0,0,0,0
00938592,62,11,51,0,0,0,0,0,1
00938798,39,0,39,0,1,1,0,1,1
00939510,30,8,22,0,0,0,0,0,1
00940631,91,8,83,0,2,1,1,0,0
00941082,72,4,68,0,1,1,0,1,1
00941405,48,4,44,0,1,1,0,1,1
00941519,22,3,19,0,1,1,0,1,1
00941599,15,3,12,0,1,1,0,1,1
00945878,25,2,23,0,2,1,1,2,0
00946858,13,3,10,0,1,1,0,1,1
00946978,37,6,31,0,1,1,0,1,1
00947080,9,4,5,0,2,2,0,0,0
00947098,34,4,30,0,1,1,0,1,1
00947106,5,2,3,0,0,0,0,0,1
00947662,51,12,39,0,1,1,0,1,1
00947866,9,3,6,0,1,1,0,1,1
00948298,40,8,32,0,2,2,0,1,1
00948978,53,10,43,0,2,2,0,2,1
00949328,7,3,4,0,1,1,0,1,1
00949417,113,7,106,0,1,1,0,1,1
00951093,29,5,24,0,1,1,0,1,1
00952132,12,5,7,0,0,0,0,0,1
00953026,8,0,8,0,0,0,0,0,1
00955661,14,3,11,0,1,1,0,1,1
00955888,30,4,26,0,1,1,0,1,1
00955957,67,9,58,0,1,1,0,1,1
00956098,27,0,27,0,1,1,0,1,1
00956195,15,0,15,0,0,0,0,0,1
00958286,3,3,0,0,2,2,0,0,0
00958313,22,0,22,0,0,0,0,0,1
00958986,39,10,29,0,1,1,0,0,1
00959045,44,1,43,0,0,0,0,0,1
00959082,51,6,45,0,2,2,0,2,1
00959543,13,5,8,0,1,1,0,1,1
00960343,59,2,57,0,1,1,0,1,1
00961209,32,0,32,0,0,0,0,0,1
00964140,5,2,3,0,1,1,0,0,0
00964908,5,3,2,0,3,3,0,0,0
00966676,23,0,23,0,0,0,0,0,1
00967447,7,3,4,0,1,1,0,1,0
00968007,32,0,32,0,0,0,0,0,1
00969373,32,0,32,0,1,1,0,1,1
00970105,5,4,1,0,1,1,0,0,0
00970812,40,5,35,0,1,1,0,1,1
00971448,68,4,64,0,1,1,0,1,1
00972265,39,10,29,0,1,1,0,1,1
00972694,96,6,90,0,0,0,0,0,0
00973091,24,0,24,0,1,1,0,1,1
00974633,16,5,11,0,1,1,0,0,1
00975756,20,5,15,0,1,1,0,1,1
00976167,19,0,19,0,0,0,0,0,1
00977646,5,5,0,0,3,3,0,0,1
00978228,5,4,1,0,6,6,0,0,1
00979108,28,5,23,0,1,1,0,1,1
00979395,60,4,56,0,2,2,0,1,1
00979845,2,2,0,0,2,2,0,0,0
00980152,40,11,29,0,0,0,0,0,0
00981908,115,20,95,0,0,0,0,0,1
00982833,52,5,47,0,1,1,0,1,1
00983571,16,1,15,0,1,1,0,1,1
00984642,6,4,2,0,2,2,0,0,0
00984972,8,5,3,0,2,2,0,0,0
00985685,28,8,20,0,0,0,0,0,0
00987950,18,4,14,0,1,1,0,1,0
00988645,14,5,9,0,0,0,0,0,0
00988671,15,2,13,0,1,1,0,1,1
00988857,27,5,22,0,2,2,0,0,1
00989459,28,5,23,0,1,1,0,1,1
00992512,12,4,8,0,0,0,0,0,0
00992943,6,1,5,0,1,1,0,0,0
00995419,26,3,23,0,1,1,0,1,1
00995838,6,0,6,0,0,0,0,0,0
00996488,22,5,17,0,1,1,0,1,1
00998314,34,8,26,0,0,0,0,0,1
01002091,24,5,19,0,1,1,0,1,1
01002610,63,5,58,0,1,1,0,1,0
01003561,6,1,5,0,1,1,0,0,0
01003645,30,3,27,0,1,1,0,1,1
01003834,0,0,0,0,0,0,0,0,0
01004355,39,3,36,0,1,1,0,1,1
01004676,26,0,26,0,0,0,0,0,1
01005897,56,0,56,0,0,0,0,0,0
01005899,31,5,26,0,1,1,0,1,1
01006112,47,8,39,0,1,1,0,1,1
01007593,29,3,26,0,2,2,0,2,1
01008371,71,13,58,0,0,0,0,0,1
01008395,0,0,0,0,0,0,0,0,0
01008689,24,1,23,0,1,1,0,1,1
01009194,14,2,12,0,1,1,0,1,1
01011189,38,3,35,0,0,0,0,0,0
01011549,19,2,17,0,0,0,0,0,0
01011637,93,16,77,0,1,1,0,1,1
01012247,11,5,6,0,1,1,0,1,1
01012768,72,28,44,0,0,0,0,0,1
01013406,25,5,20,0,1,1,0,1,1
01015628,28,0,28,0,1,1,0,1,1
01015851,35,0,35,0,1,1,0,1,1
01016104,7,3,4,0,0,0,0,0,0
01016261,103,18,85,0,0,0,0,0,1
01017417,29,0,29,0,1,1,0,1,1
01018204,8,2,6,0,1,1,0,1,0
01018794,8,7,1,0,1,1,0,0,0
01020115,3,3,0,0,2,2,0,0,0
01021212,40,6,34,0,3,3,0,3,1
01023979,0,0,0,0,0,0,0,0,0
01024821,6,3,3,0,1,1,0,0,0
01028004,21,4,17,0,0,0,0,0,0
01029814,5,2,3,0,1,1,0,0,0
01030135,28,3,25,0,2,2,0,2,1
01031815,32,4,28,0,1,1,0,1,1
01034035,5,3,2,0,2,2,0,0,0
01035500,22,0,22,0,1,1,0,1,1
01036926,41,7,34,0,4,2,2,1,1
01037345,8,2,6,0,1,1,0,0,0
01037437,7,3,4,0,3,3,0,1,0
01038028,0,0,0,0,0,0,0,0,0
01039351,33,4,29,0,1,1,0,1,1
01040814,20,5,15,0,1,1,0,1,1
01041697,21,5,16,0,1,1,0,1,1
01041726,20,0,20,0,1,1,0,1,1
01041776,20,0,20,0,1,1,0,1,1
01041946,67,9,58,0,13,8,5,0,0
01042759,13,5,8,0,1,1,0,1,1
01046873,47,4,43,0,1,1,0,1,1
01047586,16,0,16,0,0,0,0,0,1
01048339,17,5,12,0,0,0,0,0,0
01048591,49,2,47,0,1,1,0,1,0
01049197,27,3,24,0,0,0,0,0,0
01049704,38,2,36,0,2,1,1,2,1
01050948,24,3,21,0,1,1,0,1,1
01051111,10,6,4,0,2,1,1,0,1
01052150,15,0,15,0,0,0,0,0,1
01052871,6,5,1,0,3,3,0,0,0
01053470,23,2,21,0,1,1,0,1,1
01055334,26,11,15,0,1,1,0,1,1
01056769,27,4,23,0,1,1,0,1,1
01056774,45,2,43,0,2,1,1,2,1
01057636,111,11,100,0,0,0,0,0,0
01058023,16,3,13,0,1,1,0,1,1
01059497,7,3,4,0,1,1,0,0,0
01059992,28,9,19,0,1,1,0,0,0
01061217,6,4,2,0,3,2,1,0,0
01063129,18,3,15,0,1,1,0,1,1
01064095,21,4,17,0,1,1,0,1,1
01065002,15,4,11,0,1,1,0,1,1
01065578,6,5,1,0,1,1,0,0,0
01065887,9,2,7,0,1,1,0,1,1
01067704,11,2,9,0,2,2,0,0,1
01071050,10,2,8,0,2,1,1,1,0
01071194,24,6,18,0,0,0,0,0,0
01072023,10,8,2,0,3,3,0,0,1
01072627,40,5,35,0,1,1,0,1,1
01072847,32,3,29,0,1,1,0,1,1
01074166,31,5,26,0,1,1,0,1,1
01075752,44,4,40,0,1,1,0,1,1
01076928,26,2,24,0,1,1,0,1,1
01079943,8,4,4,0,1,1,0,0,0
01080598,20,0,20,0,0,0,0,0,1
01082593,36,0,36,0,0,0,0,0,1
01082908,17,4,13,0,1,1,0,1,1
01083899,37,1,36,0,0,0,0,0,1
01085977,30,0,30,0,0,0,0,0,1
01086296,15,0,15,0,1,1,0,1,1
01089326,37,3,34,0,1,1,0,1,1
01089916,8,4,4,0,1,1,0,0,0
01091581,11,1,10,0,4,2,2,1,1
01101017,105,19,86,0,0,0,0,0,1
01101649,29,3,26,0,1,1,0,1,1
01102834,29,3,26,0,1,1,0,1,1
01104245,112,13,99,0,0,0,0,0,0
01104598,44,8,36,0,1,1,0,1,1
01104811,31,5,26,0,1,1,0,1,1
01105991,9,5,4,0,1,1,0,0,1
01107591,8,6,2,0,1,1,0,0,0
01111004,7,5,2,0,1,1,0,0,0
01113804,6,3,3,0,1,1,0,0,0
01116219,11,3,8,0,1,1,0,0,0
01116632,29,7,22,0,1,1,0,0,0
01118580,70,6,64,0,1,1,0,1,1
01121804,4,3,1,0,3,3,0,0,0
11080177,1,1,0,0,0,0,0,0,0
11081245,2,0,2,0,1,1,0,0,0
11081458,2,2,0,0,2,2,0,0,1
11081522,2,2,0,0,1,1,0,0,1
11082024,1,0,1,0,1,1,0,0,0
11082397,1,1,0,0,1,1,0,0,0
11082748,2,2,0,0,2,2,0,0,0
11083369,1,1,0,0,1,1,0,0,0
11084397,4,4,0,0,1,1,0,1,1
11084430,4,4,0,0,1,1,0,1,1
11085178,1,1,0,0,1,1,0,0,0
11085651,5,5,0,0,1,1,0,1,1
11085738,2,2,0,0,2,2,0,0,0
11085746,3,3,0,0,0,0,0,0,0
11085877,1,0,1,0,1,1,0,0,0
11086462,4,2,2,0,1,1,0,1,0
11086943,1,1,0,0,1,1,0,0,0
11087297,2,1,1,0,2,1,1,0,0
11087370,1,1,0,0,1,1,0,0,0
11087420,1,1,0,0,1,1,0,0,0
11087628,1,1,0,0,1,1,0,0,0
11088301,1,1,0,0,1,1,0,0,0
11090952,1,1,0,0,1,1,0,0,1
11090953,1,1,0,0,1,1,0,0,1
11091482,2,1,1,0,1,1,0,0,0
11092545,1,1,0,0,1,1,0,0,0
11093377,1,1,0,0,1,1,0,0,0
11093574,2,2,0,0,2,2,0,0,0
11094017,1,1,0,0,0,0,0,0,0
11094068,1,1,0,0,0,0,0,0,0
11094577,1,1,0,0,0,0,0,0,0
11095408,2,2,0,0,1,1,0,0,0
11096220,1,0,1,0,1,1,0,0,0
11096926,1,1,0,0,1,1,0,0,0
11099521,4,2,2,0,1,1,0,1,0
11104111,2,2,0,0,1,1,0,1,1
11104688,1,1,0,0,1,1,0,0,0
11104857,1,1,0,0,1,1,0,0,0
11105902,5,5,0,0,1,1,0,1,0
11106180,2,0,2,0,1,1,0,0,0
11106516,5,0,5,0,0,0,0,0,0
11107110,1,1,0,0,1,1,0,0,0
11108512,3,2,1,0,2,1,1,0,0
11108658,2,2,0,0,4,4,0,1,0
11109770,1,1,0,0,1,1,0,0,0
11111772,3,2,1,0,1,1,0,1,0
11112272,2,2,0,0,1,1,0,1,1
11112823,1,1,0,0,2,2,0,1,0
11112924,2,2,0,0,2,2,0,0,0
11114276,2,2,0,0,0,0,0,0,0
11115107,4,3,1,0,1,1,0,0,1
11115546,4,3,1,0,1,1,0,0,1
11116196,2,1,1,0,2,1,1,0,0
11116668,2,1,1,0,1,1,0,1,0
11116788,1,1,0,0,1,1,0,0,0
11117740,1,0,1,0,1,1,0,0,0
11118591,2,2,0,0,0,0,0,0,1
11119032,2,2,0,0,0,0,0,0,0
11119079,2,2,0,0,0,0,0,0,1
11119098,2,2,0,0,0,0,0,0,1
11119757,1,1,0,0,1,1,0,0,0
11120418,1,1,0,0,1,1,0,0,0
11122633,1,1,0,0,1,1,0,0,0
11122780,2,2,0,0,1,1,0,0,0
11123698,1,1,0,0,1,1,0,0,1
11123700,4,0,4,0,0,0,0,0,0
11124118,1,1,0,0,1,1,0,0,0
11128551,1,1,0,0,1,1,0,0,0
11128968,4,3,1,0,2,1,1,0,0
11129726,1,1,0,0,1,1,0,0,0
11131948,2,2,0,0,1,1,0,0,0
11134420,1,1,0,0,1,1,0,0,0
11134829,2,2,0,0,2,2,0,0,0
11135652,1,1,0,0,1,1,0,0,0
11135989,2,0,2,0,1,1,0,0,0
11137165,1,1,0,0,1,1,0,0,0
11137534,5,5,0,0,1,1,0,1,0
11137739,1,1,0,0,1,0,1,0,0
11137816,1,1,0,0,1,1,0,0,0
11138075,2,2,0,0,2,2,0,0,0
11138329,1,0,1,0,2,2,0,0,0
11138423,1,1,0,0,1,1,0,1,0
11142487,3,3,0,0,0,0,0,0,0
11143187,1,1,0,0,0,0,0,0,0
11143343,2,2,0,0,1,1,0,0,0
11143859,1,1,0,0,1,1,0,0,0
11143981,1,1,0,0,1,1,0,1,0
11144307,2,2,0,0,0,0,0,0,0
11144350,1,1,0,0,1,1,0,0,0
11144704,1,1,0,0,1,1,0,0,0
11145188,2,2,0,0,2,2,0,0,1
11146878,1,1,0,0,0,0,0,0,0
11147353,2,2,0,0,1,1,0,1,1
11147483,2,2,0,0,1,1,0,1,1
11148203,1,1,0,0,1,1,0,0,0
11148552,1,1,0,0,1,1,0,0,0
11148993,10,10,0,0,2,2,0,2,1
11149480,1,1,0,0,1,1,0,0,0
11149817,2,2,0,0,2,2,0,0,0
11151881,1,1,0,0,1,1,0,0,0
11151893,1,1,0,0,1,1,0,0,0
11152011,1,1,0,0,1,1,0,0,0
11152618,1,1,0,0,1,1,0,0,0
11153107,1,1,0,0,0,0,0,0,0
11153631,3,3,0,0,1,1,0,1,0
11155126,3,3,0,0,3,3,0,0,0
11155381,2,2,0,0,1,1,0,0,0
11162998,3,1,2,0,3,1,2,0,0
11163735,1,1,0,0,1,1,0,0,0
11164295,1,1,0,0,1,1,0,0,0
11164553,1,1,0,0,1,1,0,0,0
11164818,2,2,0,0,1,1,0,0,0
11165196,4,4,0,0,1,1,0,0,1
11165866,2,2,0,0,1,1,0,1,0
11165870,2,2,0,0,2,2,0,0,0
11166205,3,2,1,0,1,1,0,0,1
11166222,3,1,2,0,3,1,2,0,0
11166252,1,0,1,0,1,1,0,0,0
11166982,1,1,0,0,1,1,0,0,0
11167106,1,1,0,0,1,1,0,0,0
11167499,1,1,0,0,1,1,0,0,0
11168014,2,2,0,0,1,1,0,0,1
11168663,3,3,0,0,1,1,0,0,0
11169442,1,1,0,0,1,1,0,0,0
11170226,1,1,0,0,1,1,0,0,0
11171346,2,2,0,0,1,1,0,0,0
11172973,2,1,1,0,2,1,1,1,0
11173245,1,1,0,0,1,1,0,0,0
11173764,2,2,0,0,2,2,0,0,0
11174840,4,0,4,0,0,0,0,0,0
11175894,4,4,0,0,2,2,0,0,1
11180874,4,2,2,0,1,1,0,0,0
11181287,1,1,0,0,1,1,0,0,0
11184368,1,1,0,0,1,1,0,0,0
11184723,1,1,0,0,0,0,0,0,0
11187005,1,0,1,0,1,1,0,0,0
11187832,1,1,0,0,1,1,0,0,0
11187894,1,1,0,0,0,0,0,0,0
11189566,1,1,0,0,1,1,0,0,0
11190167,2,2,0,0,2,1,1,2,0
11190518,1,1,0,0,1,1,0,0,0
11190898,3,3,0,0,1,1,0,1,1
11191320,2,2,0,0,1,1,0,0,0
11191743,1,1,0,0,1,1,0,0,0
11192371,2,2,0,0,1,1,0,0,0
11193155,1,1,0,0,1,1,0,0,0
11193802,2,2,0,0,2,2,0,0,0
11193849,5,3,2,0,1,1,0,1,0
11194332,2,2,0,0,1,1,0,0,0
11194343,2,1,1,0,2,1,1,0,0
11194947,1,1,0,0,1,1,0,0,0
11197046,1,0,1,0,1,1,0,0,0
11197538,1,0,1,0,1,1,0,0,0
11198347,1,1,0,0,1,1,0,1,0
11198443,1,1,0,0,1,1,0,1,0
11200123,2,2,0,0,2,2,0,0,1
11201809,4,3,1,0,1,1,0,1,0
11202058,1,0,1,0,1,1,0,0,0
11202693,2,2,0,0,1,1,0,0,0
11202885,1,1,0,0,2,2,0,0,0
11203358,2,2,0,0,1,1,0,0,0
11203550,1,1,0,0,1,1,0,0,0
11204546,1,0,1,0,1,1,0,0,0
11204902,1,1,0,0,1,1,0,0,0
11205194,10,7,3,0,2,1,1,1,0
11208458,1,1,0,0,1,1,0,0,0
11208576,1,1,0,0,1,1,0,0,0
11209338,1,1,0,0,1,1,0,0,0
11209468,1,0,1,0,1,0,1,0,0
11211928,1,1,0,0,1,1,0,0,0
11211984,2,2,0,0,1,1,0,1,0
11212342,1,1,0,0,1,1,0,0,0
11215079,2,2,0,0,0,0,0,0,0
11215937,2,2,0,0,2,2,0,0,0
11216313,2,2,0,0,2,2,0,0,0
11216757,1,1,0,0,1,1,0,0,0
11217952,4,4,0,0,1,1,0,1,1
11219479,1,1,0,0,1,1,0,0,0
11219675,2,2,0,0,2,2,0,0,0
11222843,1,1,0,0,2,2,0,0,0
11222919,7,5,2,0,0,0,0,0,0
11223449,1,1,0,0,1,1,0,0,0
11223487,2,2,0,0,2,2,0,0,0
11223883,2,1,1,0,2,1,1,0,0
11224608,1,1,0,0,1,1,0,0,0
11226230,1,1,0,0,1,1,0,0,1
11226891,2,2,0,0,1,1,0,0,0
11227998,1,1,0,0,2,2,0,0,0
11228533,12,10,2,0,0,0,0,0,0
11228591,1,1,0,0,1,1,0,0,0
11230089,2,2,0,0,1,1,0,1,0
11230974,3,2,1,0,2,1,1,2,1
11231740,2,2,0,0,1,1,0,0,0
11232154,1,1,0,0,1,1,0,0,0
11232558,1,1,0,0,1,1,0,0,0
11232727,1,1,0,0,2,2,0,0,0
11232971,3,3,0,0,2,2,0,0,1
11233181,2,2,0,0,1,1,0,0,0
11234740,1,1,0,0,1,1,0,1,0
11234758,7,7,0,0,2,1,1,0,1
11235984,2,2,0,0,0,0,0,0,0
11236741,3,3,0,0,1,1,0,0,1
11238088,3,3,0,0,1,1,0,0,0
11238848,3,2,1,0,1,1,0,1,0
11240273,1,1,0,0,1,1,0,0,0
11240414,2,2,0,0,2,2,0,0,0
11241023,2,2,0,0,1,1,0,0,1
11243462,2,2,0,0,2,2,0,2,1
11243945,2,2,0,0,1,1,0,0,0
11245399,3,3,0,0,2,2,0,0,0
11245750,1,1,0,0,1,1,0,0,0
11245921,1,1,0,0,0,0,0,0,0
11246251,3,1,2,0,2,1,1,0,0
11246273,1,0,1,0,1,1,0,0,0
11248061,4,4,0,0,3,3,0,0,1
11249076,2,1,1,0,2,1,1,0,0
11249170,2,2,0,0,1,1,0,0,0
11249384,1,1,0,0,1,1,0,0,0
11249419,1,1,0,0,1,1,0,0,0
05691766,9,5,4,0,1,1,0,1,1
05692180,4,2,2,0,2,2,0,0,1
05693055,9,4,5,0,1,1,0,1,1
05693583,5,3,2,0,1,1,0,0,0
05693745,8,0,8,0,0,0,0,0,1
05693850,22,0,22,0,0,0,0,0,1
05695017,10,2,8,0,1,1,0,1,1
05695035,3,1,2,0,1,1,0,0,0
05695702,8,4,4,0,3,3,0,0,0
05701029,4,2,2,0,1,1,0,0,0
05701911,8,3,5,0,1,1,0,0,1
05702423,2,2,0,0,1,1,0,0,1
05703322,3,2,1,0,1,1,0,0,0
05703376,3,1,2,0,1,1,0,0,0
05704457,9,5,4,0,2,2,0,0,0
05706449,19,3,16,0,1,1,0,1,1
05706702,4,1,3,0,1,1,0,0,0
05708093,30,5,25,0,1,1,0,0,0
05708176,3,2,1,0,2,2,0,0,0
05709353,9,0,9,0,0,0,0,0,1
05710575,3,0,3,0,0,0,0,0,1
05711851,14,5,9,0,0,0,0,0,1
05716909,5,3,2,0,2,2,0,0,0
05716995,5,0,5,0,0,0,0,0,0
05718419,7,4,3,0,1,1,0,0,1
05718474,3,3,0,0,2,2,0,0,0
05719163,2,1,1,0,1,1,0,0,0
05720319,5,0,5,0,1,1,0,0,0
05720682,6,1,5,0,1,1,0,0,1
05721591,4,0,4,0,0,0,0,0,1
05721592,4,0,4,0,0,0,0,0,1
05721832,7,1,6,0,1,1,0,0,0
05722136,4,1,3,0,2,2,0,0,1
05724979,27,3,24,0,1,1,0,1,1
05729112,3,3,0,0,1,1,0,0,0
05731397,7,1,6,0,1,0,1,0,1
05733182,6,4,2,0,1,1,0,0,1
05734515,13,2,11,0,1,1,0,1,1
05735565,6,3,3,0,1,1,0,0,0
05735872,4,2,2,0,1,1,0,0,0
05736693,4,1,3,0,0,0,0,0,0
05737261,12,6,6,0,0,0,0,0,0
05737715,7,2,5,0,2,2,0,0,1
05738353,16,3,13,0,1,1,0,0,1
05739102,8,0,8,1,1,1,0,0,1
05739565,5,1,4,0,1,1,0,0,0
05740177,14,3,11,0,2,1,1,1,0
05740182,4,1,3,0,1,1,0,0,0
05740449,31,2,29,0,1,1,0,1,1
05740791,11,2,9,0,1,1,0,1,0
05740858,6,3,3,0,1,1,0,0,1
05741514,11,1,10,0,2,2,0,0,1
05741852,5,0,5,0,2,2,0,0,1
05741955,8,2,6,0,1,1,0,1,1
05742011,6,0,6,0,0,0,0,0,1
05742076,11,3,8,0,1,1,0,1,1
05743550,6,5,1,0,1,1,0,0,0
05743626,4,0,4,0,0,0,0,0,1
05744419,2,2,0,0,1,1,0,0,0
05744856,3,1,2,0,1,1,0,0,1
05744857,4,2,2,0,1,1,0,0,1
05744864,3,1,2,0,1,1,0,0,1
05745174,5,3,2,0,1,1,0,0,0
05746491,6,2,4,0,1,1,0,0,0
05748303,6,3,3,0,1,1,0,0,1
05748613,3,2,1,0,1,1,0,0,0
05751804,7,5,2,0,3,1,2,1,0
05751932,4,1,3,0,0,0,0,0,1
05752217,13,6,7,0,1,1,0,1,1
05752533,16,4,12,0,1,0,1,0,0
05754977,4,2,2,0,0,0,0,0,0
05755135,5,1,4,0,0,0,0,0,1
05755341,14,6,8,0,1,1,0,0,1
05755637,4,3,1,0,2,2,0,0,0
05755836,3,1,2,0,1,1,0,0,0
05756258,6,2,4,0,1,1,0,0,0
05756295,5,3,2,0,2,2,0,0,1
05757471,5,4,1,0,1,1,0,1,1
05758223,25,5,20,0,0,0,0,0,0
05758967,3,2,1,0,1,1,0,0,1
05759409,10,0,10,0,0,0,0,0,1
05762028,4,1,3,0,1,1,0,0,0
05764555,5,3,2,0,2,2,0,0,1
05764956,6,4,2,0,2,2,0,0,1
05766258,5,3,2,0,2,2,0,0,1
05766993,3,2,1,0,2,2,0,0,1
05767003,3,0,3,0,2,2,0,0,0
05768008,7,4,3,0,3,3,0,0,1
05768401,4,0,4,0,0,0,0,0,0
05768446,4,2,2,0,1,1,0,0,0
05768823,3,0,3,0,0,0,0,0,1
05770270,16,0,16,0,0,0,0,0,1
05770953,3,2,1,0,1,1,0,0,1
05771327,3,0,3,0,0,0,0,0,1
05771493,3,2,1,0,1,1,0,0,0
05772181,4,2,2,0,1,1,0,0,1
05772223,3,1,2,0,1,1,0,0,1
05772287,4,3,1,0,1,1,0,0,1
05774879,4,2,2,0,1,1,0,0,1
05775046,3,3,0,0,1,1,0,0,1
05775190,4,3,1,0,2,2,0,0,1
05777438,9,0,9,0,0,0,0,0,1
05777772,6,3,3,0,4,4,0,1,1
05778052,11,5,6,0,5,4,1,0,0
05778204,5,0,5,0,1,1,0,1,0
05778493,6,0,6,0,0,0,0,0,1
05778768,19,0,19,0,1,1,0,0,1
05779059,11,3,8,0,1,1,0,1,1
05779997,7,5,2,0,1,1,0,1,1
05780094,4,2,2,0,1,1,0,0,0
05780181,7,1,6,0,2,1,1,0,1
05780353,2,2,0,0,1,1,0,0,0
05781496,9,4,5,0,1,1,0,1,1
05786104,3,1,2,0,1,1,0,0,0
05787179,6,3,3,0,2,2,0,0,1
05787439,16,5,11,0,2,1,1,2,1
05788465,7,2,5,0,1,1,0,1,1
05790132,3,3,0,0,2,2,0,0,0
05790256,4,2,2,0,1,1,0,1,1
05791450,4,0,4,0,0,0,0,0,1
05791589,9,3,6,0,1,1,0,1,1
05792192,4,1,3,0,1,1,0,0,1
05792278,4,1,3,0,1,1,0,0,1
05792400,4,1,3,0,1,1,0,0,1
05792692,6,4,2,0,3,3,0,0,0
05794494,12,2,10,0,1,1,0,1,1
05795115,3,0,3,0,0,0,0,0,1
05795193,6,0,6,0,0,0,0,0,1
05797367,6,3,3,0,2,2,0,0,0
05797448,6,1,5,0,2,1,1,0,0
05797584,6,3,3,0,1,1,0,1,1
05797585,6,3,3,0,1,1,0,1,1
05797623,7,3,4,0,2,2,0,0,1
05797953,3,1,2,0,1,1,0,0,1
05799601,3,0,3,0,2,2,0,0,1
05799659,5,3,2,0,2,2,0,0,0
05800771,4,2,2,0,2,2,0,0,0
05801433,17,2,15,0,0,0,0,0,1
05801467,17,2,15,0,1,1,0,1,1
05802437,5,0,5,0,1,1,0,0,0
05803985,4,2,2,0,1,1,0,0,1
05804397,26,2,24,0,2,1,1,2,1
05805069,14,3,11,0,0,0,0,0,1
05805276,3,2,1,0,1,1,0,0,0
05805640,5,3,2,0,2,2,0,0,1
05806409,4,3,1,0,1,1,0,0,1
05807220,3,1,2,0,1,1,0,0,0
05807296,6,0,6,0,0,0,0,0,1
05808051,4,2,2,0,1,1,0,0,1
05808375,8,1,7,0,1,1,0,0,0
05809432,9,5,4,0,1,1,0,1,1
05809949,9,5,4,0,1,1,0,1,1
05810661,11,3,8,0,1,1,0,1,1
05811355,12,2,10,0,1,1,0,1,1
05811364,21,5,16,0,1,1,0,1,1
05811374,12,2,10,0,1,1,0,1,1
05811376,7,1,6,0,1,1,0,1,1
05811470,7,3,4,0,0,0,0,0,1
05811471,4,0,4,0,0,0,0,0,1
05811807,5,1,4,0,1,1,0,0,1
05811851,7,3,4,0,1,1,0,1,0
05812162,3,0,3,0,0,0,0,0,1
05812177,6,0,6,0,0,0,0,0,1
05813190,3,0,3,0,0,0,0,0,1
05814349,4,3,1,0,2,2,0,0,1
05814584,25,4,21,0,1,1,0,1,1
05814586,18,5,13,0,1,1,0,1,1
05814704,5,0,5,0,0,0,0,0,1
05818571,4,2,2,0,1,1,0,0,0
05819097,6,4,2,0,1,1,0,0,0
05819791,52,9,43,0,0,0,0,0,0
05821054,3,3,0,0,2,2,0,0,1
05821406,3,0,3,0,0,0,0,0,1
05821594,5,2,3,0,1,1,0,0,0
05821633,3,2,1,0,1,1,0,0,1
05821987,20,4,16,0,2,2,0,2,1
05822343,4,3,1,0,1,1,0,0,1
05822489,14,3,11,0,2,1,1,2,1
05822581,32,8,24,0,0,0,0,0,0
05822622,3,2,1,0,1,1,0,0,1
05822773,4,0,4,0,0,0,0,0,1
05822854,6,3,3,0,1,1,0,0,1
05823597,8,4,4,0,2,2,0,0,0
05824277,9,5,4,0,1,1,0,1,1
05824433,46,0,46,0,2,2,0,1,1
05825057,5,3,2,0,2,2,0,0,1
05825189,4,3,1,0,2,2,0,0,1
05825670,11,0,11,0,1,1,0,1,1
05825858,9,0,9,0,1,1,0,1,1
05826330,5,3,2,0,2,2,0,0,0
05826404,3,2,1,0,1,1,0,0,1
05826743,6,2,4,0,0,0,0,0,0
05827191,20,8,12,0,0,0,0,0,0
05827530,6,2,4,0,2,2,0,0,0
05828020,4,0,4,0,0,0,0,0,1
05829346,4,0,4,0,0,0,0,0,1
05829570,24,8,16,0,0,0,0,0,1
05830475,4,3,1,0,2,2,0,0,1
05830499,5,3,2,0,2,2,0,0,1
05831748,14,0,14,0,0,0,0,0,1
05833170,15,6,9,0,1,1,0,1,1
05833211,14,0,14,0,0,0,0,0,0
05837232,33,9,24,0,0,0,0,0,0
05838734,5,0,5,0,0,0,0,0,1
05838740,4,2,2,0,0,0,0,0,1
05838921,3,0,3,0,0,0,0,0,1
05839399,23,0,23,0,1,1,0,1,1
05840308,4,1,3,0,1,1,0,0,0
05840738,4,2,2,0,3,1,2,1,0
05841700,2,2,0,0,1,1,0,0,1
05842963,6,3,3,0,1,1,0,1,0
05844296,13,1,12,0,4,2,2,1,1
05844872,2,2,0,0,1,1,0,0,1
05846544,15,2,13,0,1,1,0,1,1
05848118,5,2,3,0,1,1,0,0,1
05848284,3,3,0,0,1,1,0,0,0
05848380,10,4,6,0,1,1,0,1,1
05848676,4,0,4,0,0,0,0,0,0
05848756,12,2,10,0,1,1,0,0,1
05849833,19,3,16,0,2,2,0,2,1
05850751,14,2,12,0,1,1,0,1,1
05853624,4,3,1,0,2,2,0,0,0
05853895,11,3,8,0,2,2,0,1,1
05855946,5,4,1,0,1,1,0,0,0
05856137,18,3,15,0,5,1,4,5,1
05858062,6,2,4,0,1,1,0,0,0
05860067,13,1,12,0,1,1,0,1,1
05860068,13,1,12,0,1,1,0,1,1
05860075,13,1,12,0,1,1,0,1,1
05860291,13,1,12,0,1,1,0,1,1
05860966,7,4,3,0,4,4,0,0,1
05861345,25,9,16,0,0,0,0,0,0
05864014,37,10,27,0,0,0,0,0,0
05864023,4,3,1,0,1,1,0,0,1
05865116,7,2,5,0,1,1,0,1,1
05865642,9,5,4,0,1,1,0,0,0
05869077,5,3,2,0,1,1,0,0,0
05869088,17,3,14,0,2,1,1,0,0
05870117,4,2,2,0,1,1,0,0,0
05871926,9,3,6,0,1,1,0,0,1
05873752,15,0,15,0,1,1,0,1,1
05874483,5,1,4,0,1,1,0,0,0
05874840,17,2,15,0,1,1,0,1,1
05875221,8,0,8,0,0,0,0,0,1
05875926,5,2,3,0,0,0,0,0,0
05876695,13,2,11,0,1,1,0,1,1
05876737,16,2,14,0,1,1,0,1,1
05877112,5,3,2,0,2,2,0,0,0
05877488,4,2,2,0,1,1,0,0,0
05879337,17,7,10,0,0,0,0,0,0
05879510,23,5,18,0,0,0,0,0,0
05880082,6,4,2,0,4,4,0,2,1
05880085,6,4,2,0,4,4,0,2,1
05880104,6,4,2,0,4,4,0,2,1
05880739,6,4,2,0,4,4,0,2,1
05880834,7,4,3,0,1,1,0,0,0
05881529,5,4,1,0,1,1,0,0,0
05881755,6,4,2,0,4,4,0,2,1
05882061,14,10,4,0,0,0,0,0,0
05882818,21,5,16,0,0,0,0,0,1
05883014,44,11,33,0,0,0,0,0,0
05883936,2,2,0,0,1,1,0,0,0
05887080,8,3,5,2,1,1,0,1,0
05887222,16,4,12,0,2,2,0,2,1
05889570,3,3,0,0,2,2,0,0,0
05891434,22,7,15,0,1,1,0,1,0
05891911,8,2,6,0,2,2,0,2,0
05892581,4,3,1,0,1,1,0,0,0
05893279,7,4,3,0,1,1,0,1,1
05893492,15,4,11,0,1,1,0,1,0
05894329,17,2,15,0,1,1,0,1,1
05894734,8,5,3,0,3,1,2,1,0
05894739,3,0,3,0,0,0,0,0,1
05895178,13,3,10,0,0,0,0,0,0
05895219,19,2,17,0,1,1,0,1,1
05896488,4,1,3,0,0,0,0,0,0
05897167,7,2,5,0,2,2,0,0,1
05898666,4,3,1,0,4,4,0,0,1
05900656,30,13,17,0,0,0,0,0,0
05900942,19,3,16,0,7,3,4,0,0
05902298,8,3,5,0,2,2,0,0,0
05902755,4,2,2,0,2,2,0,0,0
05902955,3,2,1,0,1,1,0,0,0
05903628,6,0,6,0,1,1,0,0,1
05903745,14,2,12,0,1,1,0,1,0
05905521,11,4,7,0,1,1,0,1,0
05905828,4,2,2,0,1,1,0,0,0
05905835,7,3,4,0,1,1,0,0,1
05907189,2,2,0,0,2,2,0,0,0
05909399,5,0,5,0,0,0,0,0,1
05909747,3,3,0,0,2,2,0,0,0
05911000,10,5,5,0,3,3,0,0,1
05911004,7,1,6,0,2,2,0,0,1
05911037,7,0,7,0,0,0,0,0,1
05914795,5,0,5,0,1,1,0,1,0
05915058,3,2,1,0,1,1,0,0,0
05916350,9,7,2,0,0,0,0,0,0
05917006,4,2,2,0,2,2,0,0,0
05917703,4,2,2,0,1,1,0,0,0
05918513,9,2,7,0,0,0,0,0,0
05918993,4,2,2,0,2,2,0,0,1
05920587,4,1,3,0,1,1,0,0,0
05923364,3,0,3,0,2,2,0,0,1
05929419,4,2,2,0,1,1,0,0,0
05929681,9,4,5,0,1,1,0,1,1
05929901,4,1,3,0,1,1,0,0,1
05929972,22,3,19,0,1,1,0,1,0
05931495,5,0,5,0,2,2,0,0,1
05931821,4,2,2,0,1,1,0,0,0
05932194,12,2,10,0,1,1,0,1,1
05932945,21,10,11,0,0,0,0,0,1
05933789,3,0,3,0,0,0,0,0,1
05933895,5,1,4,0,3,1,2,0,1
05934373,10,0,10,0,1,1,0,1,1
05935270,9,2,7,0,2,0,2,0,0
05936827,5,1,4,0,1,1,0,0,0
05936970,6,1,5,0,0,0,0,0,0
05937535,7,2,5,0,1,1,0,0,0
05939726,11,0,11,0,0,0,0,0,1
05940040,15,7,8,0,1,1,0,0,1
05940087,25,6,19,0,2,1,1,2,1
05940223,10,0,10,0,0,0,0,0,1
05940775,11,3,8,0,2,2,0,0,0
05941261,11,4,7,0,0,0,0,0,1
05941568,6,3,3,0,1,1,0,1,1
05942095,5,1,4,0,1,1,0,0,0
05943470,28,6,22,0,2,2,0,2,1
05945222,25,4,21,0,1,1,0,1,1
05945291,24,4,20,0,1,1,0,1,1
05945307,24,4,20,0,1,1,0,1,1
05945308,24,4,20,0,1,1,0,1,1
05945309,20,3,17,0,1,1,0,1,1
05945310,10,0,10,0,0,0,0,0,1
05945314,24,4,20,0,1,1,0,1,1
05945320,24,4,20,0,1,1,0,1,1
05945357,10,0,10,0,0,0,0,0,1
05945367,24,4,20,0,1,1,0,1,1
05945487,24,4,20,0,1,1,0,1,1
05946111,24,4,20,0,1,1,0,1,1
05946283,7,0,7,0,0,0,0,0,1
05946559,14,4,10,0,2,2,0,2,1
05947232,2,2,0,0,1,1,0,0,0
05947399,2,2,0,0,2,2,0,0,0
05947493,4,0,4,0,1,1,0,0,0
05951147,8,0,8,0,1,1,0,1,1
05952892,8,3,5,0,1,1,0,1,1
05953015,15,6,9,0,0,0,0,0,1
05956357,5,3,2,0,0,0,0,0,0
05958166,5,4,1,0,0,0,0,0,0
05958372,3,0,3,0,0,0,0,0,1
05959432,11,3,8,0,1,1,0,1,1
05961262,5,3,2,0,1,1,0,0,1
05963314,9,1,8,0,0,0,0,0,0
05963334,9,4,5,0,1,1,0,1,1
05963337,9,4,5,0,1,1,0,1,1
05963433,9,4,5,0,1,1,0,1,1
05963845,5,0,5,0,0,0,0,0,1
05964221,4,1,3,0,2,1,1,0,0
05964261,7,2,5,0,1,1,0,0,0
05965794,2,0,2,0,0,0,0,0,1
05967946,19,0,19,0,0,0,0,0,1
05968486,11,2,9,0,3,2,1,0,0
05969853,15,4,11,0,0,0,0,0,1
05969869,2,2,0,0,1,1,0,0,0
05969922,19,7,12,0,0,0,0,0,0
SC072316,18,0,18,0,1,1,0,1,1
SC075133,48,7,41,0,1,1,0,1,1
SC075638,12,3,9,0,1,1,0,1,1
SC075790,11,1,10,0,2,1,1,1,1
SC076037,56,7,49,0,9,6,3,0,1
SC076501,40,2,38,0,1,1,0,1,1
SC079500,5,4,1,0,1,1,0,0,1
SC084281,21,0,21,0,0,0,0,0,1
SC090149,34,0,34,0,1,1,0,1,1
SC090317,16,4,12,0,1,1,0,1,1
SC090492,22,0,22,0,1,1,0,1,1
SC090546,3,3,0,0,2,2,0,0,0
SC093413,31,2,29,0,2,1,1,2,1
SC093685,26,8,18,0,1,1,0,1,1
SC094479,35,3,32,0,2,2,0,2,1
SC094860,78,10,68,0,0,0,0,0,1
SC097140,19,3,16,0,1,1,0,1,0
SC097606,67,5,62,0,1,1,0,1,1
SC098858,21,8,13,0,1,1,0,1,1
SC099391,21,0,21,0,1,1,0,1,1
SC100700,18,0,18,0,1,1,0,1,1
SC101839,10,0,10,0,1,1,0,1,1
SC108972,9,3,6,0,1,1,0,1,1
SC109131,21,10,11,0,5,1,4,1,1
SC111806,16,2,14,0,1,1,0,1,0
SC113579,9,2,7,0,1,1,0,1,1
SC115235,30,2,28,0,2,1,1,2,1
SC115534,15,4,11,0,2,2,0,2,1
SC115535,6,0,6,0,0,0,0,0,1
SC117747,13,4,9,0,3,3,0,0,1
SC118811,46,4,42,0,1,1,0,1,1
SC119306,6,0,6,0,0,0,0,0,1
SC119419,9,2,7,0,2,2,0,0,1
SC121126,47,3,44,0,2,1,1,2,1
SC126384,33,0,33,0,0,0,0,0,1
SC127012,62,8,54,0,1,1,0,1,1
SC128566,43,3,40,0,1,1,0,1,1
SC128650,21,1,20,0,2,1,1,1,1
SC129785,32,6,26,0,0,0,0,0,1
SC130871,24,6,18,0,1,1,0,1,1
SC135479,14,3,11,0,2,2,0,0,1
SC136296,53,3,50,0,1,1,0,1,1
SC138897,26,0,26,0,0,0,0,0,1
SC139271,16,7,9,0,0,0,0,0,1
SC139616,40,0,40,0,0,0,0,0,1
SC139617,51,3,48,0,1,1,0,1,1
SC140381,25,0,25,0,1,1,0,1,1
SC141431,51,0,51,0,0,0,0,0,0
SC143746,57,0,57,0,0,0,0,0,1
SC144767,36,4,32,0,1,1,0,1,1
SC145163,17,0,17,0,0,0,0,0,1
SC147919,10,0,10,0,0,0,0,0,1
SC149440,41,10,31,0,1,1,0,1,1
SC150493,12,4,8,0,1,1,0,1,1
SC150590,48,11,37,0,0,0,0,0,1
SC153019,12,4,8,0,1,1,0,1,1
SC153205,5,3,2,0,1,1,0,0,0
SC154655,43,1,42,0,0,0,0,0,1
SC155637,22,0,22,0,0,0,0,0,1
SC156302,28,5,23,0,0,0,0,0,1
SC157185,17,8,9,0,1,1,0,1,1
SC158731,23,5,18,0,1,1,0,1,1
SC160123,25,3,22,0,2,1,1,2,1
SC160930,19,3,16,0,2,2,0,2,1
SC162342,13,6,7,0,1,1,0,1,1
SC162868,23,5,18,0,1,1,0,1,1
SC164619,9,0,9,0,0,0,0,0,1
SC165107,14,3,11,0,1,1,0,0,1
SC166146,27,4,23,0,2,2,0,2,1
SC167168,11,3,8,0,1,1,0,1,1
SC167959,23,4,19,0,2,1,1,2,1
SC168786,16,3,13,0,1,1,0,1,1
SC169985,13,3,10,0,3,3,0,0,1
SC170010,7,2,5,0,2,2,0,0,0
SC170841,26,3,23,0,1,1,0,1,1
SC171891,76,4,72,1,0,0,0,0,1
SC171894,5,0,5,0,1,1,0,0,1
SC172958,5,2,3,0,1,1,0,0,0
SC173232,89,12,77,0,0,0,0,0,1
SC174292,13,3,10,0,1,1,0,0,1
SC174924,21,3,18,0,1,1,0,1,1
SC175589,11,5,6,0,2,2,0,0,1
SC175918,81,8,73,0,0,0,0,0,1
SC176165,61,0,61,0,0,0,0,0,1
SC178108,25,2,23,0,1,1,0,1,1
SC178109,20,4,16,0,2,1,1,2,1
SC179111,20,8,12,0,0,0,0,0,1
SC180199,17,0,17,0,1,1,0,1,1
SC181688,11,0,11,0,0,0,0,0,1
SC182553,7,3,4,0,1,1,0,0,0
SC184082,12,4,8,0,1,1,0,1,1
SC185657,22,4,18,0,1,1,0,1,1
SC186520,16,3,13,0,1,1,0,1,1
SC187460,19,6,13,0,1,1,0,1,1
SC188819,83,4,79,0,0,0,0,0,1
SC189034,5,0,5,0,0,0,0,0,1
SC189253,27,10,17,0,2,0,2,0,1
SC189419,17,4,13,0,1,1,0,1,1
SC191763,12,0,12,0,0,0,0,0,1
SC192082,10,5,5,0,2,2,0,2,1
SC192142,32,10,22,0,3,3,0,3,1
SC192174,18,4,14,0,1,1,0,1,1
SC192450,32,0,32,0,0,0,0,0,1
SC192451,32,0,32,0,0,0,0,0,1
SC192452,32,0,32,0,0,0,0,0,1
SC192453,27,4,23,0,1,1,0,1,1
SC192454,25,0,25,0,0,0,0,0,1
SC192455,32,0,32,0,0,0,0,0,1
SC192456,32,0,32,0,0,0,0,0,1
SC196138,6,2,4,0,1,1,0,0,1
SC196608,31,5,26,0,1,1,0,1,1
SC198780,45,8,37,0,0,0,0,0,1
SC200185,5,3,2,0,3,3,0,0,0
SC200212,32,4,28,0,1,1,0,1,1
SC200884,5,3,2,0,1,1,0,0,1
SC202394,20,2,18,0,1,1,0,1,1
SC205786,6,4,2,0,2,2,0,0,0
SC206116,21,0,21,0,0,0,0,0,1
SC207810,5,0,5,0,1,1,0,0,1
SC207825,5,3,2,0,1,1,0,0,0
SC208030,14,0,14,0,0,0,0,0,1
SC209180,16,0,16,0,0,0,0,0,1
SC209205,13,0,13,0,1,1,0,1,1
SC209206,18,6,12,0,0,0,0,0,1
SC210035,21,3,18,0,1,1,0,1,1
SC211594,25,3,22,0,3,1,2,3,1
SC213049,15,5,10,0,3,1,2,1,1
SC213374,38,4,34,0,1,1,0,1,1
SC213376,38,4,34,0,1,1,0,1,1
SC213377,38,4,34,0,1,1,0,1,1
SC214204,14,4,10,0,2,2,0,2,1
SC214564,119,22,97,0,0,0,0,0,1
SC216881,11,0,11,0,1,1,0,1,1
SC217231,17,2,15,0,1,1,0,1,1
SC218749,13,4,9,0,1,1,0,1,1
SC218813,78,13,65,0,1,1,0,1,1
SC219347,4,3,1,0,2,2,0,0,0
SC220379,10,0,10,0,0,0,0,0,1
SC220736,18,0,18,0,0,0,0,0,1
SC221290,24,4,20,0,2,1,1,2,1
SC221428,23,8,15,0,0,0,0,0,1
SC223172,9,5,4,0,1,1,0,0,1
SC225393,5,0,5,0,0,0,0,0,1
SC226006,8,2,6,0,1,1,0,0,1
SC228859,16,0,16,0,0,0,0,0,1
SC230591,5,2,3,0,1,1,0,0,1
SC230949,33,1,32,0,1,1,0,0,1
SC232581,11,2,9,0,1,1,0,0,1
SC232862,5,3,2,0,1,1,0,0,1
SC233416,21,3,18,0,2,2,0,2,1
SC235634,9,5,4,0,3,3,0,0,0
SC236975,9,2,7,0,1,1,0,0,0
SC238922,12,0,12,0,1,1,0,1,1
SC239934,38,0,38,0,0,0,0,0,1
SC240234,18,8,10,0,0,0,0,0,1
SC243133,8,0,8,0,0,0,0,0,1
SC243294,19,0,19,0,0,0,0,0,1
SC243668,12,6,6,0,1,1,0,1,0
SC244283,18,2,16,0,1,1,0,1,1
SC245711,11,4,7,0,2,1,1,2,1
SC246318,18,4,14,0,0,0,0,0,1
SC247348,14,3,11,0,1,1,0,1,1
SC255427,12,3,9,0,1,1,0,1,1
SC255429,37,4,33,0,1,1,0,1,1
SC255430,20,7,13,0,2,1,1,2,1
SC256248,13,10,3,0,1,1,0,1,1
SC256649,7,2,5,0,1,1,0,1,1
SC259049,16,0,16,0,0,0,0,0,1
SC262079,10,2,8,0,2,1,1,0,1
SC262556,12,0,12,0,0,0,0,0,1
SC263305,11,0,11,0,0,0,0,0,1
SC269639,36,1,35,0,1,1,0,1,1
SC270227,15,5,10,0,1,1,0,1,1
SC271163,6,3,3,1,1,1,0,1,0
SC274559,11,4,7,0,1,1,0,1,1
SC275002,8,2,6,0,1,1,0,1,1
SC275023,4,1,3,0,2,2,0,0,0
SC277210,12,0,12,0,0,0,0,0,1
SC280687,4,0,4,0,0,0,0,0,1
SC285432,14,3,11,0,0,0,0,0,0
SC285894,13,4,9,0,1,1,0,1,1
SC288178,16,3,13,0,1,1,0,1,1
SC288265,6,4,2,0,1,1,0,1,1
SC291056,14,7,7,0,1,1,0,1,0
SC291287,3,0,3,0,0,0,0,0,1
SC304609,15,5,10,0,2,2,0,2,1
SC305524,12,4,8,0,1,1,0,1,1
SC308948,10,0,10,0,0,0,0,0,1
SC311652,16,6,10,0,1,1,0,1,1
SC312299,16,4,12,0,2,2,0,2,1
SC312841,8,0,8,0,0,0,0,0,1
SC312980,8,2,6,0,1,1,0,1,1
SC312981,8,0,8,0,0,0,0,0,1
SC313818,24,8,16,1,1,1,0,1,1
SC313819,23,6,17,1,3,3,0,2,1
SC314690,5,2,3,0,1,1,0,0,1
SC314976,3,0,3,0,1,1,0,0,0
SC315853,10,2,8,0,4,2,2,0,1
SC318203,6,0,6,0,0,0,0,0,1
SC320482,4,2,2,0,1,1,0,1,1
SC321451,22,7,15,0,1,1,0,0,1
SC332758,13,2,11,0,1,1,0,1,1
SC333124,5,2,3,0,1,1,0,0,1
SC333202,8,2,6,0,1,1,0,1,1
SC334574,6,3,3,0,1,1,0,0,1
SC334739,6,3,3,1,2,2,0,1,1
SC334811,7,0,7,0,0,0,0,0,1
SC335804,16,4,12,0,2,2,0,2,1
SC338536,7,5,2,0,1,1,0,1,0
SC339123,9,5,4,0,1,1,0,0,1
SC341063,7,3,4,0,1,1,0,0,1
SC348293,6,6,0,0,5,3,2,4,1
SC353717,7,0,7,0,0,0,0,0,0
SC355383,12,4,8,0,1,1,0,1,1
SC359252,3,2,1,0,2,2,0,0,1
SC362431,5,2,3,0,1,1,0,1,1
SC364401,2,1,1,0,2,1,1,0,1
SC365458,1,1,0,0,1,1,0,0,1
SC369920,4,2,2,0,1,1,0,0,0
SC373349,3,2,1,0,1,1,0,0,0
SC373389,4,1,3,0,2,1,1,1,1
SC375774,2,2,0,0,1,1,0,0,1
SC381243,8,5,3,0,3,3,0,0,1
SC382573,8,5,3,0,1,1,0,1,1
SC385905,4,2,2,0,1,1,0,1,1
SC388092,4,2,2,1,1,1,0,1,1
SC389092,6,3,3,1,1,1,0,1,1
SC389810,4,0,4,0,0,0,0,0,1
SC392759,8,0,8,0,1,1,0,1,1
SC393096,8,2,6,0,1,1,0,1,1
SC393097,8,0,8,0,0,0,0,0,1
SC393098,8,4,4,0,3,1,2,3,1
SC394595,1,1,0,0,1,1,0,0,0
SC394719,1,1,0,0,1,1,0,0,1
SC399384,5,0,5,0,0,0,0,0,1
SC400790,2,2,0,0,1,1,0,0,0
SC402300,1,1,0,0,1,1,0,0,0
SC407442,5,3,2,0,1,1,0,0,1
SC407876,8,5,3,0,1,1,0,1,1
SC417637,8,4,4,1,1,1,0,1,1
SC418838,13,5,8,0,1,1,0,1,1
SC420393,26,11,15,0,0,0,0,0,0
SC422707,3,1,2,0,3,1,2,0,0
SC425069,2,2,0,0,1,1,0,0,0
SC429705,6,0,6,0,0,0,0,0,1
SC430922,2,2,0,0,2,2,0,0,1
SC431138,5,3,2,0,4,4,0,0,1
SC447499,2,2,0,0,1,1,0,0,0
SC448078,3,1,2,0,1,0,1,0,0
SC453327,14,5,9,0,2,1,1,2,1
SC458756,4,0,4,0,0,0,0,0,1
SC463080,6,3,3,0,4,4,0,0,1
SC463798,11,4,7,0,2,2,0,2,1
SC465243,1,0,1,0,0,0,0,0,0
SC466184,7,1,6,0,2,1,1,1,1
SC472048,11,4,7,0,2,2,0,2,1
SC472800,13,7,6,0,0,0,0,0,0
SC474851,3,3,0,0,1,1,0,0,1
SC475828,7,0,7,0,0,0,0,0,0
SC478633,2,2,0,0,1,1,0,0,0
SC483484,13,10,3,0,2,2,0,0,1
SC495997,2,2,0,0,1,1,0,0,1
SC500555,2,2,0,0,1,1,0,0,1
SC502326,1,1,0,0,1,1,0,0,0
SC504497,1,0,1,0,0,0,0,0,0
SC512680,2,1,1,0,1,1,0,0,0
SC514201,2,0,2,0,0,0,0,0,1
SC521276,1,1,0,0,1,1,0,1,0
SC533614,2,2,0,0,4,4,0,0,1
SC535054,1,0,1,0,0,0,0,0,0
SC535413,3,0,3,0,2,2,0,0,1
SC536073,1,0,1,0,0,0,0,0,0
SC537035,1,0,1,0,1,1,0,0,0
SC543655,3,3,0,0,1,1,0,1,0
SC543681,3,3,0,0,1,1,0,1,0
SC546068,6,4,2,0,5,2,3,4,1
SC546223,2,2,0,0,1,1,0,0,1
SC546594,2,2,0,0,1,1,0,1,1
SC548014,2,2,0,0,1,1,0,0,1
SC552930,1,1,0,0,0,0,0,0,0
SC553564,1,1,0,0,1,1,0,0,0
SC555814,1,1,0,0,1,1,0,0,0
SC556380,1,1,0,0,1,1,0,0,0
SC562669,2,2,0,0,2,2,0,0,0
SC562874,2,2,0,0,1,1,0,0,1
SC565290,1,0,1,0,1,1,0,0,0
SC574401,3,1,2,0,2,1,1,0,0
SC576111,2,2,0,0,2,2,0,0,1
SC576184,1,1,0,0,1,1,0,1,1
SC578062,1,0,1,0,1,1,0,0,0
SC578778,3,2,1,0,5,4,1,1,1
SC586197,4,3,1,0,1,1,0,0,1
SC587170,1,1,0,0,1,1,0,0,0
SC588875,3,3,0,0,1,1,0,1,1
SC590903,2,2,0,0,2,2,0,0,1
SC590904,2,2,0,0,2,2,0,0,1
SC590905,2,2,0,0,2,2,0,0,1
SC590906,2,2,0,0,2,2,0,0,1
SC590907,2,2,0,0,2,2,0,0,1
SC596421,5,4,1,0,1,1,0,1,1
SC596422,5,5,0,0,0,0,0,0,1
SC597202,1,1,0,0,1,1,0,0,0
SC600382,3,2,1,0,2,2,0,2,1
SC600637,1,1,0,0,1,1,0,0,1
SC601169,2,1,1,0,0,0,0,0,0
SC601608,1,1,0,0,1,1,0,0,0
SC601917,5,5,0,0,1,1,0,0,1
SC603058,4,4,0,0,1,1,0,1,1
SC603933,2,2,0,0,1,1,0,0,1
SC612323,2,2,0,0,1,1,0,0,1
SC612938,1,1,0,0,1,1,0,1,0
SC615258,1,1,0,0,2,2,0,0,0
SC615929,2,2,0,0,2,2,0,0,0
SC618765,1,1,0,0,1,1,0,0,0
SC620316,1,1,0,0,1,1,0,0,0
SC622433,2,2,0,0,2,2,0,0,0
SC623515,2,2,0,0,2,1,1,2,1
SC631540,1,1,0,0,1,1,0,0,0
SL001534,0,0,0,0,0,0,0,0,0
SL002158,0,0,0,0,0,0,0,0,0
SL002163,0,0,0,0,0,0,0,0,0
SL002166,0,0,0,0,0,0,0,0,0
SL003587,0,0,0,0,0,0,0,0,0
SL008028,0,0,0,0,0,0,0,0,0
SL008788,0,0,0,0,0,0,0,0,0
SL010171,0,0,0,0,0,0,0,0,0
SL010231,0,0,0,0,0,0,0,0,0
SL011929,0,0,0,0,0,0,0,0,0
SL012256,0,0,0,0,1,1,0,0,0
SL012438,0,0,0,0,0,0,0,0,0
SL018733,0,0,0,0,0,0,0,0,0
SL018734,0,0,0,0,0,0,0,0,0
SL018736,0,0,0,0,0,0,0,0,0
SL018939,0,0,0,0,0,0,0,0,0
SL022276,0,0,0,0,0,0,0,0,0
SL022617,0,0,0,0,0,0,0,0,0
SL027025,0,0,0,0,0,0,0,0,0
SL027923,0,0,0,0,1,1,0,0,0
SL030632,0,0,0,0,1,1,0,0,0
SL031264,0,0,0,0,0,0,0,0,0
SL032372,0,0,0,0,0,0,0,0,0
SO301438,12,0,12,0,0,0,0,0,1
SO301528,4,0,4,0,0,0,0,0,1
SO301790,8,0,8,0,0,0,0,0,1
SO301792,5,5,0,0,1,1,0,0,1
SO301878,3,3,0,0,1,1,0,1,1
SO301976,5,0,5,0,0,0,0,0,1
SO302402,2,2,0,0,0,0,0,0,0
SO302766,11,8,3,0,1,1,0,0,1
SO303886,3,3,0,0,1,1,0,0,1
SO304076,5,0,5,0,1,1,0,0,0
SO305086,60,0,60,0,0,0,0,0,1
SO305217,4,2,2,0,1,1,0,0,1
SO305470,4,3,1,0,3,2,1,3,1
SO306320,13,12,1,0,1,1,0,0,0
SO306433,6,6,0,0,2,2,0,0,1
SO306448,5,5,0,0,2,2,0,0,1
SO306564,15,15,0,0,1,1,0,0,0
SP02160R,0,0,0,0,0,0,0,0,0
SP02382R,0,0,0,0,0,0,0,0,0
ZC000150,9,4,5,0,0,0,0,0,0
ZC000169,13,3,10,0,0,0,0,0,0
02930355,23,0,23,0,0,0,0,0,1
02931186,8,0,8,0,2,2,0,0,0
02931643,48,4,44,0,0,0,0,0,1
02933627,12,4,8,0,1,1,0,1,0
02936084,10,2,8,0,0,0,0,0,0
02936262,10,0,10,0,0,0,0,0,1
02936276,7,2,5,0,1,1,0,0,0
02936831,22,2,20,0,1,1,0,0,0
02937075,11,2,9,0,1,1,0,0,1
02937203,27,3,24,0,0,0,0,0,1
02937296,36,10,26,0,0,0,0,0,1
02938700,19,3,16,0,1,1,0,1,1
02938723,18,3,15,0,1,1,0,1,1
02938965,9,0,9,0,0,0,0,0,0
02938993,60,3,57,0,1,1,0,1,1
02938994,44,2,42,0,1,1,0,1,1
02939376,8,0,8,0,1,1,0,0,0
02939574,19,0,19,0,2,2,0,0,0
02940993,6,0,6,0,0,0,0,0,1
02942310,7,2,5,0,2,2,0,0,1
02943978,20,1,19,0,1,1,0,1,1
02944000,21,0,21,0,0,0,0,0,1
02944269,23,6,17,0,1,1,0,1,0
02944310,10,0,10,0,0,0,0,0,1
02945478,5,3,2,0,1,1,0,0,1
02946205,17,0,17,0,0,0,0,0,0
02946644,11,3,8,0,1,1,0,1,0
02946679,59,3,56,0,1,1,0,1,1
02947208,26,0,26,0,0,0,0,0,1
02947500,16,2,14,0,1,1,0,0,0
02947527,16,3,13,0,1,1,0,1,1
02948329,10,3,7,0,1,1,0,1,1
02949715,12,6,6,0,2,1,1,0,0
02950349,6,3,3,0,2,2,0,0,0
02952260,51,11,40,0,2,2,0,2,1
02953045,13,0,13,0,1,1,0,1,0
02955169,23,8,15,0,2,1,1,0,0
02957012,22,3,19,0,1,1,0,1,1
02957181,33,2,31,0,1,1,0,1,1
02957327,65,10,55,0,1,1,0,1,1
02957574,4,3,1,0,2,2,0,0,0
02957968,24,0,24,0,0,0,0,0,1
02958399,31,6,25,0,1,1,0,1,1
02960039,10,2,8,0,1,1,0,1,1
02960617,11,10,1,0,0,0,0,0,1
02962116,66,5,61,0,0,0,0,0,0
02962601,45,9,36,0,0,0,0,0,0
02964844,22,5,17,0,1,1,0,1,1
02964988,7,3,4,0,1,1,0,0,0
02965040,8,4,4,0,3,3,0,0,1
02966054,63,6,57,0,1,1,0,1,1
02966113,30,3,27,0,1,1,0,1,1
02966357,6,4,2,0,3,3,0,0,1
02966638,5,3,2,0,0,0,0,0,0
02966640,5,3,2,0,0,0,0,0,0
02966946,33,4,29,0,1,1,0,1,1
02967121,77,12,65,0,0,0,0,0,0
02968233,9,4,5,0,1,1,0,0,1
02968645,16,2,14,0,1,1,0,1,1
02968916,19,4,15,0,1,1,0,1,1
02969614,14,0,14,0,0,0,0,0,1
02970035,16,7,9,0,1,1,0,1,1
02970218,23,3,20,0,1,1,0,1,0
02971428,11,0,11,0,0,0,0,0,1
02973057,36,0,36,0,1,1,0,1,1
02973246,20,1,19,0,1,1,0,0,1
02973571,10,3,7,0,2,0,2,2,1
02973913,11,3,8,0,1,1,0,0,0
02974333,36,6,30,0,1,1,0,1,1
02974488,16,2,14,0,1,1,0,1,1
02974995,15,0,15,0,0,0,0,0,1
02975261,32,7,25,0,0,0,0,0,0
02975955,4,2,2,0,2,2,0,0,0
02976601,24,0,24,0,0,0,0,0,1
02976748,36,9,27,0,1,1,0,0,1
02977555,9,3,6,0,2,2,0,0,0
02978176,4,0,4,0,0,0,0,0,0
02978412,42,1,41,0,1,1,0,1,1
02981163,9,4,5,0,1,1,0,0,0
02981969,9,0,9,0,0,0,0,0,1
02984320,47,5,42,0,0,0,0,0,1
02984635,9,2,7,0,1,1,0,0,1
02985190,28,4,24,0,1,1,0,1,1
02989577,31,0,31,0,1,1,0,1,0
02990119,13,0,13,0,0,0,0,0,1
02990783,120,21,99,0,0,0,0,0,0
02991857,14,3,11,0,2,2,0,0,0
02992457,28,5,23,0,0,0,0,0,0
02992862,16,0,16,0,0,0,0,0,1
02993822,24,7,17,0,0,0,0,0,0
02994482,8,3,5,0,2,2,0,0,0
02995748,16,4,12,0,1,1,0,0,1
02996620,25,0,25,0,0,0,0,0,1
02997067,28,6,22,0,0,0,0,0,1
03001459,13,3,10,0,1,1,0,0,1
03002306,9,2,7,0,2,2,0,0,1
03002336,9,3,6,0,2,2,0,0,0
03003797,21,0,21,0,0,0,0,0,1
03003852,6,0,6,0,0,0,0,0,1
03006074,5,3,2,0,2,2,0,0,1
03007386,6,3,3,0,1,1,0,0,1
03007536,30,1,29,0,1,1,0,1,1
03007934,45,2,43,0,1,1,0,1,1
03007935,45,2,43,0,1,1,0,1,1
03007938,40,2,38,0,1,1,0,1,1
03007943,33,2,31,0,1,1,0,1,1
03007944,49,2,47,0,1,1,0,1,1
03008745,12,5,7,0,0,0,0,0,1
03009473,10,3,7,0,3,3,0,1,0
03010321,45,3,42,0,1,1,0,1,1
03010919,45,3,42,0,1,1,0,1,1
03011024,4,0,4,0,0,0,0,0,1
03011029,57,2,55,0,1,1,0,1,1
03011193,65,4,61,0,1,1,0,1,1
03012624,15,0,15,0,0,0,0,0,1
03013232,39,3,36,0,1,1,0,1,1
03013518,10,2,8,0,1,1,0,0,0
03014422,18,4,14,0,0,0,0,0,0
03015817,12,0,12,0,0,0,0,0,1
03016120,9,2,7,0,2,2,0,0,1
03016827,6,3,3,0,2,2,0,0,0
03017503,15,3,12,0,2,2,0,0,1
03017841,28,14,14,0,2,1,1,2,0
03018113,5,3,2,0,2,2,0,0,1
03019029,14,1,13,0,1,1,0,1,1
03019717,13,3,10,0,0,0,0,0,1
03019773,29,0,29,0,1,1,0,1,1
03020005,31,10,21,0,0,0,0,0,0
03020693,19,0,19,0,1,1,0,1,1
03022441,6,2,4,0,1,1,0,0,0
03023493,44,6,38,0,1,1,0,1,1
03024921,11,0,11,0,0,0,0,0,1
03025491,19,5,14,0,1,1,0,1,0
03026882,7,2,5,0,0,0,0,0,0
03027761,5,3,2,0,2,2,0,0,0
03028365,6,1,5,0,1,1,0,0,1
03029439,36,0,36,0,0,0,0,0,1
03029896,6,4,2,0,2,2,0,0,0
03030810,5,3,2,0,2,2,0,0,0
03031656,48,7,41,0,1,1,0,0,1
03032481,24,0,24,0,1,1,0,1,1
03032579,10,0,10,0,1,1,0,1,0
03032760,22,0,22,0,0,0,0,0,1
03034298,16,3,13,0,1,1,0,1,1
03035109,8,5,3,0,2,1,1,2,0
03035115,9,6,3,0,2,1,1,2,0
03035709,23,0,23,1,0,0,0,0,1
03036943,3,2,1,0,3,2,1,0,0
03037046,8,1,7,0,0,0,0,0,1
03037084,23,3,20,0,0,0,0,0,0
03037111,5,3,2,0,2,2,0,0,0
03037632,8,0,8,0,0,0,0,0,1
03037955,34,9,25,0,0,0,0,0,0
03038051,19,4,15,0,1,1,0,0,1
03038275,18,4,14,0,1,1,0,1,1
03038288,24,0,24,0,0,0,0,0,1
03038307,21,0,21,0,0,0,0,0,1
03038313,21,0,21,0,0,0,0,0,1
03038503,25,2,23,0,2,2,0,0,0
03040742,14,3,11,0,1,1,0,1,1
03041245,24,0,24,0,0,0,0,0,1
03042243,11,1,10,0,0,0,0,0,1
03042680,33,10,23,0,1,1,0,0,0
03043379,29,0,29,0,0,0,0,0,1
03043815,14,7,7,0,1,1,0,1,1
03043839,12,3,9,0,1,1,0,1,1
03044741,6,3,3,0,0,0,0,0,0
03045607,24,7,17,0,2,1,1,2,1
03046296,37,0,37,0,1,1,0,1,1
03046536,44,11,33,0,0,0,0,0,0
03046577,7,1,6,0,1,1,0,0,0
03046600,7,3,4,0,1,1,0,0,0
03047020,12,3,9,0,3,1,2,1,1
03047110,25,5,20,0,0,0,0,0,1
03047165,39,0,39,0,1,1,0,1,1
03047966,27,0,27,0,0,0,0,0,1
03048838,22,4,18,0,2,1,1,2,1
03049092,7,1,6,0,0,0,0,0,1
03049932,17,0,17,0,0,0,0,0,1
03050388,21,4,17,0,1,1,0,1,1
03050523,6,1,5,0,1,1,0,0,0
03050947,6,1,5,0,0,0,0,0,1
03051442,31,0,31,0,0,0,0,0,1
03052023,29,9,20,0,4,3,1,0,1
03053431,6,5,1,0,2,2,0,0,1
03053666,5,3,2,0,1,1,0,0,1
03054967,32,7,25,0,1,1,0,1,0
03055248,8,3,5,0,1,1,0,0,1
03056377,21,9,12,0,1,1,0,1,0
03057516,23,6,17,0,0,0,0,0,0
03059065,24,0,24,0,0,0,0,0,1
03059256,5,3,2,0,1,1,0,0,0
03060487,25,0,25,0,0,0,0,0,1
03060702,33,4,29,0,1,1,0,1,1
03062375,20,5,15,0,3,2,1,3,1
03063532,35,0,35,0,1,1,0,1,1
03063820,15,7,8,0,1,1,0,1,0
03066672,5,3,2,0,1,1,0,0,1
03070256,5,2,3,0,1,1,0,0,1
03070482,18,5,13,0,1,1,0,1,1
03072230,19,4,15,0,4,3,1,0,1
03072541,57,5,52,0,1,1,0,1,1
03073845,34,7,27,0,2,1,1,2,1
03074268,5,3,2,0,1,1,0,0,0
03074320,22,4,18,1,1,1,0,0,1
03074835,7,4,3,0,1,1,0,1,0
03077146,15,5,10,0,1,1,0,1,0
03078447,29,1,28,0,1,1,0,1,1
03079336,10,3,7,0,1,1,0,0,1
03084677,45,7,38,0,0,0,0,0,1
03084798,16,5,11,0,0,0,0,0,0
03085104,14,0,14,0,0,0,0,0,0
03085170,44,8,36,0,1,1,0,0,0
03086378,85,16,69,0,1,1,0,1,1
03086382,22,5,17,0,1,1,0,1,1
03086995,23,0,23,0,0,0,0,0,1
03087103,24,5,19,0,2,2,0,2,1
03087175,24,5,19,0,2,2,0,2,1
03087187,24,0,24,0,0,0,0,0,1
03087779,18,3,15,0,0,0,0,0,1
03088472,24,5,19,0,1,1,0,1,1
03089989,27,3,24,0,1,1,0,1,1
03091040,27,3,24,0,1,1,0,1,1
03092251,31,4,27,0,0,0,0,0,1
03092870,25,5,20,0,2,2,0,2,1
03093486,16,7,9,0,1,1,0,0,0
03094141,24,5,19,0,2,2,0,2,1
03094597,6,3,3,0,2,2,0,0,0
03095557,33,5,28,0,1,1,0,1,1
03095751,31,6,25,0,0,0,0,0,1
03097471,9,0,9,0,0,0,0,0,1
03098240,12,3,9,0,2,1,1,1,0
03098593,44,7,37,0,0,0,0,0,0
03099047,32,3,29,0,1,1,0,1,1
03099287,6,0,6,0,0,0,0,0,1
03099763,19,3,16,0,1,1,0,1,1
03100258,10,0,10,0,1,1,0,0,1
03100354,31,6,25,0,1,1,0,0,0
03101215,25,5,20,0,1,1,0,1,1
03101886,28,3,25,0,1,1,0,1,1
03102054,22,4,18,0,1,1,0,0,1
03102684,32,3,29,0,1,1,0,1,1
03104670,85,4,81,0,1,1,0,1,1
03104671,88,12,76,0,1,1,0,1,1
03106332,35,4,31,0,2,2,0,2,1
03107232,10,3,7,0,1,1,0,0,0
03107630,7,3,4,0,2,2,0,0,0
03107969,7,3,4,0,0,0,0,0,0
03109650,32,3,29,0,1,1,0,1,1
03111540,5,1,4,0,1,1,0,0,0
03114590,50,12,38,0,1,1,0,1,1
03115084,30,2,28,0,1,1,0,1,1
03115088,29,3,26,0,1,1,0,1,1
03116567,8,2,6,0,1,1,0,0,0
03116765,5,0,5,0,0,0,0,0,0
03117563,10,6,4,0,1,1,0,0,0
03117906,7,2,5,0,2,1,1,0,0
03118409,17,0,17,0,0,0,0,0,1
03118614,25,0,25,0,0,0,0,0,1
03118648,5,3,2,0,2,2,0,0,0
03119069,11,0,11,0,0,0,0,0,1
03119353,7,2,5,0,2,1,1,1,1
03120328,22,5,17,0,1,1,0,0,1
03120977,7,3,4,0,1,1,0,0,1
03121772,19,0,19,0,0,0,0,0,1
03125316,8,4,4,0,1,1,0,0,1
03126017,10,1,9,0,1,1,0,0,1
03126168,35,4,31,0,1,1,0,1,1
03126711,15,3,12,0,1,1,0,1,1
03128187,14,3,11,0,3,1,2,1,0
03128694,49,15,34,0,0,0,0,0,0
03131273,29,8,21,0,1,1,0,1,1
03131624,27,4,23,0,1,1,0,1,1
03131750,0,0,0,0,0,0,0,0,0
03132165,20,0,20,0,1,1,0,1,1
03132671,5,1,4,0,1,1,0,0,0
03133249,7,1,6,0,1,1,0,0,0
03133599,42,5,37,0,0,0,0,0,1
03134026,10,2,8,0,0,0,0,0,1
03134290,33,3,30,0,1,1,0,1,1
03134383,18,3,15,0,1,1,0,1,1
03134540,42,2,40,0,2,1,1,2,1
03135205,35,8,27,0,0,0,0,0,1
03135882,27,4,23,0,1,1,0,1,1
03135945,31,4,27,0,11,2,9,0,1
03136695,13,2,11,0,0,0,0,0,0
03137449,42,4,38,0,1,1,0,1,1
03137494,13,2,11,0,1,1,0,1,1
03138087,18,3,15,0,0,0,0,0,1
03138574,8,2,6,0,1,1,0,1,1
03138736,4,2,2,0,2,2,0,0,1
03138881,22,3,19,0,0,0,0,0,1
03139019,28,5,23,0,0,0,0,0,1
03140273,45,4,41,0,1,1,0,1,1
03141707,16,4,12,0,1,1,0,1,1
03141709,13,2,11,0,0,0,0,0,1
03142214,33,3,30,0,1,1,0,1,1
03142604,25,6,19,0,5,5,0,0,0
03144016,25,4,21,0,1,0,1,1,1
03144067,27,4,23,0,1,1,0,1,1
03145216,28,6,22,0,1,1,0,1,1
03147164,51,9,42,0,2,2,0,2,1
03147490,17,1,16,0,1,1,0,1,1
03147725,5,3,2,0,2,2,0,0,1
03147927,28,2,26,0,1,1,0,1,1
03148073,9,2,7,0,2,2,0,0,0
03148118,30,4,26,0,1,1,0,1,1
03148926,6,4,2,0,2,2,0,0,1
03149336,5,3,2,0,1,1,0,1,0
03150113,9,3,6,0,1,1,0,0,0
03150205,6,0,6,0,1,1,0,0,1
03150227,11,2,9,0,0,0,0,0,1
03150680,21,0,21,0,1,1,0,1,1
03151270,15,2,13,0,1,1,0,1,1
03151878,54,6,48,0,10,5,5,0,0
03152137,6,4,2,0,1,1,0,0,0
03152455,5,3,2,0,1,1,0,0,0
03152721,11,5,6,0,0,0,0,0,0
03152730,23,2,21,0,1,1,0,1,1
03152823,11,5,6,0,0,0,0,0,0
03152835,11,5,6,0,0,0,0,0,0
03153131,11,5,6,0,0,0,0,0,0
03154125,22,0,22,0,0,0,0,0,1
03156479,21,3,18,0,1,1,0,1,1
03157061,6,1,5,0,1,1,0,0,0
03157276,4,2,2,0,1,1,0,0,1
03157759,18,3,15,0,2,2,0,2,1
03157977,26,0,26,0,0,0,0,0,1
03158105,22,5,17,0,1,1,0,1,1
03158106,28,4,24,0,1,1,0,1,1
03158108,28,0,28,0,0,0,0,0,1
03158788,8,2,6,0,0,0,0,0,1
03158846,13,2,11,0,1,1,0,1,1
03161085,28,2,26,0,2,2,0,2,1
03161219,30,2,28,0,1,1,0,1,1
03161225,24,2,22,0,1,1,0,1,1
03162555,29,4,25,0,0,0,0,0,1
03163638,8,3,5,0,1,1,0,0,1
03164472,7,3,4,0,0,0,0,0,1
03164540,20,0,20,0,0,0,0,0,1
03165181,7,0,7,0,0,0,0,0,1
03165809,16,7,9,0,0,0,0,0,1
03166614,12,0,12,0,0,0,0,0,1
03167586,45,0,45,0,1,1,0,1,1
03167622,48,5,43,0,1,1,0,1,1
03167637,7,4,3,0,1,1,0,1,1
03168139,10,0,10,0,0,0,0,0,1
03169281,40,11,29,0,1,1,0,1,1
03169368,19,0,19,0,0,0,0,0,1
03169474,16,5,11,0,1,1,0,1,1
03169578,16,2,14,0,6,2,4,0,0
03169833,29,3,26,0,1,1,0,1,1
07780681,13,7,6,0,0,0,0,0,1
07780711,4,3,1,2,3,2,1,2,0
07781030,1,1,0,0,1,1,0,0,0
07783490,5,3,2,0,1,1,0,1,0
07783670,3,3,0,0,1,1,0,0,0
07785068,1,0,1,0,0,0,0,0,1
07788661,2,1,1,0,1,1,0,0,1
07789920,2,2,0,0,2,2,0,0,0
07792311,3,3,0,0,3,3,0,0,0
07793895,12,6,6,0,3,3,0,1,1
07794755,1,1,0,0,1,1,0,0,0
07794812,3,0,3,0,0,0,0,0,0
07794882,3,0,3,0,0,0,0,0,0
07795138,4,2,2,0,0,0,0,0,1
07796143,8,2,6,0,1,1,0,1,1
07798490,4,2,2,0,1,1,0,0,0
07798935,1,1,0,0,1,1,0,0,0
07799444,1,0,1,0,0,0,0,0,1
07799562,5,5,0,0,2,2,0,1,1
07800255,8,2,6,0,1,1,0,1,1
07800879,16,4,12,0,1,1,0,1,1
07801531,3,0,3,0,0,0,0,0,0
07801599,3,0,3,0,0,0,0,0,0
07801602,3,0,3,0,0,0,0,0,0
07801716,1,1,0,0,1,1,0,0,0
07805312,2,0,2,0,1,1,0,0,0
07806475,4,2,2,1,1,1,0,0,0
07808551,1,1,0,0,1,1,0,0,0
07809078,2,1,1,0,1,1,0,0,0
07809298,1,1,0,0,1,1,0,0,0
07809595,6,3,3,0,0,0,0,0,0
07809756,4,3,1,0,1,1,0,0,1
07810719,1,0,1,0,2,2,0,0,0
07811282,1,1,0,0,2,2,0,0,0
07811317,21,6,15,0,1,1,0,1,1
07811331,2,2,0,0,1,1,0,0,0
07812454,2,1,1,0,1,1,0,0,0
07814192,13,8,5,0,3,3,0,1,1
07815973,5,2,3,0,3,3,0,0,0
07816582,4,2,2,0,2,1,1,0,0
07817954,3,2,1,0,1,1,0,0,0
07818477,1,1,0,0,1,1,0,0,0
07819951,2,1,1,0,1,1,0,0,0
07820197,2,2,0,0,2,2,0,0,0
07820491,2,2,0,0,3,3,0,0,0
07820660,4,1,3,0,2,1,1,0,0
07820869,2,0,2,0,1,1,0,0,0
07821691,1,1,0,0,1,1,0,0,0
07822612,1,1,0,0,2,2,0,0,0
07822668,1,1,0,0,2,2,0,0,0
07823588,14,8,6,0,0,0,0,0,1
07824276,14,3,11,0,1,1,0,1,0
07824653,2,2,0,0,1,1,0,0,0
07825856,48,11,37,0,0,0,0,0,0
07829948,9,5,4,0,1,1,0,0,1
07830172,17,7,10,0,3,3,0,3,0
07830948,21,8,13,0,2,2,0,0,0
07831879,1,1,0,0,1,1,0,0,0
07832663,6,4,2,0,0,0,0,0,0
07834179,1,0,1,0,0,0,0,0,1
07834351,5,4,1,0,2,2,0,0,1
07835121,2,0,2,0,0,0,0,0,0
07835615,2,2,0,0,1,1,0,0,0
07835682,7,2,5,0,1,1,0,1,0
07836045,6,6,0,0,4,4,0,0,0
07837894,4,1,3,0,1,1,0,0,0
07839504,10,2,8,0,2,1,1,0,0
07841200,4,0,4,0,0,0,0,0,0
07841690,3,0,3,0,0,0,0,0,0
07841693,2,1,1,0,1,1,0,0,0
07841898,2,1,1,0,1,1,0,0,0
07842519,1,1,0,0,1,1,0,0,0
07842885,3,2,1,0,2,1,1,0,1
07844208,3,3,0,0,2,2,0,0,0
07844774,2,0,2,0,0,0,0,0,1
07845675,34,13,21,0,1,1,0,0,0
07845683,1,1,0,0,1,1,0,0,0
07845950,11,9,2,0,0,0,0,0,1
07846473,1,1,0,0,0,0,0,0,0
07852085,5,0,5,0,0,0,0,0,1
07852552,2,2,0,0,0,0,0,0,1
07852613,8,4,4,0,1,1,0,1,0
07853123,5,2,3,0,3,2,1,0,0
07855482,7,0,7,0,5,5,0,0,0
07856243,16,4,12,0,1,0,1,0,0
07856795,1,1,0,0,1,1,0,0,0
07857069,4,3,1,0,0,0,0,0,0
07857369,1,1,0,0,1,1,0,0,0
07857878,16,8,8,0,2,2,0,2,1
07858647,13,6,7,0,0,0,0,0,1
07860226,4,3,1,0,2,2,0,0,0
07861667,11,3,8,0,1,1,0,1,0
07862031,4,4,0,0,2,2,0,0,0
07863296,2,0,2,0,0,0,0,0,1
07863400,2,0,2,0,0,0,0,0,1
07864859,6,5,1,0,0,0,0,0,0
07865033,5,2,3,0,1,1,0,1,1
07865850,44,12,32,0,8,4,4,0,1
07866477,8,0,8,0,0,0,0,0,1
07866933,1,1,0,0,1,1,0,0,0
07870879,4,4,0,0,1,1,0,0,0
07871724,2,1,1,0,2,2,0,0,0
07872188,6,4,2,0,0,0,0,0,1
07873317,1,1,0,0,1,1,0,0,0
07873512,2,2,0,0,2,2,0,0,0
07874846,3,3,0,0,5,5,0,0,0
07876132,11,0,11,0,1,1,0,1,1
07876531,3,2,1,0,1,1,0,0,1
07876846,3,0,3,0,1,1,0,0,0
07877054,2,2,0,0,2,2,0,0,0
07879605,2,1,1,0,1,1,0,0,0
07880266,4,3,1,0,0,0,0,0,0
07880573,4,2,2,0,1,1,0,0,1
07881759,1,1,0,0,1,1,0,0,0
07881889,38,0,38,0,4,4,0,0,0
07883446,42,13,29,0,0,0,0,0,0
07884046,13,4,9,0,1,1,0,1,1
07884446,1,0,1,0,0,0,0,0,0
07885004,4,4,0,0,1,1,0,0,1
07885051,33,11,22,0,0,0,0,0,1
07886277,1,0,1,0,0,0,0,0,0
07886344,6,4,2,0,0,0,0,0,0
07887350,2,1,1,0,1,1,0,0,0
07887988,7,4,3,0,2,2,0,2,0
07888016,7,5,2,0,0,0,0,0,0
07888261,6,0,6,0,1,1,0,0,0
07889349,12,4,8,0,1,1,0,1,1
07889474,9,3,6,0,1,1,0,0,0
07891165,2,0,2,0,0,0,0,0,0
07891683,7,4,3,0,1,1,0,0,0
07893179,1,1,0,0,1,1,0,0,1
07894106,4,1,3,0,1,1,0,0,0
07894544,2,2,0,0,2,2,0,0,0
07895311,1,0,1,0,0,0,0,0,0
07895585,3,1,2,0,3,2,1,0,0
07897089,8,5,3,0,0,0,0,0,1
07899376,2,2,0,0,1,1,0,0,0
07900194,10,7,3,0,1,1,0,1,0
07900795,14,8,6,0,0,0,0,0,0
07903148,2,2,0,0,2,2,0,0,0
07904115,1,0,1,0,1,1,0,0,0
07906387,3,1,2,0,2,1,1,0,0
07906736,9,7,2,0,0,0,0,0,0
07907337,2,2,0,0,2,2,0,0,0
07908728,2,2,0,0,2,2,0,0,0
07909590,4,0,4,0,0,0,0,0,1
07909670,2,1,1,0,1,1,0,0,0
07909733,2,2,0,0,2,2,0,0,0
07909961,3,3,0,0,3,3,0,0,0
07910982,3,3,0,0,1,1,0,0,0
07911481,13,7,6,0,2,1,1,1,1
07913252,1,0,1,0,0,0,0,0,1
07913400,1,0,1,0,0,0,0,0,1
07913466,4,0,4,0,2,1,1,0,0
07913492,1,0,1,0,0,0,0,0,1
07914727,1,0,1,0,1,1,0,0,0
07915178,2,0,2,0,0,0,0,0,0
07916009,3,2,1,0,1,1,0,0,0
07920836,3,0,3,0,0,0,0,0,0
07921778,2,2,0,0,3,3,0,1,0
07922078,8,4,4,0,1,1,0,1,1
07922432,5,5,0,0,1,1,0,0,1
07922536,1,1,0,0,1,1,0,0,0
07922681,1,1,0,0,0,0,0,0,1
07923087,2,1,1,0,2,1,1,0,0
07923315,1,1,0,0,1,1,0,1,1
07923329,44,10,34,0,0,0,0,0,0
07924270,23,6,17,0,2,1,1,2,1
07924357,2,2,0,0,2,2,0,0,0
07928473,3,2,1,0,1,1,0,0,0
07928747,1,1,0,0,1,1,0,0,1
07931407,10,3,7,0,1,1,0,1,1
07932852,1,1,0,0,1,1,0,0,0
07934019,1,1,0,0,1,1,0,0,0
07934340,11,4,7,0,1,1,0,1,1
07934360,1,0,1,0,1,1,0,0,0
07934507,1,1,0,0,1,1,0,0,0
07935515,39,8,31,0,0,0,0,0,0
07936061,17,3,14,0,1,1,0,1,1
07937212,4,0,4,0,1,1,0,0,0
07940077,2,1,1,0,0,0,0,0,0
07940942,2,1,1,0,1,1,0,0,0
07940949,1,1,0,0,1,1,0,0,0
07940988,1,1,0,0,1,1,0,0,0
07941165,6,2,4,0,1,1,0,0,0
07941382,5,2,3,0,1,1,0,0,0
07944820,1,0,1,0,0,0,0,0,0
07945417,25,8,17,0,0,0,0,0,1
07945628,1,0,1,0,0,0,0,0,0
07945911,1,1,0,0,1,1,0,0,0
07945972,1,1,0,0,1,1,0,0,0
07946399,2,2,0,0,1,1,0,0,0
07946416,3,3,0,0,2,2,0,0,0
07946964,1,1,0,0,2,2,0,0,0
07947565,4,3,1,0,0,0,0,0,0
07947657,1,0,1,0,0,0,0,0,0
07947879,13,6,7,0,0,0,0,0,1
07947893,3,1,2,0,1,1,0,1,0
07948431,9,3,6,0,2,2,0,2,1
07949462,1,0,1,0,0,0,0,0,0
07949801,4,4,0,0,1,1,0,0,0
07949858,4,2,2,0,3,1,2,1,0
07951060,5,0,5,0,0,0,0,0,1
07951145,12,4,8,0,0,0,0,0,0
07951737,2,2,0,0,1,1,0,0,1
07953341,6,5,1,0,0,0,0,0,0
07957355,1,1,0,0,1,1,0,0,0
07957593,4,3,1,0,2,2,0,1,1
07958676,12,5,7,0,3,1,2,1,1
07958732,3,1,2,0,1,1,0,0,1
07958890,5,5,0,0,3,0,3,0,1
07959031,8,4,4,0,3,1,2,3,1
07960494,1,1,0,0,1,1,0,0,1
07960550,5,1,4,0,3,1,2,1,0
07960581,24,8,16,0,1,1,0,1,1
07960889,1,1,0,0,1,1,0,0,0
07961352,2,1,1,0,1,1,0,0,0
07961463,1,1,0,0,1,1,0,0,0
07962088,15,8,7,0,1,1,0,1,1
07962217,16,7,9,0,10,7,3,0,1
07962463,1,1,0,0,1,1,0,0,0
07962578,1,1,0,0,1,1,0,0,0
07963028,1,1,0,0,3,3,0,0,0
07963035,4,0,4,0,0,0,0,0,1
07963386,3,0,3,0,0,0,0,0,0
07965503,6,4,2,0,3,3,0,0,1
07965826,1,1,0,0,1,1,0,0,0
07968149,4,3,1,0,3,3,0,0,1
07969173,3,2,1,0,2,2,0,1,0
07970756,6,0,6,0,0,0,0,0,0
07972197,11,4,7,0,2,2,0,2,1
07973391,3,1,2,0,1,1,0,0,0
07974041,1,1,0,0,1,1,0,0,0
07974167,13,6,7,0,3,1,2,1,1
07974212,2,1,1,0,2,2,0,0,0
07975902,2,0,2,0,2,2,0,0,0
07976468,3,3,0,0,2,2,0,0,0
07976655,2,2,0,0,2,2,0,0,0
07978510,2,1,1,0,1,1,0,0,0
07978943,8,0,8,0,0,0,0,0,1
07980334,5,3,2,0,2,1,1,2,1
07980394,3,2,1,0,1,1,0,0,0
07980401,4,2,2,0,1,1,0,0,1
07980665,8,3,5,0,1,1,0,1,1
07980777,13,0,13,0,0,0,0,0,1
07982220,2,1,1,0,1,1,0,0,0
07982401,4,1,3,0,0,0,0,0,0
07982624,2,0,2,0,2,2,0,0,0
07983802,2,0,2,0,0,0,0,0,0
07983913,1,1,0,0,1,1,0,0,0
07983969,7,2,5,0,1,1,0,1,1
07985278,1,1,0,0,0,0,0,0,1
07985448,4,2,2,0,1,1,0,1,0
07985979,3,3,0,0,1,1,0,0,1
07986464,3,2,1,0,2,2,0,0,0
07988398,2,0,2,0,0,0,0,0,1
07988956,2,2,0,0,1,1,0,0,1
07989034,3,1,2,0,2,1,1,2,0
07989774,1,0,1,0,0,0,0,0,1
07990660,13,5,8,0,0,0,0,0,1
07990772,6,3,3,0,0,0,0,0,0
07991984,2,2,0,0,1,1,0,0,0
07992450,5,5,0,0,2,2,0,0,0
07993423,1,1,0,0,2,2,0,1,0
07993736,2,2,0,0,2,2,0,0,0
07993785,9,3,6,0,1,1,0,1,1
07993835,2,0,2,0,0,0,0,0,0
07994703,1,1,0,0,1,1,0,0,0
07995090,3,3,0,0,2,2,0,0,0
07995608,1,1,0,0,1,1,0,0,0
07996433,5,0,5,0,1,1,0,1,0
07996942,3,3,0,0,2,2,0,0,0
07998870,3,3,0,0,3,3,0,3,1
07999553,3,3,0,0,2,2,0,0,0
02111149,38,11,27,0,1,1,0,1,1
02113253,43,7,36,0,1,1,0,1,1
02113750,37,5,32,0,6,5,1,0,0
02114114,14,3,11,0,1,1,0,1,0
02114427,9,0,9,0,0,0,0,0,1
02114430,71,6,65,0,1,1,0,1,1
02114802,34,3,31,0,1,1,0,1,1
02114901,49,3,46,0,1,1,0,1,1
02116519,54,6,48,0,1,1,0,1,1
02119811,3,2,1,0,1,1,0,0,1
02120177,24,0,24,0,0,0,0,0,1
02120687,3,3,0,0,2,2,0,0,0
02121957,4,3,1,0,2,2,0,0,0
02122174,55,8,47,0,0,0,0,0,1
02124666,4,4,0,0,3,3,0,0,1
02124695,172,9,163,0,0,0,0,0,1
02125799,83,7,76,0,1,1,0,1,1
02127833,29,6,23,0,1,1,0,0,1
02128556,28,2,26,0,0,0,0,0,1
02129331,38,3,35,0,0,0,0,0,0
02129484,9,3,6,0,3,1,2,1,0
02130459,4,3,1,0,1,1,0,1,1
02130654,27,0,27,0,0,0,0,0,1
02131240,27,5,22,0,1,1,0,1,1
02132955,30,4,26,1,2,0,2,0,1
02134529,34,6,28,0,2,0,2,0,0
02135920,26,4,22,0,1,1,0,1,1
02138416,17,3,14,0,1,1,0,1,1
02141878,17,3,14,0,2,1,1,2,1
02144339,56,5,51,0,0,0,0,0,0
02144713,7,0,7,0,0,0,0,0,0
02144808,15,0,15,0,0,0,0,0,1
02144999,17,2,15,0,1,1,0,1,1
02146022,22,3,19,0,1,1,0,1,1
02146767,10,4,6,0,1,1,0,0,1
02147473,22,11,11,0,0,0,0,0,1
02148964,3,3,0,0,2,1,1,0,0
02150221,43,13,30,0,0,0,0,0,1
02152850,33,4,29,0,0,0,0,0,1
02153164,36,3,33,0,1,1,0,1,1
02154007,2,2,0,0,0,0,0,0,1
02154127,29,6,23,0,2,1,1,2,1
02155691,3,3,0,0,2,2,0,0,0
02157418,11,3,8,0,2,2,0,0,0
02159554,25,4,21,0,1,1,0,0,1
02160684,4,0,4,0,0,0,0,0,1
02161644,4,2,2,0,1,1,0,0,0
02162028,43,6,37,0,1,1,0,1,1
02164880,49,9,40,0,1,1,0,0,1
02165745,3,0,3,0,0,0,0,0,0
02166429,66,4,62,0,0,0,0,0,0
02167187,0,0,0,0,0,0,0,0,0
02167675,28,0,28,0,1,1,0,1,1
02168435,27,3,24,0,1,1,0,1,1
02168890,63,4,59,0,1,1,0,1,1
02168903,4,3,1,0,1,1,0,0,1
02170011,12,2,10,0,1,1,0,1,1
02171496,26,9,17,0,0,0,0,0,1
02172518,39,13,26,0,1,1,0,0,1
02172877,19,2,17,0,1,1,0,1,1
02174809,15,3,12,0,1,1,0,1,1
02174992,1,1,0,0,0,0,0,0,1
02176723,25,2,23,0,0,0,0,0,0
02177451,28,3,25,0,1,1,0,1,1
02181480,73,3,70,0,1,1,0,1,1
02181888,15,7,8,0,5,1,4,1,0
02181929,2,2,0,0,0,0,0,0,1
02182762,63,10,53,0,1,1,0,1,1
02184041,60,10,50,0,1,1,0,1,1
02184418,17,0,17,0,0,0,0,0,1
02184853,84,9,75,0,0,0,0,0,1
02185097,52,5,47,0,1,1,0,1,1
02185220,13,0,13,0,1,1,0,1,1
02187610,20,0,20,0,0,0,0,0,1
02188468,6,3,3,0,1,1,0,1,0
02189928,21,3,18,0,1,1,0,1,1
02191311,3,3,0,0,2,2,0,0,0
02191603,21,0,21,0,0,0,0,0,1
02192937,47,3,44,0,1,1,0,1,1
02197910,65,7,58,0,0,0,0,0,1
02197956,15,9,6,0,0,0,0,0,0
02198179,13,6,7,0,1,1,0,1,0
02199095,38,3,35,0,1,1,0,1,1
02199542,55,13,42,0,0,0,0,0,1
02199674,45,0,45,0,0,0,0,0,1
02200692,38,5,33,0,2,2,0,2,1
02200831,35,4,31,0,1,1,0,1,1
02201275,40,3,37,0,1,1,0,1,1
02201396,38,6,32,0,1,1,0,1,1
02201975,27,5,22,0,1,1,0,1,1
02202681,62,4,58,0,2,2,0,2,1
02202731,8,0,8,0,0,0,0,0,0
02202947,7,3,4,0,2,2,0,0,1
02209385,45,12,33,0,0,0,0,0,1
02210699,49,7,42,0,0,0,0,0,0
02211998,38,10,28,0,1,1,0,1,1
02213529,26,4,22,0,0,0,0,0,1
02215516,4,2,2,0,1,1,0,0,0
02215803,22,0,22,0,0,0,0,0,0
02216505,24,0,24,0,0,0,0,0,1
02217099,20,4,16,0,1,1,0,1,1
02218202,61,12,49,0,1,1,0,1,1
02218477,11,3,8,0,2,2,0,0,1
02222181,7,0,7,0,0,0,0,0,1
02225732,17,0,17,0,0,0,0,0,1
02227594,20,5,15,0,1,1,0,0,1
02228813,7,3,4,0,0,0,0,0,0
02230494,32,3,29,0,1,0,1,1,1
02230634,3,2,1,0,2,2,0,0,0
02231656,22,0,22,0,1,1,0,1,1
02231974,6,1,5,0,1,1,0,0,0
02232547,12,0,12,0,0,0,0,0,1
02233451,29,3,26,0,1,1,0,1,1
02233654,84,4,80,0,1,1,0,1,1
02234290,21,0,21,0,1,1,0,1,1
02235761,24,0,24,0,1,1,0,1,1
02236190,11,4,7,0,0,0,0,0,0
02239545,27,0,27,0,0,0,0,0,1
02242132,8,3,5,0,0,0,0,0,0
02243060,25,0,25,0,1,1,0,1,1
02243832,47,7,40,0,4,3,1,0,0
02244773,8,4,4,0,1,1,0,1,1
02245999,12,4,8,0,1,1,0,1,1
02247432,31,5,26,0,0,0,0,0,1
02247735,89,4,85,0,1,1,0,1,1
02248023,7,2,5,0,1,1,0,1,0
02249123,5,1,4,0,1,1,0,0,0
02249271,28,5,23,0,1,1,0,1,1
02249382,24,4,20,0,1,1,0,1,1
02249561,24,5,19,0,1,1,0,1,1
02251822,29,0,29,0,0,0,0,0,1
02253188,4,3,1,0,2,2,0,2,1
02253975,9,2,7,0,1,1,0,1,1
02254232,19,7,12,0,0,0,0,0,0
02254895,4,3,1,0,1,1,0,0,0
02255180,19,2,17,0,0,0,0,0,0
02255591,7,3,4,0,3,1,2,1,1
02256478,3,2,1,0,1,1,0,0,0
02256491,29,3,26,0,1,1,0,1,1
02258235,11,5,6,0,1,1,0,0,0
02259349,36,4,32,0,1,1,0,1,1
02259514,20,0,20,0,0,0,0,0,1
02260183,4,2,2,0,1,1,0,1,0
02260991,79,17,62,0,0,0,0,0,1
02262815,5,2,3,0,1,1,0,0,0
02263496,10,3,7,0,1,1,0,1,1
02265614,9,3,6,0,1,1,0,1,1
02268092,72,9,63,0,0,0,0,0,1
02269227,2,2,0,0,0,0,0,0,1
02271026,3,0,3,0,2,1,1,0,0
02271896,36,0,36,0,0,0,0,0,1
02271935,39,0,39,0,0,0,0,0,1
02272411,18,2,16,0,0,0,0,0,1
02272577,42,3,39,0,1,1,0,1,1
02272789,11,1,10,0,4,2,2,1,1
02274227,31,10,21,0,1,1,0,1,1
02275265,27,5,22,0,1,1,0,1,1
02276727,24,1,23,0,2,2,0,0,1
02278164,4,3,1,0,2,2,0,0,1
02280630,8,2,6,0,2,1,1,1,1
02281402,12,3,9,0,1,1,0,1,1
02285524,30,4,26,0,1,1,0,1,1
02286167,16,10,6,0,0,0,0,0,0
02287319,9,2,7,0,4,3,1,1,0
02287862,35,3,32,0,1,1,0,1,1
02288142,23,4,19,0,0,0,0,0,1
02290281,12,0,12,0,1,1,0,0,1
02290487,34,0,34,0,0,0,0,0,1
02291753,69,4,65,0,1,1,0,1,1
02293376,3,0,3,0,0,0,0,0,0
02294926,16,4,12,0,0,0,0,0,1
02295801,10,2,8,0,1,1,0,1,1
02295886,16,5,11,0,3,2,1,0,1
02298021,25,0,25,0,1,1,0,1,1
02298338,6,0,6,0,0,0,0,0,1
02299428,50,3,47,0,1,1,0,1,0
02299800,14,4,10,0,0,0,0,0,0
02300676,28,0,28,0,0,0,0,0,1
02301423,30,6,24,0,1,1,0,1,1
02301452,83,10,73,0,1,0,1,0,1
02301779,20,3,17,0,2,2,0,2,1
02303094,12,6,6,0,1,1,0,1,1
02303103,12,3,9,0,1,1,0,1,1
02304681,6,3,3,0,1,1,0,0,1
02304755,39,7,32,0,1,1,0,1,1
02304992,57,4,53,0,3,1,2,3,1
02305098,22,0,22,0,0,0,0,0,1
02306906,32,5,27,0,2,2,0,2,1
02306954,7,3,4,0,1,1,0,0,0
02307096,30,3,27,0,2,2,0,2,1
02307319,7,3,4,0,0,0,0,0,0
02307341,8,3,5,0,2,1,1,1,1
02307505,3,3,0,0,1,1,0,0,0
02308101,54,13,41,0,1,1,0,0,1
02311843,11,4,7,0,1,1,0,1,1
02311977,19,5,14,0,1,1,0,1,1
02314002,4,2,2,0,0,0,0,0,0
02316298,21,4,17,0,1,1,0,1,0
02316369,5,2,3,0,3,2,1,0,0
02316967,26,3,23,0,1,1,0,1,1
02319124,24,1,23,0,1,1,0,0,0
02319743,27,5,22,0,0,0,0,0,0
02319746,6,2,4,0,0,0,0,0,0
02320279,11,6,5,0,0,0,0,0,1
02320388,0,0,0,0,0,0,0,0,0
02320508,26,0,26,0,0,0,0,0,1
02320966,21,3,18,0,1,1,0,1,1
02322945,33,0,33,0,0,0,0,0,1
02323258,6,1,5,0,1,1,0,0,1
02323420,33,2,31,0,2,2,0,0,1
02323516,12,1,11,0,4,2,2,1,1
02324596,11,2,9,0,1,1,0,0,1
02324637,32,0,32,0,0,0,0,0,1
02324663,12,1,11,0,0,0,0,0,0
02326223,16,0,16,0,0,0,0,0,1
02326316,31,4,27,0,1,1,0,1,1
02328489,31,6,25,0,1,1,0,1,1
02328561,52,7,45,0,1,1,0,1,1
02328565,40,6,34,0,1,1,0,1,1
02328662,24,5,19,0,2,2,0,0,1
02330557,7,3,4,0,1,1,0,0,0
02330755,3,3,0,0,2,2,0,0,0
02331936,47,4,43,0,0,0,0,0,1
02332045,30,0,30,0,0,0,0,0,1
02332284,99,8,91,0,1,1,0,1,0
02332465,11,0,11,0,0,0,0,0,1
02332529,71,7,64,0,1,1,0,1,1
02333700,34,5,29,0,1,1,0,1,1
02334236,3,2,1,0,1,1,0,0,0
02336447,16,3,13,0,0,0,0,0,1
02336587,70,14,56,0,0,0,0,0,0
02338548,69,7,62,0,2,1,1,2,1
02338612,7,1,6,0,2,2,0,0,0
02339826,72,11,61,0,0,0,0,0,1
02340150,43,5,38,0,1,1,0,1,1
02342029,15,3,12,0,1,1,0,1,1
02343438,18,0,18,0,0,0,0,0,0
02343731,21,4,17,0,2,1,1,2,1
02343760,36,5,31,0,1,1,0,1,1
02344177,27,0,27,0,0,0,0,0,1
02345206,8,6,2,0,4,4,0,0,0
02345258,10,5,5,1,1,1,0,1,1
02345397,15,5,10,0,1,1,0,1,1
02347198,29,0,29,0,1,1,0,1,1
02347461,2,2,0,0,0,0,0,0,0
02352435,46,3,43,0,1,1,0,1,1
02352665,24,4,20,0,1,1,0,1,1
02353086,4,3,1,0,2,2,0,0,1
02353392,59,11,48,0,0,0,0,0,0
02354342,17,0,17,0,1,1,0,1,1
02356570,28,5,23,0,1,1,0,1,1
02357558,79,4,75,0,1,1,0,1,1
02358972,10,4,6,0,3,1,2,3,1
02359756,18,3,15,0,2,2,0,0,1
02360377,5,4,1,0,2,2,0,2,1
02361283,30,5,25,0,1,1,0,1,1
02361287,26,5,21,0,1,1,0,1,1
02361305,33,0,33,0,1,1,0,1,1
02361310,28,5,23,0,2,2,0,2,1
02361444,24,7,17,0,0,0,0,0,1
02361476,37,5,32,0,1,1,0,1,1
02361568,28,5,23,0,1,1,0,1,1
02362187,26,0,26,0,0,0,0,0,1
02362210,47,5,42,0,1,1,0,1,1
02362253,26,5,21,0,1,1,0,1,1
02362563,28,5,23,0,1,1,0,1,1
02362953,27,5,22,0,1,1,0,1,1
02362988,30,5,25,0,1,1,0,1,1
02363256,16,3,13,0,1,1,0,1,1
02363378,32,0,32,0,0,0,0,0,1
02365718,17,4,13,0,0,0,0,0,0
02365900,124,5,119,0,0,0,0,0,1
02366377,26,11,15,0,0,0,0,0,1
02366942,39,6,33,0,1,1,0,1,1
02366963,67,4,63,0,1,1,0,1,1
02366995,43,4,39,0,1,1,0,1,1
02367076,66,2,64,0,1,1,0,1,1
02367078,47,3,44,0,1,1,0,1,1
02368991,7,2,5,0,1,1,0,1,0
02370592,51,3,48,0,0,0,0,0,1
02373490,18,3,15,0,1,1,0,1,1
02375077,41,8,33,0,3,3,0,1,1
02375962,16,3,13,0,0,0,0,0,1
02378072,10,2,8,0,1,1,0,0,0
02379610,7,3,4,0,1,1,0,0,0
02380110,30,3,27,0,1,1,0,1,1
02381891,39,7,32,0,0,0,0,0,1
02385197,34,5,29,0,1,1,0,1,1
02385818,29,3,26,0,1,1,0,1,1
02387490,5,0,5,0,1,1,0,0,1
02388701,15,8,7,0,0,0,0,0,1
02388740,31,5,26,0,1,1,0,1,0
02389761,16,0,16,0,0,0,0,0,1
02391638,8,4,4,0,1,1,0,1,0
02392854,34,0,34,0,1,1,0,1,1
02393175,42,10,32,0,0,0,0,0,1
02393366,25,2,23,0,0,0,0,0,1
02397134,111,23,88,0,0,0,0,0,0
02397322,18,8,10,0,1,1,0,0,0
02397594,11,3,8,0,0,0,0,0,0
02400509,57,8,49,0,0,0,0,0,1
02403986,12,3,9,0,0,0,0,0,0
02404052,20,3,17,0,1,1,0,0,1
02404350,44,6,38,0,1,1,0,1,1
02404351,36,0,36,0,1,1,0,1,1
02406054,35,3,32,0,1,1,0,1,1
02408386,46,0,46,0,0,0,0,0,1
02412105,10,8,2,0,2,2,0,0,0
02413137,28,5,23,0,1,1,0,1,1
02414308,13,3,10,0,2,2,0,0,0
02415387,15,4,11,0,1,1,0,1,1
02415597,25,0,25,0,0,0,0,0,1
02417647,5,3,2,0,2,2,0,0,0
02418209,18,3,15,0,1,1,0,0,0
02418670,19,6,13,0,0,0,0,0,0
02419432,38,3,35,0,0,0,0,0,1
02420882,11,4,7,0,1,1,0,1,1
02420895,20,3,17,0,0,0,0,0,1
02421407,30,3,27,0,1,1,0,1,1
02421808,3,2,1,0,1,1,0,1,1
02421891,26,0,26,0,0,0,0,0,1
02422007,26,0,26,0,0,0,0,0,1
02422152,8,2,6,0,1,1,0,0,1
02424035,46,3,43,0,1,1,0,1,1
02425361,17,2,15,0,1,1,0,1,0
02425966,29,0,29,1,0,0,0,0,1
02426011,33,4,29,0,1,1,0,1,1
02426069,2,2,0,0,0,0,0,0,1
02426112,34,0,34,0,0,0,0,0,1
02426166,31,3,28,0,1,1,0,1,1
02426169,34,5,29,0,1,1,0,1,1
02426353,32,5,27,0,1,1,0,1,1
02426471,10,6,4,0,2,2,0,0,0
02428514,8,2,6,0,2,2,0,1,0
02430235,22,3,19,0,2,2,0,2,1
02430319,28,0,28,0,1,1,0,1,1
02430594,24,4,20,0,0,0,0,0,0
02433198,10,7,3,0,1,1,0,0,1
02433281,6,3,3,0,1,1,0,0,1
02437760,8,2,6,0,1,1,0,0,1
02438132,6,0,6,0,1,1,0,0,1
02438534,21,8,13,0,0,0,0,0,1
02438671,19,3,16,0,1,1,0,1,1
02439846,0,0,0,0,0,0,0,0,0
02440858,11,4,7,0,1,1,0,1,1
02444036,19,3,16,0,2,2,0,2,1
02446027,10,4,6,0,1,1,0,1,1
02447548,24,0,24,0,0,0,0,0,1
02447790,30,0,30,0,0,0,0,0,1
02448361,13,5,8,0,5,1,4,1,1
02448835,40,5,35,0,1,1,0,1,1
02449056,4,4,0,0,1,1,0,0,0
02449715,18,0,18,0,0,0,0,0,1
02450180,26,8,18,0,1,1,0,1,1
02450365,46,0,46,0,0,0,0,0,1
02450755,8,5,3,0,2,2,0,0,0
02450936,38,3,35,0,4,3,1,0,1
02450962,30,1,29,0,3,0,3,0,0
02451177,55,4,51,0,1,1,0,1,1
02453881,16,0,16,0,0,0,0,0,1
02454345,24,6,18,0,1,1,0,1,1
02454600,18,2,16,0,2,1,1,0,0
02455347,106,7,99,0,3,3,0,3,1
02457122,28,5,23,0,1,1,0,1,1
02459405,37,4,33,0,1,1,0,1,1
02459671,68,2,66,0,2,1,1,1,1
02459997,34,0,34,0,0,0,0,0,1
02460198,19,3,16,0,2,2,0,0,0
02460956,7,3,4,0,1,1,0,0,0
02462241,42,0,42,0,0,0,0,0,1
02464040,122,2,120,0,2,1,1,2,1
02467207,45,7,38,0,1,1,0,1,1
02467733,34,3,31,0,2,2,0,2,1
02471319,15,4,11,0,3,1,2,1,1
02471382,42,6,36,0,2,0,2,0,0
02472818,29,5,24,0,2,2,0,2,1
02474912,39,6,33,0,1,1,0,1,1
02475286,5,5,0,0,1,1,0,0,1
02475628,39,0,39,0,0,0,0,0,1
02476638,8,3,5,0,0,0,0,0,1
02477486,6,2,4,0,1,1,0,0,0
02478802,27,4,23,0,1,1,0,1,1
02480139,11,3,8,0,1,1,0,0,1
02480484,15,0,15,0,1,1,0,1,1
02482174,22,0,22,0,1,1,0,1,1
02482274,22,0,22,0,1,1,0,1,1
02483862,17,0,17,0,0,0,0,0,1
02484446,36,3,33,0,1,1,0,1,1
02485637,4,3,1,0,1,1,0,0,0
02485665,34,0,34,0,0,0,0,0,1
02486702,5,2,3,0,2,1,1,0,0
02486842,18,0,18,0,0,0,0,0,1
02487502,25,0,25,0,0,0,0,0,1
02487533,32,0,32,0,0,0,0,0,1
02487535,29,0,29,0,0,0,0,0,1
02487620,7,4,3,0,1,1,0,0,0
02487643,15,0,15,0,0,0,0,0,1
02488040,33,0,33,0,0,0,0,0,1
02488138,12,3,9,0,0,0,0,0,1
02488927,169,11,158,0,0,0,0,0,1
02490104,26,4,22,0,1,1,0,1,1
02490139,34,3,31,0,1,1,0,1,1
02490359,10,3,7,0,1,1,0,1,1
02490584,14,2,12,0,1,1,0,1,1
02492235,6,1,5,0,1,1,0,0,0
02492411,78,13,65,0,0,0,0,0,1
02493041,31,7,24,0,1,1,0,1,1
02493838,3,3,0,0,2,2,0,0,1
02494406,15,6,9,0,0,0,0,0,0
02495472,34,4,30,0,1,1,0,1,1
02495691,4,2,2,0,1,1,0,0,0
02495958,26,0,26,0,0,0,0,0,1
02496206,25,5,20,0,1,1,0,1,1
02496240,20,0,20,0,1,1,0,1,1
02498503,24,4,20,0,0,0,0,0,1
02498852,37,0,37,0,1,1,0,1,1
02499280,31,4,27,0,1,1,0,1,1
02499580,19,5,14,0,3,3,0,0,0
06414050,4,2,2,0,1,1,0,0,1
06414128,4,4,0,0,2,2,0,0,0
06414423,17,4,13,0,2,2,0,2,1
06414559,2,2,0,0,1,1,0,0,0
06415098,5,1,4,0,1,1,0,0,1
06415429,5,0,5,0,0,0,0,0,1
06415540,2,2,0,0,1,1,0,0,0
06416162,4,2,2,0,1,1,0,0,1
06417317,2,1,1,0,1,1,0,0,1
06417488,5,3,2,0,1,1,0,0,1
06418282,10,2,8,0,1,1,0,1,1
06418331,6,3,3,0,1,1,0,0,1
06418438,3,3,0,0,1,1,0,0,0
06418869,4,2,2,0,2,2,0,0,1
06419025,3,0,3,0,1,1,0,0,0
06419359,12,1,11,0,2,1,1,1,1
06420564,7,0,7,0,0,0,0,0,1
06420568,7,0,7,0,0,0,0,0,1
06420574,8,0,8,0,0,0,0,0,1
06420723,4,2,2,0,1,1,0,0,1
06420732,27,0,27,0,0,0,0,0,1
06420927,21,0,21,0,0,0,0,0,1
06420934,21,0,21,0,0,0,0,0,1
06420969,23,0,23,0,0,0,0,0,1
06421118,3,0,3,0,1,1,0,0,1
06421258,7,5,2,0,1,1,0,0,1
06421999,5,0,5,0,0,0,0,0,1
06422017,4,2,2,0,1,1,0,1,1
06422142,13,2,11,0,2,2,0,0,0
06422165,5,3,2,0,2,2,0,0,1
06422358,6,4,2,0,3,3,0,0,1
06422502,5,1,4,0,1,1,0,0,1
06422508,4,2,2,0,2,2,0,0,1
06422804,5,0,5,0,2,2,0,0,1
06422920,5,0,5,0,0,0,0,0,1
06422947,2,2,0,0,1,1,0,0,1
06423033,16,0,16,0,0,0,0,0,1
06423292,4,1,3,0,1,1,0,0,1
06423349,7,0,7,0,1,1,0,0,1
06423525,3,3,0,0,1,1,0,0,0
06424400,18,3,15,0,1,1,0,1,1
06424479,3,0,3,0,0,0,0,0,1
06425158,5,2,3,0,1,1,0,0,1
06425264,5,3,2,0,2,2,0,0,1
06425376,4,2,2,0,1,1,0,1,1
06425482,29,6,23,0,2,1,1,2,1
06425771,7,0,7,0,0,0,0,0,1
06425774,6,4,2,0,3,3,0,0,1
06425800,67,0,67,0,2,2,0,2,1
06425881,6,2,4,0,0,0,0,0,1
06425892,8,0,8,0,0,0,0,0,0
06426366,4,2,2,0,1,1,0,0,1
06426462,5,1,4,0,1,1,0,0,1
06426466,12,3,9,0,1,1,0,1,1
06426905,6,1,5,0,1,1,0,0,0
06427136,4,2,2,0,1,1,0,0,1
06427182,6,0,6,0,0,0,0,0,1
06427235,5,0,5,0,1,1,0,1,1
06427329,4,1,3,0,1,1,0,0,0
06428199,10,5,5,0,5,4,1,0,0
06428244,5,0,5,0,2,2,0,0,1
06428444,4,2,2,0,1,1,0,0,1
06428537,10,0,10,0,1,1,0,1,1
06428748,6,2,4,0,3,1,2,3,0
06428869,2,2,0,0,1,1,0,0,0
06429764,4,0,4,0,0,0,0,0,1
06430441,8,0,8,0,0,0,0,0,1
06430540,6,2,4,0,1,1,0,0,1
06430729,4,0,4,0,0,0,0,0,1
06430766,7,5,2,0,1,1,0,1,1
06431862,6,4,2,0,1,1,0,0,1
06431986,5,3,2,0,1,1,0,0,1
06432016,2,2,0,0,1,1,0,0,0
06432026,4,2,2,0,1,1,0,0,1
06432220,4,4,0,0,3,3,0,0,0
06432698,4,0,4,0,0,0,0,0,1
06433889,6,0,6,0,0,0,0,0,1
06434621,11,3,8,0,4,3,1,2,1
06434634,7,3,4,0,3,3,0,0,1
06434643,4,3,1,0,2,2,0,0,1
06434912,13,3,10,0,1,1,0,1,1
06435040,6,0,6,0,2,2,0,0,1
06435094,3,1,2,0,1,1,0,0,0
06435503,17,0,17,0,0,0,0,0,1
06436009,15,4,11,0,6,3,3,3,1
06436245,20,6,14,0,5,3,2,0,1
06436264,19,4,15,0,2,2,0,2,1
06437104,10,2,8,0,1,1,0,1,1
06437140,8,4,4,0,1,1,0,0,1
06437349,7,0,7,0,0,0,0,0,1
06437380,7,4,3,0,3,3,0,0,0
06437496,4,2,2,0,1,1,0,0,1
06437909,3,1,2,0,1,1,0,0,1
06438936,26,0,26,0,0,0,0,0,1
06439209,6,2,4,0,1,1,0,0,1
06439693,11,4,7,0,1,1,0,1,1
06439761,20,9,11,0,1,1,0,1,1
06439876,4,0,4,0,1,1,0,0,1
06439986,3,0,3,0,0,0,0,0,1
06440378,5,3,2,0,3,3,0,0,1
06440464,7,2,5,0,2,2,0,0,1
06440922,5,2,3,0,1,1,0,0,1
06441150,9,0,9,0,0,0,0,0,1
06441533,6,0,6,0,0,0,0,0,1
06441549,6,4,2,0,2,2,0,0,1
06441589,6,4,2,0,1,1,0,1,1
06442028,18,5,13,0,1,1,0,1,1
06442102,3,3,0,0,2,2,0,0,0
06442133,5,3,2,0,1,1,0,0,1
06442276,6,4,2,0,1,1,0,1,1
06442595,4,3,1,0,2,2,0,0,1
06442875,6,2,4,0,1,1,0,0,1
06443528,5,2,3,0,1,1,0,1,1
06443736,6,2,4,0,1,1,0,0,1
06443857,5,2,3,0,1,1,0,0,1
06444010,19,4,15,0,2,2,0,2,1
06445355,6,0,6,0,0,0,0,0,1
06445377,3,0,3,0,3,2,1,0,1
06445419,6,3,3,0,2,2,0,0,1
06445864,10,1,9,0,0,0,0,0,0
06445873,3,1,2,0,1,1,0,0,1
06445879,17,3,14,0,1,1,0,1,1
06446302,5,0,5,0,0,0,0,0,1
06447607,4,2,2,0,1,1,0,0,1
06448014,2,2,0,0,1,1,0,0,0
06448025,13,4,9,0,8,4,4,0,0
06448063,5,3,2,0,1,1,0,0,1
06448126,18,7,11,0,0,0,0,0,1
06448592,5,0,5,0,1,1,0,0,1
06449040,20,3,17,0,2,1,1,2,1
06449218,8,2,6,0,1,1,0,0,1
06449335,4,2,2,0,1,1,0,0,0
06449456,11,0,11,0,0,0,0,0,1
06449686,6,0,6,0,1,0,1,0,1
06449787,6,0,6,0,0,0,0,0,1
06449928,5,3,2,0,1,1,0,0,1
06449944,5,3,2,0,1,1,0,0,1
06449994,5,2,3,0,0,0,0,0,1
06450348,5,3,2,0,1,1,0,0,0
06450452,3,3,0,0,2,2,0,0,0
06450467,5,3,2,0,1,1,0,0,1
06451233,4,2,2,0,1,1,0,0,1
06451271,22,3,19,0,2,1,1,2,1
06451374,4,2,2,0,1,1,0,0,1
06451441,6,4,2,0,1,1,0,0,1
06451478,4,2,2,0,1,1,0,0,0
06451603,11,2,9,0,0,0,0,0,1
06451650,2,2,0,0,1,1,0,0,0
06451745,6,4,2,0,1,1,0,0,1
06451817,5,2,3,0,3,3,0,0,1
06452503,5,0,5,0,2,2,0,0,0
06452779,5,2,3,0,2,2,0,0,1
06452959,4,0,4,0,0,0,0,0,1
06452998,3,0,3,0,0,0,0,0,1
06453072,4,1,3,0,1,1,0,0,1
06453257,6,2,4,0,2,2,0,1,1
06453457,3,0,3,0,0,0,0,0,1
06453482,2,0,2,0,0,0,0,0,1
06453489,2,0,2,0,0,0,0,0,1
06453593,12,1,11,0,4,2,2,1,1
06453830,12,7,5,0,2,2,0,2,1
06453891,6,0,6,0,0,0,0,0,1
06454089,4,2,2,0,1,1,0,0,1
06454105,5,3,2,0,2,2,0,0,1
06454122,5,0,5,0,2,2,0,0,1
06454146,5,3,2,0,1,1,0,1,1
06454176,7,2,5,0,2,2,0,0,1
06454471,14,0,14,0,0,0,0,0,1
06455581,4,3,1,0,1,1,0,1,1
06455671,2,1,1,0,1,1,0,0,0
06455788,19,4,15,0,2,2,0,2,1
06455947,6,2,4,0,1,1,0,0,1
06456323,6,0,6,0,0,0,0,0,1
06456344,6,4,2,0,2,2,0,0,1
06457246,5,3,2,0,2,2,0,0,1
06457257,5,2,3,0,1,1,0,0,1
06457721,10,6,4,0,3,1,2,1,0
06457794,5,3,2,0,3,3,0,0,1
06457830,3,0,3,0,0,0,0,0,1
06457834,5,3,2,0,2,2,0,0,1
06458029,10,3,7,0,1,1,0,1,1
06458377,4,0,4,0,1,1,0,0,1
06458380,4,0,4,0,0,0,0,0,1
06458504,9,2,7,0,0,0,0,0,0
06458580,11,3,8,0,0,0,0,0,1
06459120,8,3,5,0,1,1,0,1,1
06462846,7,0,7,0,1,1,0,1,1
06462849,7,0,7,0,1,1,0,1,1
06462850,7,4,3,0,1,1,0,1,1
06462852,7,0,7,0,1,1,0,1,1
06462853,7,0,7,0,1,1,0,1,1
06462854,7,0,7,0,1,1,0,1,1
06462855,7,0,7,0,1,1,0,1,1
06462856,7,0,7,0,1,1,0,1,1
06463031,8,4,4,0,1,1,0,1,1
06463493,7,0,7,0,1,1,0,1,1
06463761,7,0,7,0,1,1,0,0,1
06464338,11,3,8,0,1,1,0,1,1
06464539,6,1,5,0,2,1,1,0,0
06464783,7,4,3,0,1,1,0,0,0
06464825,3,0,3,0,2,2,0,0,0
06464988,7,2,5,0,6,4,2,0,1
06465032,4,0,4,0,0,0,0,0,1
06465313,5,3,2,0,1,1,0,0,1
06465358,4,2,2,0,4,4,0,0,1
06465371,4,2,2,0,2,2,0,0,1
06465395,10,0,10,0,0,0,0,0,1
06465806,5,1,4,0,1,1,0,1,1
06466083,6,1,5,0,2,1,1,0,1
06466105,3,3,0,0,2,2,0,0,0
06466234,2,0,2,0,1,1,0,0,0
06466371,9,2,7,0,2,1,1,0,1
06466422,10,7,3,0,0,0,0,0,1
06466537,7,3,4,0,2,2,0,0,1
06466811,16,6,10,0,0,0,0,0,1
06467108,4,0,4,0,2,2,0,0,1
06468205,7,0,7,0,0,0,0,0,1
06468832,5,2,3,0,1,1,0,0,0
06469210,4,0,4,0,0,0,0,0,1
06469607,9,2,7,0,1,1,0,0,1
06470047,4,1,3,0,1,1,0,0,1
06470363,4,0,4,0,0,0,0,0,1
06470364,5,0,5,0,0,0,0,0,1
06470369,5,3,2,0,1,1,0,0,1
06470644,5,2,3,0,1,1,0,0,1
06470668,5,2,3,0,1,1,0,0,1
06471157,5,2,3,0,1,1,0,0,1
06471233,15,6,9,0,1,1,0,1,1
06471276,15,6,9,0,2,2,0,2,1
06471620,9,3,6,0,3,3,0,0,1
06471659,15,6,9,0,1,1,0,1,1
06472473,2,1,1,0,1,1,0,0,0
06472571,13,2,11,0,0,0,0,0,1
06472916,7,3,4,0,1,1,0,0,1
04119491,6,3,3,0,1,1,0,1,0
04119659,27,5,22,0,1,1,0,1,1
04120739,13,0,13,0,0,0,0,0,1
04121875,10,2,8,0,2,2,0,0,0
04122078,19,3,16,1,1,1,0,1,1
04122355,16,5,11,0,0,0,0,0,1
04122636,24,8,16,0,0,0,0,0,1
04124438,12,0,12,0,0,0,0,0,1
04125371,18,4,14,0,7,6,1,1,1
04128034,17,4,13,0,2,2,0,0,0
04128850,32,4,28,0,0,0,0,0,1
04129360,11,0,11,0,0,0,0,0,1
04129523,12,5,7,0,4,4,0,0,1
04129587,11,2,9,0,1,1,0,0,1
04130113,49,10,39,0,10,0,10,0,0
04132464,6,2,4,0,1,1,0,0,1
04132469,6,2,4,0,1,1,0,0,1
04132733,11,2,9,0,1,1,0,0,0
04134550,25,4,21,0,1,1,0,1,1
04134714,19,0,19,0,1,1,0,1,1
04134744,23,0,23,0,1,1,0,1,1
04135634,4,0,4,0,0,0,0,0,1
04136011,2,2,0,0,1,1,0,0,0
04137300,12,3,9,0,1,1,0,1,1
04138515,5,3,2,0,1,1,0,0,1
04139057,4,0,4,0,0,0,0,0,1
04139999,13,0,13,0,0,0,0,0,1
04141197,12,2,10,0,9,7,2,0,1
04141352,10,0,10,0,0,0,0,0,1
04141481,6,2,4,0,1,1,0,0,1
04143066,5,2,3,0,2,2,0,0,0
04144791,19,4,15,0,2,2,0,2,1
04145068,5,3,2,0,2,2,0,0,1
04145262,31,8,23,0,1,1,0,1,0
04145357,15,10,5,0,0,0,0,0,1
04145421,9,0,9,0,1,1,0,1,1
04145427,9,0,9,0,1,1,0,1,1
04145431,8,0,8,0,1,1,0,1,1
04145508,9,0,9,0,1,1,0,1,1
04145522,11,3,8,0,1,1,0,1,1
04146820,42,8,34,0,2,2,0,2,1
04146956,12,0,12,0,0,0,0,0,1
04146962,18,4,14,0,0,0,0,0,1
04147176,32,0,32,0,0,0,0,0,1
04147269,10,4,6,0,1,1,0,1,1
04150687,9,4,5,0,0,0,0,0,0
04152555,8,3,5,0,1,1,0,0,0
04154268,5,2,3,0,1,1,0,0,1
04154556,34,4,30,0,1,1,0,1,1
04154855,27,3,24,0,1,1,0,1,1
04154859,9,2,7,0,1,1,0,0,0
04154910,20,3,17,0,1,1,0,1,1
04155293,6,1,5,0,1,1,0,0,1
04155620,20,2,18,0,1,1,0,1,1
04156685,22,0,22,0,0,0,0,0,1
04157857,5,2,3,0,2,2,0,0,0
04158138,10,6,4,0,1,1,0,1,1
04158202,8,3,5,0,1,1,0,0,1
04158725,21,2,19,0,0,0,0,0,0
04159256,27,1,26,0,1,1,0,0,1
04159477,22,3,19,0,0,0,0,0,1
04161207,13,2,11,0,3,1,2,1,0
04162931,13,4,9,0,0,0,0,0,0
04162951,22,5,17,0,1,0,1,0,0
04163221,7,0,7,0,0,0,0,0,1
04163500,11,4,7,0,1,1,0,1,1
04164156,31,0,31,0,1,1,0,1,1
04165061,5,2,3,0,1,1,0,0,0
04165609,14,2,12,0,0,0,0,0,1
04165632,11,0,11,0,0,0,0,0,1
04165701,20,0,20,0,0,0,0,0,1
04165748,16,0,16,0,0,0,0,0,1
04166889,36,2,34,0,2,1,1,2,1
04166900,18,3,15,0,2,2,0,2,1
04166910,30,3,27,0,1,1,0,1,1
04167038,30,3,27,0,1,1,0,1,1
04167062,18,3,15,0,2,1,1,2,1
04167080,39,3,36,0,1,1,0,1,1
04167219,15,4,11,0,1,1,0,0,1
04167535,20,3,17,1,1,1,0,1,1
04167779,9,4,5,0,1,1,0,1,1
04168664,12,3,9,0,1,1,0,1,0
04168774,5,2,3,0,2,1,1,0,1
04169630,5,0,5,0,0,0,0,0,1
04169762,11,4,7,0,1,1,0,1,1
04170241,45,7,38,0,0,0,0,0,0
04170309,7,3,4,0,1,1,0,0,0
04170517,20,0,20,0,0,0,0,0,1
04170519,16,6,10,0,1,1,0,1,1
04170863,7,2,5,0,1,1,0,1,1
04170896,5,1,4,0,1,1,0,0,0
04170924,18,3,15,0,1,1,0,1,1
04171005,5,3,2,0,2,2,0,0,0
04171035,23,0,23,0,0,0,0,0,1
04171639,6,3,3,0,1,1,0,0,1
04172071,5,2,3,0,2,2,0,0,0
04172544,7,1,6,0,1,1,0,0,1
04173547,17,0,17,0,0,0,0,0,1
04173713,12,2,10,0,1,1,0,1,1
04174396,5,0,5,0,0,0,0,0,0
04175157,4,0,4,0,0,0,0,0,1
04175374,6,3,3,0,0,0,0,0,1
04175628,10,3,7,0,1,1,0,1,1
04176480,4,1,3,0,2,2,0,0,0
04176679,10,2,8,0,1,1,0,1,0
04176994,29,7,22,0,0,0,0,0,0
04177616,6,2,4,0,2,2,0,0,1
04177900,33,7,26,0,1,1,0,0,1
04178176,10,3,7,0,2,2,0,0,0
04178221,8,0,8,0,0,0,0,0,0
04179747,18,9,9,0,0,0,0,0,0
04180022,4,2,2,0,1,1,0,0,1
04180520,8,0,8,0,0,0,0,0,1
04181288,9,5,4,0,0,0,0,0,0
04181928,17,4,13,0,2,1,1,2,1
04181937,19,3,16,0,1,1,0,1,1
04183686,6,3,3,0,2,2,0,0,0
04185316,104,23,81,0,0,0,0,0,1
04185784,5,2,3,0,2,2,0,0,1
04186093,8,2,6,0,2,2,0,0,0
04186148,7,3,4,0,1,1,0,0,1
04186543,15,0,15,0,0,0,0,0,1
04186887,4,2,2,0,2,2,0,0,0
04186902,15,3,12,0,1,1,0,1,1
04187040,37,5,32,0,1,1,0,1,1
04187042,14,4,10,0,1,1,0,1,1
04187052,10,0,10,0,0,0,0,0,1
04187057,15,6,9,0,0,0,0,0,1
04187071,5,1,4,0,1,1,0,0,1
04187081,31,7,24,0,4,1,3,0,1
04187205,7,2,5,0,1,1,0,0,1
04187209,4,2,2,0,1,1,0,0,1
04187226,7,2,5,0,0,0,0,0,1
04187398,4,2,2,0,1,1,0,0,0
04187692,4,2,2,0,1,1,0,0,1
04188491,19,7,12,0,1,1,0,1,1
04188657,6,2,4,0,1,1,0,0,1
04189876,27,5,22,0,1,1,0,0,0
04190151,16,0,16,0,0,0,0,0,1
04190153,17,0,17,0,0,0,0,0,1
04190170,15,0,15,0,0,0,0,0,1
04190179,16,0,16,0,0,0,0,0,1
04191312,10,4,6,0,2,2,0,0,1
04191520,7,3,4,0,1,1,0,0,0
04191670,5,3,2,0,2,2,0,0,0
04191927,15,3,12,0,1,1,0,1,1
04192035,7,2,5,0,3,2,1,0,1
04192358,8,2,6,0,2,2,0,0,0
04194155,5,0,5,0,0,0,0,0,0
04195141,7,2,5,0,1,1,0,0,1
04195146,13,5,8,0,0,0,0,0,1
04195386,11,4,7,0,0,0,0,0,1
04195775,7,2,5,0,1,1,0,0,0
04197941,8,4,4,0,1,1,0,1,0
04198561,12,3,9,0,0,0,0,0,0
04199588,15,3,12,0,1,1,0,1,1
04199651,27,4,23,0,1,1,0,1,1
04199668,10,4,6,0,0,0,0,0,0
04200476,11,3,8,0,1,1,0,1,1
04200777,10,0,10,0,0,0,0,0,1
04201236,22,4,18,0,0,0,0,0,1
04201625,6,3,3,0,1,1,0,1,0
04203924,7,3,4,0,2,2,0,0,1
04205449,7,2,5,0,1,1,0,1,1
04207344,15,2,13,0,0,0,0,0,0
04208144,10,2,8,0,1,1,0,1,1
04208160,10,2,8,0,1,1,0,1,1
04209890,8,5,3,0,2,2,0,2,1
04210407,4,2,2,0,1,1,0,0,0
04211077,6,3,3,0,2,2,0,0,0
04212563,36,8,28,0,0,0,0,0,1
04214058,29,7,22,0,0,0,0,0,1
04214259,19,0,19,0,0,0,0,0,1
04214272,14,0,14,0,0,0,0,0,1
04214280,6,0,6,0,0,0,0,0,1
04214296,14,0,14,0,0,0,0,0,1
04214736,5,0,5,0,0,0,0,0,1
04216782,20,0,20,0,0,0,0,0,1
04216809,20,0,20,0,0,0,0,0,1
04216823,34,1,33,0,3,1,2,3,1
04216858,34,1,33,0,3,1,2,3,1
04216868,34,1,33,0,3,1,2,3,1
04216881,34,1,33,0,3,1,2,3,1
04216938,33,4,29,0,2,1,1,2,1
04217267,18,0,18,0,0,0,0,0,1
04217356,3,1,2,0,0,0,0,0,1
04217374,3,1,2,0,0,0,0,0,1
04217385,3,1,2,0,0,0,0,0,1
04217393,3,1,2,0,0,0,0,0,1
04217406,3,1,2,0,0,0,0,0,1
04217412,3,1,2,0,0,0,0,0,1
04217708,4,2,2,0,1,1,0,0,1
04218999,3,1,2,0,0,0,0,0,1
04219007,3,1,2,0,0,0,0,0,1
04219008,3,1,2,0,0,0,0,0,1
04219022,3,1,2,0,0,0,0,0,1
04219047,19,0,19,0,0,0,0,0,1
04219556,25,3,22,0,1,1,0,0,1
04219952,7,2,5,0,1,1,0,1,1
04219995,3,1,2,0,0,0,0,0,1
04220217,3,1,2,0,0,0,0,0,1
04220226,3,1,2,0,0,0,0,0,1
04220231,3,1,2,0,0,0,0,0,1
04220381,28,6,22,0,1,1,0,1,1
04220587,52,12,40,0,0,0,0,0,1
04220649,30,8,22,0,1,1,0,0,1
04221080,41,0,41,0,0,0,0,0,1
04221429,109,12,97,0,0,0,0,0,1
04222000,5,3,2,0,2,2,0,0,0
04223669,12,5,7,0,0,0,0,0,1
04224891,27,7,20,0,0,0,0,0,1
04225238,6,0,6,0,0,0,0,0,1
04226824,13,3,10,0,1,1,0,1,1
04226902,9,1,8,0,1,1,0,0,1
04226919,7,2,5,0,1,1,0,0,1
04228155,25,0,25,0,0,0,0,0,1
04229509,20,15,5,0,3,1,2,1,1
04229646,7,0,7,0,0,0,0,0,1
04229819,26,0,26,0,0,0,0,0,1
04229861,6,2,4,0,2,2,0,0,1
04230126,16,0,16,0,0,0,0,0,0
04230439,31,0,31,0,0,0,0,0,1
04230694,7,1,6,0,0,0,0,0,0
04231155,27,7,20,1,1,1,0,1,1
04231189,6,3,3,0,2,2,0,0,0
04231260,24,5,19,0,0,0,0,0,1
04231944,3,1,2,0,0,0,0,0,1
04232378,7,3,4,0,4,4,0,1,0
04232750,19,6,13,0,1,1,0,1,1
04235180,12,2,10,0,1,1,0,1,1
04236536,13,2,11,0,1,1,0,1,1
04237917,4,3,1,0,2,2,0,0,1
04238273,12,2,10,0,3,2,1,0,0
04238980,3,1,2,0,0,0,0,0,1
04238984,3,1,2,0,0,0,0,0,1
04239718,10,1,9,0,2,1,1,0,0
04239895,6,4,2,0,3,3,0,0,0
09770083,3,3,0,0,0,0,0,0,0
09770360,5,5,0,0,1,1,0,1,0
09770814,2,2,0,0,1,1,0,0,0
09771349,5,2,3,0,2,0,2,0,0
09771439,2,2,0,0,2,2,0,0,0
09771556,12,7,5,0,1,1,0,1,1
09771586,11,6,5,0,1,1,0,1,1
09771968,1,1,0,0,2,2,0,1,0
09772405,11,6,5,0,1,1,0,1,1
09772695,2,1,1,0,2,1,1,0,0
09773776,5,3,2,0,1,0,1,0,1
09773963,5,2,3,0,1,1,0,1,1
09774291,3,3,0,0,1,1,0,1,1
09776090,3,3,0,0,1,1,0,0,1
09777155,2,0,2,0,2,2,0,0,0
09779111,3,0,3,0,0,0,0,0,1
09779572,2,2,0,0,1,1,0,0,0
09779726,8,7,1,0,6,6,0,0,0
09780382,10,5,5,0,1,1,0,1,1
09780898,2,0,2,0,1,1,0,0,0
09781909,2,0,2,0,2,2,0,0,0
09782451,5,2,3,0,1,1,0,1,1
09784367,12,7,5,0,1,1,0,1,1
09784671,2,1,1,0,1,1,0,0,0
09785103,3,3,0,0,1,1,0,1,0
09785647,2,2,0,0,2,2,0,0,0
09786142,1,1,0,0,1,1,0,0,0
09786852,1,1,0,0,1,1,0,0,0
09786902,2,2,0,0,2,2,0,0,0
09788260,1,1,0,0,1,1,0,0,1
09789655,2,1,1,0,1,1,0,0,0
09789712,3,2,1,0,1,1,0,0,0
09792222,1,1,0,0,1,1,0,0,0
09792223,1,0,1,0,1,1,0,0,0
09794696,4,0,4,0,1,1,0,0,0
09795636,12,4,8,0,1,1,0,1,1
09795638,12,4,8,0,1,1,0,1,1
09795648,12,4,8,0,1,1,0,1,1
09795849,1,1,0,0,1,1,0,0,0
09798581,6,1,5,0,1,1,0,0,1
09798915,2,1,1,0,2,1,1,0,0
09800947,1,0,1,0,1,1,0,0,0
09803063,1,1,0,0,1,1,0,0,0
09803857,1,0,1,0,0,0,0,0,1
09805293,6,1,5,0,1,1,0,0,1
09805388,1,1,0,0,1,1,0,0,0
09805543,3,1,2,0,1,1,0,0,0
09805744,4,4,0,0,4,3,1,1,0
09805821,9,9,0,1,0,0,0,0,1
09807631,6,4,2,0,2,1,1,0,0
09809040,6,5,1,0,0,0,0,0,0
09809724,1,1,0,0,1,1,0,0,0
09809921,1,1,0,0,0,0,0,0,0
09812491,3,0,3,0,1,1,0,0,1
09814021,4,3,1,0,4,3,1,1,0
09814183,2,0,2,0,0,0,0,0,0
09816531,1,0,1,0,1,1,0,0,0
09816694,1,0,1,0,0,0,0,0,1
09818831,1,0,1,0,1,1,0,0,0
09820183,8,0,8,0,0,0,0,0,1
09821856,1,1,0,0,1,1,0,0,0
09822724,1,1,0,0,1,1,0,0,0
09823494,1,1,0,0,1,1,0,0,0
09823652,2,2,0,0,1,1,0,0,0
09823670,2,2,0,0,0,0,0,0,0
09823943,1,1,0,0,1,1,0,0,0
09825444,4,1,3,0,1,1,0,1,0
09825905,2,2,0,0,1,1,0,0,0
09826166,3,3,0,0,1,1,0,1,0
09826669,11,5,6,0,3,3,0,0,1
09826758,10,5,5,0,3,3,0,0,1
09826773,10,5,5,0,3,3,0,0,1
09826787,46,16,30,0,0,0,0,0,1
09828971,1,1,0,0,1,1,0,0,0
09831081,2,2,0,0,1,1,0,0,1
09831869,2,1,1,0,1,1,0,0,0
09832582,7,2,5,0,3,3,0,0,1
09834735,1,1,0,0,1,1,0,0,0
09835312,2,0,2,0,1,1,0,0,1
09837381,1,0,1,0,1,1,0,0,0
09837401,2,0,2,0,1,1,0,0,0
09838581,1,0,1,0,0,0,0,0,1
09838960,2,0,2,0,2,2,0,0,0
09839322,2,0,2,0,1,1,0,0,0
09839481,2,2,0,0,2,2,0,0,0
09840181,6,2,4,0,1,1,0,0,0
09842110,1,0,1,0,1,1,0,0,1
09844031,2,1,1,0,1,1,0,0,0
09844523,4,3,1,0,0,0,0,0,0
09844938,1,0,1,0,1,1,0,0,0
09846123,2,2,0,0,2,2,0,0,0
09846290,4,3,1,0,1,1,0,1,0
09846381,1,1,0,0,1,1,0,0,0
09846485,1,0,1,0,0,0,0,0,0
09847689,2,0,2,0,1,1,0,1,1
09848313,2,2,0,0,2,2,0,0,0
09848874,8,6,2,0,2,1,1,0,1
09850953,2,2,0,0,3,3,0,1,0
09850985,2,2,0,0,3,3,0,1,0
09851128,32,17,15,0,0,0,0,0,0
09851295,4,4,0,0,2,1,1,1,0
09851329,8,1,7,0,5,1,4,0,0
09851453,3,3,0,0,2,2,0,0,0
09853277,2,2,0,0,1,1,0,0,1
09854557,1,1,0,0,1,1,0,0,0
09854664,2,2,0,0,1,1,0,0,0
09855035,1,1,0,0,1,1,0,0,0
09855264,6,4,2,0,1,1,0,1,1
09855833,3,0,3,0,2,2,0,0,1
09856029,2,2,0,0,2,2,0,0,0
09856999,1,0,1,0,1,1,0,0,0
09857189,7,4,3,0,1,1,0,0,0
09858455,1,1,0,0,1,1,0,0,0
09858936,10,4,6,0,0,0,0,0,1
09858973,2,2,0,0,1,1,0,0,0
09859350,4,2,2,0,1,1,0,1,1
09859720,2,2,0,0,1,1,0,0,0
09859903,3,2,1,0,3,2,1,0,0
09860721,1,1,0,0,1,1,0,0,0
09862186,4,2,2,0,0,0,0,0,0
09863072,1,1,0,0,1,1,0,0,0
09865416,1,1,0,0,1,1,0,0,0
09865447,1,1,0,0,1,1,0,0,0
09865943,1,1,0,0,1,1,0,0,0
09866870,2,1,1,0,2,1,1,0,0
09866940,1,1,0,0,1,1,0,0,0
09868223,2,2,0,0,2,2,0,0,0
09869080,1,1,0,0,1,1,0,0,0
09869765,1,1,0,0,1,1,0,0,0
09870421,7,5,2,0,5,0,5,0,0
09870693,2,2,0,0,1,1,0,0,0
09871186,3,2,1,0,0,0,0,0,0
09876827,8,4,4,0,0,0,0,0,0
09876972,3,1,2,0,1,1,0,0,0
09879145,1,1,0,0,2,2,0,0,0
09879961,1,1,0,0,1,1,0,0,0
09880327,2,2,0,0,2,2,0,0,0
09881410,6,5,1,0,2,2,0,1,0
09881449,6,0,6,0,0,0,0,0,0
09886880,3,0,3,0,2,1,1,0,0
09887438,2,0,2,0,2,1,1,0,0
09888674,1,0,1,0,1,1,0,0,0
09889172,1,1,0,0,1,1,0,0,0
09889615,11,5,6,0,0,0,0,0,1
09890152,4,4,0,0,2,2,0,0,1
09892433,3,3,0,0,3,1,2,0,0
09893316,3,2,1,0,1,1,0,0,0
09894386,3,2,1,0,2,2,0,0,0
09896693,1,1,0,0,1,1,0,0,0
09897698,5,4,1,0,1,1,0,0,1
09898430,3,2,1,0,1,1,0,1,1
09899246,4,3,1,0,3,3,0,0,0
09899449,1,1,0,0,1,1,0,0,0
09899801,3,2,1,0,1,1,0,0,1
09902896,1,0,1,0,1,1,0,0,0
09903556,2,2,0,0,1,1,0,0,1
09903987,4,1,3,0,2,2,0,2,1
09905286,2,2,0,0,1,1,0,0,0
09907549,2,2,0,0,1,1,0,0,0
09908347,1,1,0,0,1,1,0,0,0
09908421,1,0,1,0,1,1,0,0,0
09909551,2,1,1,0,2,2,0,0,0
09912095,2,2,0,0,2,2,0,0,1
09913107,2,2,0,0,1,1,0,1,1
09913341,4,4,0,0,1,1,0,1,1
09913468,9,4,5,0,2,1,1,2,0
09913962,3,3,0,0,1,1,0,0,1
09914320,2,2,0,0,1,1,0,0,0
09914639,2,2,0,0,2,2,0,0,0
09915444,1,1,0,0,1,1,0,0,0
09915957,12,10,2,0,0,0,0,0,0
09917811,4,4,0,0,1,1,0,1,1
09918136,2,0,2,0,2,2,0,0,0
09918883,13,6,7,0,2,2,0,2,1
09919382,9,0,9,0,0,0,0,0,1
09920819,2,0,2,0,0,0,0,0,0
09921093,1,1,0,0,1,1,0,0,0
09922379,5,4,1,0,0,0,0,0,0
09923076,4,4,0,0,1,1,0,1,0
09923451,2,1,1,0,3,1,2,3,1
09926428,6,4,2,0,2,2,0,0,1
09926936,1,0,1,0,1,1,0,0,0
09927603,2,2,0,0,2,2,0,0,0
09928225,1,1,0,0,1,1,0,0,0
09930120,3,3,0,0,2,2,0,0,0
09931251,3,2,1,0,1,1,0,0,0
09931962,7,2,5,0,1,1,0,1,1
09935016,1,1,0,0,2,2,0,0,0
09935225,1,1,0,0,1,1,0,0,0
09935767,2,2,0,0,1,1,0,0,0
09936295,1,1,0,0,1,1,0,0,0
09936362,1,0,1,0,1,1,0,0,0
09938159,1,1,0,0,1,1,0,0,0
09939402,2,2,0,0,2,2,0,0,0
09939937,1,1,0,0,1,1,0,0,0
09941604,2,2,0,0,2,2,0,0,0
09943103,4,3,1,0,1,1,0,1,0
09943393,7,4,3,0,1,1,0,1,0
09943407,2,0,2,0,1,1,0,1,0
09944191,2,1,1,0,2,1,1,0,0
09945399,2,2,0,0,1,1,0,0,0
09947416,3,3,0,0,2,2,0,0,0
09948080,1,0,1,0,1,1,0,0,0
09948962,1,1,0,0,1,1,0,1,0
09949999,4,0,4,0,0,0,0,0,1
09950016,4,0,4,0,0,0,0,0,1
09951689,1,1,0,0,1,1,0,0,0
09951822,1,0,1,0,0,0,0,0,0
09951955,2,0,2,0,1,1,0,0,0
09953690,2,0,2,0,1,1,0,0,0
09953773,6,4,2,0,0,0,0,0,0
09958525,22,18,4,0,0,0,0,0,0
09959136,4,4,0,0,1,1,0,1,1
09959426,1,1,0,0,1,1,0,0,0
09960018,1,1,0,0,1,1,0,0,0
09961241,1,1,0,0,1,1,0,0,0
09961936,1,0,1,0,0,0,0,0,1
09962010,3,2,1,0,3,3,0,0,0
09962113,1,1,0,0,1,1,0,0,0
09962667,3,2,1,0,1,1,0,0,0
09964243,1,1,0,0,0,0,0,0,0
09964958,2,2,0,0,2,1,1,1,0
09965803,1,1,0,0,1,1,0,0,0
09965954,6,4,2,0,1,1,0,1,1
09966486,6,2,4,0,1,1,0,0,1
09966662,6,0,6,0,0,0,0,0,1
09967119,1,1,0,0,1,1,0,0,0
09967944,1,1,0,0,1,1,0,0,0
09968644,1,1,0,0,1,1,0,0,0
09970522,6,0,6,0,0,0,0,0,1
09972178,2,0,2,0,1,1,0,0,0
09972433,6,6,0,0,0,0,0,0,0
09972965,3,1,2,0,3,1,2,0,0
09973281,2,2,0,0,1,1,0,0,0
09973707,4,4,0,0,4,4,0,0,0
09974867,2,2,0,0,1,1,0,1,1
09976204,12,4,8,0,0,0,0,0,1
09976283,1,0,1,0,1,1,0,0,0
09978380,2,2,0,0,1,1,0,0,0
09980813,6,3,3,0,0,0,0,0,1
09981643,3,3,0,0,1,1,0,0,0
09982640,3,1,2,0,2,2,0,2,1
09983600,5,1,4,0,4,4,0,0,1
09984516,1,1,0,0,1,1,0,0,0
09984999,2,2,0,0,2,2,0,0,0
09985002,1,1,0,0,1,1,0,0,0
09985317,5,2,3,0,1,1,0,0,1
09985572,6,0,6,0,0,0,0,0,1
09986426,7,6,1,0,3,1,2,3,1
09986729,1,1,0,0,1,1,0,0,0
09987495,12,7,5,0,2,1,1,0,0
09987590,2,2,0,0,2,2,0,0,0
09989000,5,2,3,0,1,1,0,1,1
09989185,6,2,4,0,1,1,0,1,1
09991916,3,3,0,0,2,2,0,0,1
09991965,2,1,1,0,3,2,1,1,0
09992203,15,10,5,0,1,1,0,1,1
09994485,1,0,1,0,0,0,0,0,0
09996181,1,0,1,0,1,1,0,0,0
09996664,5,4,1,0,1,1,0,1,1
09997394,2,1,1,0,2,1,1,0,1
09997512,1,1,0,0,0,0,0,0,0
09997610,1,1,0,0,1,1,0,0,0
09997656,2,2,0,0,2,2,0,0,0
09998176,3,2,1,0,1,1,0,0,0
09998988,2,2,0,0,1,1,0,0,0
10000431,2,2,0,0,2,2,0,0,0
10000475,6,2,4,0,1,1,0,0,1
10000684,9,8,1,0,0,0,0,0,0
10002354,1,1,0,0,1,1,0,0,0
10003432,2,2,0,0,2,2,0,0,0
10006752,2,1,1,0,1,1,0,0,0
10007626,4,3,1,0,1,1,0,1,1
10007757,1,1,0,0,1,1,0,0,0
10007896,1,1,0,0,1,1,0,0,0
10009504,2,2,0,0,1,1,0,0,0
10009918,11,7,4,0,3,1,2,0,1
10011158,2,2,0,0,1,1,0,0,1
10013985,1,0,1,0,0,0,0,0,1
10014085,2,2,0,0,2,2,0,0,0
10014440,6,0,6,0,2,2,0,0,1
10015444,9,3,6,0,1,1,0,1,1
10015556,5,4,1,0,4,4,0,0,0
10015809,1,1,0,0,1,1,0,0,0
10017197,1,1,0,0,1,1,0,1,0
10017774,5,1,4,0,2,2,0,1,1
10017870,1,0,1,0,1,1,0,0,0
10018061,8,3,5,0,1,1,0,1,1
10018095,7,3,4,0,1,1,0,1,1
10020664,2,2,0,0,2,2,0,2,0
10022717,2,2,0,0,2,2,0,0,0
10023161,4,3,1,0,1,1,0,0,1
10023270,1,1,0,0,1,1,0,0,0
10024121,9,5,4,0,1,1,0,0,0
10026284,2,2,0,0,0,0,0,0,0
10026874,2,2,0,0,1,1,0,1,0
10028674,1,0,1,0,1,1,0,0,0
10028724,2,0,2,0,0,0,0,0,0
10028946,2,2,0,0,1,1,0,0,0
10029333,1,0,1,0,1,1,0,0,0
10029369,2,0,2,0,2,2,0,0,0
10029550,5,5,0,0,1,1,0,1,1
10030251,3,1,2,0,1,1,0,0,0
10031467,1,0,1,0,0,0,0,0,0
10033669,1,1,0,0,1,1,0,0,0
10034612,2,2,0,0,2,2,0,0,0
10036848,5,2,3,0,2,2,0,0,0
10037345,4,4,0,0,2,2,0,0,0
10041032,1,1,0,0,1,1,0,0,0
10042606,2,2,0,0,1,1,0,1,0
10042712,3,3,0,0,3,3,0,0,0
10043228,4,4,0,0,3,3,0,0,0
10043631,1,0,1,0,1,1,0,0,0
10044338,2,2,0,0,2,2,0,0,0
10046009,9,4,5,1,1,1,0,1,0
10047890,4,3,1,0,2,1,1,2,1
10049784,1,1,0,0,1,1,0,0,0
10051264,1,1,0,0,1,1,0,0,0
10051674,2,2,0,0,1,1,0,0,0
10051787,4,3,1,0,4,3,1,0,0
10053854,2,0,2,0,2,2,0,0,0
10054063,3,3,0,0,1,1,0,0,0
10054518,14,7,7,0,0,0,0,0,1
10055327,1,1,0,0,1,1,0,0,0
10055482,5,2,3,1,2,1,1,1,1
10055690,4,4,0,0,0,0,0,0,0
10057031,2,0,2,0,1,1,0,0,0
10058183,6,3,3,0,3,1,2,3,1
10059069,6,4,2,0,0,0,0,0,0
10059591,5,3,2,0,1,1,0,1,0
10059923,3,2,1,0,1,1,0,0,0
10060955,2,2,0,0,2,2,0,0,0
10064886,8,7,1,0,1,1,0,1,1
10068168,2,2,0,0,2,2,0,0,0
10068504,2,2,0,0,2,2,0,0,0
10068774,2,2,0,0,1,1,0,1,0
10069094,2,1,1,0,0,0,0,0,0
10070076,1,1,0,0,1,1,0,0,0
10070094,1,1,0,0,1,1,0,1,0
10070814,2,2,0,0,2,2,0,0,0
10072549,2,0,2,0,2,2,0,0,1
10074474,7,4,3,0,5,1,4,1,1
10074707,1,1,0,0,1,1,0,0,0
10075186,1,1,0,0,1,1,0,0,0
10076328,6,4,2,0,1,1,0,1,0
10078396,2,0,2,0,1,1,0,0,0
04670417,9,1,8,0,1,1,0,0,1
04670427,6,0,6,0,0,0,0,0,1
04670795,4,2,2,0,1,1,0,0,0
04670961,8,3,5,0,0,0,0,0,0
04671020,22,2,20,0,1,1,0,1,1
04671563,5,3,2,0,0,0,0,0,0
04671977,7,4,3,0,1,1,0,0,0
04673202,13,4,9,0,2,2,0,0,1
04675657,28,7,21,0,0,0,0,0,0
04675720,14,4,10,0,0,0,0,0,1
04676572,41,0,41,0,1,1,0,1,1
04676590,36,0,36,0,1,1,0,1,1
04676602,35,0,35,0,1,1,0,1,1
04677863,4,0,4,0,1,1,0,0,0
04677925,8,2,6,0,1,1,0,0,1
04678356,4,2,2,0,2,2,0,0,0
04678522,5,3,2,0,2,2,0,0,1
04679298,9,6,3,0,1,1,0,0,1
04679597,9,5,4,0,1,1,0,1,0
04679643,4,1,3,0,2,2,0,0,0
04680088,5,3,2,0,2,2,0,0,0
04680474,5,3,2,0,2,2,0,0,0
04681156,9,4,5,0,0,0,0,0,0
04681724,6,2,4,0,1,1,0,0,0
04682088,19,1,18,0,1,1,0,1,1
04682208,75,29,46,0,0,0,0,0,0
04683163,6,0,6,0,0,0,0,0,0
04683683,18,3,15,0,1,1,0,1,1
04684691,7,3,4,0,1,1,0,0,0
04685252,9,3,6,0,2,2,0,0,0
04686026,8,0,8,0,1,1,0,0,0
04687799,24,4,20,0,0,0,0,0,0
04688545,5,1,4,0,1,1,0,0,0
04689130,26,4,22,0,1,0,1,0,1
04689828,4,3,1,0,2,2,0,0,0
04692388,13,2,11,0,2,2,0,2,1
04693440,5,3,2,0,2,2,0,0,0
04696047,8,3,5,0,1,1,0,0,1
04696505,5,2,3,0,1,1,0,0,1
04696839,27,4,23,0,7,1,6,4,1
04697650,4,2,2,0,1,1,0,1,1
04697839,4,2,2,0,1,1,0,0,1
04699155,10,5,5,0,0,0,0,0,1
04699524,11,2,9,0,11,11,0,11,1
04699779,3,2,1,0,1,1,0,0,0
04701175,5,3,2,0,2,2,0,0,1
04702108,7,2,5,0,1,1,0,0,0
04703224,19,7,12,0,1,1,0,1,1
04704729,4,1,3,0,0,0,0,0,1
04705025,9,2,7,0,1,1,0,0,0
04706060,7,2,5,0,1,1,0,0,1
04706447,10,3,7,0,1,1,0,0,1
04706529,19,0,19,0,0,0,0,0,1
04707422,4,2,2,0,1,1,0,0,0
04708272,8,0,8,0,0,0,0,0,1
04708641,5,0,5,0,0,0,0,0,1
04708897,5,2,3,0,2,2,0,0,0
04708929,5,0,5,0,0,0,0,0,1
04710434,4,1,3,0,1,1,0,0,0
04710574,18,7,11,0,3,1,2,2,1
04712925,11,0,11,0,0,0,0,0,1
04713302,5,0,5,0,2,2,0,0,0
04713417,7,3,4,0,3,3,0,0,0
04713977,7,2,5,0,1,1,0,0,1
04713985,5,2,3,0,1,1,0,0,1
04714039,11,4,7,0,2,2,0,0,1
04715958,21,8,13,0,0,0,0,0,1
04716155,4,2,2,0,2,2,0,0,1
04718208,7,3,4,0,1,1,0,0,0
04719672,8,1,7,0,1,1,0,1,1
04719865,7,3,4,0,2,2,0,0,1
04720439,22,5,17,0,1,1,0,1,1
04720979,5,3,2,0,2,2,0,0,0
04721046,15,2,13,0,2,2,0,0,1
04721742,4,2,2,0,0,0,0,0,0
04723103,6,2,4,0,1,1,0,0,0
04723252,5,2,3,0,2,1,1,0,1
04726360,24,2,22,0,2,2,0,2,1
04726394,4,2,2,0,1,1,0,0,0
04726837,17,4,13,0,1,1,0,1,1
04727693,5,2,3,0,1,1,0,0,1
04727874,29,9,20,0,0,0,0,0,1
04728026,5,1,4,0,2,1,1,0,0
04729593,3,2,1,0,1,1,0,0,0
04730543,4,2,2,0,1,1,0,0,0
04731536,22,0,22,0,0,0,0,0,1
04732063,12,0,12,0,0,0,0,0,1
04733475,12,3,9,0,6,1,5,0,0
04733479,29,0,29,0,1,1,0,1,1
04734422,6,2,4,0,3,1,2,0,1
04736566,23,0,23,0,0,0,0,0,0
04736776,14,4,10,0,0,0,0,0,0
04737491,8,0,8,0,0,0,0,0,1
04738098,21,6,15,0,0,0,0,0,0
04738105,10,2,8,0,0,0,0,0,1
04738167,6,1,5,0,1,1,0,0,0
04738406,17,8,9,0,1,1,0,0,0
04738932,5,2,3,0,1,1,0,0,0
04739205,6,2,4,0,1,1,0,0,0
04739247,5,0,5,0,0,0,0,0,1
04740273,5,3,2,0,2,2,0,0,0
04740289,6,3,3,0,1,1,0,0,1
04740334,5,2,3,0,1,1,0,0,0
04741637,9,0,9,0,0,0,0,0,1
04742072,5,3,2,0,2,2,0,0,0
04742505,13,3,10,0,0,0,0,0,1
04743106,5,1,4,1,1,1,0,1,0
04743602,99,16,83,0,1,1,0,1,1
04743955,4,2,2,0,1,1,0,0,1
04744791,19,0,19,0,0,0,0,0,1
04746877,5,1,4,0,1,1,0,0,0
04747359,12,1,11,0,1,1,0,1,1
04748264,6,3,3,0,2,1,1,2,0
04749705,4,2,2,0,1,1,0,0,0
04752037,11,1,10,0,0,0,0,0,1
04753249,12,4,8,0,0,0,0,0,0
04753552,3,1,2,0,1,1,0,0,0
04754248,4,1,3,0,1,1,0,0,1
04755383,7,0,7,0,1,1,0,0,0
04755625,10,3,7,0,1,1,0,1,1
04758041,5,3,2,0,2,2,0,0,0
04759686,5,3,2,0,2,2,0,0,0
04759878,8,3,5,0,2,2,0,0,1
04759881,10,2,8,0,3,3,0,1,1
04761892,5,3,2,0,1,1,0,0,0
04762392,6,2,4,0,1,1,0,0,0
04763144,3,2,1,0,1,1,0,0,0
04765447,12,0,12,0,0,0,0,0,1
04766099,14,3,11,0,1,1,0,1,1
04768146,7,0,7,0,0,0,0,0,1
04768253,15,0,15,0,0,0,0,0,1
04768918,7,2,5,0,1,1,0,0,1
04770256,27,0,27,0,0,0,0,0,1
04773061,17,4,13,0,2,1,1,0,0
04774825,3,3,0,0,2,2,0,0,0
04777565,7,3,4,0,0,0,0,0,0
04778043,3,2,1,0,1,1,0,0,1
04778508,15,0,15,0,0,0,0,0,0
04778901,4,2,2,0,0,0,0,0,0
04779433,24,4,20,0,0,0,0,0,0
04779767,13,3,10,0,1,1,0,1,1
04780713,18,0,18,0,0,0,0,0,0
04780788,16,7,9,0,2,2,0,1,1
04781346,4,2,2,0,1,1,0,0,1
04781697,3,0,3,0,0,0,0,0,1
04781705,3,0,3,0,0,0,0,0,1
04782079,4,0,4,0,2,2,0,0,1
04783263,22,2,20,0,1,1,0,1,1
04783484,5,3,2,0,2,2,0,0,0
04784399,5,3,2,0,2,2,0,0,0
04784905,7,0,7,0,2,2,0,0,0
04785053,8,1,7,0,0,0,0,0,0
04787262,11,2,9,0,1,1,0,1,1
04787639,58,13,45,0,0,0,0,0,1
04789582,5,3,2,0,1,1,0,0,1
04790426,17,7,10,0,1,1,0,1,1
04791283,24,4,20,0,0,0,0,0,1
04792413,4,1,3,0,1,1,0,0,0
04793167,17,7,10,0,1,1,0,1,1
04793696,10,5,5,0,1,1,0,1,1
04793729,20,3,17,1,1,1,0,1,1
04793815,32,6,26,0,2,2,0,2,1
04794094,20,3,17,0,1,1,0,1,1
04794099,15,3,12,0,1,1,0,1,1
04794682,17,5,12,1,0,0,0,0,0
04795357,11,8,3,0,0,0,0,0,0
04796012,5,3,2,0,1,1,0,0,1
04797154,5,3,2,0,1,1,0,0,1
04797158,11,2,9,0,0,0,0,0,0
04797230,4,2,2,0,1,1,0,0,1
04797346,20,5,15,0,1,1,0,1,1
04798389,12,3,9,0,0,0,0,0,0
04800794,4,2,2,0,1,1,0,0,1
04801204,10,2,8,1,1,1,0,0,1
04802888,5,0,5,0,0,0,0,0,1
04804114,3,2,1,0,2,2,0,2,1
04804475,5,5,0,0,3,1,2,1,0
04804648,5,5,0,0,3,1,2,1,0
04805105,8,1,7,0,3,1,2,0,1
04805781,20,3,17,1,1,1,0,1,1
04806891,9,0,9,0,0,0,0,0,1
04807064,32,7,25,0,0,0,0,0,0
04807288,11,5,6,0,0,0,0,0,1
04807904,30,5,25,0,1,1,0,1,1
04808151,5,3,2,0,2,2,0,0,0
04808335,5,0,5,0,0,0,0,0,1
04808420,8,2,6,0,1,1,0,0,1
04808580,5,3,2,0,2,2,0,0,0
04808853,7,0,7,0,0,0,0,0,1
04808994,6,0,6,0,1,1,0,1,1
04809335,11,2,9,0,1,1,0,1,1
04811451,4,1,3,0,1,1,0,0,0
04812240,4,2,2,0,1,1,0,0,0
04812278,7,3,4,0,0,0,0,0,1
04815067,4,2,2,0,2,2,0,0,1
04815181,43,14,29,0,0,0,0,0,0
04815365,6,3,3,0,2,1,1,0,0
04815525,6,2,4,0,0,0,0,0,0
04816054,8,4,4,0,0,0,0,0,0
04816786,39,8,31,0,0,0,0,0,1
04817448,9,4,5,0,1,1,0,1,1
04818639,7,3,4,0,0,0,0,0,1
04818735,6,1,5,0,1,1,0,0,1
04820602,4,1,3,0,1,1,0,0,1
04822376,5,2,3,0,1,1,0,0,0
04822541,8,4,4,0,1,1,0,0,0
04822997,29,0,29,0,0,0,0,0,1
04824801,7,0,7,0,0,0,0,0,0
04825491,10,0,10,0,0,0,0,0,1
04826778,3,3,0,0,2,2,0,0,0
04827518,5,3,2,0,2,2,0,0,0
04827804,8,5,3,0,3,1,2,1,0
04828050,4,2,2,0,1,1,0,0,0
04829102,6,2,4,0,1,1,0,0,1
04829817,20,3,17,0,4,1,3,2,1
04830735,28,6,22,0,2,1,1,0,0
04833623,23,6,17,0,4,2,2,4,0
04834430,11,2,9,0,1,1,0,1,1
04834434,20,3,17,0,1,1,0,1,1
04834718,3,0,3,0,1,1,0,1,0
04835087,11,2,9,0,1,1,0,1,1
04835820,13,0,13,0,0,0,0,0,1
04836872,19,2,17,0,0,0,0,0,1
04839119,12,3,9,0,1,1,0,1,1
04839409,16,3,13,0,0,0,0,0,1
04840151,4,0,4,0,0,0,0,0,1
04840187,5,3,2,0,2,2,0,0,0
04843280,4,2,2,0,1,1,0,0,0
04844858,6,0,6,0,2,2,0,0,1
04846017,5,3,2,0,1,1,0,0,0
04846353,6,4,2,0,2,2,0,0,0
04848368,6,3,3,0,2,2,0,2,1
04849220,8,3,5,0,4,1,3,1,1
04849998,9,2,7,0,1,1,0,1,1
04850355,6,0,6,0,1,1,0,0,0
04850612,12,0,12,0,0,0,0,0,1
04851498,30,9,21,0,0,0,0,0,1
04851962,4,2,2,0,1,1,0,0,1
04852017,18,3,15,0,1,1,0,1,1
04853184,6,0,6,0,0,0,0,0,0
04854568,4,2,2,0,1,1,0,0,0
04855173,54,16,38,0,0,0,0,0,1
04855333,11,3,8,0,1,1,0,1,1
04857188,4,2,2,0,2,2,0,0,0
04857238,5,3,2,0,2,2,0,0,0
04859399,11,0,11,0,0,0,0,0,1
04859512,8,5,3,1,1,1,0,1,1
04860054,7,1,6,0,2,1,1,0,0
04860660,26,7,19,0,1,1,0,1,1
04860827,8,0,8,0,0,0,0,0,1
04860867,12,3,9,0,1,1,0,1,1
04861200,5,2,3,0,1,1,0,0,0
04863660,5,1,4,0,1,1,0,1,0
04864434,19,3,16,0,1,1,0,1,1
04866132,9,1,8,0,0,0,0,0,0
04867503,20,4,16,2,1,0,1,1,1
04867504,20,4,16,2,1,0,1,1,1
04868329,16,6,10,0,0,0,0,0,1
04868792,15,7,8,0,0,0,0,0,0
04869751,5,3,2,0,2,2,0,0,1
04869878,6,1,5,0,1,1,0,0,0
03680535,26,4,22,0,1,1,0,1,1
03680937,39,3,36,0,1,1,0,1,1
03680951,31,3,28,0,1,1,0,1,1
03681869,12,5,7,0,1,1,0,0,1
03682804,16,2,14,0,1,1,0,1,1
03682822,15,5,10,0,2,1,1,1,0
03682831,12,2,10,0,0,0,0,0,0
03683003,25,7,18,0,1,1,0,0,1
03683292,11,1,10,0,1,1,0,1,1
03684674,6,1,5,0,1,1,0,0,1
03684770,18,3,15,0,1,1,0,1,1
03685684,5,4,1,0,3,3,0,0,1
03685725,4,2,2,0,1,1,0,0,1
03686262,12,0,12,0,1,1,0,0,1
03686284,43,11,32,0,3,3,0,0,0
03687910,54,5,49,0,0,0,0,0,1
03689320,6,4,2,0,2,2,0,0,0
03689584,20,2,18,0,1,1,0,1,1
03690115,10,4,6,0,1,1,0,1,1
03690823,17,4,13,0,0,0,0,0,0
03691898,46,9,37,0,1,1,0,1,1
03692001,20,2,18,0,1,1,0,1,1
03692917,5,1,4,0,1,1,0,0,0
03693914,32,4,28,0,2,2,0,2,1
03694734,7,2,5,0,1,1,0,1,0
03695235,28,10,18,0,0,0,0,0,0
03696164,5,2,3,0,1,1,0,0,0
03696339,21,5,16,0,4,3,1,1,1
03697438,10,3,7,0,1,1,0,0,1
03697505,39,5,34,0,1,1,0,1,1
03698902,5,2,3,0,1,1,0,0,1
03698922,10,3,7,0,1,1,0,1,0
03701224,6,0,6,0,0,0,0,0,1
03702428,35,3,32,0,1,1,0,1,1
03703703,14,3,11,0,4,3,1,1,0
03704346,5,3,2,0,2,2,0,0,1
03704603,6,2,4,0,1,1,0,0,1
03704778,10,0,10,0,0,0,0,0,1
03705788,23,8,15,0,2,2,0,0,0
03706064,18,4,14,0,1,1,0,1,1
03707787,18,3,15,0,1,1,0,1,1
03709565,33,9,24,0,0,0,0,0,0
03709785,30,3,27,0,1,1,0,1,1
03710765,7,2,5,0,1,1,0,0,0
03710781,7,4,3,0,3,3,0,0,0
03712295,8,1,7,0,1,1,0,0,0
03712966,7,3,4,0,1,1,0,1,0
03713679,30,1,29,0,1,1,0,1,1
03714138,6,2,4,0,1,1,0,0,1
03714277,12,2,10,0,1,1,0,1,1
03714669,15,3,12,0,1,1,0,1,0
03715032,16,0,16,0,1,1,0,0,1
03715044,20,4,16,0,1,1,0,1,0
03715387,6,3,3,0,2,2,0,0,0
03715410,36,5,31,0,1,1,0,1,1
03716362,30,4,26,0,1,1,0,1,1
03716519,16,2,14,0,1,1,0,1,1
03719472,18,3,15,0,1,1,0,1,1
03719637,18,0,18,0,0,0,0,0,1
03720217,14,2,12,0,5,5,0,2,1
03720483,8,4,4,0,1,1,0,0,0
03721837,11,4,7,0,3,3,0,0,0
03722939,15,3,12,0,0,0,0,0,1
03723445,9,2,7,0,3,3,0,1,1
03725039,36,4,32,0,1,1,0,1,1
03726292,21,3,18,0,1,1,0,1,1
03726512,5,0,5,0,0,0,0,0,1
03726930,16,6,10,0,2,2,0,2,1
03729073,18,3,15,0,1,1,0,1,1
03729917,16,0,16,0,0,0,0,0,1
03730009,7,0,7,0,0,0,0,0,0
03730131,10,3,7,0,0,0,0,0,0
03730788,7,0,7,0,0,0,0,0,1
03731333,8,0,8,0,0,0,0,0,0
03731439,4,2,2,0,1,1,0,0,1
03732253,23,6,17,0,0,0,0,0,1
03732285,6,2,4,0,1,1,0,0,1
03732993,33,0,33,0,0,0,0,0,0
03733058,22,3,19,0,1,1,0,1,1
03733077,27,3,24,0,1,1,0,1,1
03733088,22,4,18,0,1,1,0,1,1
03734124,4,1,3,0,1,1,0,0,1
03735007,14,4,10,0,2,1,1,1,1
03735154,19,5,14,0,1,1,0,1,1
03735333,5,2,3,0,1,1,0,0,0
03735433,9,1,8,0,1,1,0,1,0
03736485,5,0,5,0,1,1,0,0,0
03736918,24,0,24,0,0,0,0,0,1
03737642,10,2,8,0,1,1,0,0,0
03737678,5,0,5,0,2,2,0,0,1
03738674,28,4,24,0,1,1,0,1,1
03738678,13,0,13,0,2,2,0,0,1
03739124,36,3,33,0,0,0,0,0,1
03739319,9,0,9,0,0,0,0,0,1
03739551,14,2,12,0,2,2,0,2,1
03739954,32,3,29,0,2,1,1,2,1
03740620,14,0,14,0,0,0,0,0,1
03740753,10,1,9,0,1,1,0,1,1
03741198,11,2,9,0,1,1,0,1,1
03741454,13,2,11,0,0,0,0,0,1
03746069,10,0,10,0,0,0,0,0,1
03747176,20,0,20,0,0,0,0,0,1
03747506,16,1,15,0,4,2,2,1,1
03747980,6,2,4,0,2,2,0,0,1
03749062,5,1,4,0,1,1,0,0,1
03749063,17,2,15,0,1,1,0,1,1
03749322,10,4,6,0,1,1,0,1,1
03749323,9,4,5,0,1,1,0,1,1
03749328,10,1,9,0,1,1,0,0,1
03749416,5,0,5,0,1,1,0,0,0
03749576,12,5,7,0,6,6,0,1,1
03751152,6,1,5,0,1,1,0,0,1
03751732,5,3,2,0,2,2,0,0,0
03753345,53,4,49,0,0,0,0,0,1
03753765,12,0,12,0,1,1,0,1,1
03754942,10,6,4,0,1,1,0,1,0
03755033,34,4,30,0,1,1,0,1,1
03755337,5,2,3,0,1,1,0,0,1
03755464,33,0,33,0,1,1,0,1,1
03755701,9,5,4,0,0,0,0,0,0
03756152,32,11,21,0,0,0,0,0,0
03756817,21,2,19,1,1,1,0,1,1
03757200,17,2,15,0,0,0,0,0,1
03757248,29,8,21,0,1,1,0,0,0
03758317,4,2,2,0,1,1,0,0,1
03760824,10,0,10,0,1,1,0,1,1
03761135,22,5,17,0,0,0,0,0,1
03761178,25,3,22,0,1,1,0,1,1
03761194,20,3,17,0,1,1,0,1,1
03761906,6,3,3,0,2,1,1,0,1
03762879,29,5,24,0,0,0,0,0,1
03762890,26,2,24,0,1,1,0,1,1
03764415,8,0,8,0,0,0,0,0,1
03764584,7,0,7,0,0,0,0,0,1
03764784,6,0,6,0,2,1,1,0,0
03767321,13,0,13,0,0,0,0,0,0
03767752,25,0,25,0,0,0,0,0,1
03768392,6,3,3,0,1,1,0,0,0
03768746,9,2,7,0,1,1,0,0,1
03768838,5,2,3,0,2,2,0,0,1
03769269,7,4,3,0,1,1,0,1,1
03769516,5,1,4,0,0,0,0,0,1
03769605,25,0,25,0,0,0,0,0,1
03769694,9,6,3,0,1,1,0,0,0
03769702,24,6,18,0,0,0,0,0,1
03769768,19,7,12,0,0,0,0,0,0
03769775,28,15,13,0,0,0,0,0,1
03770007,17,0,17,0,0,0,0,0,1
03770319,13,7,6,0,6,6,0,0,1
03770430,5,3,2,0,2,2,0,0,1
03770568,17,6,11,0,1,1,0,1,1
03770985,13,9,4,0,4,3,1,1,0
03771108,13,2,11,0,3,2,1,1,1
03771991,31,0,31,0,0,0,0,0,1
03773247,21,0,21,0,0,0,0,0,1
03773737,24,8,16,0,0,0,0,0,0
03773789,37,3,34,0,1,1,0,1,1
03775012,18,4,14,0,1,1,0,1,1
03775122,33,5,28,0,1,1,0,1,1
03775228,6,0,6,0,0,0,0,0,1
03776520,17,5,12,0,1,1,0,1,1
03776523,20,3,17,0,1,1,0,1,1
03776633,18,0,18,1,0,0,0,0,1
03777276,20,0,20,0,1,1,0,1,1
03777280,5,0,5,0,2,2,0,0,1
03778430,5,3,2,0,0,0,0,0,1
03781302,12,4,8,0,2,2,0,0,0
03781498,17,0,17,0,0,0,0,0,1
03782935,23,0,23,0,0,0,0,0,1
03782943,19,0,19,0,0,0,0,0,1
03782947,12,3,9,0,1,1,0,1,1
03783281,14,3,11,0,2,2,0,0,1
03783386,18,5,13,0,2,1,1,1,1
03783920,5,0,5,0,0,0,0,0,1
03784577,15,0,15,0,0,0,0,0,1
03784932,4,2,2,0,1,1,0,0,0
03785049,11,0,11,1,0,0,0,0,0
03786105,7,1,6,0,1,1,0,0,1
03786339,33,0,33,0,0,0,0,0,1
03786387,10,2,8,0,1,1,0,0,1
03786989,29,0,29,0,1,1,0,1,1
03787141,6,3,3,0,2,2,0,1,0
03787294,16,0,16,0,0,0,0,0,1
03787518,20,0,20,0,0,0,0,0,1
03788183,16,3,13,0,1,1,0,1,1
03788862,4,2,2,0,1,1,0,0,0
03788956,20,0,20,0,1,1,0,1,1
03789061,8,2,6,0,1,1,0,0,1
03789231,6,0,6,0,0,0,0,0,1
03789309,4,2,2,0,1,1,0,0,1
03789894,5,0,5,0,1,1,0,0,0
03790871,7,1,6,0,1,1,0,0,1
03791447,4,2,2,0,2,2,0,0,1
03791923,6,3,3,0,2,2,0,0,1
03792408,23,3,20,0,1,1,0,1,1
03792496,11,3,8,0,1,1,0,1,1
03792590,23,0,23,0,0,0,0,0,1
03792886,30,4,26,0,2,1,1,1,1
03792949,8,5,3,0,2,2,0,0,1
03793946,9,5,4,0,0,0,0,0,1
03794679,4,3,1,0,1,1,0,0,0
03795008,10,4,6,0,1,1,0,0,0
03795232,14,5,9,0,0,0,0,0,1
03795868,18,0,18,0,0,0,0,0,1
03795965,11,5,6,0,2,2,0,0,1
03796233,35,4,31,0,1,1,0,1,1
03796951,31,0,31,0,0,0,0,0,1
03798315,5,2,3,0,1,1,0,0,0
03798359,7,2,5,0,1,1,0,0,0
03798891,5,3,2,0,2,2,0,0,1
03800882,16,0,16,0,1,1,0,0,1
03801508,6,1,5,0,1,1,0,0,0
03801700,4,2,2,0,2,2,0,0,1
03801846,5,3,2,0,1,1,0,0,0
03803544,4,1,3,0,1,1,0,0,1
03804593,7,3,4,0,1,1,0,0,1
03804831,10,1,9,0,1,1,0,1,1
03805705,8,0,8,0,0,0,0,0,1
03805708,30,3,27,0,1,1,0,1,1
03806216,22,3,19,0,2,2,0,2,1
03806233,18,4,14,0,1,1,0,1,1
03806342,9,4,5,0,3,3,0,0,1
03806388,11,7,4,0,1,1,0,0,1
03806491,40,5,35,0,4,1,3,1,0
03807559,24,5,19,0,1,1,0,1,1
03807723,9,3,6,0,3,3,0,1,1
03807789,10,4,6,0,1,1,0,0,1
03807883,5,2,3,0,1,1,0,0,0
03808291,22,0,22,0,0,0,0,0,1
03808857,17,3,14,0,1,1,0,1,1
03808866,21,0,21,0,0,0,0,0,1
03808998,14,1,13,1,1,1,0,0,1
03810395,29,0,29,0,1,1,0,1,1
03810841,24,0,24,0,0,0,0,0,1
03810974,34,2,32,0,1,1,0,1,1
03811155,9,0,9,0,0,0,0,0,1
03811720,7,3,4,0,2,2,0,0,1
03812015,39,3,36,0,1,1,0,1,1
03812071,11,4,7,0,3,2,1,0,1
03812646,16,0,16,0,0,0,0,0,1
03813010,10,3,7,0,1,1,0,1,1
03813859,23,5,18,0,1,1,0,1,1
03814008,8,0,8,0,0,0,0,0,1
03814118,12,4,8,0,3,3,0,0,0
03814318,21,6,15,0,1,0,1,0,1
03814724,5,0,5,0,0,0,0,0,1
03815052,41,0,41,0,0,0,0,0,1
03815545,13,0,13,0,1,1,0,0,0
03815604,23,4,19,0,0,0,0,0,1
03816616,29,6,23,0,1,1,0,1,1
03816999,8,5,3,0,0,0,0,0,0
03818176,32,4,28,0,1,1,0,1,1
03818182,20,2,18,0,3,3,0,0,1
03818321,24,4,20,0,1,1,0,1,1
03818324,19,5,14,0,1,1,0,1,1
03818327,27,4,23,0,1,1,0,1,1
03818330,19,4,15,0,1,1,0,1,1
03818982,23,0,23,0,1,1,0,1,1
03819961,10,4,6,0,1,1,0,1,1
03820149,6,2,4,0,1,1,0,0,1
03821546,14,2,12,0,2,2,0,0,1
03822618,26,4,22,0,0,0,0,0,1
03822808,9,6,3,0,5,5,0,1,0
03823129,35,12,23,0,0,0,0,0,0
03823580,22,0,22,0,0,0,0,0,1
03824159,16,2,14,0,2,1,1,0,0
03824818,25,7,18,0,0,0,0,0,0
03825041,13,4,9,0,1,1,0,1,1
03825262,29,5,24,0,2,2,0,2,1
03825437,9,2,7,0,2,1,1,0,1
03825499,12,4,8,0,0,0,0,0,1
03826071,6,3,3,0,1,1,0,0,0
03826797,33,10,23,0,1,1,0,1,1
03826898,6,0,6,0,0,0,0,0,1
03826915,6,0,6,0,0,0,0,0,1
03829309,7,4,3,0,1,1,0,1,1
03829341,15,4,11,0,1,1,0,1,1
03829460,27,5,22,0,1,1,0,0,1
03829462,35,9,26,0,1,1,0,1,1
03829464,7,0,7,0,0,0,0,0,1
03829466,22,3,19,0,0,0,0,0,1
03829467,17,3,14,0,1,1,0,1,1
03829468,25,3,22,0,1,1,0,1,1
03829469,26,3,23,0,1,1,0,1,1
03829472,17,3,14,0,1,1,0,1,1
03829473,30,5,25,0,3,3,0,3,1
03829481,17,4,13,0,3,1,2,1,1
03829615,15,3,12,0,1,1,0,1,1
03829852,8,1,7,0,0,0,0,0,1
03829939,18,3,15,0,1,1,0,1,1
03830104,4,1,3,0,1,1,0,0,1
03830335,68,2,66,0,2,1,1,0,1
03830687,10,2,8,0,1,1,0,0,0
03830974,11,0,11,0,0,0,0,0,1
03831070,10,1,9,0,1,1,0,0,0
03831711,18,6,12,0,5,5,0,0,0
03832821,11,0,11,0,0,0,0,0,1
03833210,5,1,4,0,1,1,0,0,1
03835495,4,2,2,0,2,2,0,0,1
03835617,33,4,29,0,4,4,0,4,1
03835994,4,0,4,0,1,1,0,0,1
03836106,32,9,23,0,0,0,0,0,0
03837152,40,5,35,0,1,1,0,1,1
03837274,13,0,13,0,0,0,0,0,1
03837407,3,0,3,0,1,1,0,0,0
03837708,6,2,4,0,1,1,0,0,1
03838618,93,18,75,0,2,1,1,0,0
03839319,10,2,8,0,1,1,0,0,1
03839469,34,3,31,0,1,1,0,1,1
03839967,7,2,5,0,1,1,0,1,0
03840005,5,3,2,0,2,2,0,0,1
03840597,23,4,19,0,1,1,0,1,1
03840993,21,3,18,0,0,0,0,0,1
03841801,27,0,27,0,0,0,0,0,1
03843123,26,4,22,0,1,1,0,1,0
03843128,28,4,24,0,0,0,0,0,0
03843233,24,0,24,0,0,0,0,0,1
03844250,7,3,4,0,1,1,0,1,1
03844803,6,2,4,0,1,1,0,0,1
03844815,4,0,4,0,0,0,0,0,1
03844914,28,3,25,0,1,1,0,1,1
03845432,19,7,12,0,2,1,1,1,1
03845467,18,7,11,0,2,1,1,1,1
03846299,9,6,3,0,3,3,0,0,1
03846895,6,2,4,0,1,1,0,0,1
03847224,8,3,5,0,2,2,0,0,1
03847425,4,0,4,0,1,1,0,0,1
03847708,18,2,16,0,1,1,0,1,1
03847935,6,1,5,0,1,1,0,0,0
03847949,4,2,2,0,1,1,0,0,1
03848002,21,4,17,0,1,1,0,1,1
03848732,10,0,10,0,0,0,0,0,1
03849103,13,4,9,0,0,0,0,0,1
03849147,12,0,12,0,0,0,0,0,1
03849601,20,6,14,0,1,1,0,1,1
03849878,12,3,9,0,2,2,0,0,1
03850154,15,7,8,0,2,0,2,0,1
03850542,27,3,24,0,1,1,0,1,1
03851251,14,0,14,0,1,1,0,1,1
03852217,26,5,21,0,1,1,0,1,1
03852234,12,0,12,0,0,0,0,0,1
03852243,16,5,11,0,1,1,0,1,1
03852250,11,0,11,0,1,1,0,1,1
03852298,11,0,11,0,0,0,0,0,1
03852299,26,0,26,0,0,0,0,0,1
03852415,4,2,2,0,2,2,0,0,0
03853535,7,0,7,0,0,0,0,0,1
03854275,25,4,21,0,2,1,1,2,1
03854387,7,2,5,0,2,2,0,0,1
03854447,5,2,3,0,1,1,0,0,1
03854469,4,0,4,0,0,0,0,0,0
03854855,19,0,19,0,0,0,0,0,1
03855837,25,3,22,0,1,1,0,1,1
03855973,6,2,4,0,1,1,0,0,1
03856111,18,0,18,0,0,0,0,0,1
03856988,21,3,18,0,0,0,0,0,1
03857924,56,7,49,0,1,1,0,0,0
03857998,18,0,18,0,0,0,0,0,1
03858243,12,0,12,0,0,0,0,0,1
03860715,17,2,15,0,1,1,0,1,1
03861293,17,3,14,0,1,1,0,1,1
03861414,33,5,28,0,0,0,0,0,1
03861752,56,9,47,0,1,1,0,0,1
03862015,3,2,1,0,1,1,0,0,0
03862330,6,2,4,0,0,0,0,0,1
03863990,4,2,2,0,1,1,0,0,0
03864155,10,1,9,0,1,1,0,0,1
03865370,10,3,7,0,2,2,0,0,1
03865871,7,4,3,0,2,2,0,0,1
03866274,26,3,23,0,2,2,0,2,1
03866452,13,0,13,0,0,0,0,0,1
03866549,14,4,10,0,0,0,0,0,0
03869072,11,3,8,0,1,1,0,0,0
03870327,19,4,15,0,1,1,0,0,1
03870358,17,0,17,0,0,0,0,0,1
03870484,15,0,15,0,0,0,0,0,1
03870674,46,7,39,0,0,0,0,0,1
03871363,7,0,7,0,0,0,0,0,1
03871904,13,3,10,0,1,1,0,1,1
03871978,6,5,1,0,1,1,0,0,0
03872217,7,2,5,0,2,2,0,0,0
03874038,5,2,3,0,1,1,0,0,0
03874071,5,0,5,0,0,0,0,0,0
03874855,9,2,7,0,2,2,0,1,1
03874882,25,4,21,0,1,1,0,1,1
03875074,15,0,15,0,0,0,0,0,1
03875190,5,0,5,0,0,0,0,0,1
03875201,5,1,4,0,1,1,0,1,0
03875229,4,0,4,0,0,0,0,0,1
03876449,14,3,11,0,1,1,0,1,1
03876999,14,0,14,0,0,0,0,0,1
03877443,87,10,77,0,0,0,0,0,0
03878046,18,3,15,0,1,1,0,1,1
03878148,42,4,38,0,4,1,3,4,1
03878327,5,2,3,0,1,1,0,0,0
03878599,38,0,38,0,2,1,1,2,1
03878948,8,4,4,0,1,1,0,0,1
03879072,16,6,10,0,2,1,1,2,1
03879590,50,0,50,0,2,1,1,2,1
03170972,6,2,4,0,1,1,0,0,1
03171596,4,1,3,0,1,1,0,0,1
03171767,5,2,3,0,1,1,0,0,0
03172527,29,3,26,0,1,1,0,1,1
03172543,37,5,32,0,1,1,0,0,0
03173418,69,8,61,0,1,1,0,1,1
03173461,5,0,5,0,0,0,0,0,1
03173815,30,8,22,0,1,1,0,1,1
03173933,8,3,5,0,1,1,0,0,0
03173991,38,3,35,0,2,2,0,1,1
03174756,20,4,16,0,1,1,0,1,1
03175221,4,1,3,0,1,1,0,0,0
03175892,11,5,6,1,1,1,0,0,1
03176906,53,7,46,0,1,1,0,1,1
03177211,17,1,16,0,1,1,0,0,0
03177407,8,3,5,0,2,2,0,0,0
03178606,10,0,10,0,1,1,0,0,0
03179462,10,4,6,0,0,0,0,0,1
03179628,30,0,30,0,1,1,0,1,1
03181671,12,3,9,0,1,1,0,1,1
03182378,15,1,14,0,1,1,0,1,1
03182433,11,0,11,0,0,0,0,0,1
03182775,36,1,35,0,1,1,0,1,1
03183968,6,1,5,0,1,1,0,0,1
03184234,33,5,28,0,0,0,0,0,0
03184319,26,3,23,0,0,0,0,0,1
03184583,18,6,12,0,2,1,1,1,0
03185047,28,4,24,0,1,1,0,1,1
03185107,12,0,12,0,1,1,0,0,0
03185249,10,1,9,0,0,0,0,0,0
03186043,29,4,25,0,1,1,0,1,1
03189185,44,3,41,0,2,1,1,2,0
03189566,6,2,4,0,1,1,0,0,1
03190619,27,3,24,0,0,0,0,0,0
03191734,28,5,23,0,0,0,0,0,1
03192424,16,3,13,0,2,1,1,0,0
03193400,71,8,63,0,0,0,0,0,0
03193979,26,2,24,0,1,1,0,1,1
03194230,4,0,4,0,0,0,0,0,1
03194626,9,4,5,0,1,1,0,0,1
03195198,6,2,4,0,2,2,0,0,0
03195344,6,4,2,0,1,1,0,1,1
03195584,45,3,42,0,1,1,0,1,1
03195829,7,0,7,0,1,1,0,0,1
03196171,80,12,68,0,1,1,0,1,1
03196483,5,3,2,0,2,2,0,0,0
03196691,27,9,18,0,0,0,0,0,1
03197238,9,0,9,0,0,0,0,0,1
03197318,24,4,20,0,1,1,0,1,1
03198223,4,1,3,0,1,1,0,0,1
03198488,7,5,2,0,2,2,0,0,0
03199626,5,3,2,0,1,1,0,0,0
03201640,28,6,22,0,1,1,0,1,1
03204761,22,6,16,0,1,1,0,1,1
03205310,12,0,12,0,0,0,0,0,1
03206406,13,0,13,0,0,0,0,0,1
03207200,17,5,12,0,1,1,0,0,1
03209036,17,5,12,0,1,1,0,0,1
03210105,14,5,9,0,1,1,0,1,0
03210452,25,1,24,0,1,1,0,1,1
03211337,9,8,1,0,0,0,0,0,0
03211657,56,4,52,0,2,1,1,2,1
03212452,8,3,5,0,2,2,0,0,0
03213316,18,0,18,0,0,0,0,0,1
03213553,18,0,18,0,0,0,0,0,1
03213927,33,6,27,0,1,1,0,1,1
03214121,5,2,3,0,1,1,0,0,1
03216286,4,3,1,0,0,0,0,0,1
03217859,20,6,14,0,0,0,0,0,1
03218068,7,3,4,0,2,1,1,1,0
03218119,9,0,9,0,0,0,0,0,1
03218612,12,0,12,0,2,1,1,2,1
03218803,7,2,5,0,2,1,1,0,0
03224254,39,9,30,0,0,0,0,0,0
03224406,31,2,29,0,1,1,0,1,1
03224889,22,4,18,0,1,1,0,1,1
03225580,10,2,8,0,2,2,0,0,1
03225584,12,4,8,0,2,2,0,0,1
03225797,7,0,7,0,0,0,0,0,1
03225840,28,5,23,0,1,1,0,1,1
03226091,19,3,16,0,2,0,2,2,1
03226406,16,2,14,0,1,1,0,1,1
03226651,14,1,13,0,0,0,0,0,0
03226910,37,2,35,0,1,1,0,1,1
03227432,32,4,28,0,1,1,0,1,1
03229304,36,0,36,0,0,0,0,0,1
03229417,16,3,13,0,1,1,0,1,1
03231822,8,3,5,0,0,0,0,0,0
03232092,5,3,2,0,2,2,0,0,0
03232292,8,4,4,0,2,0,2,0,0
03232652,39,0,39,0,0,0,0,0,1
03232682,35,4,31,0,1,1,0,1,1
03232740,20,4,16,0,1,1,0,1,1
03232788,21,4,17,0,1,1,0,1,1
03232852,21,5,16,0,1,1,0,1,1
03233986,11,2,9,0,2,2,0,0,0
03234033,35,4,31,0,1,1,0,1,1
03234176,24,3,21,0,1,1,0,1,1
03235317,8,3,5,0,0,0,0,0,0
03236336,17,5,12,0,1,1,0,1,1
03237018,6,3,3,0,1,1,0,0,0
03237831,6,2,4,0,1,1,0,0,1
03238026,30,1,29,0,1,1,0,1,1
03238666,7,4,3,0,1,1,0,0,0
03239438,13,4,9,0,1,1,0,1,0
03239587,24,5,19,0,2,2,0,2,1
03239635,24,5,19,0,1,1,0,1,1
03239951,28,5,23,0,1,1,0,1,1
03239986,24,5,19,0,2,2,0,2,1
03243016,5,3,2,0,1,1,0,0,0
03243762,15,8,7,0,0,0,0,0,0
03244222,5,2,3,0,2,1,1,0,0
03245514,66,16,50,0,0,0,0,0,0
03246469,36,2,34,0,1,1,0,1,1
03246599,21,4,17,0,1,1,0,1,1
03246901,14,4,10,0,4,4,0,0,1
03246983,5,0,5,0,1,1,0,0,1
03247587,8,3,5,0,1,1,0,0,0
03247591,29,7,22,0,2,1,1,1,1
03247667,11,5,6,1,2,1,1,0,1
03248056,8,1,7,0,1,1,0,0,1
03248459,11,0,11,0,1,1,0,1,1
03248750,19,2,17,0,0,0,0,0,1
03249009,25,3,22,0,1,1,0,1,1
03249818,8,2,6,0,1,1,0,0,1
03251269,18,0,18,0,1,1,0,1,1
03251475,53,6,47,0,0,0,0,0,0
03251659,17,0,17,0,0,0,0,0,1
03253095,40,0,40,0,2,1,1,2,1
03253796,7,5,2,0,0,0,0,0,0
03255495,11,2,9,0,1,1,0,1,1
03255740,21,4,17,0,1,1,0,1,1
03256359,31,6,25,0,1,1,0,1,1
03256413,16,4,12,0,0,0,0,0,1
03256744,28,3,25,0,1,1,0,1,1
03256867,6,2,4,0,1,1,0,0,1
03258931,6,0,6,0,1,1,0,0,1
03259539,30,6,24,0,0,0,0,0,1
03264487,17,6,11,0,1,1,0,0,1
03265357,5,2,3,0,1,1,0,0,0
03266889,18,4,14,0,0,0,0,0,0
03268696,19,5,14,0,0,0,0,0,1
03268838,5,2,3,0,1,1,0,0,0
03268858,28,6,22,0,0,0,0,0,1
03269134,5,3,2,0,1,1,0,1,1
03270465,45,2,43,0,1,1,0,1,1
03270679,47,8,39,0,0,0,0,0,1
03270987,31,0,31,0,0,0,0,0,1
03271084,22,0,22,0,0,0,0,0,1
03271439,23,3,20,0,1,1,0,1,1
03271821,12,2,10,0,1,1,0,1,1
03271968,46,0,46,0,0,0,0,0,1
03273784,53,4,49,0,0,0,0,0,0
03274666,9,3,6,0,1,1,0,0,0
03275257,6,0,6,0,0,0,0,0,1
03276904,8,0,8,0,0,0,0,0,1
03277701,14,7,7,0,1,1,0,0,1
03278419,29,5,24,0,2,2,0,2,1
03278620,17,6,11,0,1,1,0,1,1
03279102,16,4,12,0,0,0,0,0,1
03282601,5,2,3,0,1,1,0,0,1
03282897,15,0,15,0,0,0,0,0,1
03282982,14,5,9,0,1,1,0,0,0
03283501,25,2,23,0,2,2,0,2,1
03283735,32,0,32,0,0,0,0,0,1
03285380,17,4,13,0,2,2,0,2,1
03285603,23,0,23,0,0,0,0,0,1
03286015,11,2,9,0,1,1,0,0,0
03286747,14,0,14,0,1,1,0,1,1
03286750,14,2,12,0,1,1,0,1,1
03287013,4,2,2,0,1,1,0,0,0
03287882,9,0,9,0,0,0,0,0,1
03288100,21,3,18,0,1,1,0,1,1
03288261,21,3,18,0,1,1,0,1,1
03289031,5,3,2,0,2,2,0,0,0
03289367,12,5,7,0,2,2,0,0,1
03289771,6,3,3,0,1,1,0,0,0
03290399,39,6,33,0,5,5,0,0,1
03291300,9,4,5,0,2,2,0,0,0
03291380,22,7,15,0,1,1,0,0,0
03292147,7,0,7,0,0,0,0,0,1
03292923,17,2,15,0,1,1,0,1,1
03295455,38,5,33,0,1,1,0,1,1
03295664,8,3,5,0,3,3,0,0,0
03296014,12,1,11,0,1,1,0,1,1
03296399,12,2,10,0,1,1,0,1,1
03296825,43,14,29,0,0,0,0,0,1
03297049,10,3,7,0,1,1,0,1,1
03298048,15,4,11,0,1,1,0,1,1
03298442,24,4,20,0,1,1,0,1,0
03298903,44,9,35,0,1,1,0,1,1
03300794,41,3,38,0,0,0,0,0,0
03300949,9,3,6,0,2,2,0,0,1
03301940,31,3,28,0,1,1,0,1,1
03302887,25,8,17,0,1,1,0,1,1
03303363,19,4,15,0,0,0,0,0,1
03303501,6,3,3,0,2,2,0,0,0
03303689,51,16,35,0,0,0,0,0,1
03304979,7,0,7,0,0,0,0,0,0
03305040,6,1,5,0,1,1,0,0,0
03306265,5,2,3,0,1,1,0,0,0
03306303,21,0,21,0,0,0,0,0,1
03306468,11,3,8,0,1,1,0,0,1
03308182,6,1,5,0,1,1,0,0,0
03308486,33,4,29,0,1,1,0,1,1
03309770,28,3,25,0,0,0,0,0,1
03309912,45,3,42,0,1,1,0,1,1
03310225,41,9,32,0,0,0,0,0,1
03311094,5,1,4,0,1,1,0,0,0
03311138,5,2,3,0,1,1,0,0,0
03311493,10,0,10,0,0,0,0,0,1
03311709,37,5,32,0,1,1,0,1,1
03311810,6,2,4,0,1,1,0,0,0
03311896,24,1,23,0,3,1,2,0,0
03312220,26,4,22,0,1,1,0,1,1
03313063,26,3,23,0,1,1,0,1,1
03313210,11,2,9,0,0,0,0,0,0
03313802,34,7,27,0,1,1,0,1,1
03314917,7,4,3,0,3,3,0,0,0
03315618,7,4,3,0,1,1,0,1,1
03317493,17,2,15,0,2,1,1,2,1
03318263,16,0,16,0,0,0,0,0,1
03318735,8,2,6,0,1,1,0,0,0
03319466,44,3,41,0,1,1,0,1,1
03319702,8,3,5,0,1,1,0,0,1
03319706,31,3,28,0,1,1,0,1,1
03320296,28,13,15,0,0,0,0,0,0
03320915,22,3,19,0,1,1,0,1,1
03320972,44,7,37,0,0,0,0,0,1
03321425,6,3,3,0,3,3,0,0,1
03321428,39,0,39,0,0,0,0,0,1
03322042,12,4,8,0,3,3,0,1,1
03322151,65,4,61,0,1,1,0,1,1
03322615,18,0,18,0,0,0,0,0,1
03324200,4,2,2,0,1,1,0,1,0
03325083,21,0,21,0,1,1,0,1,1
03325268,11,6,5,0,3,3,0,1,0
03325776,15,6,9,0,0,0,0,0,0
03327636,13,4,9,0,1,1,0,1,1
03328703,5,3,2,0,2,2,0,0,1
03329617,6,3,3,0,2,2,0,0,0
03329834,70,2,68,0,0,0,0,0,0
03330923,22,4,18,0,1,0,1,1,1
03331553,14,0,14,0,0,0,0,0,1
03331632,27,3,24,0,3,2,1,0,1
03331984,7,2,5,0,0,0,0,0,1
03332258,24,5,19,0,1,1,0,1,1
03332828,10,1,9,0,0,0,0,0,1
03333312,13,4,9,0,1,1,0,1,1
03334141,20,4,16,0,1,1,0,0,1
03334524,23,5,18,0,0,0,0,0,1
03334713,17,0,17,0,2,1,1,2,1
03334745,6,1,5,0,1,1,0,0,1
03334872,81,14,67,0,0,0,0,0,1
03335284,22,3,19,0,1,1,0,1,1
03335371,6,3,3,0,1,1,0,0,0
03335428,18,3,15,0,1,1,0,0,1
03335712,7,0,7,0,0,0,0,0,1
03336407,18,0,18,0,1,1,0,1,1
03336790,53,8,45,0,1,1,0,1,1
03339154,31,0,31,0,1,1,0,1,1
03340083,35,2,33,0,0,0,0,0,0
03340252,45,9,36,0,0,0,0,0,1
03340325,34,8,26,0,0,0,0,0,0
03340629,18,2,16,0,1,1,0,0,0
03341421,17,0,17,0,1,1,0,1,1
03341932,20,3,17,0,1,1,0,1,1
03343307,40,8,32,0,1,1,0,1,1
03343568,13,5,8,0,0,0,0,0,1
03343863,4,1,3,0,1,1,0,0,1
03344406,30,4,26,0,2,1,1,2,1
03345052,8,3,5,0,2,2,0,0,0
03345230,35,10,25,0,0,0,0,0,0
03346773,5,2,3,0,0,0,0,0,1
03346853,32,7,25,0,1,1,0,0,1
03347086,7,1,6,0,0,0,0,0,1
03347110,23,4,19,0,1,1,0,1,1
03348456,40,10,30,0,0,0,0,0,1
03348630,7,0,7,0,0,0,0,0,1
03351661,5,3,2,0,2,2,0,0,0
03352439,10,2,8,0,2,2,0,0,0
03352721,8,3,5,0,1,1,0,0,0
03353746,15,2,13,0,1,1,0,0,0
03353978,4,0,4,0,0,0,0,0,1
03354124,24,3,21,0,1,1,0,1,1
03355651,39,3,36,0,2,2,0,2,1
03356444,23,0,23,0,0,0,0,0,1
03356526,91,21,70,0,0,0,0,0,1
03358021,21,7,14,0,6,6,0,0,1
03358035,40,3,37,0,1,1,0,1,1
03359457,42,5,37,0,0,0,0,0,0
03360075,32,8,24,0,0,0,0,0,1
03360313,10,3,7,0,1,1,0,1,0
03360334,55,10,45,0,1,1,0,0,0
03363450,8,1,7,0,1,1,0,0,1
03363834,16,4,12,0,1,1,0,0,1
03364046,5,3,2,0,1,1,0,0,1
03365455,6,1,5,0,1,1,0,0,0
03366506,44,0,44,0,0,0,0,0,1
03368357,14,0,14,0,0,0,0,0,1
03369745,8,3,5,0,2,2,0,0,1
03371104,22,5,17,0,1,1,0,1,1
03371321,11,5,6,0,2,2,0,0,1
03371525,7,3,4,0,2,2,0,0,0
03372016,8,2,6,0,1,1,0,0,0
03372097,37,0,37,0,0,0,0,0,1
03372177,26,5,21,0,0,0,0,0,0
03372928,29,3,26,0,1,1,0,1,1
03373384,29,4,25,0,1,1,0,0,0
03375041,13,3,10,0,2,1,1,0,0
03375306,52,7,45,0,0,0,0,0,1
03377901,7,4,3,0,1,1,0,0,0
03377905,7,4,3,0,1,1,0,0,0
03378202,28,0,28,0,0,0,0,0,1
03378550,11,4,7,0,0,0,0,0,1
03378610,32,0,32,0,0,0,0,0,1
03379501,30,0,30,0,1,1,0,0,0
03382237,34,4,30,0,1,1,0,1,1
03383236,11,0,11,1,0,0,0,0,0
03383475,50,4,46,0,1,1,0,1,0
03383881,13,4,9,0,1,1,0,1,1
03384487,13,4,9,0,1,1,0,1,1
03385322,14,2,12,0,0,0,0,0,0
03386018,11,0,11,0,0,0,0,0,1
03386860,5,2,3,0,1,1,0,1,1
03386929,38,9,29,0,0,0,0,0,1
03386998,16,0,16,0,0,0,0,0,1
03387094,36,2,34,0,1,1,0,1,0
03387274,5,3,2,0,1,1,0,0,1
03388395,11,2,9,0,1,1,0,0,1
03390170,30,8,22,0,1,1,0,1,0
03390345,29,3,26,0,1,1,0,1,1
03390944,16,4,12,0,1,1,0,1,1
03391578,10,0,10,0,0,0,0,0,1
03391867,7,3,4,0,0,0,0,0,0
03392535,18,3,15,0,1,1,0,1,1
03392685,17,5,12,0,1,1,0,1,1
03394234,29,3,26,0,1,1,0,1,1
03394380,4,2,2,0,3,3,0,0,0
03394622,23,3,20,0,2,2,0,2,0
03395389,38,12,26,0,0,0,0,0,1
03396935,12,3,9,0,1,1,0,1,1
03398515,7,0,7,0,0,0,0,0,0
03399480,8,2,6,0,1,1,0,0,0
02740316,15,3,12,0,0,0,0,0,1
02740621,4,2,2,0,1,1,0,0,0
02742166,6,3,3,0,1,1,0,0,0
02745919,12,0,12,0,0,0,0,0,1
02746405,30,0,30,0,0,0,0,0,1
02746610,14,0,14,0,0,0,0,0,1
02746641,37,5,32,0,1,1,0,1,1
02747901,28,5,23,0,1,1,0,1,1
02747909,36,3,33,0,1,1,0,1,1
02747911,19,0,19,0,0,0,0,0,1
02747934,19,6,13,0,0,0,0,0,1
02748513,10,3,7,0,3,3,0,1,0
02748954,5,3,2,0,1,1,0,1,1
02750459,17,3,14,0,1,1,0,1,1
02751106,20,2,18,0,1,1,0,0,0
02751131,11,3,8,0,0,0,0,0,0
02752603,27,6,21,0,1,1,0,1,1
02752793,76,9,67,0,1,1,0,1,0
02753023,102,4,98,0,4,0,4,0,1
02753142,31,1,30,0,3,1,2,0,1
02754010,37,0,37,0,0,0,0,0,1
02754921,19,4,15,0,1,1,0,1,1
02755423,23,0,23,0,0,0,0,0,1
02755583,53,6,47,0,0,0,0,0,0
02755730,30,5,25,0,1,1,0,1,1
02755827,16,3,13,0,1,1,0,1,1
02756521,173,14,159,0,0,0,0,0,1
02756660,128,53,75,0,1,1,0,0,0
02759673,35,0,35,0,0,0,0,0,1
02761034,19,0,19,0,0,0,0,0,1
02761796,18,4,14,0,1,1,0,1,1
02762460,35,2,33,0,1,1,0,1,1
02762721,28,3,25,0,1,1,0,1,1
02762997,20,5,15,0,1,1,0,1,1
02765697,0,0,0,0,0,0,0,0,1
02766114,10,4,6,0,0,0,0,0,1
02766993,67,15,52,0,2,2,0,2,1
02767055,83,9,74,0,3,1,2,0,1
02767939,45,3,42,0,1,1,0,1,1
02769350,27,0,27,0,0,0,0,0,1
02769904,52,4,48,0,1,1,0,1,1
02770415,20,6,14,0,0,0,0,0,0
02770904,29,3,26,0,1,1,0,1,1
02771937,31,3,28,0,1,1,0,1,1
02772202,20,5,15,0,1,1,0,1,1
02772271,18,3,15,0,1,1,0,1,1
02772394,34,5,29,0,1,1,0,1,1
02773923,6,3,3,0,1,1,0,0,1
02776424,13,3,10,0,1,1,0,1,1
02776963,36,9,27,0,1,1,0,1,1
02778794,27,1,26,0,1,1,0,1,1
02779500,9,2,7,0,1,1,0,0,0
02782845,9,2,7,0,1,1,0,1,0
02783356,10,3,7,0,1,1,0,0,0
02783452,33,2,31,0,2,1,1,2,1
02784097,7,2,5,0,2,2,0,0,0
02786597,62,6,56,0,0,0,0,0,0
02790922,36,0,36,0,0,0,0,0,1
02791889,74,4,70,0,1,1,0,1,1
02792001,35,3,32,0,1,1,0,1,1
02792006,66,3,63,0,1,1,0,1,1
02792272,10,3,7,0,1,1,0,0,0
02792457,27,1,26,0,0,0,0,0,1
02792946,6,1,5,0,1,1,0,0,1
02794372,5,3,2,0,2,2,0,0,0
02794958,20,0,20,0,0,0,0,0,1
02796531,20,3,17,0,1,1,0,1,1
02796837,20,3,17,0,1,1,0,1,1
02798348,6,3,3,0,1,1,0,1,0
02799543,23,3,20,0,0,0,0,0,1
02799844,34,0,34,0,1,1,0,1,1
02800301,59,9,50,0,1,1,0,0,1
02800636,59,10,49,0,1,1,0,1,1
02800802,32,1,31,0,1,1,0,1,1
02800803,28,0,28,0,0,0,0,0,1
02800965,0,0,0,0,0,0,0,0,1
02801121,32,3,29,0,1,1,0,1,1
02801202,14,3,11,0,1,1,0,1,1
02803379,58,0,58,0,0,0,0,0,1
02804492,8,3,5,0,2,2,0,0,1
02805451,11,0,11,0,0,0,0,0,1
02806093,43,2,41,0,1,1,0,1,1
02806289,8,1,7,0,1,1,0,0,0
02807159,37,0,37,0,0,0,0,0,0
02808390,56,10,46,0,0,0,0,0,1
02808850,10,2,8,0,1,1,0,0,0
02809202,6,3,3,0,1,1,0,1,0
02809456,13,3,10,0,1,1,0,1,1
02810623,35,3,32,0,0,0,0,0,0
02811407,2,2,0,0,2,2,0,0,0
02811609,24,0,24,0,1,1,0,1,1
02812508,7,6,1,0,2,2,0,0,0
02812683,8,2,6,0,0,0,0,0,0
02812697,10,0,10,0,0,0,0,0,1
02813292,23,2,21,0,1,1,0,1,1
02813358,88,12,76,0,1,1,0,1,1
02815000,28,2,26,0,1,1,0,1,1
02815227,25,2,23,0,2,2,0,2,1
02815333,23,0,23,0,1,1,0,1,1
02817936,10,3,7,0,2,2,0,0,0
02818086,27,0,27,0,0,0,0,0,1
02818721,15,0,15,0,0,0,0,0,1
02818821,10,4,6,0,1,1,0,1,0
02819896,28,4,24,0,1,1,0,1,1
02820813,20,6,14,0,3,1,2,1,0
02821608,33,5,28,0,1,1,0,1,1
02821970,16,3,13,0,1,1,0,1,1
02825067,8,3,5,0,1,1,0,0,0
02825282,10,3,7,0,1,1,0,0,1
02826466,19,3,16,0,1,1,0,1,1
02826978,63,15,48,0,0,0,0,0,1
02828554,25,0,25,0,1,1,0,1,1
02829156,54,13,41,0,0,0,0,0,1
02829540,33,4,29,0,0,0,0,0,1
02830747,8,3,5,0,2,2,0,0,0
02832020,17,3,14,0,1,1,0,1,1
02832212,8,1,7,0,2,1,1,0,1
02833153,11,0,11,0,0,0,0,0,1
02834830,7,3,4,0,2,2,0,0,0
02836091,22,5,17,0,1,0,1,0,0
02836858,35,4,31,0,3,3,0,0,1
02837387,12,4,8,0,1,1,0,0,0
02839836,56,7,49,0,2,2,0,2,1
02840685,8,0,8,0,0,0,0,0,1
02844532,28,5,23,0,1,1,0,1,1
02844616,26,3,23,0,1,0,1,1,1
02844653,13,6,7,0,4,1,3,1,0
02844654,10,5,5,0,4,2,2,1,0
02845563,5,1,4,0,1,1,0,0,1
02846473,24,4,20,0,2,2,0,0,1
02846797,12,1,11,0,1,1,0,1,1
02846916,11,2,9,0,1,1,0,0,0
02847255,10,3,7,0,2,2,0,0,1
02848454,56,0,56,0,4,2,2,0,0
02849172,8,0,8,0,0,0,0,0,1
02849404,7,3,4,0,1,1,0,0,1
02849795,22,0,22,0,1,1,0,1,1
02849983,22,2,20,0,1,1,0,1,1
02850484,18,3,15,0,1,1,0,1,1
02851316,55,8,47,0,1,1,0,1,1
02852812,29,2,27,0,1,1,0,1,1
02853731,12,7,5,0,3,1,2,1,0
02853771,12,7,5,0,3,1,2,1,0
02854090,46,2,44,0,1,1,0,1,1
02854405,32,5,27,0,1,1,0,1,1
02855059,34,5,29,0,1,1,0,1,1
02855423,28,10,18,0,0,0,0,0,0
02855468,18,3,15,0,1,1,0,1,1
02856074,16,0,16,0,0,0,0,0,1
02858045,31,0,31,0,1,1,0,1,1
02858623,21,0,21,0,0,0,0,0,1
02859403,28,1,27,0,0,0,0,0,1
02859445,0,0,0,0,0,0,0,0,1
02861942,9,2,7,0,1,1,0,0,1
02862148,82,11,71,0,2,1,1,0,0
02862814,6,2,4,0,1,1,0,0,1
02865616,6,3,3,0,1,1,0,0,1
02867315,7,3,4,0,1,1,0,0,1
02867446,55,0,55,0,0,0,0,0,1
02867684,25,7,18,0,0,0,0,0,1
02868332,20,7,13,0,3,1,2,0,0
02868384,55,4,51,0,1,1,0,1,1
02868875,50,13,37,0,0,0,0,0,1
02871187,40,0,40,0,0,0,0,0,1
02871556,12,0,12,0,1,1,0,1,1
02872234,35,2,33,0,1,1,0,1,1
02872411,30,6,24,0,1,0,1,0,1
02872475,5,2,3,0,1,1,0,0,1
02872489,5,0,5,0,0,0,0,0,0
02872876,12,3,9,0,1,1,0,0,1
02873336,7,0,7,0,0,0,0,0,0
02873648,5,3,2,0,2,2,0,0,0
02873670,26,0,26,3,1,1,0,1,1
02874708,23,3,20,0,1,1,0,0,1
02877004,6,2,4,0,1,1,0,0,0
02877158,14,9,5,0,0,0,0,0,1
02877612,18,5,13,0,2,2,0,0,1
02878490,8,3,5,0,0,0,0,0,1
02879724,28,8,20,0,0,0,0,0,1
02881849,26,0,26,0,3,2,1,2,1
02882201,19,0,19,0,0,0,0,0,1
02882225,5,3,2,0,1,1,0,0,1
02883030,25,0,25,0,0,0,0,0,1
02883177,57,10,47,0,2,2,0,2,1
02883596,23,3,20,0,1,1,0,1,1
02885276,20,0,20,0,2,2,0,2,1
02886886,6,4,2,0,0,0,0,0,1
02886938,10,3,7,0,1,1,0,0,1
02887005,8,2,6,0,2,1,1,1,1
02887007,16,6,10,0,1,1,0,0,1
02887058,20,2,18,0,1,1,0,1,1
02891064,41,6,35,0,0,0,0,0,1
02891307,24,7,17,0,0,0,0,0,1
02892872,21,5,16,0,0,0,0,0,1
02893060,38,4,34,0,2,2,0,2,1
02893365,29,5,24,0,0,0,0,0,1
02894291,24,11,13,0,1,1,0,1,0
02894677,9,0,9,0,0,0,0,0,0
02895938,10,4,6,0,1,1,0,1,1
02896250,20,4,16,0,2,2,0,2,1
02896508,23,2,21,0,0,0,0,0,1
02896700,51,7,44,0,0,0,0,0,1
02897801,8,4,4,0,1,1,0,0,0
02899038,23,0,23,0,1,1,0,1,1
02899116,24,2,22,0,1,1,0,1,1
02899713,31,2,29,0,1,1,0,0,1
02900722,13,3,10,0,1,1,0,1,1
02901034,26,0,26,0,0,0,0,0,1
02901114,8,1,7,0,1,1,0,0,0
02901263,17,2,15,0,1,1,0,1,1
02901787,25,3,22,0,2,2,0,2,1
02902416,74,4,70,0,1,1,0,1,1
02902926,31,5,26,0,1,1,0,1,1
02902958,9,2,7,0,2,2,0,1,1
02903749,57,4,53,0,13,7,6,0,0
02904358,22,5,17,0,1,1,0,1,1
02904478,5,2,3,0,1,1,0,0,0
02904784,4,3,1,0,2,2,0,0,0
02904897,29,0,29,0,0,0,0,0,1
02904942,28,5,23,0,2,2,0,2,1
02905667,15,1,14,0,4,2,2,1,1
02905726,3,2,1,0,1,1,0,0,1
02905925,31,1,30,0,1,1,0,1,1
02906593,26,7,19,0,1,1,0,1,1
02906991,39,5,34,0,1,1,0,1,1
02906994,35,4,31,0,1,1,0,1,1
02907403,4,0,4,0,0,0,0,0,0
02907543,20,6,14,0,1,1,0,1,1
02907610,36,3,33,0,1,1,0,1,1
02908000,16,3,13,0,1,1,0,1,1
02908082,19,0,19,0,0,0,0,0,1
02908089,16,3,13,0,2,1,1,2,1
02909297,15,9,6,0,2,2,0,0,1
02909623,32,7,25,0,0,0,0,0,1
02909638,15,6,9,0,1,1,0,1,0
02910116,20,4,16,0,1,1,0,1,1
02911143,25,0,25,0,0,0,0,0,1
02912338,51,2,49,0,1,1,0,1,1
02912655,46,5,41,0,0,0,0,0,1
02913191,19,4,15,0,1,1,0,1,1
02913278,37,10,27,0,0,0,0,0,1
02913554,20,5,15,0,1,1,0,1,1
02914479,8,0,8,0,0,0,0,0,1
02914518,2,2,0,0,0,0,0,0,1
02914954,27,3,24,0,1,1,0,1,1
02915215,4,2,2,0,1,1,0,0,0
02915273,16,3,13,0,1,1,0,1,1
02918124,37,2,35,0,1,1,0,1,1
02918913,28,3,25,0,1,1,0,1,1
02919246,9,3,6,0,2,2,0,0,0
02920061,37,4,33,0,1,1,0,1,1
02920235,23,0,23,0,0,0,0,0,1
02921414,16,4,12,0,0,0,0,0,1
02921462,49,6,43,0,1,1,0,1,1
02921536,12,0,12,0,1,1,0,1,1
02921944,0,0,0,0,0,0,0,0,1
02923119,17,0,17,0,0,0,0,0,1
02923252,42,6,36,0,1,1,0,1,1
02924357,42,0,42,1,0,0,0,0,1
02924707,46,4,42,0,1,1,0,1,1
02924874,15,3,12,0,1,1,0,1,1
02927112,13,0,13,0,0,0,0,0,1
02927565,12,2,10,0,3,2,1,0,1
02928814,0,0,0,0,0,0,0,0,1
02929801,39,4,35,0,1,0,1,1,1
02929932,8,4,4,0,1,1,0,0,1
NI031351,11,3,8,0,0,0,0,0,1
NI031494,3,3,0,0,1,1,0,0,1
NI031997,52,9,43,0,2,2,0,0,1
NI032652,17,3,14,0,1,1,0,1,1
NI032803,23,4,19,0,1,1,0,1,1
NI033106,48,13,35,0,0,0,0,0,1
NI033497,28,8,20,0,0,0,0,0,1
NI033849,9,5,4,0,1,1,0,0,1
NI034042,20,6,14,0,3,3,0,0,1
NI034898,4,3,1,0,2,2,0,0,1
NI035042,4,4,0,0,1,1,0,0,0
NI035703,12,3,9,0,2,2,0,0,0
NI035752,3,0,3,0,1,1,0,0,1
NI036466,5,3,2,0,1,1,0,0,0
NI036962,30,8,22,0,1,1,0,1,1
NI037477,14,3,11,0,2,2,0,2,1
NI037709,14,2,12,0,1,1,0,1,1
NI038905,11,3,8,0,0,0,0,0,1
NI039959,30,0,30,0,0,0,0,0,1
NI040379,14,9,5,0,1,1,0,0,1
NI041233,3,3,0,0,1,1,0,0,0
NI042547,12,3,9,0,0,0,0,0,0
NI045809,43,12,31,0,0,0,0,0,1
NI050771,42,9,33,0,0,0,0,0,1
NI050863,50,11,39,0,1,1,0,0,1
NI051793,12,0,12,0,0,0,0,0,1
NI053107,19,2,17,0,1,1,0,1,1
NI053389,4,4,0,0,0,0,0,0,0
NI053390,7,1,6,0,0,0,0,0,0
NI053391,4,1,3,0,0,0,0,0,0
NI053392,3,3,0,0,0,0,0,0,0
NI055506,15,3,12,0,1,1,0,1,1
NI056385,4,0,4,0,0,0,0,0,1
NI056386,4,2,2,0,1,1,0,0,1
NI056638,6,4,2,0,2,1,1,0,0
NI056719,4,3,1,0,2,2,0,0,1
NI057110,7,4,3,0,2,2,0,0,1
NI058026,9,3,6,0,0,0,0,0,0
NI058673,8,0,8,0,0,0,0,0,0
NI058984,8,3,5,0,2,2,0,0,0
NI059464,11,3,8,0,2,2,0,2,1
NI059715,18,2,16,0,1,1,0,0,0
NI060060,5,2,3,0,1,1,0,0,0
NI065086,26,4,22,0,1,1,0,1,1
NI067989,17,9,8,0,0,0,0,0,1
NI071777,13,0,13,0,0,0,0,0,1
NI072127,10,2,8,0,1,1,0,1,1
NI072882,4,1,3,0,0,0,0,0,0
NI073060,7,5,2,0,2,0,2,0,1
NI602218,2,0,2,0,0,0,0,0,0
NI603221,3,2,1,0,2,2,0,0,1
NI604890,3,3,0,0,2,2,0,0,1
NI605794,3,0,3,0,0,0,0,0,0
NI606362,12,3,9,0,2,2,0,2,1
NI606409,12,3,9,0,2,2,0,2,1
NI608667,4,4,0,0,2,2,0,0,1
NI612007,3,0,3,0,0,0,0,0,0
NI613754,3,2,1,0,1,1,0,1,1
NI614552,4,4,0,0,2,2,0,0,1
NI614934,5,5,0,0,4,4,0,0,0
NI622062,2,0,2,0,0,0,0,0,1
NI623437,6,1,5,0,3,1,2,3,0
NI623838,10,6,4,0,2,2,0,0,1
NI624914,5,4,1,0,1,1,0,0,1
NI625571,3,1,2,0,2,1,1,0,0
NI628638,2,0,2,0,0,0,0,0,1
NI631223,2,1,1,0,0,0,0,0,0
NI631501,4,3,1,0,1,1,0,1,1
NI632740,1,1,0,0,1,1,0,0,1
NI638801,3,3,0,0,2,2,0,1,1
NI641445,4,3,1,0,0,0,0,0,0
NI645109,2,2,0,0,2,2,0,0,0
NI645897,2,2,0,0,1,1,0,1,1
NI645950,2,0,2,0,2,2,0,0,1
NI648039,1,1,0,0,1,1,0,0,0
NI649520,4,3,1,0,1,1,0,1,1
NI649724,15,13,2,0,0,0,0,0,1
NI649957,6,5,1,0,1,1,0,0,1
NI649960,1,0,1,0,0,0,0,0,1
NI651723,1,1,0,0,1,1,0,0,0
NI653481,1,1,0,0,1,1,0,1,0
NI654233,5,5,0,0,2,2,0,0,1
NI657620,2,2,0,0,1,1,0,1,1
NI658768,1,1,0,0,1,1,0,0,0
NI661147,1,1,0,0,1,1,0,0,0
OC300846,7,7,0,0,0,0,0,0,0
OC300878,108,43,65,1,1,1,0,0,1
OC301522,156,153,3,0,0,0,0,0,1
OC302716,22,9,13,0,0,0,0,0,1
OC302991,361,286,75,0,13,10,3,0,0
OC303359,250,83,167,0,0,0,0,0,1
OC303959,9,3,6,4,1,1,0,1,1
OC304017,11,0,11,0,0,0,0,0,1
OC304026,50,35,15,0,0,0,0,0,1
OC304029,52,35,17,0,0,0,0,0,1
OC304205,35,35,0,0,1,1,0,0,1
OC304261,56,54,2,0,4,2,2,4,1
OC304821,4,2,2,0,1,1,0,0,0
OC304870,24,0,24,1,0,0,0,0,1
OC305123,243,236,7,0,2,2,0,2,1
OC305288,81,57,24,0,1,1,0,1,1
OC305342,44,2,42,0,2,1,1,2,1
OC305343,20,6,14,0,1,1,0,1,1
OC305875,89,82,7,0,0,0,0,0,1
OC306215,162,161,1,0,0,0,0,0,1
OC306597,3,3,0,0,1,1,0,0,1
OC307719,19,5,14,0,1,1,0,0,0
OC308039,36,24,12,1,0,0,0,0,1
OC308268,2,2,0,0,2,2,0,0,0
OC308575,13,10,3,0,2,2,0,0,1
OC308605,17,2,15,0,1,1,0,1,1
OC309328,90,3,87,1,1,1,0,1,1
OC309568,39,2,37,0,2,1,1,2,1
OC309813,32,10,22,0,1,1,0,1,1
OC310420,39,19,20,0,0,0,0,0,0
OC312088,10,2,8,0,2,2,0,0,0
OC313768,21,20,1,1,0,0,0,0,1
OC314005,67,32,35,1,9,8,1,2,1
OC314069,1397,10,1387,0,1,1,0,1,1
OC314684,3,0,3,0,0,0,0,0,1
OC317703,6,3,3,0,1,1,0,0,0
OC318291,7,3,4,6,1,1,0,1,1
OC318950,6,0,6,3,0,0,0,0,1
OC320522,60,48,12,0,5,5,0,0,1
OC320936,36,13,23,0,0,0,0,0,1
OC321009,4,4,0,0,3,3,0,0,1
OC322045,415,187,228,0,0,0,0,0,1
OC322291,11,0,11,1,2,2,0,0,1
OC322739,9,3,6,0,3,1,2,1,0
OC322836,11,9,2,0,0,0,0,0,1
OC322935,197,95,102,0,0,0,0,0,1
OC322965,4,2,2,0,1,1,0,0,0
OC323516,25,12,13,0,1,1,0,1,1
OC325075,4,2,2,0,2,1,1,0,1
OC325292,5,3,2,4,2,1,1,1,1
OC325464,3,2,1,0,1,1,0,1,1
OC325717,3,2,1,0,2,2,0,0,0
OC326180,5,3,2,0,0,0,0,0,1
OC326546,7,4,3,0,0,0,0,0,0
OC327176,25,19,6,1,2,2,0,0,1
OC327512,5,3,2,0,4,3,1,0,1
OC327860,2,2,0,0,1,1,0,0,0
OC328400,2,2,0,0,2,2,0,0,0
OC328592,15,13,2,0,0,0,0,0,1
OC328594,4,2,2,0,2,2,0,0,1
OC328656,4,2,2,0,0,0,0,0,1
OC329250,4,2,2,0,1,1,0,0,1
OC329392,137,57,80,0,1,1,0,1,1
OC330011,4,3,1,0,3,3,0,0,1
OC330252,460,204,256,0,0,0,0,0,1
OC331086,14,5,9,0,2,2,0,0,1
OC331671,7,3,4,0,0,0,0,0,0
OC331918,2,2,0,2,0,0,0,0,1
OC333073,9,2,7,2,2,1,1,0,1
OC333537,4,2,2,0,2,2,0,2,0
OC333709,65,46,19,0,1,1,0,1,1
OC333791,8,0,8,8,0,0,0,0,1
OC334323,302,288,14,0,4,2,2,4,1
OC334398,68,2,66,0,5,1,4,1,1
OC334430,4,0,4,0,0,0,0,0,1
OC334647,5,0,5,0,0,0,0,0,1
OC334653,7,0,7,6,1,1,0,1,1
OC334677,6,2,4,6,1,1,0,0,1
OC335427,3,3,0,0,2,2,0,0,0
OC336943,2,0,2,0,0,0,0,0,1
OC339018,19,14,5,3,1,1,0,1,1
OC339137,5,3,2,4,1,1,0,1,1
OC339863,5,0,5,0,0,0,0,0,1
OC340127,4,0,4,0,0,0,0,0,0
OC340425,27,2,25,1,1,1,0,1,1
OC342504,4,2,2,0,1,1,0,0,1
OC342889,10,5,5,0,0,0,0,0,0
OC343458,5,2,3,0,1,1,0,0,1
OC343563,7,3,4,6,1,1,0,1,1
OC344173,15,2,13,0,2,2,0,2,1
OC344192,5,0,5,0,2,2,0,0,0
OC344209,9,2,7,0,1,1,0,1,1
OC345220,9,5,4,0,1,1,0,0,1
OC345423,3,0,3,0,3,3,0,0,1
OC345558,3,3,0,0,3,3,0,0,0
OC347034,28,22,6,0,2,2,0,0,1
OC347127,2,0,2,0,2,2,0,0,0
OC348736,20,0,20,0,1,1,0,0,1
OC348774,7,2,5,0,4,4,0,0,0
OC349663,6,0,6,6,1,1,0,0,1
OC349808,13,0,13,0,0,0,0,0,1
OC350252,10,10,0,0,0,0,0,0,0
OC351102,60,53,7,0,0,0,0,0,1
OC351442,2,2,0,0,0,0,0,0,0
OC351506,125,121,4,0,2,2,0,2,1
OC351726,3,2,1,0,2,2,0,0,0
OC351914,6,0,6,6,0,0,0,0,1
OC352355,6,0,6,0,0,0,0,0,1
OC353475,11,11,0,0,0,0,0,0,0
OC353478,10,10,0,0,0,0,0,0,0
OC353480,16,13,3,0,0,0,0,0,0
OC353539,9,8,1,0,0,0,0,0,0
OC353669,12,12,0,0,0,0,0,0,0
OC354356,14,13,1,0,2,2,0,0,1
OC354703,4,0,4,4,0,0,0,0,1
OC355694,2,2,0,0,2,2,0,0,0
OC356155,30,0,30,0,0,0,0,0,1
OC356756,3,0,3,0,1,1,0,0,1
OC356867,2,0,2,2,0,0,0,0,0
OC357296,2,0,2,0,1,1,0,1,0
OC358406,2,0,2,0,2,2,0,0,0
OC359611,143,139,4,0,2,2,0,2,1
OC359821,115,111,4,0,2,2,0,2,1
OC360936,5,4,1,0,0,0,0,0,0
OC361387,7,3,4,6,1,1,0,1,1
OC361417,116,49,67,0,5,3,2,0,1
OC361768,2,0,2,0,0,0,0,0,1
OC363126,26,22,4,3,2,2,0,0,1
OC363649,2,0,2,2,0,0,0,0,1
OC363836,3,0,3,0,0,0,0,0,0
OC365681,3,3,0,0,1,1,0,1,1
OC366138,3,2,1,0,1,1,0,0,1
OC366318,26,25,1,3,2,2,0,0,1
OC367395,6,0,6,0,2,2,0,0,1
OC367960,3,0,3,0,0,0,0,0,0
OC368433,5,2,3,0,2,2,0,0,0
OC369572,9,3,6,0,1,1,0,0,1
OC370622,2,2,0,0,2,2,0,0,1
OC371548,3,3,0,2,1,1,0,1,0
OC371681,4,4,0,0,2,2,0,0,0
OC372133,6,3,3,4,1,1,0,1,1
OC373659,8,4,4,0,1,1,0,1,1
OC373719,4,2,2,0,3,2,1,1,0
OC374267,2,0,2,2,1,1,0,0,0
OC376110,6,0,6,0,0,0,0,0,1
OC376679,9,4,5,1,2,1,1,1,0
OC376991,8,8,0,0,2,2,0,0,1
OC377357,2,2,0,0,0,0,0,0,1
OC378912,6,6,0,0,1,1,0,0,0
OC380645,3,3,0,0,1,1,0,0,1
OC381000,2,2,0,0,1,1,0,1,0
OC381527,2,2,0,0,1,1,0,0,0
OC381809,11,3,8,0,2,2,0,0,0
OC381823,2,0,2,2,0,0,0,0,0
OC382968,2,0,2,0,0,0,0,0,0
OC383029,5,3,2,4,1,1,0,1,1
OC383133,2,0,2,1,1,1,0,0,1
OC383782,5,2,3,2,3,2,1,2,0
OC383989,18,13,5,0,1,1,0,1,0
OC384496,3,2,1,0,2,2,0,2,0
OC384710,5,2,3,0,1,1,0,0,1
OC385350,3,0,3,0,1,1,0,1,0
OC385635,44,19,25,0,3,3,0,2,1
OC385820,63,50,13,0,0,0,0,0,0
OC385980,2,0,2,0,0,0,0,0,1
OC386692,3,0,3,0,1,1,0,0,0
OC387230,3,3,0,0,3,3,0,0,0
OC388098,3,3,0,0,1,1,0,0,0
OC388179,11,9,2,1,10,8,2,1,1
OC388738,3,2,1,0,0,0,0,0,0
OC390123,54,34,20,0,0,0,0,0,0
OC391241,4,3,1,0,3,3,0,0,0
OC391376,2,2,0,0,2,2,0,0,0
OC391377,4,2,2,0,3,2,1,0,1
OC392408,4,0,4,4,1,1,0,0,0
OC393640,5,2,3,0,1,1,0,0,0
OC393681,3,0,3,0,3,2,1,0,0
OC394386,3,3,0,0,1,1,0,0,1
OC395202,30,29,1,3,1,1,0,1,1
OC395814,4,3,1,0,2,1,1,2,0
OC397142,10,4,6,1,2,1,1,1,0
OC397480,2,0,2,0,0,0,0,0,0
OC399130,3,2,1,1,1,1,0,1,0
OC399308,8,8,0,1,3,3,0,1,0
OC399906,4,3,1,1,2,1,1,2,0
OC399957,5,4,1,0,0,0,0,0,0
OC399969,141,127,14,0,0,0,0,0,1
OC400105,4,4,0,0,2,2,0,2,1
OC400187,2,2,0,0,2,2,0,0,1
OC400463,2,2,0,0,2,2,0,0,0
OC400667,4,2,2,4,1,1,0,0,0
OC401143,2,2,0,0,2,2,0,0,1
OC401458,9,4,5,1,2,1,1,1,0
OC402270,3,2,1,0,3,2,1,3,0
OC402475,66,0,66,0,0,0,0,0,1
OC402724,3,2,1,0,2,2,0,0,1
OC403461,4,4,0,0,4,2,2,0,1
OC404141,2,2,0,2,1,1,0,1,0
OC407531,2,2,0,2,0,0,0,0,0
OC407681,7,7,0,0,2,2,0,0,0
OC411493,2,2,0,0,2,2,0,0,0
OC412216,2,2,0,0,2,2,0,0,0
OC412642,4,2,2,0,2,1,1,0,0
OC412653,8,8,0,1,1,1,0,0,1
OC412900,3,2,1,0,3,2,1,3,0
OC413373,3,0,3,0,3,3,0,0,0
OC414811,2,2,0,0,2,2,0,0,1
OC415050,31,0,31,0,2,2,0,0,1
OC415334,15,0,15,0,2,2,0,0,1
OC415335,32,0,32,0,2,2,0,0,1
OC415997,4,3,1,1,3,2,1,2,0
OC416673,3,3,0,0,3,3,0,0,0
OC417558,2,2,0,0,2,2,0,2,0
OC417597,2,2,0,0,2,2,0,2,0
OC417866,4,4,0,0,0,0,0,0,0
OC418115,2,2,0,0,2,2,0,0,1
OC419182,4,2,2,0,2,1,1,1,0
OC419588,2,2,0,0,1,1,0,0,0
OC419596,2,2,0,0,1,1,0,1,0
OC420058,2,2,0,0,1,1,0,1,0
OC420177,3,2,1,1,2,2,0,1,1
OC420642,3,3,0,0,3,3,0,0,1
OC420643,3,3,0,0,3,3,0,0,1
OC421357,2,2,0,0,2,2,0,0,0
OC421619,2,2,0,0,2,2,0,0,1
OC422858,2,2,0,0,2,2,0,0,0
OC423339,2,2,0,2,2,2,0,2,0
OC423791,2,2,0,0,1,1,0,1,0
OC424671,2,2,0,0,1,1,0,1,0
OC424780,4,3,1,0,0,0,0,0,0
OC424788,2,2,0,0,0,0,0,0,0
OC424860,2,2,0,0,2,2,0,0,0
OC426205,6,6,0,0,0,0,0,0,0
OC426380,2,2,0,0,2,2,0,0,0
OC426486,2,2,0,0,2,2,0,0,0
OC426833,2,2,0,0,1,1,0,0,1
OC426887,4,3,1,0,3,1,2,0,0
OC427124,2,2,0,0,2,2,0,1,0
OC427441,2,2,0,0,2,2,0,0,0
R0000568,48,10,38,0,1,1,0,1,1
R0000733,83,17,66,0,1,1,0,1,1
RS004174,0,0,0,0,0,0,0,0,0
RS004194,0,0,0,0,0,0,0,0,0
RS004353,0,0,0,0,0,0,0,0,0
RS004378,0,0,0,0,0,0,0,0,0
RS004385,0,0,0,0,0,0,0,0,0
RS004405,0,0,0,0,0,0,0,0,0
RS004554,0,0,0,0,0,0,0,0,0
RS007007,0,0,0,0,0,0,0,0,0
RS007081,0,0,0,0,0,0,0,0,0
RS007108,0,0,0,0,0,0,0,0,0
RS007192,0,0,0,0,0,0,0,0,0
RS007352,0,0,0,0,0,0,0,0,0
RS007381,0,0,0,0,0,0,0,0,0
RS007425,0,0,0,0,0,0,0,0,0
RS007427,0,0,0,0,0,0,0,0,0
RS007465,0,0,0,0,0,0,0,0,0
RS007527,0,0,0,0,0,0,0,0,0
RS007531,0,0,0,0,0,0,0,0,0
RS007577,0,0,0,0,0,0,0,0,0
RS007584,0,0,0,0,0,0,0,0,0
RS007597,0,0,0,0,0,0,0,0,0
RS007723,0,0,0,0,0,0,0,0,0
RS007730,0,0,0,0,0,0,0,0,0
RS007794,0,0,0,0,0,0,0,0,0
RS007828,0,0,0,0,0,0,0,0,0
RS007829,0,0,0,0,0,0,0,0,0
RS007837,0,0,0,0,0,0,0,0,0
RS007860,0,0,0,0,0,0,0,0,0
SC000489,21,7,14,1,0,0,0,0,1
SC000750,78,8,70,0,1,1,0,1,1
SC001645,32,5,27,0,1,1,0,1,1
SC001731,43,7,36,0,0,0,0,0,1
SC002816,41,3,38,0,1,1,0,1,1
SC003197,38,3,35,0,1,1,0,1,1
SC006192,43,3,40,0,1,1,0,1,1
SC007173,42,3,39,0,1,1,0,1,1
SC008349,46,8,38,0,0,0,0,0,1
SC010174,14,3,11,0,1,1,0,1,1
SC013654,35,3,32,0,1,1,0,1,1
SC014472,18,5,13,0,1,1,0,1,1
SC014477,53,5,48,1,1,1,0,1,1
SC015346,12,0,12,0,0,0,0,0,1
SC017306,28,5,23,0,1,1,0,1,1
SC018411,30,5,25,0,1,1,0,1,1
SC018714,48,10,38,0,0,0,0,0,1
SC019354,15,4,11,0,1,1,0,1,1
SC020954,33,4,29,0,1,1,0,1,1
SC021118,44,0,44,0,1,1,0,1,1
SC021540,26,5,21,0,3,1,2,1,1
SC024068,48,6,42,0,1,1,0,1,1
SC024642,11,0,11,0,0,0,0,0,1
SC024759,31,4,27,0,1,1,0,1,1
SC029203,25,3,22,0,1,1,0,1,1
SC029367,57,0,57,0,0,0,0,0,1
SC030263,23,6,17,0,1,1,0,1,1
SC035148,127,16,111,0,0,0,0,0,1
SC041917,30,5,25,0,1,1,0,1,1
SC044723,87,12,75,1,0,0,0,0,1
SC044771,24,3,21,0,1,1,0,1,1
SC044986,13,5,8,0,1,1,0,1,1
SC046004,45,4,41,0,1,1,0,0,1
SC046564,11,4,7,0,1,1,0,1,1
SC047035,22,0,22,0,0,0,0,0,1
SC047949,19,3,16,0,1,1,0,1,1
SC053832,41,5,36,0,1,1,0,1,0
SC056222,9,3,6,0,1,1,0,1,1
SC059453,23,3,20,0,1,1,0,1,1
SC059454,20,0,20,0,1,1,0,1,1
SC060893,21,0,21,0,0,0,0,0,1
SC062886,21,4,17,0,2,2,0,2,1
SC065605,30,3,27,0,1,1,0,1,1
SC065846,5,0,5,0,0,0,0,0,1
SC067087,90,11,79,0,0,0,0,0,1
05370544,29,7,22,0,0,0,0,0,0
05373481,9,0,9,0,0,0,0,0,1
05373496,7,2,5,0,2,2,0,0,0
05373890,10,5,5,0,2,2,0,0,1
05373909,13,4,9,0,2,2,0,0,1
05373916,15,0,15,0,0,0,0,0,1
05373919,11,4,7,0,2,2,0,0,1
05373951,13,4,9,0,2,2,0,0,1
05373991,13,4,9,0,2,2,0,0,1
05374338,5,2,3,0,1,1,0,1,0
05375019,7,2,5,0,1,1,0,1,1
05375065,28,8,20,0,0,0,0,0,0
05375076,10,3,7,0,1,1,0,1,1
05375141,22,2,20,0,0,0,0,0,1
05376952,12,2,10,0,1,1,0,1,1
05376960,6,4,2,0,1,1,0,0,0
05377023,8,0,8,0,0,0,0,0,1
05377145,3,2,1,0,2,2,0,0,0
05378991,2,2,0,0,1,1,0,0,0
05379553,13,0,13,0,0,0,0,0,1
05381080,5,0,5,0,0,0,0,0,1
05382220,16,3,13,0,1,1,0,1,1
05382221,16,3,13,0,1,1,0,1,1
05382262,26,2,24,0,1,1,0,1,1
05383234,20,3,17,0,2,2,0,2,1
05384148,53,11,42,0,0,0,0,0,0
05384616,19,5,14,0,1,1,0,1,1
05384910,4,0,4,0,2,2,0,0,0
05385638,9,0,9,0,0,0,0,0,1
05386079,20,8,12,0,0,0,0,0,1
05386112,5,2,3,0,1,1,0,0,1
05386418,10,7,3,0,2,2,0,0,1
05386427,13,0,13,0,0,0,0,0,1
05386788,11,0,11,0,0,0,0,0,1
05386790,11,0,11,0,0,0,0,0,1
05386803,6,3,3,0,1,1,0,1,1
05386955,17,0,17,0,0,0,0,0,1
05386956,28,2,26,0,1,1,0,1,1
05387790,5,3,2,0,2,2,0,0,0
05390028,8,0,8,0,0,0,0,0,1
05391455,8,1,7,0,1,1,0,1,1
05391778,10,2,8,0,0,0,0,0,0
05391794,6,4,2,0,3,3,0,0,0
05393344,26,5,21,0,1,1,0,1,1
05393793,10,3,7,0,1,1,0,0,1
05395059,4,1,3,0,1,1,0,0,0
05395743,20,4,16,0,4,4,0,4,1
05396181,13,3,10,0,1,1,0,1,1
05396227,5,1,4,0,1,1,0,0,0
05396270,11,4,7,0,1,1,0,1,1
05396870,22,6,16,0,0,0,0,0,1
05397004,17,4,13,0,2,2,0,2,1
05397063,19,4,15,0,0,0,0,0,1
05397676,5,3,2,0,3,3,0,0,0
05397785,18,5,13,0,0,0,0,0,0
05400020,24,2,22,0,1,1,0,1,1
05400512,8,3,5,0,2,1,1,0,0
05400865,15,0,15,0,0,0,0,0,1
05401378,7,1,6,0,1,1,0,0,1
05401393,5,1,4,0,1,1,0,0,0
05401672,6,1,5,0,4,4,0,0,0
05402228,5,0,5,0,0,0,0,0,0
05402968,5,0,5,0,0,0,0,0,0
05403280,11,4,7,0,1,1,0,1,1
05404490,10,4,6,0,1,1,0,1,1
05405982,23,0,23,0,0,0,0,0,1
05406320,4,3,1,0,1,1,0,0,1
05407406,4,1,3,0,1,1,0,0,0
05407683,5,2,3,0,0,0,0,0,0
05407768,20,7,13,0,0,0,0,0,1
05407893,5,3,2,0,2,2,0,0,0
05408107,24,10,14,0,0,0,0,0,0
05408314,19,4,15,0,2,2,0,2,1
05409178,3,0,3,0,1,1,0,0,0
05409369,4,3,1,0,2,2,0,0,0
05410412,17,0,17,0,0,0,0,0,1
05412359,10,6,4,0,0,0,0,0,0
05412731,5,2,3,0,1,1,0,0,0
05414220,4,2,2,0,1,1,0,1,0
05414715,8,0,8,0,0,0,0,0,1
05415348,6,2,4,0,1,1,0,0,0
05415907,18,3,15,0,1,1,0,1,0
05417092,9,5,4,0,1,1,0,1,1
05417108,9,5,4,0,1,1,0,1,1
05417120,9,5,4,0,1,1,0,1,1
05418234,12,1,11,0,2,2,0,0,0
05418408,10,0,10,0,0,0,0,0,1
05418426,17,0,17,0,0,0,0,0,1
05420963,91,14,77,0,0,0,0,0,1
05421073,9,5,4,0,1,1,0,1,1
05422042,2,2,0,0,1,1,0,0,0
05422551,15,0,15,0,0,0,0,0,1
05422559,12,3,9,0,1,1,0,0,1
05423137,8,2,6,0,1,1,0,0,0
05423632,10,4,6,0,1,1,0,0,0
05426874,4,0,4,0,0,0,0,0,1
05428502,5,1,4,0,0,0,0,0,0
05429032,10,2,8,0,1,1,0,1,1
05429878,5,0,5,0,0,0,0,0,1
05429891,10,0,10,0,1,1,0,1,1
05430106,10,2,8,0,0,0,0,0,0
05431528,8,0,8,0,0,0,0,0,1
05431580,3,0,3,0,0,0,0,0,1
05431946,8,2,6,0,1,1,0,1,1
05432285,5,2,3,0,2,2,0,0,1
05432957,6,2,4,0,1,1,0,0,0
05433298,7,3,4,0,2,2,0,0,1
05433333,9,3,6,0,1,1,0,0,1
05435204,8,5,3,0,0,0,0,0,0
05436117,16,5,11,0,1,1,0,0,1
05436673,18,0,18,0,1,1,0,1,1
05437517,20,3,17,0,1,1,0,1,1
05438577,2,2,0,0,1,1,0,1,0
05439154,8,3,5,0,1,1,0,1,1
05440599,5,3,2,0,2,2,0,0,0
05440605,2,2,0,0,1,1,0,1,0
05441033,5,1,4,0,1,1,0,0,1
05442349,12,3,9,0,2,2,0,0,1
05442364,12,3,9,0,2,2,0,0,1
05443041,12,3,9,0,2,2,0,0,1
05443044,12,3,9,0,2,2,0,0,1
05443205,4,2,2,0,0,0,0,0,0
05443517,13,5,8,0,1,1,0,0,1
05444440,14,0,14,0,0,0,0,0,1
05444672,5,3,2,0,2,2,0,0,0
05444725,6,3,3,0,0,0,0,0,1
05447670,4,2,2,0,1,1,0,0,0
05448103,6,0,6,0,0,0,0,0,0
05451176,13,0,13,0,0,0,0,0,1
05451630,28,1,27,0,3,1,2,3,1
05451913,14,0,14,0,0,0,0,0,1
05452162,6,2,4,0,3,2,1,0,0
05452202,28,4,24,0,1,1,0,1,1
05453232,9,3,6,0,1,1,0,1,1
05454426,6,3,3,0,0,0,0,0,0
05455199,4,2,2,0,1,1,0,0,0
05455644,43,13,30,0,0,0,0,0,1
05455687,11,0,11,0,0,0,0,0,1
05457739,7,0,7,0,0,0,0,0,1
05461103,4,2,2,0,0,0,0,0,1
05461126,4,2,2,0,0,0,0,0,1
05462286,11,4,7,0,0,0,0,0,1
05464391,6,1,5,0,1,1,0,0,1
05464880,4,3,1,0,1,1,0,0,0
05467491,5,0,5,0,0,0,0,0,1
05467860,7,0,7,0,0,0,0,0,0
05468720,5,3,2,0,2,2,0,0,0
05468845,7,5,2,0,5,4,1,0,1
05468846,6,4,2,0,4,3,1,0,1
05469453,7,2,5,0,1,1,0,1,0
05471868,8,3,5,0,0,0,0,0,0
05472922,4,0,4,0,1,1,0,0,0
05473213,9,4,5,0,0,0,0,0,1
05477711,6,2,4,0,4,2,2,0,0
05478001,8,4,4,0,0,0,0,0,0
05478530,7,0,7,0,0,0,0,0,1
05479637,7,0,7,0,0,0,0,0,1
05480069,5,2,3,0,1,1,0,0,0
05480338,5,1,4,0,1,1,0,0,1
05481377,10,1,9,0,0,0,0,0,1
05481386,10,0,10,0,0,0,0,0,1
05482421,6,3,3,0,0,0,0,0,1
05485349,30,10,20,0,0,0,0,0,0
05485678,28,6,22,0,1,1,0,1,1
05486638,20,5,15,0,1,1,0,1,1
05489010,3,2,1,0,1,1,0,0,0
05489355,7,0,7,0,0,0,0,0,1
05489727,2,2,0,0,1,1,0,1,0
05490129,3,2,1,0,2,2,0,0,1
05490276,0,0,0,0,0,0,0,0,1
05490420,18,1,17,0,0,0,0,0,0
05491588,25,8,17,0,0,0,0,0,1
05492468,6,2,4,0,1,1,0,0,0
05492798,4,2,2,0,2,2,0,0,0
05493387,19,2,17,0,1,1,0,1,1
05494083,5,3,2,0,2,2,0,0,0
05494795,9,0,9,0,0,0,0,0,1
05494867,10,0,10,0,0,0,0,0,1
05495096,10,6,4,0,0,0,0,0,1
05497310,29,0,29,0,1,1,0,0,0
05497802,15,0,15,0,0,0,0,0,1
05498724,10,7,3,0,0,0,0,0,0
05501389,3,1,2,0,1,1,0,0,0
05501979,3,0,3,0,0,0,0,0,1
05504699,6,2,4,0,2,2,0,0,0
05505149,3,0,3,0,2,2,0,0,0
05505173,3,1,2,0,2,2,0,0,0
05506268,5,3,2,0,2,2,0,0,0
05507387,14,4,10,0,1,1,0,1,1
05509086,57,9,48,0,0,0,0,0,0
05510783,5,2,3,0,1,1,0,0,0
05511848,19,4,15,0,2,2,0,0,1
05515857,17,4,13,0,1,1,0,0,1
05518335,18,4,14,0,1,1,0,0,1
05518392,9,3,6,0,2,2,0,0,0
05519729,4,2,2,0,1,1,0,0,0
05521056,10,0,10,0,1,1,0,0,0
05521915,10,0,10,0,0,0,0,0,1
05522704,6,0,6,0,2,2,0,0,0
05524060,5,1,4,0,1,1,0,0,1
05525879,4,0,4,0,1,1,0,0,1
05527011,9,2,7,0,1,1,0,0,0
05528188,3,3,0,0,2,2,0,0,0
05530776,58,10,48,0,0,0,0,0,1
05532192,4,2,2,0,1,1,0,0,1
05535367,5,0,5,0,2,2,0,0,0
05536252,5,2,3,0,3,2,1,1,1
05536487,10,5,5,0,0,0,0,0,0
05536780,4,3,1,0,2,2,0,0,0
05537660,3,0,3,0,1,1,0,0,0
05537947,21,5,16,0,1,1,0,1,1
05540445,8,2,6,0,0,0,0,0,0
05540539,5,3,2,0,3,3,0,0,0
05541340,3,1,2,0,1,1,0,0,0
05542159,6,4,2,0,1,1,0,0,0
05542416,6,2,4,0,1,1,0,0,1
05543379,3,2,1,0,1,1,0,0,1
05544383,10,0,10,0,0,0,0,0,1
05545375,5,3,2,0,1,1,0,0,0
05545515,16,1,15,0,1,1,0,1,1
05545749,7,3,4,0,0,0,0,0,1
05546492,6,4,2,0,0,0,0,0,0
05546638,27,8,19,0,0,0,0,0,1
05546901,23,4,19,0,0,0,0,0,1
05547374,5,3,2,0,2,2,0,0,1
05547510,10,0,10,0,0,0,0,0,0
05549190,6,0,6,0,0,0,0,0,1
05549234,6,0,6,0,0,0,0,0,1
05549592,4,2,2,0,1,1,0,0,0
05549616,7,0,7,0,0,0,0,0,1
05549995,16,3,13,0,2,2,0,0,1
05551672,10,6,4,0,2,2,0,1,0
05554196,52,7,45,0,1,1,0,0,1
05554437,5,2,3,0,1,1,0,0,1
05555321,5,1,4,0,2,1,1,0,0
05557301,12,6,6,0,0,0,0,0,0
05557943,4,2,2,0,2,1,1,0,0
05559028,7,5,2,0,2,2,0,2,0
05559226,4,0,4,0,0,0,0,0,0
05559297,5,3,2,0,2,2,0,0,0
05561002,3,2,1,0,1,1,0,0,0
05561728,4,2,2,0,2,2,0,0,0
05562093,0,0,0,0,0,0,0,0,1
05562589,12,6,6,0,1,1,0,0,0
05563206,26,5,21,0,0,0,0,0,1
05564884,21,12,9,0,0,0,0,0,0
05565928,3,1,2,0,1,1,0,0,0
05566615,6,0,6,0,0,0,0,0,1
05566838,4,2,2,0,1,1,0,0,0
05567097,3,2,1,0,2,2,0,0,0
05567306,19,3,16,0,1,1,0,1,1
05567682,18,4,14,0,1,1,0,0,1
05567945,7,0,7,0,1,1,0,1,1
05567975,17,0,17,0,0,0,0,0,1
05567985,7,0,7,0,1,1,0,1,1
05568015,7,0,7,0,1,1,0,1,1
05568155,8,0,8,0,1,1,0,1,1
05568324,4,2,2,0,1,1,0,0,0
05568381,5,4,1,0,4,1,3,1,1
05569617,9,5,4,0,1,1,0,0,0
05570233,6,0,6,0,0,0,0,0,0
05573304,10,4,6,0,1,1,0,0,1
05573594,3,3,0,0,2,2,0,0,0
05574485,13,6,7,0,2,2,0,0,1
05575906,4,0,4,0,1,1,0,0,1
05576758,22,5,17,0,0,0,0,0,1
05577224,8,4,4,0,0,0,0,0,0
05580562,6,3,3,0,1,1,0,0,0
05581645,7,2,5,0,1,1,0,0,1
05582332,12,3,9,0,1,1,0,0,0
05582490,26,4,22,0,1,1,0,1,1
05582643,23,8,15,0,0,0,0,0,0
05583837,10,0,10,0,0,0,0,0,1
05584679,7,3,4,0,1,1,0,0,1
05585998,21,0,21,0,0,0,0,0,1
05586314,9,1,8,0,0,0,0,0,0
05586562,4,0,4,0,0,0,0,0,0
05588669,3,3,0,0,2,2,0,0,0
05589064,3,3,0,0,2,2,0,0,0
05591920,15,9,6,0,1,1,0,0,0
05592112,7,0,7,0,0,0,0,0,1
05592192,3,2,1,0,1,1,0,0,0
05592789,5,1,4,0,1,1,0,0,0
05594889,25,6,19,0,0,0,0,0,1
05595445,14,2,12,0,1,1,0,1,1
05595462,9,3,6,0,2,2,0,0,1
05595709,32,3,29,0,2,1,1,0,0
05596459,2,0,2,0,0,0,0,0,1
05596553,4,3,1,0,2,2,0,0,0
05597188,19,6,13,0,1,1,0,0,1
05597472,7,2,5,0,1,1,0,0,0
05598134,4,3,1,0,2,2,0,0,0
05599674,5,2,3,0,1,1,0,1,1
05599801,4,0,4,0,1,1,0,0,1
05599963,9,0,9,0,0,0,0,0,1
05600195,10,2,8,0,1,1,0,1,1
05600197,10,2,8,0,1,1,0,1,1
05602169,10,2,8,0,1,1,0,1,1
05602581,31,9,22,0,0,0,0,0,0
05603442,5,3,2,0,2,2,0,0,1
05603660,3,0,3,0,0,0,0,0,1
05603875,28,0,28,0,1,1,0,1,1
05603956,6,0,6,0,1,1,0,1,0
05604259,4,2,2,0,1,1,0,0,1
05604551,6,2,4,0,2,1,1,0,0
05605025,10,5,5,0,1,1,0,1,1
05605411,10,0,10,0,0,0,0,0,1
05605478,10,0,10,0,0,0,0,0,1
05605481,10,0,10,0,0,0,0,0,1
05607276,25,3,22,1,1,1,0,1,0
05607391,11,4,7,0,1,1,0,0,1
05607463,27,7,20,1,0,0,0,0,1
05607631,5,2,3,0,1,1,0,0,1
05608690,21,4,17,0,5,3,2,0,0
05608858,5,0,5,0,0,0,0,0,1
05609455,14,4,10,0,1,1,0,0,1
05609781,19,4,15,0,1,1,0,1,1
05610997,16,3,13,0,2,2,0,0,0
05611932,16,0,16,0,0,0,0,0,1
05612691,5,0,5,0,0,0,0,0,1
05616818,9,5,4,0,1,1,0,0,0
05622587,10,5,5,0,1,1,0,1,1
05624885,2,0,2,0,0,0,0,0,1
05624902,2,0,2,0,0,0,0,0,1
05626997,27,7,20,0,0,0,0,0,0
05627029,2,1,1,0,1,1,0,0,0
05627775,3,1,2,0,1,1,0,0,0
05628046,7,5,2,0,4,4,0,0,0
05629540,19,3,16,0,0,0,0,0,0
05631693,7,0,7,0,2,1,1,0,0
05631739,5,2,3,0,2,2,0,0,0
05632635,5,3,2,0,2,2,0,0,0
05634052,4,0,4,0,0,0,0,0,0
05640154,11,5,6,0,1,1,0,1,1
05640458,4,2,2,0,1,1,0,0,0
05640740,28,4,24,0,2,1,1,2,1
05641471,3,1,2,0,1,1,0,0,0
05641515,8,5,3,0,4,4,0,0,1
05642022,5,0,5,0,0,0,0,0,1
05642292,4,0,4,0,0,0,0,0,1
05643048,18,0,18,0,0,0,0,0,1
05644938,6,0,6,0,0,0,0,0,1
05645055,2,0,2,0,1,1,0,0,0
05645331,4,2,2,0,1,1,0,0,0
05645455,6,0,6,0,0,0,0,0,1
05647568,9,3,6,0,1,1,0,1,1
05647739,6,2,4,0,0,0,0,0,1
05648109,5,0,5,0,2,2,0,0,1
05649413,8,0,8,0,1,1,0,1,1
05650532,7,0,7,0,0,0,0,0,1
05652705,3,2,1,0,1,1,0,0,1
05652706,3,2,1,0,1,1,0,0,1
05657472,25,1,24,0,1,1,0,1,1
05658357,12,0,12,0,0,0,0,0,1
05659940,3,3,0,0,2,2,0,0,0
05660568,6,1,5,0,1,1,0,0,1
05660800,4,0,4,0,1,1,0,0,1
05661019,12,4,8,0,0,0,0,0,0
05661360,7,5,2,0,1,1,0,1,0
05662101,6,3,3,0,1,1,0,0,0
05662664,3,0,3,0,0,0,0,0,0
05663740,15,2,13,0,0,0,0,0,1
05665271,19,5,14,0,0,0,0,0,1
05665863,4,0,4,0,2,2,0,0,0
05666752,23,3,20,0,2,1,1,0,0
05668085,5,3,2,0,2,2,0,0,0
05668245,4,3,1,0,2,1,1,0,0
05670672,6,1,5,0,0,0,0,0,1
05671684,21,4,17,0,0,0,0,0,0
05672642,8,3,5,0,1,1,0,0,1
05672869,10,2,8,0,1,1,0,1,1
05673039,140,0,140,0,1,1,0,0,1
05673738,11,6,5,0,0,0,0,0,0
05675378,12,3,9,0,2,1,1,0,0
05675800,18,0,18,0,0,0,0,0,1
05678509,16,0,16,0,0,0,0,0,1
05679423,13,3,10,0,1,1,0,1,1
05681687,9,5,4,0,0,0,0,0,0
05683361,5,3,2,0,2,2,0,0,1
05683589,2,0,2,0,0,0,0,0,1
05687200,6,1,5,0,3,1,2,1,0
05687775,22,4,18,0,1,1,0,1,1
05688533,34,3,31,0,1,1,0,1,0
07170250,9,2,7,0,3,1,2,3,0
07170314,9,2,7,0,3,1,2,3,0
07171019,1,1,0,0,2,2,0,0,0
07172034,1,1,0,0,1,1,0,0,0
07173979,5,4,1,0,1,1,0,0,0
07176392,10,4,6,0,0,0,0,0,0
07176393,19,3,16,0,2,2,0,2,1
07177995,3,2,1,0,2,2,0,0,1
07178463,10,2,8,0,2,1,1,2,0
07178592,1,1,0,0,2,2,0,0,1
07179041,2,1,1,0,1,1,0,0,1
07179316,2,2,0,0,1,1,0,0,0
07179948,14,0,14,0,0,0,0,0,1
07179949,12,0,12,0,0,0,0,0,1
07180072,1,0,1,0,0,0,0,0,1
07182183,18,10,8,0,0,0,0,0,1
07182792,1,1,0,0,1,1,0,0,0
07184260,2,0,2,0,1,1,0,0,0
07185482,7,3,4,0,1,1,0,1,1
07185540,3,0,3,0,0,0,0,0,1
07185594,18,4,14,0,2,2,0,2,1
07186247,1,1,0,0,1,1,0,0,0
07187444,3,3,0,0,2,2,0,0,0
07187991,7,6,1,0,1,1,0,0,0
07189004,5,2,3,0,0,0,0,0,1
07189345,1,1,0,0,1,1,0,0,1
07189398,1,1,0,0,1,1,0,0,0
07189822,1,1,0,0,1,1,0,0,1
07190386,15,3,12,0,1,1,0,1,0
07193336,4,2,2,0,1,1,0,0,1
07193337,4,4,0,0,0,0,0,0,0
07193348,4,3,1,0,1,1,0,0,0
07193737,4,3,1,0,1,1,0,0,0
07193829,10,4,6,0,1,1,0,1,1
07194054,7,4,3,0,1,1,0,1,1
07194580,15,0,15,0,0,0,0,0,1
07196230,10,4,6,0,2,2,0,2,0
07196594,7,4,3,0,1,1,0,1,1
07197045,12,6,6,0,2,2,0,1,0
07198747,2,2,0,0,1,1,0,0,1
07200499,22,4,18,0,1,1,0,1,1
07200773,9,3,6,0,1,1,0,1,1
07200912,2,1,1,0,1,1,0,0,0
07204783,2,2,0,0,2,2,0,0,0
07205003,8,2,6,0,2,2,0,0,1
07205442,2,2,0,0,1,1,0,0,0
07207636,2,2,0,0,2,2,0,0,0
07208517,9,5,4,0,0,0,0,0,1
07209057,7,0,7,0,0,0,0,0,1
07210463,3,1,2,0,1,1,0,0,0
07213330,3,3,0,0,1,1,0,1,1
07213374,6,2,4,0,1,1,0,0,1
07214035,3,2,1,0,2,2,0,0,0
07217418,23,9,14,0,0,0,0,0,0
07218799,2,1,1,0,3,1,2,0,0
07219124,10,0,10,0,0,0,0,0,1
07220459,10,4,6,0,0,0,0,0,1
07221241,3,3,0,0,2,2,0,0,1
07224399,5,2,3,0,0,0,0,0,1
07224997,1,1,0,0,1,1,0,0,0
07226626,4,2,2,0,1,1,0,1,1
07226689,2,1,1,0,1,1,0,0,0
07226699,3,3,0,0,3,3,0,0,0
07226837,15,0,15,0,0,0,0,0,1
07228598,3,2,1,0,2,2,0,0,0
07228709,1,1,0,0,1,1,0,0,0
07230960,3,3,0,0,2,2,0,0,0
07231010,18,15,3,0,1,1,0,1,1
07231303,13,5,8,0,3,1,2,1,1
07231778,5,0,5,0,1,1,0,0,1
07232058,5,5,0,0,3,0,3,0,1
07233113,25,10,15,0,8,6,2,0,0
07233528,7,2,5,0,1,1,0,1,1
07234051,2,0,2,0,0,0,0,0,0
07234097,4,2,2,0,2,2,0,0,1
07234707,22,4,18,0,1,1,0,1,1
07235280,13,6,7,0,1,1,0,1,1
07237935,17,7,10,0,0,0,0,0,0
07240624,21,7,14,0,0,0,0,0,0
07241442,5,3,2,0,3,3,0,0,1
07242265,2,0,2,0,0,0,0,0,0
07243033,26,13,13,0,1,0,1,0,0
07246975,16,4,12,0,1,1,0,0,0
07247238,18,7,11,0,0,0,0,0,0
07247341,4,3,1,0,2,2,0,0,0
07248444,7,0,7,0,0,0,0,0,1
07250181,6,1,5,0,1,1,0,0,0
07250549,7,5,2,0,0,0,0,0,1
07253336,2,2,0,0,2,2,0,0,0
07256655,9,4,5,0,1,1,0,1,1
07258491,25,9,16,0,1,1,0,1,1
07261541,5,2,3,0,2,1,1,0,0
07262918,4,3,1,0,0,0,0,0,1
07263835,6,4,2,0,1,1,0,0,0
07264501,2,2,0,0,2,2,0,0,0
07264678,28,9,19,0,0,0,0,0,1
07265982,9,3,6,0,1,1,0,1,0
07266312,6,0,6,0,0,0,0,0,1
07267638,5,4,1,0,3,1,2,1,0
07270745,7,4,3,0,0,0,0,0,0
07271657,5,3,2,0,2,2,0,0,1
07273848,2,1,1,0,2,1,1,1,0
07273934,3,1,2,0,1,1,0,0,0
07274100,6,5,1,0,0,0,0,0,0
07276853,4,0,4,0,0,0,0,0,1
07278654,3,0,3,0,0,0,0,0,1
07278844,6,4,2,0,10,10,0,1,1
07278867,7,4,3,0,11,10,1,1,1
07279760,5,3,2,0,0,0,0,0,1
07279868,12,0,12,0,0,0,0,0,1
07283993,6,3,3,0,4,1,3,1,0
07284542,6,3,3,0,1,1,0,1,1
07285230,7,3,4,0,1,1,0,0,1
07285438,7,3,4,0,2,2,0,2,1
07285667,16,0,16,0,0,0,0,0,1
07285884,2,1,1,0,1,1,0,0,0
07286116,7,4,3,0,1,1,0,0,0
07287246,5,2,3,0,1,1,0,1,0
07287389,3,1,2,0,1,1,0,0,0
07288563,3,2,1,0,2,2,0,0,0
07289145,5,2,3,0,2,1,1,0,0
07291380,3,2,1,0,1,1,0,0,1
07293521,22,7,15,0,0,0,0,0,0
07294491,1,1,0,0,0,0,0,0,0
07297257,8,0,8,0,0,0,0,0,1
07299463,1,1,0,0,1,1,0,0,0
07300010,6,4,2,0,1,1,0,1,1
07302286,3,0,3,0,0,0,0,0,0
07302465,2,0,2,0,1,1,0,0,0
07303630,3,0,3,0,0,0,0,0,1
07304443,30,8,22,0,0,0,0,0,0
07305054,2,2,0,0,1,1,0,0,0
07305923,14,3,11,0,2,1,1,2,1
07306622,3,1,2,0,1,1,0,0,0
07308389,2,0,2,0,1,1,0,0,0
07310535,4,2,2,0,2,2,0,0,1
07311824,1,1,0,0,1,1,0,0,0
07312896,30,10,20,0,0,0,0,0,1
07314422,1,1,0,0,2,2,0,0,0
07315957,1,1,0,0,1,1,0,0,0
07317393,3,3,0,0,1,1,0,1,0
07317395,3,3,0,0,2,2,0,0,0
07317556,1,1,0,0,2,2,0,0,0
07317718,3,3,0,0,2,2,0,0,0
07317720,15,2,13,0,1,1,0,1,1
07319304,2,1,1,0,2,2,0,0,0
07322169,4,0,4,0,2,2,0,0,0
07322569,4,0,4,0,0,0,0,0,1
07325051,2,2,0,0,1,1,0,0,0
07326078,7,0,7,0,2,2,0,2,1
07327371,9,4,5,0,1,1,0,1,1
07327556,5,3,2,0,1,1,0,1,1
07327954,3,2,1,0,2,2,0,0,0
07329164,8,3,5,0,4,3,1,0,0
07329677,2,0,2,0,1,1,0,0,0
07329930,11,5,6,0,1,1,0,1,1
07330087,6,3,3,0,1,1,0,1,1
07333089,17,9,8,0,3,3,0,0,0
07335019,6,3,3,0,2,1,1,0,0
07335368,2,0,2,0,2,2,0,0,0
07336254,15,0,15,0,0,0,0,0,0
07336521,1,0,1,0,0,0,0,0,1
07338658,7,3,4,0,1,1,0,0,0
07338685,4,4,0,0,2,2,0,0,1
07338749,4,0,4,0,0,0,0,0,1
07339088,3,0,3,0,1,0,1,0,0
07340518,19,12,7,0,0,0,0,0,1
07340972,7,3,4,0,1,1,0,1,1
07341552,1,1,0,0,1,1,0,0,0
07342023,1,1,0,0,1,1,0,0,0
07342682,1,0,1,0,1,1,0,0,0
07342849,9,5,4,0,1,1,0,1,1
07343051,16,3,13,0,0,0,0,0,0
07343156,10,3,7,0,1,1,0,0,0
07344701,1,1,0,0,1,1,0,0,0
07345214,3,3,0,0,1,1,0,0,0
07345280,8,0,8,0,0,0,0,0,1
07345580,1,1,0,0,2,2,0,0,0
07347890,2,2,0,0,1,1,0,0,0
07348220,2,2,0,0,1,1,0,0,0
07348389,4,2,2,0,1,1,0,0,0
07348659,1,1,0,0,1,1,0,0,0
07350037,3,1,2,0,1,1,0,0,0
07350514,1,0,1,0,0,0,0,0,0
07352176,1,0,1,0,0,0,0,0,0
07354765,1,1,0,0,1,1,0,0,0
07354935,2,2,0,0,2,2,0,0,0
07355778,12,4,8,0,2,2,0,2,1
07356292,1,1,0,0,1,1,0,0,0
07356573,2,2,0,0,4,4,0,0,0
07356881,2,1,1,0,1,1,0,0,1
07357127,2,2,0,0,1,1,0,0,0
07359431,3,3,0,0,2,2,0,0,0
07359592,4,2,2,0,2,2,0,0,0
07360913,9,3,6,0,2,2,0,0,1
07361059,3,2,1,0,2,2,0,0,1
07363895,4,0,4,1,0,0,0,0,0
07363941,3,0,3,1,0,0,0,0,0
07364604,2,2,0,0,1,1,0,0,0
07366143,1,1,0,0,1,1,0,0,0
07366674,5,4,1,0,0,0,0,0,0
07369869,10,2,8,0,0,0,0,0,0
07369885,7,0,7,0,1,1,0,1,1
07369991,3,3,0,0,3,3,0,0,1
07370163,3,3,0,0,3,3,0,0,0
07371122,4,4,0,0,4,2,2,0,0
07371746,13,6,7,0,2,0,2,0,0
07372080,18,5,13,0,0,0,0,0,0
07373988,3,2,1,0,2,2,0,0,0
07374707,3,2,1,0,1,1,0,0,0
07375556,8,3,5,0,1,1,0,1,1
07376729,18,6,12,0,0,0,0,0,1
07379801,1,1,0,0,2,2,0,0,0
07380427,2,2,0,0,2,2,0,0,0
07380605,3,0,3,0,2,2,0,1,0
07380745,1,1,0,0,1,1,0,0,0
07380770,1,1,0,0,1,1,0,0,0
07381420,25,6,19,0,2,1,1,2,1
07381946,3,1,2,0,1,1,0,0,0
07382345,4,3,1,0,2,2,0,0,0
07382952,2,2,0,0,0,0,0,0,0
07383769,21,9,12,0,8,8,0,0,0
07384561,2,2,0,0,2,2,0,0,0
07384812,2,2,0,0,2,2,0,0,0
07385350,2,1,1,0,1,1,0,0,0
07386720,1,1,0,0,2,2,0,0,0
07391909,15,7,8,0,1,1,0,0,1
07391924,9,0,9,0,0,0,0,0,0
07392164,1,1,0,0,2,2,0,0,0
07392284,2,2,0,0,1,1,0,0,0
07393345,28,17,11,0,0,0,0,0,1
07394654,1,1,0,0,1,1,0,0,0
07394671,12,8,4,0,0,0,0,0,0
07394698,2,0,2,0,0,0,0,0,0
07394830,2,0,2,0,0,0,0,0,0
07395130,5,0,5,0,0,0,0,0,0
07396567,3,3,0,0,2,2,0,0,0
07397803,4,1,3,0,3,1,2,0,0
07398119,9,4,5,0,0,0,0,0,0
07398870,7,4,3,0,0,0,0,0,1
07399160,3,3,0,0,2,2,0,0,0
07399382,3,2,1,0,1,1,0,0,0
07400418,2,2,0,0,1,1,0,0,0
07401113,3,3,0,0,1,1,0,1,0
07401490,13,4,9,0,2,2,0,2,1
07403648,2,1,1,0,1,1,0,0,1
07405181,2,2,0,0,1,1,0,0,0
07407120,6,0,6,0,0,0,0,0,1
07407551,1,1,0,0,1,1,0,0,0
07408573,2,1,1,0,1,1,0,0,0
07409238,2,2,0,0,2,2,0,0,0
07411074,10,5,5,0,0,0,0,0,0
07412237,6,0,6,0,0,0,0,0,0
07412548,2,1,1,0,1,1,0,0,1
07413284,2,1,1,0,1,1,0,0,1
07414103,2,2,0,0,2,2,0,0,1
07415467,1,1,0,0,1,1,0,0,0
07416230,2,1,1,0,2,1,1,0,0
07416617,6,3,3,0,1,1,0,1,1
07416643,12,7,5,0,1,1,0,0,0
07416869,6,3,3,0,5,3,2,0,0
07417138,2,2,0,0,2,2,0,0,1
07417300,9,0,9,0,0,0,0,0,1
07418449,3,0,3,0,0,0,0,0,0
07418585,14,0,14,0,1,1,0,0,0
07418645,2,2,0,0,1,1,0,0,1
07419788,15,8,7,0,1,1,0,0,1
07420265,1,1,0,0,1,1,0,0,0
07420347,2,2,0,0,2,2,0,0,0
07420638,3,2,1,0,2,2,0,1,0
07420983,3,2,1,0,2,2,0,0,0
07422567,2,1,1,0,1,1,0,0,0
07422588,9,3,6,0,1,1,0,1,1
07422922,1,0,1,0,0,0,0,0,1
07424174,9,4,5,0,0,0,0,0,0
07425445,5,5,0,0,0,0,0,0,0
07425891,20,11,9,0,0,0,0,0,0
07427941,2,2,0,0,2,2,0,0,0
07429586,3,2,1,0,1,1,0,0,1
07430535,4,2,2,0,1,1,0,0,0
07431392,2,2,0,0,1,1,0,0,0
07433244,7,1,6,0,2,2,0,1,0
07434476,2,2,0,0,2,2,0,0,1
07434518,5,4,1,0,0,0,0,0,0
07434617,1,1,0,0,1,1,0,0,0
07435459,2,2,0,0,1,1,0,0,0
07435646,5,4,1,0,1,1,0,0,0
07436054,1,0,1,0,0,0,0,0,0
07438619,2,0,2,0,0,0,0,0,1
07442751,1,1,0,0,1,1,0,0,0
07443251,3,3,0,0,2,2,0,0,1
07443536,2,2,0,0,1,1,0,1,0
07444180,6,0,6,0,1,1,0,1,1
07445493,39,15,24,0,3,0,3,0,0
07447290,4,2,2,0,2,2,0,0,0
07448468,4,0,4,0,1,1,0,0,0
07449136,33,13,20,0,0,0,0,0,1
07452726,1,1,0,0,2,1,1,0,0
07452872,6,2,4,0,1,1,0,1,1
07455452,35,13,22,0,0,0,0,0,0
07456185,14,5,9,0,0,0,0,0,0
07457183,1,0,1,0,0,0,0,0,0
07457867,26,11,15,0,0,0,0,0,0
07458285,5,1,4,0,1,1,0,1,1
07459742,28,10,18,0,4,3,1,0,0
07459811,2,0,2,0,0,0,0,0,0
07460395,1,0,1,0,1,1,0,0,0
07461147,61,52,9,0,2,2,0,1,0
07461969,1,1,0,0,1,1,0,0,0
07462747,10,3,7,0,1,1,0,1,0
07463779,8,5,3,0,4,4,0,0,1
07465435,12,4,8,0,2,2,0,2,1
07468546,11,6,5,0,2,2,0,0,1
07468558,10,0,10,0,2,2,0,0,1
07468571,9,4,5,0,2,2,0,0,1
07468582,11,5,6,0,1,1,0,0,1
07468597,9,4,5,0,2,2,0,0,1
07469437,7,3,4,0,2,2,0,1,0
07469616,3,0,3,0,1,1,0,0,0
07470610,2,1,1,0,1,1,0,0,0
07473177,11,0,11,0,1,1,0,1,1
07474406,10,2,8,0,3,1,2,3,0
07475104,10,7,3,2,3,1,2,1,0
07476339,2,1,1,0,4,3,1,0,0
07476998,2,1,1,0,2,1,1,0,0
07477111,3,3,0,0,2,2,0,0,0
07477770,17,4,13,0,2,2,0,2,1
07477778,8,0,8,0,0,0,0,0,0
07478372,1,1,0,0,1,1,0,0,0
07479835,3,2,1,0,1,1,0,0,0
07480622,2,2,0,0,1,1,0,0,0
07481069,12,2,10,0,0,0,0,0,0
07482186,1,1,0,0,1,1,0,0,0
07483287,4,0,4,0,1,1,0,1,0
07485242,8,4,4,0,0,0,0,0,1
07485257,2,2,0,0,1,1,0,0,0
07488061,6,5,1,0,1,1,0,0,0
07489217,4,0,4,0,0,0,0,0,0
07489336,2,0,2,0,0,0,0,0,1
05970100,8,3,5,0,1,1,0,1,1
05970602,2,2,0,0,2,2,0,0,0
05970667,11,0,11,0,0,0,0,0,1
05972612,5,0,5,0,2,2,0,0,0
05973116,4,2,2,0,0,0,0,0,1
05974173,2,0,2,0,0,0,0,0,1
05974354,3,3,0,0,2,2,0,0,0
05975864,5,0,5,0,0,0,0,0,1
05976507,20,4,16,0,2,2,0,2,1
05977271,4,0,4,0,2,2,0,0,1
05977603,42,10,32,0,1,0,1,0,0
05977625,3,2,1,0,2,2,0,0,0
05977968,21,5,16,0,2,2,0,2,1
05978292,2,1,1,0,1,1,0,0,1
05978596,4,3,1,0,1,1,0,0,0
05980315,8,5,3,0,1,1,0,0,0
05980797,3,0,3,1,0,0,0,0,0
05981009,12,3,9,0,2,2,0,0,0
05981825,14,0,14,0,1,1,0,1,1
05982592,4,2,2,0,2,2,0,0,0
05982966,21,2,19,0,1,1,0,1,1
05983198,16,4,12,0,0,0,0,0,0
05983946,11,3,8,0,2,2,0,0,0
05984658,8,0,8,0,0,0,0,0,1
05985626,20,6,14,0,0,0,0,0,0
05986575,4,2,2,0,2,1,1,1,0
05986711,16,4,12,0,2,2,0,2,1
05988389,20,3,17,0,1,1,0,1,0
05991408,6,2,4,0,2,2,0,0,0
05992073,18,10,8,0,0,0,0,0,1
05992353,7,2,5,0,2,2,0,0,0
05992642,70,14,56,0,0,0,0,0,1
05994760,7,1,6,0,2,2,0,0,0
05995084,5,5,0,0,2,2,0,0,0
05995943,13,4,9,0,2,2,0,2,1
05998477,4,2,2,0,1,1,0,0,1
05998995,9,3,6,0,0,0,0,0,0
05999216,6,0,6,0,0,0,0,0,1
05999302,4,2,2,0,2,2,0,0,1
06000071,3,2,1,0,2,2,0,0,0
06000941,20,3,17,0,2,1,1,2,1
06001442,29,9,20,0,1,1,0,1,1
06002695,4,2,2,0,1,1,0,0,0
06003254,8,3,5,0,1,1,0,0,0
06003756,10,3,7,0,1,1,0,1,1
06004338,3,3,0,0,1,1,0,0,0
06004512,9,6,3,0,2,2,0,0,1
06007230,5,3,2,0,2,2,0,0,0
06010708,16,2,14,0,0,0,0,0,1
06010834,10,5,5,0,0,0,0,0,1
06011894,8,3,5,0,1,1,0,1,1
06013143,15,3,12,0,1,1,0,1,0
06013161,18,0,18,0,0,0,0,0,1
06014593,10,2,8,0,0,0,0,0,1
06015141,11,2,9,0,1,1,0,1,1
06015316,4,2,2,0,2,2,0,0,0
06015824,7,0,7,0,0,0,0,0,1
06016149,12,2,10,0,1,1,0,1,1
06017793,5,3,2,0,3,3,0,1,1
06018005,20,5,15,0,2,2,0,2,1
06018008,20,5,15,0,2,2,0,2,1
06018232,6,4,2,0,1,1,0,0,1
06018748,15,2,13,0,1,1,0,1,1
06019063,7,5,2,0,0,0,0,0,1
06019492,9,3,6,0,2,2,0,0,1
06019976,6,3,3,0,1,1,0,0,1
06020342,3,2,1,0,1,1,0,0,1
06020564,4,0,4,0,1,1,0,0,1
06021105,12,2,10,0,0,0,0,0,0
06021385,19,5,14,0,2,2,0,2,1
06021388,19,5,14,0,2,2,0,2,1
06021395,20,5,15,0,2,2,0,2,1
06021396,19,5,14,0,2,2,0,2,1
06021397,19,5,14,0,2,2,0,2,1
06021492,8,0,8,0,0,0,0,0,1
06022152,5,3,2,0,2,2,0,0,1
06022348,12,10,2,0,1,1,0,0,1
06022784,4,2,2,0,1,1,0,1,1
06023058,3,2,1,0,1,1,0,0,0
06023458,5,0,5,0,0,0,0,0,1
06023494,16,5,11,0,1,1,0,1,1
06023552,16,7,9,0,2,2,0,2,1
06023774,5,0,5,0,3,3,0,0,1
06024038,5,3,2,0,2,2,0,0,0
06024250,6,2,4,0,1,1,0,0,1
06024819,4,2,2,0,2,2,0,0,1
06025156,27,8,19,0,1,1,0,0,0
06025252,12,2,10,0,1,1,0,1,1
06025495,5,3,2,0,2,2,0,0,0
06025681,4,0,4,0,0,0,0,0,1
06025801,4,2,2,0,2,2,0,0,1
06025838,6,2,4,0,0,0,0,0,1
06025889,6,0,6,0,0,0,0,0,0
06027093,7,5,2,0,2,2,0,0,1
06027434,3,3,0,0,2,2,0,0,0
06027484,2,2,0,0,1,1,0,1,0
06028016,5,2,3,0,1,1,0,0,0
06028127,5,3,2,0,1,1,0,0,1
06028128,9,4,5,0,1,1,0,1,1
06028364,14,3,11,0,1,1,0,1,1
06028633,10,0,10,0,0,0,0,0,1
06029296,2,2,0,0,1,1,0,0,0
06029445,6,2,4,0,1,1,0,0,1
06029889,4,2,2,0,1,1,0,0,1
06029939,8,3,5,0,0,0,0,0,0
06029962,5,1,4,0,1,1,0,0,1
06030312,6,0,6,0,1,1,0,0,1
06030326,6,3,3,0,1,1,0,1,1
06030501,10,3,7,0,1,1,0,1,1
06030553,7,2,5,0,1,1,0,1,1
06030659,6,3,3,0,0,0,0,0,0
06030803,8,3,5,0,1,1,0,0,1
06031220,5,3,2,0,2,2,0,0,1
06031241,6,4,2,0,1,1,0,0,1
06031246,8,0,8,0,0,0,0,0,1
06032131,24,3,21,0,1,1,0,1,1
06032145,4,2,2,0,1,1,0,0,1
06032719,5,0,5,0,0,0,0,0,1
06032755,11,3,8,0,0,0,0,0,1
06033097,7,3,4,0,2,2,0,1,1
06033814,5,2,3,0,1,1,0,0,0
06033841,4,0,4,0,0,0,0,0,1
06033864,4,0,4,0,0,0,0,0,1
06033909,8,6,2,0,0,0,0,0,0
06034019,5,3,2,0,1,1,0,1,1
06034081,6,2,4,0,1,1,0,0,0
06034211,9,0,9,0,0,0,0,0,1
06034226,19,4,15,0,0,0,0,0,1
06034396,20,6,14,0,1,1,0,1,1
06035134,6,4,2,0,3,3,0,0,1
06035252,7,3,4,0,3,3,0,0,1
06035375,3,0,3,0,0,0,0,0,1
06035503,3,0,3,0,0,0,0,0,1
06035564,4,0,4,0,0,0,0,0,1
06035588,4,3,1,0,2,2,0,0,1
06035967,8,3,5,0,0,0,0,0,1
06035972,7,2,5,0,2,1,1,0,1
06036097,10,0,10,0,0,0,0,0,1
06036339,5,3,2,0,2,2,0,0,1
06036724,6,4,2,0,1,1,0,0,1
06037086,5,3,2,0,2,2,0,0,1
06037448,8,2,6,0,1,1,0,1,1
06037609,5,3,2,0,1,1,0,0,1
06037612,4,2,2,0,2,2,0,0,1
06037745,10,1,9,0,4,2,2,1,1
06038066,15,0,15,0,0,0,0,0,1
06038135,6,3,3,0,2,2,0,0,1
06038746,5,3,2,0,1,1,0,0,1
06039536,6,2,4,0,1,1,0,0,1
06040296,8,4,4,0,1,1,0,0,1
06040341,8,5,3,0,3,3,0,0,1
06041033,19,3,16,0,1,1,0,1,0
06041418,7,3,4,0,2,2,0,0,1
06041711,5,0,5,0,0,0,0,0,1
06042073,5,3,2,0,1,1,0,0,0
06042454,4,1,3,0,1,1,0,0,1
06042482,4,2,2,0,1,1,0,0,1
06043080,6,0,6,0,2,2,0,0,1
06043249,11,4,7,0,0,0,0,0,1
06043262,7,3,4,0,2,2,0,0,0
06043366,5,1,4,0,2,1,1,0,1
06043492,7,0,7,0,0,0,0,0,1
06043508,17,4,13,0,1,1,0,1,1
06043840,10,2,8,1,2,1,1,1,1
06043968,2,2,0,0,1,1,0,0,0
06044437,5,3,2,0,1,1,0,0,1
06044483,4,1,3,0,1,1,0,0,1
06044575,6,3,3,0,1,1,0,1,1
06044978,15,4,11,0,2,2,0,2,1
06045039,5,3,2,0,2,2,0,0,1
06045044,5,2,3,0,2,2,0,0,1
06045092,6,3,3,0,1,1,0,0,1
06045490,14,2,12,0,2,2,0,0,1
06045717,4,0,4,0,0,0,0,0,1
06045776,6,1,5,0,1,1,0,0,1
06045886,5,3,2,0,2,2,0,0,1
06045964,6,2,4,0,2,2,0,0,1
06046081,6,0,6,0,0,0,0,0,0
06046341,4,0,4,0,1,1,0,0,1
06046519,5,3,2,0,2,2,0,0,1
06046630,6,2,4,0,1,1,0,0,1
06046754,6,5,1,0,1,1,0,0,1
06046949,5,2,3,0,1,1,0,0,1
06047122,12,3,9,0,1,1,0,1,1
06047312,24,6,18,0,2,2,0,2,1
06047526,4,2,2,0,1,1,0,0,1
06047748,4,1,3,0,1,1,0,0,1
06047763,9,1,8,0,1,1,0,1,1
06047786,5,3,2,0,1,1,0,0,1
06047813,6,2,4,0,1,1,0,1,1
06047829,5,2,3,0,1,1,0,0,1
06047833,6,0,6,0,0,0,0,0,1
06047840,8,4,4,0,0,0,0,0,1
06047841,5,3,2,0,1,1,0,0,1
06047906,7,3,4,0,2,2,0,0,1
06047926,4,2,2,0,1,1,0,0,1
06048018,5,0,5,0,0,0,0,0,1
06048319,5,3,2,0,1,1,0,0,1
06048403,5,3,2,0,1,1,0,0,1
06048596,26,0,26,0,0,0,0,0,1
06048607,3,3,0,0,2,2,0,0,0
06048739,9,4,5,0,1,1,0,0,1
06048751,5,3,2,0,2,2,0,0,1
06048760,5,3,2,0,1,1,0,0,1
06048769,5,0,5,0,0,0,0,0,1
06048814,4,1,3,0,1,1,0,0,1
06048853,13,3,10,0,2,2,0,2,1
06049099,6,1,5,0,0,0,0,0,1
06049216,27,10,17,0,0,0,0,0,1
06049492,7,0,7,0,0,0,0,0,1
06049504,4,2,2,0,0,0,0,0,1
06050671,4,1,3,0,0,0,0,0,1
06050933,5,0,5,0,0,0,0,0,1
06050970,6,3,3,0,2,2,0,0,1
06051119,4,2,2,0,2,2,0,0,1
06051253,12,2,10,0,0,0,0,0,1
06051356,6,2,4,0,2,1,1,0,1
06051415,7,5,2,0,2,2,0,0,1
06051736,6,3,3,0,2,2,0,1,1
06051768,5,0,5,0,0,0,0,0,1
06051894,4,2,2,0,1,1,0,0,1
06052252,4,2,2,0,1,1,0,0,1
06052267,5,3,2,0,1,1,0,0,1
06052346,17,7,10,0,0,0,0,0,0
06052401,5,0,5,0,0,0,0,0,1
06052402,5,0,5,0,0,0,0,0,1
06052741,10,0,10,0,2,2,0,1,1
06052827,5,0,5,0,0,0,0,0,1
06052887,6,0,6,0,0,0,0,0,1
06052905,8,0,8,0,0,0,0,0,1
06052914,5,3,2,0,2,2,0,0,1
06053066,4,0,4,0,0,0,0,0,1
06053078,6,2,4,0,2,2,0,0,1
06053385,6,4,2,0,2,2,0,0,1
06053457,4,2,2,0,1,1,0,0,1
06053504,7,0,7,0,0,0,0,0,1
06053858,9,4,5,0,1,1,0,1,1
06053979,12,4,8,0,5,3,2,0,1
06053987,5,3,2,0,2,2,0,0,1
06053995,18,3,15,0,1,1,0,1,1
06054071,6,3,3,0,2,1,1,0,1
06054191,4,2,2,0,1,1,0,0,1
06054194,3,1,2,0,2,1,1,0,1
06054300,5,0,5,0,0,0,0,0,1
06054904,6,3,3,0,0,0,0,0,1
06055015,6,3,3,0,1,1,0,0,1
06055169,4,3,1,0,1,1,0,0,1
06055468,6,0,6,0,2,2,0,0,1
06055540,20,1,19,0,1,1,0,1,1
06055550,4,1,3,0,0,0,0,0,1
06055621,4,0,4,0,0,0,0,0,1
06055750,3,0,3,0,1,1,0,0,1
06055759,5,1,4,0,1,1,0,0,1
06055779,11,5,6,0,1,1,0,0,1
06055967,5,0,5,0,0,0,0,0,1
06056448,21,8,13,0,1,1,0,1,1
06056706,5,3,2,0,2,2,0,0,1
06056712,6,3,3,0,2,2,0,0,1
06056847,5,0,5,0,0,0,0,0,1
06056889,12,4,8,0,0,0,0,0,1
06056974,7,3,4,0,1,0,1,1,1
06057018,4,2,2,0,1,1,0,0,1
06057067,19,3,16,0,1,1,0,0,1
06057109,9,3,6,0,0,0,0,0,1
06057115,4,2,2,0,1,1,0,0,1
06057294,5,1,4,0,1,1,0,0,0
06057667,16,5,11,0,1,1,0,1,1
01130269,122,9,113,0,0,0,0,0,1
01130968,55,18,37,0,0,0,0,0,0
01132888,21,3,18,0,1,1,0,1,0
01133617,30,0,30,0,0,0,0,0,1
01133952,20,3,17,0,1,1,0,0,0
01135284,35,7,28,0,1,1,0,1,1
01135517,22,3,19,0,1,1,0,1,1
01136601,23,4,19,0,0,0,0,0,1
01136899,8,5,3,0,1,1,0,0,1
01137780,78,22,56,0,0,0,0,0,0
01138995,63,14,49,0,0,0,0,0,1
01139640,33,0,33,0,1,1,0,1,1
01140208,26,5,21,0,1,1,0,1,1
01141530,20,3,17,0,1,1,0,1,1
01143302,0,0,0,0,0,0,0,0,0
01145231,32,0,32,0,0,0,0,0,1
01145510,18,4,14,0,0,0,0,0,1
01146094,15,4,11,0,1,1,0,0,0
01146172,4,3,1,0,1,1,0,0,0
01146236,36,2,34,0,1,1,0,1,1
01148992,31,3,28,0,1,1,0,1,1
01150046,34,0,34,0,0,0,0,0,1
01152018,21,0,21,0,0,0,0,0,1
01154197,17,6,11,0,1,1,0,1,1
01156197,6,3,3,0,1,1,0,0,0
01156605,55,13,42,0,1,1,0,0,0
01156743,5,3,2,0,1,1,0,1,0
01157669,25,2,23,0,1,1,0,1,0
01158456,16,0,16,0,1,1,0,1,1
01158678,34,2,32,0,1,1,0,1,1
01158750,10,3,7,0,3,1,2,1,0
01159548,4,3,1,0,1,1,0,0,0
01160119,47,4,43,0,1,1,0,1,1
01160460,38,5,33,0,1,1,0,1,0
01161281,8,0,8,0,1,1,0,1,1
01166348,5,3,2,0,2,2,0,0,0
01166416,3,3,0,0,1,1,0,0,0
01168440,54,16,38,0,0,0,0,0,1
01168450,27,0,27,0,0,0,0,0,1
01170885,0,0,0,0,0,0,0,0,1
01171833,22,3,19,0,1,1,0,1,1
01172263,44,9,35,0,0,0,0,0,1
01172617,8,3,5,0,0,0,0,0,1
01172694,38,10,28,0,0,0,0,0,0
01173516,0,0,0,0,0,0,0,0,0
01173859,92,15,77,0,0,0,0,0,1
01175867,14,1,13,0,1,1,0,1,0
01176427,6,2,4,0,2,2,0,0,0
01181769,24,4,20,0,0,0,0,0,0
01182437,142,26,116,0,0,0,0,0,1
01182469,41,5,36,0,1,1,0,1,1
01182734,268,8,260,0,0,0,0,0,1
01184724,5,4,1,0,1,1,0,0,0
01186095,10,2,8,0,1,1,0,0,1
01186681,41,5,36,0,1,1,0,1,1
01188119,16,3,13,0,0,0,0,0,0
01188209,70,15,55,0,0,0,0,0,1
01189187,9,0,9,0,0,0,0,0,1
01191882,25,3,22,0,1,1,0,1,1
01195498,93,7,86,0,0,0,0,0,0
01196676,23,3,20,0,2,2,0,2,1
01197546,22,3,19,0,1,1,0,1,1
01199364,11,3,8,0,2,2,0,2,1
01199576,8,1,7,0,1,1,0,0,0
01200318,239,33,206,0,0,0,0,0,1
01201092,20,3,17,0,1,1,0,1,1
01202632,26,0,26,0,1,1,0,1,1
01203357,12,3,9,0,1,1,0,1,0
01203607,4,1,3,0,1,1,0,0,0
01204831,20,5,15,0,1,1,0,1,1
01205530,15,3,12,0,1,1,0,1,1
01205542,21,5,16,0,1,1,0,1,1
01206191,20,5,15,0,1,1,0,1,1
01207001,12,3,9,0,1,1,0,0,0
01208081,9,2,7,0,2,2,0,0,1
01208973,13,4,9,0,1,1,0,1,0
01209831,80,15,65,0,0,0,0,0,1
01214640,30,4,26,0,3,1,2,3,1
01214674,29,7,22,0,1,1,0,1,1
01215502,5,2,3,0,1,1,0,0,0
01215906,54,0,54,0,0,0,0,0,1
01216701,117,14,103,0,0,0,0,0,0
01217230,9,5,4,0,1,1,0,1,0
01218639,70,10,60,0,0,0,0,0,0
01219145,21,10,11,0,0,0,0,0,0
01219330,137,46,91,0,0,0,0,0,0
01220262,3,2,1,0,1,1,0,0,0
01220282,10,2,8,0,0,0,0,0,0
01220754,36,0,36,0,0,0,0,0,1
01221601,4,3,1,0,1,1,0,0,0
01222723,3,1,2,0,1,1,0,0,0
01223374,30,3,27,0,1,1,0,1,1
01223702,21,0,21,0,1,1,0,1,1
01223977,34,1,33,0,2,2,0,1,1
01226220,6,5,1,0,1,1,0,1,1
01230808,14,0,14,0,1,1,0,1,1
01235774,2,2,0,0,1,1,0,0,0
01237555,25,3,22,0,1,1,0,1,1
01238636,12,6,6,0,3,1,2,3,1
01240273,7,5,2,0,2,1,1,0,0
01241117,22,0,22,0,0,0,0,0,1
01244084,26,4,22,0,1,1,0,1,1
01244831,35,2,33,0,1,1,0,1,1
01245304,50,7,43,0,1,1,0,1,1
01246047,3,3,0,0,1,1,0,0,0
01246789,14,3,11,0,0,0,0,0,0
01247541,89,14,75,0,1,1,0,1,1
01248144,23,0,23,0,0,0,0,0,1
01250558,23,5,18,0,1,1,0,1,1
01251156,9,3,6,0,1,0,1,0,0
01251949,27,3,24,0,1,1,0,1,1
01252595,78,18,60,0,1,1,0,0,1
01254818,2,2,0,0,2,2,0,0,0
01256316,34,3,31,0,0,0,0,0,0
01256779,30,9,21,0,0,0,0,0,0
01259720,11,3,8,0,2,2,0,2,1
01261826,5,1,4,0,2,1,1,0,0
01263157,5,3,2,0,1,1,0,0,0
01266292,15,4,11,0,1,1,0,1,1
01267231,59,2,57,0,1,1,0,1,1
01269004,37,7,30,0,0,0,0,0,0
01269937,116,10,106,0,0,0,0,0,1
01271920,17,3,14,0,1,1,0,1,1
01272079,5,5,0,0,1,1,0,1,0
01272556,20,0,20,0,0,0,0,0,1
01272557,21,0,21,0,0,0,0,0,1
01273543,3,3,0,0,2,2,0,0,0
01273880,19,4,15,0,0,0,0,0,0
01274384,5,1,4,0,1,1,0,0,0
01276102,5,4,1,0,1,1,0,0,0
01280214,4,2,2,0,1,1,0,0,0
01280586,5,2,3,0,2,2,0,1,0
01280778,29,5,24,0,1,1,0,1,1
01281232,44,2,42,0,1,1,0,1,1
01282453,26,0,26,0,1,1,0,1,1
01284754,71,7,64,0,1,1,0,1,1
01285030,12,3,9,0,1,1,0,1,1
01286190,15,1,14,0,1,1,0,0,1
01288177,33,9,24,0,0,0,0,0,0
01289147,32,4,28,0,2,2,0,2,1
01289445,38,0,38,0,0,0,0,0,1
01290424,113,8,105,0,0,0,0,0,0
01292692,21,8,13,0,1,1,0,0,0
01295138,6,2,4,0,1,1,0,1,0
01296829,37,7,30,0,0,0,0,0,0
01297313,26,0,26,0,1,1,0,1,1
01297780,24,5,19,0,1,1,0,1,1
01297941,24,7,17,0,1,1,0,1,1
01299631,19,3,16,0,0,0,0,0,0
01299733,45,3,42,0,2,2,0,2,1
01299823,32,4,28,0,6,1,5,2,1
01299996,38,4,34,0,1,0,1,0,0
01302416,11,3,8,0,1,1,0,1,1
01303475,18,3,15,0,3,3,0,0,0
01304888,5,2,3,0,1,1,0,0,0
01305599,0,0,0,0,0,0,0,0,0
01305876,24,4,20,0,1,1,0,1,1
01310070,58,10,48,0,0,0,0,0,0
01311055,16,4,12,0,1,1,0,1,1
01312313,10,5,5,0,1,1,0,1,0
01313045,14,8,6,0,3,3,0,0,1
01313542,19,4,15,0,0,0,0,0,1
01314879,85,10,75,0,0,0,0,0,1
01315795,26,3,23,0,0,0,0,0,1
01317074,20,3,17,0,1,1,0,1,1
01317369,59,8,51,0,2,1,1,0,0
01317772,47,0,47,0,1,1,0,1,1
01318708,41,5,36,0,2,2,0,2,1
01319421,18,2,16,0,1,1,0,1,1
01323394,13,3,10,0,1,1,0,1,1
01325827,26,3,23,0,0,0,0,0,0
01327534,24,0,24,0,0,0,0,0,1
01328075,4,2,2,0,1,1,0,0,0
01330505,26,0,26,0,1,1,0,1,1
01332117,9,6,3,0,1,1,0,1,0
01333209,26,2,24,0,1,1,0,1,1
01334873,3,3,0,0,0,0,0,0,0
01336436,5,3,2,0,3,3,0,0,0
01338135,26,10,16,0,1,1,0,0,1
01338296,5,4,1,0,1,1,0,1,1
01338928,92,6,86,0,0,0,0,0,1
01339208,5,3,2,0,2,2,0,0,0
01340233,45,10,35,0,1,0,1,0,0
01341060,33,4,29,0,1,1,0,1,1
01342183,29,6,23,0,1,1,0,1,1
01342232,4,3,1,0,2,2,0,0,1
01344528,38,8,30,0,2,2,0,2,1
01352158,35,5,30,0,1,1,0,1,1
01352496,27,3,24,0,0,0,0,0,0
01353896,24,0,24,0,1,1,0,1,1
01354372,8,4,4,0,0,0,0,0,0
01355696,21,5,16,0,0,0,0,0,0
01356207,4,3,1,0,1,1,0,0,0
01356861,23,4,19,0,1,1,0,1,1
01357794,23,4,19,0,0,0,0,0,1
01358811,36,5,31,0,1,1,0,1,1
01360234,6,3,3,0,2,2,0,0,0
01362109,9,2,7,0,1,1,0,1,0
01363139,7,5,2,0,2,2,0,0,0
01363496,19,0,19,0,1,1,0,1,1
01363543,4,0,4,0,1,1,0,0,0
01365107,18,3,15,0,0,0,0,0,1
01365343,76,15,61,0,1,1,0,0,1
01365976,25,0,25,0,0,0,0,0,1
01366300,81,10,71,0,10,0,10,0,0
01369401,111,8,103,0,0,0,0,0,1
01369845,14,6,8,0,1,1,0,1,1
01371282,17,1,16,0,1,1,0,1,1
01371973,113,8,105,0,1,1,0,1,1
01372410,31,13,18,0,0,0,0,0,1
01373545,75,7,68,0,1,1,0,0,1
01377030,20,6,14,0,6,4,2,0,0
01377398,27,3,24,0,0,0,0,0,1
01377658,40,10,30,0,0,0,0,0,1
01378379,37,0,37,0,1,1,0,1,1
01383989,23,0,23,0,0,0,0,0,1
01384241,15,5,10,0,1,1,0,1,0
01384286,5,2,3,0,2,2,0,0,0
01388951,16,4,12,0,1,1,0,1,1
01389339,0,0,0,0,0,0,0,0,1
01393436,45,9,36,0,0,0,0,0,0
01393682,6,0,6,0,1,1,0,0,1
01396429,69,10,59,0,0,0,0,0,1
01400520,12,3,9,0,1,1,0,1,0
01402218,10,3,7,0,1,1,0,1,1
01403757,3,3,0,0,2,2,0,0,0
01405493,9,0,9,0,0,0,0,0,1
01407540,24,0,24,0,1,1,0,1,1
01407770,33,4,29,0,1,1,0,1,1
01407996,18,7,11,0,1,1,0,1,1
01415654,52,16,36,0,0,0,0,0,1
01417213,29,0,29,0,1,1,0,1,1
01420136,40,2,38,0,1,1,0,1,1
01425685,5,2,3,0,0,0,0,0,0
01425972,12,5,7,0,2,2,0,0,0
01426337,11,6,5,0,1,1,0,1,0
01426546,46,4,42,0,1,1,0,1,1
01430918,27,10,17,0,0,0,0,0,1
01434539,34,0,34,0,1,1,0,1,1
01438169,41,4,37,0,0,0,0,0,1
01438358,0,0,0,0,0,0,0,0,0
01439945,4,3,1,0,0,0,0,0,0
01441517,33,12,21,0,0,0,0,0,0
01442978,23,3,20,0,2,1,1,2,1
01446230,31,0,31,0,1,1,0,1,1
01446739,15,4,11,0,2,2,0,2,1
01447100,0,0,0,0,0,0,0,0,0
01447391,33,0,33,0,1,1,0,1,1
01448008,5,1,4,0,1,1,0,1,1
01449443,22,0,22,0,0,0,0,0,1
01449636,17,1,16,0,1,1,0,0,0
01450199,25,0,25,0,0,0,0,0,1
01451007,33,4,29,0,1,1,0,1,1
01454107,0,0,0,0,0,0,0,0,0
01454959,19,0,19,0,1,1,0,1,1
01455051,16,4,12,0,1,1,0,1,1
01455601,14,4,10,0,1,1,0,1,1
01455931,10,1,9,0,1,1,0,1,0
01457480,15,4,11,0,1,1,0,1,1
01459436,3,3,0,0,2,2,0,0,1
01466019,22,4,18,0,0,0,0,0,0
01466217,44,2,42,0,1,1,0,1,1
01466710,6,4,2,0,0,0,0,0,0
01466890,4,2,2,0,2,2,0,0,0
01466898,37,8,29,0,1,1,0,1,1
01468134,23,3,20,0,1,1,0,1,1
01468528,24,4,20,0,1,1,0,1,1
01468817,98,10,88,0,0,0,0,0,1
01472949,37,8,29,0,1,1,0,0,1
01473316,23,0,23,0,1,1,0,1,1
01480047,32,2,30,0,1,1,0,1,1
01480350,31,3,28,0,1,1,0,0,1
01481831,14,12,2,0,1,1,0,0,0
01483021,38,6,32,0,1,1,0,1,1
01484598,24,2,22,0,1,1,0,1,1
01486048,5,3,2,0,2,2,0,0,0
01488969,35,3,32,0,1,1,0,1,1
01489884,8,4,4,0,2,1,1,1,0
01490769,3,3,0,0,1,1,0,0,0
01491788,28,4,24,0,1,1,0,1,1
01494840,19,0,19,0,0,0,0,0,1
01499119,16,0,16,0,0,0,0,0,1
01499927,62,6,56,0,0,0,0,0,0
01501563,9,6,3,0,1,1,0,1,1
01506034,55,2,53,0,1,1,0,1,1
01507397,51,5,46,0,1,1,0,1,1
01509262,4,2,2,0,2,2,0,0,0
01509313,52,12,40,0,2,1,1,0,1
01509344,29,3,26,0,1,1,0,1,1
01509608,10,2,8,0,1,1,0,0,1
01510438,9,5,4,0,1,1,0,1,0
01511411,20,4,16,0,0,0,0,0,1
01512032,6,1,5,0,1,1,0,0,1
01512980,41,5,36,0,1,1,0,1,1
01513975,21,0,21,0,1,1,0,1,1
01515003,46,12,34,0,0,0,0,0,0
01517230,31,11,20,0,0,0,0,0,0
01518014,24,4,20,0,4,3,1,4,1
01518396,28,6,22,0,0,0,0,0,0
01519364,32,4,28,0,0,0,0,0,1
01519769,4,2,2,0,1,1,0,0,0
01520131,55,2,53,0,1,1,0,1,1
01520225,34,11,23,0,0,0,0,0,0
01520658,38,11,27,0,1,1,0,0,0
01520770,13,6,7,0,0,0,0,0,0
01521769,23,0,23,0,1,1,0,1,1
01522532,45,6,39,0,2,2,0,2,1
01522818,26,3,23,0,1,1,0,1,1
01525687,29,5,24,0,3,1,2,1,1
01529735,8,3,5,0,3,2,1,0,1
01530527,33,2,31,0,1,1,0,1,1
01532023,27,0,27,0,0,0,0,0,1
01534234,6,3,3,0,1,1,0,0,0
01534255,26,5,21,0,0,0,0,0,1
01535472,25,4,21,0,0,0,0,0,1
01538685,12,2,10,0,1,1,0,0,0
01539204,3,3,0,0,3,3,0,1,0
01539241,31,6,25,0,1,1,0,1,1
01539858,0,0,0,0,0,0,0,0,0
01540180,38,2,36,0,1,1,0,1,1
01540271,25,3,22,0,1,1,0,1,1
01543554,40,3,37,0,1,1,0,1,1
01544009,19,0,19,0,1,1,0,1,1
01550741,58,15,43,0,0,0,0,0,1
01552580,41,5,36,0,1,1,0,1,1
01552987,20,6,14,0,1,1,0,1,0
01553290,20,10,10,0,1,1,0,0,0
01556305,57,6,51,0,1,1,0,1,1
01556325,19,3,16,0,1,1,0,1,1
01557088,30,3,27,0,1,1,0,1,1
01557430,10,2,8,0,2,2,0,0,0
01557613,26,5,21,0,1,1,0,1,1
01558786,16,0,16,0,1,1,0,1,1
01559267,29,8,21,0,5,2,3,2,0
01561532,23,6,17,0,1,1,0,0,1
01566734,6,2,4,0,2,2,0,1,0
01570100,4,2,2,0,1,1,0,0,0
01570349,27,8,19,0,0,0,0,0,0
01571323,7,2,5,0,1,1,0,1,0
01571721,6,3,3,0,1,1,0,0,1
01572075,12,3,9,0,1,1,0,1,1
01574487,6,3,3,0,1,1,0,0,0
01576033,32,8,24,0,0,0,0,0,0
01578531,14,2,12,0,1,1,0,1,0
01578784,21,3,18,0,1,1,0,1,1
01578801,9,3,6,0,1,1,0,1,1
01578968,24,2,22,0,1,1,0,1,1
01579933,10,3,7,0,1,1,0,0,0
11701263,1,1,0,0,1,1,0,0,0
11703274,7,7,0,0,0,0,0,0,0
11704966,8,6,2,0,1,1,0,1,1
11705881,2,2,0,0,1,1,0,0,0
11706497,1,1,0,0,1,1,0,0,0
11706535,8,7,1,0,0,0,0,0,0
11706577,2,2,0,0,2,2,0,0,0
11706921,3,1,2,0,3,1,2,0,0
11709377,8,8,0,0,0,0,0,0,0
11710287,1,1,0,0,1,1,0,0,0
11710577,1,1,0,0,1,1,0,0,0
11710578,1,1,0,0,2,2,0,0,0
11710742,2,2,0,0,2,2,0,0,0
11713060,2,2,0,0,2,2,0,0,0
11713268,2,2,0,0,1,1,0,1,1
11713550,2,2,0,0,1,1,0,1,1
11715166,1,1,0,0,1,1,0,0,0
11715675,2,2,0,0,1,1,0,0,0
11717310,2,2,0,0,0,0,0,0,0
11717394,3,3,0,0,2,2,0,0,0
11717986,1,1,0,0,1,1,0,0,0
11718108,2,2,0,0,2,1,1,0,0
11718261,1,1,0,0,1,1,0,0,0
11718506,2,1,1,0,3,2,1,1,0
11720494,4,4,0,0,1,1,0,0,0
11721213,3,3,0,0,3,3,0,0,0
11723770,1,1,0,0,1,1,0,0,0
11725802,4,4,0,0,0,0,0,0,0
11726415,2,2,0,0,2,2,0,0,0
11726452,1,1,0,0,1,1,0,0,0
11726941,2,2,0,0,0,0,0,0,0
11727920,2,2,0,0,2,2,0,0,0
11728523,2,2,0,0,2,2,0,0,0
11728639,2,2,0,0,1,1,0,0,1
11729351,1,1,0,0,1,1,0,0,0
11729666,2,1,1,0,2,1,1,0,0
11729674,2,2,0,0,2,2,0,0,0
11729852,1,1,0,0,1,1,0,0,0
11731152,3,3,0,0,3,3,0,0,0
11731262,1,1,0,0,1,1,0,0,0
11732974,1,1,0,0,1,1,0,0,0
11734589,1,1,0,0,1,1,0,0,0
11735113,4,4,0,0,1,1,0,1,1
11737719,1,1,0,0,1,1,0,0,0
11737737,1,1,0,0,2,2,0,0,0
11737868,1,1,0,0,0,0,0,0,0
11738032,2,2,0,0,1,1,0,0,0
11738907,5,5,0,0,0,0,0,0,0
11740119,1,1,0,0,1,1,0,0,0
11741249,4,4,0,0,4,4,0,0,0
11742358,1,1,0,0,1,1,0,0,0
11743380,12,9,3,0,0,0,0,0,0
11745859,3,3,0,0,3,3,0,0,0
11745953,2,2,0,0,2,2,0,0,0
11746659,1,1,0,0,1,1,0,0,1
11750846,1,1,0,0,1,1,0,0,0
11751004,2,2,0,0,1,1,0,1,0
11751214,1,1,0,0,1,1,0,0,0
11751432,1,1,0,0,1,1,0,0,0
11751472,1,1,0,0,1,1,0,0,0
11752479,1,1,0,0,1,1,0,0,0
11753687,1,1,0,0,1,1,0,0,0
11753818,3,3,0,0,1,1,0,1,1
11754049,2,2,0,0,1,1,0,0,0
11755149,1,1,0,0,1,1,0,0,0
11759295,4,4,0,0,1,1,0,1,0
11759587,1,1,0,0,1,1,0,0,0
11760154,1,1,0,0,1,1,0,0,0
11760270,7,6,1,0,1,1,0,0,0
11762380,2,2,0,0,2,2,0,0,0
11762745,1,1,0,0,1,1,0,0,0
11765842,1,1,0,0,2,2,0,0,0
11766421,2,2,0,0,1,1,0,1,1
11766778,3,3,0,0,2,2,0,0,1
11768335,1,1,0,0,1,1,0,0,0
11771551,1,1,0,0,1,1,0,1,0
11771673,1,1,0,0,1,1,0,0,0
11772036,1,1,0,0,1,1,0,0,0
11772649,2,2,0,0,2,2,0,0,0
11772660,3,3,0,0,0,0,0,0,1
11773314,3,3,0,0,1,1,0,0,0
11773317,2,1,1,0,2,1,1,0,0
11773656,3,3,0,0,2,2,0,0,0
11774425,1,1,0,0,1,1,0,0,0
11774502,1,1,0,0,1,1,0,0,0
11776623,1,1,0,0,1,1,0,0,0
11777412,1,1,0,0,1,1,0,0,0
11779566,2,2,0,0,2,2,0,0,0
11780331,1,1,0,0,1,1,0,0,1
11781001,1,1,0,0,1,1,0,0,0
11781889,2,2,0,0,2,2,0,0,0
11783462,1,1,0,0,2,2,0,2,0
11783888,2,2,0,0,0,0,0,0,1
11784058,2,2,0,0,2,2,0,2,1
11785440,1,1,0,0,1,1,0,0,0
11785535,1,1,0,0,1,1,0,0,0
11787002,1,1,0,0,1,1,0,0,0
11787062,2,2,0,0,1,1,0,0,0
11787689,1,1,0,0,1,1,0,0,0
11787895,2,2,0,0,0,0,0,0,0
11788132,1,1,0,0,1,1,0,0,0
11791292,1,1,0,0,2,2,0,0,0
11792287,1,1,0,0,1,1,0,0,0
11794607,1,1,0,0,1,1,0,0,0
11795135,1,1,0,0,1,1,0,0,0
11796019,2,2,0,0,2,2,0,0,0
11796220,1,1,0,0,1,1,0,0,0
11796371,2,2,0,0,2,2,0,0,0
11799215,1,1,0,0,1,1,0,0,0
11799638,1,1,0,0,1,1,0,0,0
11799661,1,1,0,0,1,1,0,0,0
11800192,5,4,1,0,1,1,0,1,0
11800252,5,4,1,0,1,1,0,1,0
11800796,1,1,0,0,1,1,0,0,0
11800841,2,2,0,0,2,2,0,2,0
11801068,1,1,0,0,1,1,0,0,0
11801348,1,1,0,0,1,1,0,0,0
11802063,2,2,0,0,1,1,0,1,1
11804926,2,2,0,0,2,2,0,0,0
11806148,1,1,0,0,1,1,0,0,0
11806209,1,0,1,0,1,1,0,0,0
11806346,1,1,0,0,1,1,0,0,0
11806462,1,1,0,0,1,1,0,0,0
11806491,2,2,0,0,1,1,0,0,0
11806701,1,1,0,0,1,1,0,0,0
11806877,3,3,0,1,0,0,0,0,1
11808710,1,1,0,0,1,1,0,0,0
11809737,1,1,0,0,1,1,0,0,0
11810123,3,3,0,0,2,2,0,0,0
11812733,1,1,0,0,1,1,0,0,0
11812979,1,1,0,0,1,1,0,0,0
11813710,2,2,0,0,0,0,0,0,1
11814917,2,2,0,0,2,2,0,0,0
11815287,1,1,0,0,1,1,0,0,0
11816178,1,1,0,0,1,1,0,0,0
11816759,1,1,0,0,1,1,0,0,0
11819866,5,5,0,0,0,0,0,0,0
11820209,2,2,0,0,2,2,0,0,0
11820264,2,1,1,0,2,1,1,0,0
11820318,1,1,0,0,1,1,0,0,0
11821093,2,2,0,0,2,2,0,0,0
11821751,1,1,0,0,1,1,0,0,0
11821787,2,2,0,0,1,1,0,0,0
11822027,2,2,0,0,1,1,0,0,0
11822679,2,2,0,0,2,2,0,0,0
11823000,1,1,0,0,1,1,0,0,0
11823667,1,1,0,0,1,1,0,0,0
11823946,1,1,0,0,1,1,0,0,0
11824712,1,1,0,0,1,1,0,0,0
11825767,2,2,0,0,1,1,0,1,0
11826526,1,1,0,0,1,1,0,0,0
11826807,2,2,0,0,1,1,0,0,0
11827384,2,2,0,0,2,2,0,0,0
11827813,1,1,0,0,1,1,0,0,0
11827988,1,1,0,0,1,1,0,0,0
11828916,1,1,0,0,1,1,0,0,0
11828940,1,1,0,0,1,1,0,0,0
11829700,1,1,0,0,1,1,0,0,1
11829767,2,2,0,0,1,1,0,0,0
11831035,2,2,0,0,2,2,0,0,0
11833502,2,2,0,0,2,2,0,0,0
11835392,1,1,0,0,1,1,0,0,0
11836066,1,1,0,0,1,1,0,0,0
11836169,2,2,0,0,1,1,0,0,0
11836455,1,1,0,0,0,0,0,0,0
11836464,1,1,0,0,1,1,0,0,0
11836641,1,1,0,0,1,1,0,0,0
11837093,1,1,0,0,1,1,0,0,0
11837504,2,2,0,0,1,1,0,0,0
11839084,1,1,0,0,1,0,1,1,0
11839278,2,2,0,0,1,1,0,0,1
11839360,2,2,0,0,1,1,0,0,1
11840634,1,1,0,0,1,1,0,0,0
11842491,1,1,0,0,1,1,0,0,0
11842572,3,3,0,0,2,2,0,2,1
11842592,1,1,0,0,1,1,0,0,0
11842739,1,1,0,0,1,1,0,0,0
11843226,2,2,0,0,1,1,0,0,0
11843898,1,1,0,0,1,1,0,0,0
11844104,1,1,0,0,1,1,0,0,0
11844924,2,2,0,0,1,1,0,1,1
11845920,2,2,0,0,1,1,0,0,0
11848961,3,3,0,0,3,3,0,0,0
11849063,1,1,0,0,1,1,0,0,0
11849262,1,1,0,0,3,3,0,0,0
11849414,2,2,0,0,1,1,0,0,0
11850009,1,1,0,0,1,1,0,0,0
11850185,1,1,0,0,1,1,0,0,0
11850338,1,1,0,0,1,1,0,0,0
11851336,1,1,0,0,1,1,0,0,0
11852528,2,1,1,0,1,1,0,0,0
11852867,2,1,1,0,2,1,1,1,1
11853087,1,1,0,0,1,1,0,0,0
11853707,5,5,0,0,1,1,0,0,0
11854532,3,3,0,0,3,3,0,3,1
11857105,1,1,0,0,1,1,0,1,0
11857116,1,1,0,0,1,1,0,0,0
11857840,1,1,0,0,2,2,0,1,0
11858027,2,2,0,0,0,0,0,0,0
11858681,1,1,0,0,1,1,0,0,0
11858727,5,5,0,0,0,0,0,0,1
11859760,1,1,0,0,1,1,0,0,0
11859812,1,1,0,0,1,1,0,0,0
11860486,1,1,0,0,1,1,0,0,1
11860487,4,4,0,0,2,1,1,0,1
11862630,1,1,0,0,1,1,0,0,0
11863181,2,2,0,0,1,1,0,0,0
11863622,1,1,0,0,1,1,0,0,0
11863773,1,1,0,0,1,1,0,0,0
11864164,1,1,0,0,2,1,1,1,0
11864462,4,4,0,0,0,0,0,0,1
11864745,1,1,0,0,1,1,0,0,0
11865628,2,2,0,0,2,2,0,0,0
11866143,1,1,0,0,1,1,0,0,0
11866561,1,1,0,0,1,1,0,0,0
11866678,1,1,0,0,1,1,0,0,0
11867451,1,1,0,0,1,1,0,0,0
11870362,1,1,0,0,1,1,0,0,0
11871500,2,2,0,0,2,2,0,0,0
11871933,2,2,0,0,2,2,0,0,0
11872762,2,2,0,0,2,2,0,0,0
11872771,2,2,0,0,2,2,0,0,0
11872885,1,1,0,0,0,0,0,0,0
11873574,4,4,0,0,0,0,0,0,0
11874473,2,2,0,0,2,2,0,0,0
11875489,1,1,0,0,1,1,0,0,0
11876603,2,1,1,0,2,1,1,0,0
11877319,1,1,0,0,1,1,0,0,0
11879213,1,1,0,0,1,1,0,0,0
11879275,2,2,0,0,2,2,0,0,0
11879894,2,2,0,0,2,2,0,0,0
11880813,1,1,0,0,1,1,0,0,0
11881874,1,1,0,0,1,1,0,0,0
11882165,5,5,0,0,0,0,0,0,0
11882213,4,4,0,0,1,1,0,1,0
11882339,1,1,0,0,1,1,0,0,0
11882806,2,2,0,0,1,1,0,0,0
11882977,3,3,0,0,2,2,0,0,0
11884813,2,2,0,0,1,1,0,0,0
11885411,2,2,0,0,2,2,0,0,0
11885448,2,2,0,0,1,1,0,0,0
11885693,1,1,0,0,1,1,0,0,0
11887251,1,1,0,0,1,1,0,0,0
11887327,1,1,0,0,1,1,0,0,0
11888175,2,2,0,0,2,2,0,0,0
11889513,2,2,0,0,2,2,0,0,0
11890559,2,2,0,0,2,2,0,0,0
11892881,1,1,0,0,1,1,0,0,0
11892917,2,2,0,0,2,2,0,0,0
11892945,1,1,0,0,1,1,0,0,0
11894042,1,1,0,0,1,1,0,0,0
11895420,1,1,0,0,1,1,0,0,0
11895836,1,1,0,0,1,1,0,0,0
11897133,1,1,0,0,1,1,0,0,0
11898506,2,2,0,0,1,1,0,0,0
11898947,1,1,0,0,1,1,0,0,0
11900249,2,2,0,0,2,2,0,0,0
11900352,1,1,0,0,1,1,0,0,0
11900627,3,3,0,0,3,3,0,0,0
11900810,4,4,0,0,0,0,0,0,0
11901983,1,1,0,0,1,1,0,0,0
11902452,1,1,0,0,1,1,0,0,0
11903186,1,1,0,0,1,1,0,0,0
11904076,1,1,0,0,1,1,0,0,0
11904526,2,2,0,0,1,1,0,1,1
11906635,2,2,0,0,2,2,0,0,0
11906955,2,2,0,0,1,1,0,0,0
11907260,1,1,0,0,1,1,0,0,0
11907561,3,3,0,0,2,2,0,0,1
11908625,3,3,0,0,0,0,0,0,0
11908848,1,1,0,0,1,1,0,0,0
11908864,2,2,0,0,1,1,0,1,1
11909351,1,1,0,0,1,1,0,0,0
11910179,1,1,0,0,0,0,0,0,0
11911732,1,1,0,0,1,1,0,0,0
11912262,1,1,0,0,1,1,0,0,0
11913388,2,1,1,0,1,1,0,0,0
11913924,1,1,0,0,3,3,0,0,0
11914256,3,3,0,0,2,2,0,0,0
11914569,2,2,0,0,2,2,0,0,0
11914737,1,1,0,0,1,1,0,0,0
11915942,1,1,0,0,1,1,0,0,1
11916930,1,1,0,0,1,1,0,0,0
11917814,1,1,0,0,1,1,0,0,0
11917871,1,1,0,0,1,1,0,0,0
11918501,1,1,0,0,1,1,0,0,0
11920082,1,1,0,0,1,1,0,0,0
11920177,2,2,0,0,1,1,0,0,0
11920254,2,2,0,0,1,1,0,0,0
11920364,1,1,0,0,1,1,0,0,0
11921272,5,5,0,0,0,0,0,0,0
11924217,4,4,0,0,1,1,0,1,1
11924374,4,4,0,0,1,1,0,1,1
11924531,2,2,0,0,2,2,0,0,0
11924877,1,1,0,0,1,1,0,0,0
11924991,4,4,0,0,1,1,0,1,0
11926364,2,2,0,0,1,1,0,1,0
06220931,4,3,1,0,2,2,0,0,1
06221141,8,2,6,0,2,2,0,0,0
06221480,2,0,2,0,0,0,0,0,0
06221959,26,5,21,0,2,2,0,2,1
06223818,7,0,7,0,0,0,0,0,1
06225479,14,3,11,0,2,2,0,2,1
06225483,16,4,12,0,2,2,0,2,1
06225851,8,3,5,0,2,2,0,0,0
06226134,5,0,5,0,0,0,0,0,1
06226775,17,0,17,0,0,0,0,0,1
06226803,28,5,23,0,1,1,0,1,1
06226957,7,5,2,0,1,1,0,1,1
06227091,7,2,5,0,4,2,2,0,0
06228245,15,4,11,0,2,2,0,2,1
06229147,4,2,2,0,2,1,1,0,0
06230767,5,3,2,0,1,1,0,0,0
06231325,2,1,1,0,1,1,0,0,0
06232764,2,2,0,0,1,1,0,0,0
06237942,7,0,7,0,0,0,0,0,1
06237948,7,0,7,0,0,0,0,0,1
06237968,7,0,7,0,0,0,0,0,1
06238013,7,0,7,0,0,0,0,0,1
06240215,4,2,2,0,1,1,0,0,0
06240659,4,2,2,0,1,1,0,0,0
06241738,18,6,12,0,1,1,0,0,0
06242082,10,0,10,0,0,0,0,0,1
06242273,3,3,0,0,1,1,0,0,0
06242328,24,4,20,0,1,1,0,1,1
06242508,26,5,21,0,2,2,0,2,1
06242732,15,0,15,0,0,0,0,0,1
06243678,6,1,5,0,1,1,0,0,0
06244260,21,12,9,0,0,0,0,0,0
06245757,3,2,1,0,1,1,0,0,1
06245787,4,3,1,0,1,1,0,0,1
06246929,40,12,28,0,0,0,0,0,0
06249683,3,0,3,0,0,0,0,0,1
06249799,39,4,35,0,3,2,1,3,0
06249803,14,12,2,0,1,1,0,0,0
06249860,13,4,9,0,2,2,0,2,1
06251340,4,3,1,0,1,1,0,1,0
06252671,9,0,9,0,0,0,0,0,1
06254578,9,3,6,0,1,1,0,0,0
06254658,5,3,2,0,1,1,0,0,0
06254755,6,3,3,0,1,1,0,0,1
06254995,5,3,2,0,2,2,0,0,0
06255402,26,4,22,0,1,1,0,1,1
06255477,15,4,11,0,0,0,0,0,0
06255483,7,5,2,0,4,4,0,0,0
06255792,4,3,1,0,1,1,0,0,0
06255938,5,3,2,0,1,1,0,0,1
06256544,25,4,21,0,1,1,0,1,1
06256721,3,0,3,0,0,0,0,0,1
06256740,3,0,3,0,0,0,0,0,1
06256955,10,2,8,0,2,1,1,0,1
06258194,4,3,1,0,1,1,0,0,1
06259003,28,6,22,0,2,2,0,2,1
06259258,21,3,18,0,1,1,0,1,1
06259260,31,5,26,0,3,3,0,3,1
06259507,6,2,4,0,1,1,0,0,1
06259530,33,5,28,0,1,1,0,1,1
06259882,10,5,5,0,10,10,0,0,0
06260316,33,5,28,0,1,1,0,1,1
06261556,7,2,5,0,0,0,0,0,1
06261914,10,4,6,0,1,1,0,0,1
06262288,2,2,0,0,1,1,0,0,0
06263776,3,0,3,0,0,0,0,0,1
06263950,5,3,2,0,1,1,0,0,0
06266211,5,0,5,0,1,1,0,0,1
06266949,4,0,4,0,0,0,0,0,1
06270319,6,2,4,0,1,1,0,0,0
06271315,14,7,7,0,1,1,0,0,0
06271341,16,4,12,0,1,1,0,1,1
06271588,5,0,5,0,0,0,0,0,1
06271891,5,2,3,0,0,0,0,0,1
06271938,5,0,5,0,0,0,0,0,1
06272263,6,5,1,0,0,0,0,0,0
06273721,7,4,3,0,1,1,0,1,0
06275379,7,4,3,0,1,1,0,1,0
06277406,8,3,5,0,0,0,0,0,1
06279786,17,8,9,0,0,0,0,0,0
06280856,4,1,3,0,1,1,0,0,0
06283101,2,0,2,0,0,0,0,0,0
06283829,5,0,5,0,0,0,0,0,1
06284055,4,2,2,0,1,1,0,0,0
06285637,12,5,7,0,0,0,0,0,0
06286152,2,0,2,0,0,0,0,0,0
06287335,4,0,4,0,0,0,0,0,1
06287393,4,3,1,0,2,2,0,0,1
06287989,11,2,9,0,1,1,0,1,1
06288440,4,2,2,2,1,1,0,1,1
06289506,18,0,18,0,0,0,0,0,1
06290057,14,5,9,0,0,0,0,0,1
06293651,11,5,6,0,1,1,0,0,1
06294314,5,0,5,0,0,0,0,0,1
06295350,25,8,17,0,1,1,0,1,1
06295696,13,4,9,0,0,0,0,0,0
06296528,30,9,21,0,1,1,0,1,1
06296547,6,0,6,0,0,0,0,0,0
06296811,6,0,6,0,0,0,0,0,1
06297440,15,5,10,0,0,0,0,0,0
06298341,15,0,15,0,0,0,0,0,1
06301971,16,4,12,0,1,1,0,1,1
06302649,12,0,12,0,0,0,0,0,1
06302932,2,2,0,0,1,1,0,0,0
06303148,2,2,0,0,1,1,0,0,0
06303240,16,2,14,0,1,1,0,1,1
06303413,14,0,14,0,0,0,0,0,1
06303923,6,2,4,0,1,1,0,0,1
06304726,10,6,4,0,1,1,0,1,0
06307834,11,0,11,0,0,0,0,0,1
06309368,9,0,9,0,0,0,0,0,1
06309661,25,0,25,0,0,0,0,0,1
06309791,3,3,0,0,1,1,0,0,1
06310022,2,2,0,0,1,1,0,0,0
06310505,8,4,4,0,2,2,0,0,1
06311492,6,1,5,0,2,2,0,0,0
06313119,3,3,0,0,2,2,0,0,0
06313123,14,6,8,0,4,1,3,1,1
06313826,4,2,2,0,1,1,0,0,0
06314483,8,1,7,0,1,1,0,0,1
06315651,12,0,12,0,0,0,0,0,1
06316243,68,9,59,0,0,0,0,0,0
06317017,7,0,7,0,3,3,0,0,1
06317053,23,6,17,0,0,0,0,0,0
06317072,7,0,7,0,3,3,0,0,1
06317074,19,4,15,0,0,0,0,0,1
06317910,6,0,6,0,0,0,0,0,0
06318385,4,2,2,0,0,0,0,0,0
06324634,6,2,4,0,1,1,0,0,0
06324635,7,0,7,0,0,0,0,0,1
06325313,17,3,14,0,0,0,0,0,1
06325347,8,4,4,0,1,1,0,1,1
06325936,6,2,4,0,1,1,0,1,1
06326753,15,1,14,0,0,0,0,0,1
06326754,25,0,25,0,0,0,0,0,1
06327034,16,3,13,0,1,1,0,1,1
06327041,20,4,16,0,1,1,0,1,1
06327087,20,4,16,0,1,1,0,1,1
06327289,6,0,6,0,2,2,0,0,1
06327374,4,1,3,0,1,1,0,0,0
06328045,15,3,12,0,1,1,0,1,1
06329321,5,0,5,0,0,0,0,0,1
06329336,5,0,5,0,0,0,0,0,1
06329350,5,0,5,0,0,0,0,0,1
06330189,5,0,5,0,0,0,0,0,1
06331583,12,9,3,0,0,0,0,0,1
06332843,3,0,3,0,0,0,0,0,0
06335696,5,1,4,0,2,2,0,0,1
06335746,7,2,5,0,1,1,0,0,0
06336180,3,0,3,0,0,0,0,0,1
06337129,28,0,28,0,1,1,0,1,1
06337851,14,4,10,0,1,1,0,1,1
06338330,8,4,4,0,2,2,0,2,1
06338824,14,8,6,0,1,1,0,0,1
06339219,6,3,3,0,2,2,0,0,0
06341460,4,2,2,0,2,2,0,1,0
06341743,10,3,7,0,1,1,0,1,1
06342144,5,3,2,0,0,0,0,0,1
06342689,17,5,12,0,1,1,0,1,1
06343185,14,2,12,0,1,1,0,1,0
06343606,4,2,2,0,1,1,0,0,1
06343733,4,3,1,0,2,2,0,0,1
06344229,3,1,2,0,0,0,0,0,1
06344341,3,1,2,0,1,1,0,0,1
06345605,2,2,0,0,2,2,0,0,0
06346392,3,3,0,0,2,2,0,0,0
06349596,5,2,3,0,1,1,0,1,0
06350012,22,5,17,0,1,1,0,1,1
06350381,3,0,3,0,1,1,0,0,0
06350953,2,2,0,0,1,1,0,0,0
06351840,4,2,2,0,1,1,0,0,0
06352167,5,1,4,0,1,1,0,0,0
06352244,5,3,2,0,1,1,0,1,1
06352308,10,3,7,0,1,1,0,1,1
06352607,3,1,2,0,1,1,0,0,0
06353838,26,6,20,0,2,2,0,2,1
06353898,6,2,4,0,1,1,0,0,1
06354208,13,8,5,0,1,1,0,0,1
06354222,17,6,11,0,1,1,0,1,1
06356940,10,0,10,0,0,0,0,0,1
06357040,4,2,2,0,2,2,0,0,1
06357609,3,3,0,0,2,2,0,0,0
06359072,3,3,0,0,1,1,0,0,0
06359470,2,1,1,0,1,1,0,0,0
06360525,7,5,2,0,3,3,0,0,1
06362081,8,2,6,0,1,1,0,1,1
06362738,3,2,1,0,1,1,0,0,1
06363150,21,5,16,0,2,2,0,2,1
06363488,11,4,7,0,3,1,2,2,1
06363773,7,0,7,0,0,0,0,0,1
06364806,12,4,8,0,3,2,1,0,1
06365644,7,3,4,0,1,1,0,1,0
06367378,16,7,9,0,0,0,0,0,1
06367482,2,2,0,0,1,1,0,0,0
06368668,6,3,3,0,1,1,0,1,1
06369476,3,1,2,0,1,1,0,0,0
06370357,19,2,17,0,2,2,0,2,1
06371686,13,3,10,0,1,1,0,1,1
06371780,19,0,19,0,0,0,0,0,0
06372010,3,2,1,0,1,1,0,0,1
06372013,3,0,3,0,0,0,0,0,0
06372899,13,0,13,0,0,0,0,0,1
06372969,13,0,13,0,0,0,0,0,1
06373339,8,3,5,0,1,1,0,1,1
06373714,3,2,1,0,1,1,0,0,1
06374231,4,1,3,0,1,1,0,1,0
06376234,5,0,5,0,0,0,0,0,1
06376404,7,3,4,0,0,0,0,0,0
06376555,12,0,12,0,0,0,0,0,1
06377414,5,4,1,0,3,3,0,0,0
06377529,16,3,13,0,1,1,0,1,1
06377649,6,2,4,0,2,2,0,0,0
06380591,2,0,2,0,0,0,0,0,0
06380602,13,4,9,0,3,3,0,0,0
06381142,4,3,1,0,2,2,0,0,1
06381241,7,0,7,0,0,0,0,0,1
06381265,5,2,3,0,1,1,0,0,1
06382655,5,3,2,0,2,2,0,1,1
06383292,8,5,3,0,0,0,0,0,1
06384604,7,4,3,0,2,1,1,0,1
06384729,5,1,4,0,1,1,0,0,0
06386643,4,2,2,0,1,1,0,0,0
06387617,45,7,38,0,0,0,0,0,0
06388809,21,0,21,0,1,1,0,1,1
06389506,4,0,4,0,0,0,0,0,1
06389799,3,2,1,0,1,1,0,0,1
06390305,5,2,3,0,1,1,0,0,0
06390346,7,2,5,0,0,0,0,0,1
06391136,15,2,13,0,1,1,0,1,1
06391560,4,2,2,0,1,1,0,0,0
06391761,2,0,2,0,0,0,0,0,0
06392494,8,3,5,0,0,0,0,0,1
06394327,24,9,15,0,1,0,1,0,0
06396065,3,3,0,0,2,2,0,0,0
06396583,5,1,4,0,1,1,0,0,0
06400750,6,0,6,0,0,0,0,0,1
06400760,8,3,5,0,2,1,1,2,1
06403110,14,1,13,0,1,1,0,1,1
06403816,5,0,5,0,0,0,0,0,1
06403957,17,4,13,0,2,2,0,2,1
06404255,16,6,10,0,0,0,0,0,1
06404930,4,2,2,0,1,1,0,0,1
06405474,4,0,4,0,0,0,0,0,1
06405604,23,4,19,0,1,1,0,1,1
06407182,5,3,2,0,1,1,0,0,1
06407212,22,0,22,0,0,0,0,0,1
06407339,7,2,5,0,1,1,0,0,1
06407667,3,0,3,0,1,1,0,0,1
06407808,5,5,0,0,1,1,0,0,1
06407965,9,5,4,0,0,0,0,0,1
06408143,5,0,5,0,2,2,0,0,1
06408406,4,2,2,0,1,1,0,0,0
06408465,11,1,10,0,1,1,0,0,1
06408724,13,0,13,0,1,1,0,1,1
06408727,24,3,21,0,1,1,0,1,1
06409008,17,5,12,0,1,1,0,1,1
06409066,17,5,12,0,1,1,0,1,1
06409117,17,5,12,0,1,1,0,1,1
06409119,17,5,12,0,1,1,0,1,1
06409746,4,0,4,0,1,1,0,0,1
06410010,6,0,6,0,0,0,0,0,1
06410320,8,3,5,0,1,1,0,1,1
06410617,8,3,5,0,1,1,0,1,1
06410667,5,1,4,0,1,1,0,0,1
06410734,28,3,25,0,1,1,0,1,1
06410814,5,1,4,0,1,1,0,0,0
06411210,5,1,4,0,0,0,0,0,1
06411278,4,3,1,0,1,1,0,0,1
06412064,9,5,4,0,1,1,0,1,1
06412198,6,2,4,0,1,1,0,0,0
06412222,13,4,9,0,2,2,0,2,1
06412306,2,0,2,0,0,0,0,0,1
06412309,3,1,2,0,1,1,0,0,1
06412337,6,0,6,0,0,0,0,0,1
06412599,7,5,2,0,5,5,0,1,0
06412890,6,1,5,0,2,1,1,0,1
06412899,10,3,7,0,0,0,0,0,1
06412905,3,2,1,0,2,2,0,0,1
06412921,4,2,2,0,1,1,0,1,1
06412940,5,2,3,0,0,0,0,0,1
06413229,4,0,4,0,1,1,0,0,1
06413231,9,2,7,0,1,1,0,0,1
06413307,2,2,0,0,1,1,0,0,0
06413588,4,0,4,0,1,1,0,0,1
CE012021,0,0,0,0,0,0,0,0,0
CE012064,0,0,0,0,0,0,0,0,0
CE012087,0,0,0,0,0,0,0,0,0
CE012148,0,0,0,0,0,0,0,0,0
CE012183,0,0,0,0,0,0,0,0,0
CE012231,0,0,0,0,0,0,0,0,0
CE012252,0,0,0,0,0,0,0,0,0
CE012255,0,0,0,0,0,0,0,0,0
CE012276,0,0,0,0,0,0,0,0,0
CE012308,0,0,0,0,0,0,0,0,0
CE012315,0,0,0,0,0,0,0,0,0
CE012404,0,0,0,0,0,0,0,0,0
CE012672,0,0,0,0,0,0,0,0,0
CE012719,0,0,0,0,0,0,0,0,0
CE012885,0,0,0,0,0,0,0,0,0
CE012893,0,0,0,0,0,0,0,0,0
CE013113,0,0,0,0,0,0,0,0,0
CE013260,0,0,0,0,0,0,0,0,0
CE013317,0,0,0,0,0,0,0,0,0
CE013320,0,0,0,0,0,0,0,0,0
CE013523,0,0,0,0,0,0,0,0,0
CE013577,0,0,0,0,0,0,0,0,0
CE013638,0,0,0,0,0,0,0,0,0
CE013670,0,0,0,0,0,0,0,0,0
CE013688,0,0,0,0,0,0,0,0,0
CE013695,0,0,0,0,0,0,0,0,0
CE013739,0,0,0,0,0,0,0,0,0
CE013874,0,0,0,0,0,0,0,0,0
CE013888,0,0,0,0,0,0,0,0,0
CE013945,0,0,0,0,0,0,0,0,0
CE013978,0,0,0,0,0,0,0,0,0
CE014065,0,0,0,0,0,0,0,0,0
CE014071,0,0,0,0,0,0,0,0,0
CE014095,0,0,0,0,0,0,0,0,0
CE014144,0,0,0,0,0,0,0,0,0
CE014208,0,0,0,0,0,0,0,0,0
CE014222,0,0,0,0,0,0,0,0,0
CE014301,0,0,0,0,0,0,0,0,0
CE014549,0,0,0,0,0,0,0,0,0
CE014551,0,0,0,0,0,0,0,0,0
CE014731,0,0,0,0,0,0,0,0,0
CE014769,0,0,0,0,0,0,0,0,0
CE014835,0,0,0,0,0,0,0,0,0
CE014868,0,0,0,0,0,0,0,0,0
CE014882,0,0,0,0,0,0,0,0,0
CE014900,0,0,0,0,0,0,0,0,0
CE014909,0,0,0,0,0,0,0,0,0
CE014974,0,0,0,0,0,0,0,0,0
CE014989,0,0,0,0,0,0,0,0,0
CE015026,0,0,0,0,0,0,0,0,0
CE015027,0,0,0,0,0,0,0,0,0
CE015053,0,0,0,0,0,0,0,0,0
CE015119,0,0,0,0,0,0,0,0,0
CE015193,0,0,0,0,0,0,0,0,0
CE015245,0,0,0,0,0,0,0,0,0
CE015259,0,0,0,0,0,0,0,0,0
CE015304,0,0,0,0,0,0,0,0,0
CE015322,0,0,0,0,0,0,0,0,0
CE015342,0,0,0,0,0,0,0,0,0
CE015405,0,0,0,0,0,0,0,0,0
CE015407,0,0,0,0,0,0,0,0,0
CE015523,0,0,0,0,0,0,0,0,0
CE015672,0,0,0,0,0,0,0,0,0
CE015715,0,0,0,0,0,0,0,0,0
CE015803,0,0,0,0,0,0,0,0,0
CE015821,0,0,0,0,0,0,0,0,0
CE015836,0,0,0,0,0,0,0,0,0
CE015837,0,0,0,0,0,0,0,0,0
CE015920,0,0,0,0,0,0,0,0,0
CE015921,0,0,0,0,0,0,0,0,0
CE015935,0,0,0,0,0,0,0,0,0
CE015994,0,0,0,0,0,0,0,0,0
CE016013,0,0,0,0,0,0,0,0,0
CE016136,0,0,0,0,0,0,0,0,0
CE016147,0,0,0,0,0,0,0,0,0
CE016157,0,0,0,0,0,0,0,0,0
CE016167,0,0,0,0,0,0,0,0,0
CE016178,0,0,0,0,0,0,0,0,0
CE016306,0,0,0,0,0,0,0,0,0
CE016500,0,0,0,0,0,0,0,0,0
CE016512,0,0,0,0,0,0,0,0,0
CE016536,0,0,0,0,0,0,0,0,0
CE016654,0,0,0,0,0,0,0,0,0
CE016698,0,0,0,0,0,0,0,0,0
CE016707,0,0,0,0,0,0,0,0,0
CE016767,0,0,0,0,0,0,0,0,0
CE016828,0,0,0,0,0,0,0,0,0
CE016860,0,0,0,0,0,0,0,0,0
CE017003,0,0,0,0,0,0,0,0,0
CE017075,0,0,0,0,0,0,0,0,0
CE017268,0,0,0,0,0,0,0,0,0
CE017299,0,0,0,0,0,0,0,0,0
CE017473,0,0,0,0,0,0,0,0,0
CE017508,0,0,0,0,0,0,0,0,0
CE017522,0,0,0,0,0,0,0,0,0
CE017574,0,0,0,0,0,0,0,0,0
CE017596,0,0,0,0,0,0,0,0,0
CS000340,0,0,0,0,0,0,0,0,0
CS002855,0,0,0,0,0,0,0,0,0
CS003223,0,0,0,0,0,0,0,0,0
FC005059,37,16,21,0,0,0,0,0,1
FC009467,7,7,0,0,0,0,0,0,0
FC010666,10,0,10,0,0,0,0,0,1
FC011723,16,0,16,0,0,0,0,0,1
FC013069,17,14,3,0,0,0,0,0,1
FC013519,8,8,0,0,0,0,0,0,0
FC014055,4,4,0,0,0,0,0,0,0
FC014415,3,3,0,0,0,0,0,0,0
FC016957,5,5,0,0,0,0,0,0,1
FC017117,55,12,43,0,0,0,0,0,1
FC017124,24,4,20,0,0,0,0,0,1
FC018908,10,6,4,0,0,0,0,0,0
FC019485,23,4,19,0,0,0,0,0,1
FC019777,10,3,7,0,0,0,0,0,0
FC019783,8,4,4,0,0,0,0,0,0
FC019816,8,3,5,0,0,0,0,0,0
FC019917,10,3,7,0,0,0,0,0,0
FC020152,25,4,21,0,0,0,0,0,1
FC020689,14,0,14,0,0,0,0,0,1
FC021437,7,0,7,0,0,0,0,0,1
FC024113,14,0,14,0,0,0,0,0,1
FC024293,11,3,8,0,0,0,0,0,1
FC024446,3,1,2,0,0,0,0,0,1
FC024447,11,3,8,0,0,0,0,0,1
FC024458,18,4,14,0,0,0,0,0,1
FC024459,19,4,15,0,0,0,0,0,1
FC024469,0,0,0,0,0,0,0,0,1
FC025176,17,4,13,1,0,0,0,0,1
FC025589,9,3,6,0,0,0,0,0,1
FC025591,7,0,7,0,0,0,0,0,1
FC025605,16,4,12,0,0,0,0,0,1
FC025808,16,4,12,1,0,0,0,0,1
FC025898,2,1,1,0,0,0,0,0,0
FC026160,3,3,0,0,0,0,0,0,1
FC026860,18,4,14,0,0,0,0,0,1
FC027013,4,4,0,0,0,0,0,0,0
FC027017,4,4,0,0,0,0,0,0,0
FC027018,4,4,0,0,0,0,0,0,0
FC027023,8,4,4,1,0,0,0,0,0
FC027549,4,2,2,0,0,0,0,0,1
FC027550,4,3,1,0,0,0,0,0,1
FC027898,17,4,13,0,0,0,0,0,1
FC027902,11,0,11,0,0,0,0,0,1
FC028175,16,3,13,0,0,0,0,0,1
FC028962,12,4,8,0,0,0,0,0,1
FC029214,4,2,2,0,0,0,0,0,1
FC029562,4,0,4,0,0,0,0,0,1
FC029563,8,4,4,0,0,0,0,0,1
FC030054,9,4,5,0,0,0,0,0,1
FC030297,6,0,6,0,0,0,0,0,1
FC030628,15,8,7,0,0,0,0,0,1
FC030699,8,0,8,0,0,0,0,0,1
FC030838,10,4,6,0,0,0,0,0,1
FC031512,1,1,0,0,0,0,0,0,0
FC031640,5,3,2,0,0,0,0,0,1
FC031682,4,4,0,1,0,0,0,0,0
FC031693,3,0,3,0,0,0,0,0,1
FC031694,3,0,3,0,0,0,0,0,1
FC031697,3,0,3,0,0,0,0,0,1
FC032058,9,4,5,1,0,0,0,0,1
FC032231,15,3,12,1,0,0,0,0,1
FC033103,3,3,0,1,0,0,0,0,0
FC033109,5,4,1,0,0,0,0,0,1
FC033430,4,4,0,0,0,0,0,0,1
FC033435,5,4,1,0,0,0,0,0,1
FC033649,5,5,0,0,0,0,0,0,1
FC034250,4,4,0,1,0,0,0,0,0
FC036098,5,5,0,0,0,0,0,0,1
IP00020R,0,0,0,0,0,0,0,0,0
IP000588,0,0,0,0,0,0,0,0,0
IP00159R,0,0,0,0,0,0,0,0,0
IP00386C,0,0,0,0,0,0,0,0,0
IP00423C,0,0,0,0,0,0,0,0,0
IP00440C,0,0,0,0,0,0,0,0,0
IP00489C,0,0,0,0,0,0,0,0,0
IP00537C,0,0,0,0,0,0,0,0,0
IP00625C,0,0,0,0,0,0,0,0,0
IP00630C,0,0,0,0,0,0,0,0,0
IP00668C,0,0,0,0,0,0,0,0,0
IP00689C,0,0,0,0,0,0,0,0,0
IP00700C,0,0,0,0,0,0,0,0,0
IP00712C,0,0,0,0,0,0,0,0,0
IP01326R,0,0,0,0,0,0,0,0,0
IP025133,0,0,0,0,0,0,0,0,0
IP02610R,0,0,0,0,0,0,0,0,0
IP02756W,0,0,0,0,0,0,0,0,0
IP02854R,0,0,0,0,0,0,0,0,0
IP030447,0,0,0,0,0,0,0,0,0
IP030562,0,0,0,0,0,0,0,0,0
IP030586,0,0,0,0,0,0,0,0,0
IP030703,0,0,0,0,0,0,0,0,0
IP030791,0,0,0,0,0,0,0,0,0
IP030876,0,0,0,0,0,0,0,0,0
IP030906,0,0,0,0,0,0,0,0,0
IP030951,0,0,0,0,0,0,0,0,0
IP030955,0,0,0,0,0,0,0,0,0
IP030971,0,0,0,0,0,0,0,0,0
IP030988,0,0,0,0,0,0,0,0,0
IP031256,0,0,0,0,0,0,0,0,0
IP031260,0,0,0,0,0,0,0,0,0
IP031280,0,0,0,0,0,0,0,0,0
IP031340,0,0,0,0,0,0,0,0,0
IP031387,0,0,0,0,0,0,0,0,0
IP031506,0,0,0,0,0,0,0,0,0
IP031555,0,0,0,0,0,0,0,0,0
IP031678,0,0,0,0,0,0,0,0,0
IP031737,0,0,0,0,0,0,0,0,0
IP031911,0,0,0,0,0,0,0,0,0
IP031938,0,0,0,0,0,0,0,0,0
IP031972,0,0,0,0,0,0,0,0,0
IP031974,0,0,0,0,0,0,0,0,0
IP032017,0,0,0,0,0,0,0,0,0
IP032066,0,0,0,0,0,0,0,0,0
IP032073,0,0,0,0,0,0,0,0,0
IP032121,0,0,0,0,0,0,0,0,0
IP032124,0,0,0,0,0,0,0,0,0
IP032159,0,0,0,0,0,0,0,0,0
IP032186,0,0,0,0,0,0,0,0,0
IP032273,0,0,0,0,0,0,0,0,0
IP032298,0,0,0,0,0,0,0,0,0
IP032333,0,0,0,0,0,0,0,0,0
IP032360,0,0,0,0,0,0,0,0,0
IP032362,0,0,0,0,0,0,0,0,0
IP03729R,0,0,0,0,0,0,0,0,0
IP03992R,0,0,0,0,0,0,0,0,0
IP04222R,0,0,0,0,0,0,0,0,0
IP04239R,0,0,0,0,0,0,0,0,0
IP04311R,0,0,0,0,0,0,0,0,0
IP04536R,0,0,0,0,0,0,0,0,0
IP04572R,0,0,0,0,0,0,0,0,0
IP04627R,0,0,0,0,0,0,0,0,0
IP04649R,0,0,0,0,0,0,0,0,0
IP04654R,0,0,0,0,0,0,0,0,0
IP04681R,0,0,0,0,0,0,0,0,0
IP04763R,0,0,0,0,0,0,0,0,0
IP05266R,0,0,0,0,0,0,0,0,0
IP05333R,0,0,0,0,0,0,0,0,0
IP05372R,0,0,0,0,0,0,0,0,0
IP05463R,0,0,0,0,0,0,0,0,0
IP05471R,0,0,0,0,0,0,0,0,0
IP05580R,0,0,0,0,0,0,0,0,0
IP05595R,0,0,0,0,0,0,0,0,0
IP05655R,0,0,0,0,0,0,0,0,0
IP05807R,0,0,0,0,0,0,0,0,0
IP06127R,0,0,0,0,0,0,0,0,0
IP06302R,0,0,0,0,0,0,0,0,0
IP06454R,0,0,0,0,0,0,0,0,0
IP06614R,0,0,0,0,0,0,0,0,0
IP06921R,0,0,0,0,0,0,0,0,0
IP07023R,0,0,0,0,0,0,0,0,0
IP07285R,0,0,0,0,0,0,0,0,0
IP07291R,0,0,0,0,0,0,0,0,0
IP07302R,0,0,0,0,0,0,0,0,0
IP07421R,0,0,0,0,0,0,0,0,0
IP07762R,0,0,0,0,0,0,0,0,0
IP07923R,0,0,0,0,0,0,0,0,0
00384974,6,4,2,0,1,1,0,0,0
00387291,5,0,5,0,0,0,0,0,1
00388135,35,3,32,0,1,1,0,1,1
00388220,16,3,13,0,2,1,1,0,0
00391027,14,3,11,0,1,1,0,1,1
00392067,26,5,21,0,2,2,0,0,1
00392619,30,5,25,0,1,1,0,1,1
00393104,32,7,25,0,1,1,0,1,1
00394504,29,5,24,0,1,1,0,1,1
00395618,23,3,20,0,1,1,0,1,1
00397156,149,3,146,0,1,1,0,1,1
00402421,59,15,44,0,2,1,1,0,0
00403200,32,4,28,0,1,1,0,1,1
00403450,23,0,23,0,0,0,0,0,1
00406595,8,0,8,0,0,0,0,0,1
00406711,50,9,41,0,0,0,0,0,1
00407270,68,10,58,0,0,0,0,0,1
00407403,21,4,17,0,0,0,0,0,1
00409867,36,0,36,0,0,0,0,0,1
00410065,21,3,18,0,2,1,1,2,1
00412742,34,4,30,0,0,0,0,0,0
00414245,19,3,16,0,0,0,0,0,1
00416787,44,5,39,0,1,1,0,1,1
00418500,28,0,28,0,0,0,0,0,1
00421037,0,0,0,0,0,0,0,0,1
00422837,34,6,28,0,1,1,0,1,1
00423372,39,4,35,0,1,1,0,0,1
00425829,30,0,30,0,1,1,0,1,1
00426887,27,0,27,0,0,0,0,0,1
00427533,30,0,30,0,0,0,0,0,1
00427542,7,7,0,0,2,2,0,0,0
00429714,22,3,19,0,1,1,0,1,1
00432769,10,6,4,0,2,1,1,0,0
00434487,42,4,38,0,1,1,0,1,1
00437009,36,3,33,0,1,1,0,1,0
00438838,14,3,11,0,1,1,0,1,1
00439055,10,0,10,0,0,0,0,0,0
00439430,5,2,3,0,2,2,0,0,0
00442709,40,5,35,0,2,1,1,0,0
00443219,29,2,27,0,1,1,0,1,1
00448282,30,5,25,0,2,1,1,2,1
00448920,44,7,37,0,7,0,7,0,0
00449060,30,8,22,0,0,0,0,0,0
00452026,2,2,0,0,0,0,0,0,1
00453294,30,7,23,0,1,1,0,0,0
00458949,35,3,32,0,1,1,0,1,1
00460129,23,8,15,0,0,0,0,0,1
00460851,14,4,10,0,1,1,0,1,1
00461611,32,4,28,0,1,1,0,1,1
00461916,5,3,2,0,4,4,0,1,1
00462984,61,0,61,0,0,0,0,0,0
00463493,61,4,57,0,0,0,0,0,0
00464785,16,5,11,0,1,1,0,1,1
00464880,43,4,39,0,1,1,0,1,1
00466069,38,4,34,0,1,1,0,1,1
00467254,87,13,74,0,0,0,0,0,1
00469788,27,0,27,0,0,0,0,0,1
00470721,25,5,20,0,2,1,1,0,0
00472253,34,5,29,0,1,1,0,1,1
00472336,3,3,0,0,1,1,0,0,0
00472391,28,7,21,0,1,1,0,1,1
00473513,16,0,16,0,1,1,0,1,1
00474514,64,3,61,0,0,0,0,0,0
00475960,15,4,11,0,2,2,0,2,1
00476245,21,0,21,0,0,0,0,0,1
00477815,7,5,2,0,1,1,0,1,0
00478575,32,3,29,0,1,1,0,1,1
00478666,36,0,36,0,0,0,0,0,1
00480560,31,5,26,0,1,1,0,1,1
00480992,36,2,34,0,1,1,0,1,1
00485700,61,7,54,0,1,1,0,1,1
00488067,49,5,44,0,1,1,0,1,1
00489232,31,5,26,0,1,1,0,1,1
00489887,25,3,22,0,1,1,0,1,1
00491942,6,3,3,0,3,2,1,0,0
00492334,43,4,39,0,1,1,0,0,1
00493091,7,0,7,0,0,0,0,0,1
00493510,39,3,36,0,0,0,0,0,1
00497131,25,6,19,0,3,3,0,3,1
00497624,20,2,18,0,0,0,0,0,0
00499594,36,6,30,0,1,1,0,1,1
00501675,45,7,38,0,1,1,0,0,1
00502370,33,3,30,0,1,1,0,0,1
00506057,37,5,32,0,1,1,0,1,1
00506666,38,8,30,0,2,2,0,2,1
00507787,29,0,29,0,0,0,0,0,1
00509305,27,6,21,0,0,0,0,0,0
00509811,110,16,94,0,0,0,0,0,1
00510503,49,3,46,0,1,0,1,1,1
00510607,60,4,56,0,1,1,0,1,1
00511153,86,10,76,0,0,0,0,0,0
00511709,75,10,65,0,3,3,0,3,1
00513286,10,3,7,0,2,2,0,1,1
00514077,32,3,29,0,1,1,0,1,1
00515177,45,9,36,0,1,0,1,0,1
00517461,40,5,35,0,1,1,0,1,1
00518031,32,3,29,0,1,1,0,1,1
00518573,50,2,48,0,2,1,1,2,0
00518895,5,4,1,0,0,0,0,0,0
00519037,20,4,16,0,1,1,0,1,1
00521244,31,3,28,0,0,0,0,0,1
00521970,40,7,33,0,0,0,0,0,1
00522212,35,3,32,0,1,1,0,1,1
00522418,6,1,5,0,2,2,0,0,0
00524446,16,5,11,0,1,1,0,1,1
00525186,26,5,21,0,1,1,0,1,1
00525206,26,5,21,0,2,2,0,2,1
00525927,47,6,41,0,0,0,0,0,1
00527227,93,19,74,0,0,0,0,0,1
00527656,12,1,11,0,0,0,0,0,1
00530526,31,3,28,0,1,1,0,1,1
00532103,13,8,5,0,1,1,0,0,1
00532474,58,8,50,0,0,0,0,0,1
00533432,46,2,44,0,1,1,0,1,1
00534118,32,7,25,0,2,1,1,2,1
00534133,10,5,5,0,4,4,0,0,0
00534232,18,5,13,0,1,1,0,1,1
00535519,6,2,4,0,1,1,0,0,0
00536224,11,4,7,0,1,1,0,1,1
00536464,16,5,11,0,1,1,0,1,1
00537430,36,5,31,0,1,1,0,1,1
00540073,5,4,1,0,1,1,0,1,1
00542762,18,5,13,0,0,0,0,0,0
00544405,73,12,61,0,0,0,0,0,0
00545217,66,7,59,0,1,1,0,1,1
00547526,24,3,21,0,1,1,0,1,1
00547529,10,3,7,0,1,1,0,1,0
00548427,35,3,32,0,2,2,0,2,1
00548648,66,8,58,0,1,1,0,1,1
00548666,3,3,0,0,2,2,0,0,0
00548902,42,0,42,0,0,0,0,0,1
00549181,24,5,19,0,1,1,0,1,1
00549762,37,6,31,0,2,2,0,2,1
00551800,117,0,117,0,0,0,0,0,1
00553014,52,9,43,0,1,1,0,1,1
00553066,40,5,35,0,1,1,0,1,1
00555144,55,14,41,0,0,0,0,0,0
00555214,16,5,11,0,1,1,0,1,1
00556861,89,14,75,0,1,1,0,1,1
00559100,0,0,0,0,0,0,0,0,0
00559567,30,0,30,0,0,0,0,0,1
00559784,61,10,51,0,0,0,0,0,1
00561261,18,0,18,0,0,0,0,0,1
00561319,27,4,23,0,0,0,0,0,0
00562240,16,5,11,0,1,1,0,1,1
00563001,27,5,22,0,1,1,0,1,1
00564818,35,3,32,0,1,1,0,1,1
00565683,17,5,12,0,1,1,0,1,1
00566694,33,5,28,0,0,0,0,0,1
00567232,44,15,29,0,0,0,0,0,1
00570206,25,0,25,0,0,0,0,0,1
00571662,18,4,14,0,1,1,0,1,1
00572631,15,6,9,0,0,0,0,0,1
00573059,6,2,4,0,1,1,0,1,0
00575236,13,3,10,0,0,0,0,0,0
00575462,25,1,24,0,1,1,0,1,1
00577389,27,2,25,0,1,1,0,1,1
00579683,16,8,8,0,1,1,0,0,1
00580628,14,4,10,0,1,1,0,0,1
00580634,29,6,23,0,1,1,0,1,1
00582373,22,0,22,0,0,0,0,0,1
00585297,11,2,9,0,0,0,0,0,1
00585636,23,2,21,0,1,1,0,1,1
00588827,9,6,3,0,1,1,0,0,0
00588975,5,0,5,0,1,1,0,0,0
00592528,26,5,21,0,1,1,0,1,1
00594081,28,2,26,0,1,1,0,1,1
00596121,50,0,50,0,1,1,0,1,1
00596137,35,8,27,0,0,0,0,0,1
00599389,74,18,56,0,0,0,0,0,1
00601207,116,12,104,0,0,0,0,0,1
00601225,27,0,27,0,0,0,0,0,1
00601929,28,14,14,0,0,0,0,0,1
00602854,48,5,43,0,1,1,0,1,1
00603893,58,3,55,0,1,1,0,1,1
00604144,37,3,34,0,1,1,0,1,1
00604198,54,11,43,0,0,0,0,0,0
00604606,13,4,9,0,1,1,0,1,1
00604863,35,3,32,0,1,1,0,1,1
00607778,6,2,4,0,3,3,0,1,0
00611130,35,0,35,0,1,1,0,1,1
00611966,31,5,26,0,1,1,0,1,1
00613735,5,2,3,0,1,1,0,0,0
00615899,35,5,30,0,1,1,0,1,1
00621497,35,8,27,0,1,1,0,1,1
00622773,54,12,42,0,0,0,0,0,0
00623241,37,4,33,0,1,1,0,1,1
00623242,23,0,23,0,0,0,0,0,1
00624194,56,3,53,0,1,0,1,1,1
00624273,50,16,34,0,0,0,0,0,1
00625299,22,1,21,0,0,0,0,0,1
00628256,18,3,15,0,2,2,0,2,1
00628267,16,3,13,0,0,0,0,0,1
00629333,22,3,19,0,0,0,0,0,0
00630294,86,12,74,0,0,0,0,0,1
00632468,24,6,18,0,0,0,0,0,0
00632662,5,2,3,0,3,3,0,0,0
00637246,53,5,48,0,1,1,0,1,1
00638726,26,0,26,0,0,0,0,0,1
00638918,59,4,55,0,1,1,0,1,1
00639050,14,3,11,0,1,1,0,1,0
00641450,5,5,0,0,1,1,0,0,0
00641562,5,4,1,0,2,2,0,0,0
00644264,18,0,18,0,0,0,0,0,1
00647788,37,10,27,0,0,0,0,0,1
00648041,151,13,138,0,0,0,0,0,1
00648560,45,5,40,0,1,1,0,1,1
00653323,32,0,32,0,1,1,0,1,1
00654131,29,5,24,0,1,1,0,1,1
00655990,6,3,3,0,1,1,0,0,0
00656393,13,6,7,0,1,1,0,1,1
00658826,15,0,15,0,0,0,0,0,1
00667002,8,4,4,0,2,2,0,0,1
00667980,38,6,32,0,1,1,0,1,1
00671778,4,2,2,0,3,3,0,0,0
00672908,27,5,22,0,1,1,0,1,1
00674597,11,3,8,0,1,1,0,1,1
00674686,5,2,3,0,1,1,0,0,1
00675001,27,4,23,0,1,1,0,1,1
00675386,27,0,27,0,0,0,0,0,1
00676207,3,2,1,0,2,2,0,0,0
00678077,50,13,37,0,0,0,0,0,1
00678777,35,5,30,0,1,1,0,1,1
00679749,36,0,36,0,0,0,0,0,1
00680973,10,3,7,0,1,1,0,1,1
00683702,36,5,31,0,1,1,0,1,1
00684800,43,4,39,0,2,2,0,2,1
00685718,34,5,29,0,1,1,0,1,1
00688041,23,3,20,0,1,1,0,1,1
00689260,35,6,29,0,1,1,0,1,1
00689729,53,6,47,0,1,1,0,1,1
00691259,5,3,2,0,2,2,0,0,0
00691599,8,3,5,0,2,2,0,0,0
00693662,5,4,1,0,2,2,0,0,0
00694642,6,4,2,0,0,0,0,0,0
00699324,8,4,4,0,1,1,0,0,1
00699334,7,4,3,0,1,1,0,0,1
00701279,34,0,34,0,0,0,0,0,1
00702844,25,0,25,0,0,0,0,0,1
00703348,15,2,13,0,1,1,0,1,0
00706083,31,5,26,0,2,1,1,2,1
00707180,57,14,43,0,0,0,0,0,1
00707749,33,3,30,0,0,0,0,0,1
00710603,30,3,27,0,2,1,1,2,0
00711835,28,2,26,0,1,1,0,1,1
00712425,34,7,27,0,0,0,0,0,0
00716304,34,5,29,0,1,1,0,1,1
00718149,29,3,26,0,1,1,0,1,1
00718329,23,3,20,0,1,1,0,1,1
00718351,19,3,16,0,1,1,0,1,1
00720669,18,5,13,0,1,1,0,1,1
00721107,22,0,22,0,0,0,0,0,1
00722466,16,5,11,0,1,1,0,1,1
00723336,25,5,20,0,1,1,0,1,1
00724728,54,5,49,0,1,1,0,1,0
00725052,15,0,15,0,0,0,0,0,1
00728246,33,2,31,0,1,1,0,1,1
00729279,12,4,8,0,1,1,0,1,1
00730286,23,3,20,0,1,1,0,1,1
00730446,38,5,33,0,0,0,0,0,0
00731249,19,6,13,0,0,0,0,0,0
00735760,3,3,0,0,1,1,0,0,0
00735868,37,5,32,0,1,1,0,1,1
00738674,45,3,42,0,0,0,0,0,1
10455346,1,0,1,0,1,1,0,0,0
10456162,5,5,0,0,2,1,1,1,1
10456768,2,2,0,0,2,2,0,0,0
10457764,2,1,1,0,2,1,1,0,0
10458211,3,1,2,0,1,1,0,1,1
10458300,2,2,0,0,3,3,0,0,0
10458858,2,2,0,0,2,2,0,0,0
10458979,4,4,0,0,1,1,0,1,1
10459023,2,2,0,0,2,2,0,0,0
10461100,1,1,0,0,1,1,0,0,0
10462031,1,0,1,0,1,1,0,0,0
10462702,2,1,1,0,2,1,1,0,0
10462850,2,0,2,0,1,1,0,0,1
10462903,1,1,0,0,1,1,0,0,0
10463376,7,6,1,0,2,2,0,0,1
10463889,1,1,0,0,1,1,0,0,0
10465246,1,1,0,0,1,1,0,0,0
10465596,2,0,2,0,2,2,0,0,0
10466804,2,0,2,0,1,1,0,0,0
10467076,2,1,1,0,1,1,0,0,0
10468997,3,0,3,0,3,3,0,0,0
10469145,7,4,3,0,0,0,0,0,1
10470335,2,2,0,0,1,1,0,0,0
10472227,1,0,1,0,1,1,0,0,0
10473966,1,0,1,0,1,1,0,0,0
10474049,4,4,0,0,2,2,0,0,0
10474514,1,1,0,0,2,2,0,0,0
10474784,2,2,0,0,0,0,0,0,1
10474852,1,0,1,0,1,1,0,0,0
10474926,4,4,0,0,0,0,0,0,1
10475225,3,3,0,0,1,1,0,1,1
10475265,5,1,4,0,1,0,1,0,0
10476084,2,1,1,0,1,1,0,0,0
10477112,9,8,1,0,0,0,0,0,0
10478623,1,1,0,0,1,1,0,0,0
10478849,2,2,0,0,2,2,0,0,0
10479022,2,2,0,0,2,2,0,0,1
10480721,5,1,4,0,0,0,0,0,0
10482004,1,1,0,0,1,1,0,0,1
10482294,2,0,2,0,1,1,0,0,0
10482924,3,2,1,0,2,1,1,1,0
10483397,1,0,1,0,1,1,0,0,0
10484396,3,3,0,0,0,0,0,0,1
10484450,3,2,1,0,1,1,0,0,0
10485013,1,0,1,0,1,1,0,0,0
10485060,1,0,1,0,1,1,0,0,0
10486893,2,1,1,0,2,1,1,0,0
10487441,2,2,0,0,1,1,0,0,0
10487522,2,2,0,0,2,2,0,0,0
10487779,2,2,0,0,2,1,1,1,1
10488340,2,2,0,0,0,0,0,0,0
10489230,3,3,0,0,1,1,0,1,0
10489510,1,0,1,0,0,0,0,0,0
10489698,1,0,1,0,1,1,0,0,0
10490043,4,0,4,0,0,0,0,0,0
10490699,3,2,1,0,2,1,1,0,0
10491402,1,1,0,0,1,1,0,0,0
10492555,2,1,1,0,1,0,1,0,0
10492903,1,0,1,0,1,1,0,0,0
10493699,2,2,0,0,2,2,0,0,1
10494441,4,4,0,0,1,1,0,1,1
10494536,2,2,0,0,1,1,0,0,0
10495701,2,2,0,0,2,2,0,0,0
10496963,2,2,0,0,2,2,0,0,0
10497020,1,1,0,0,1,1,0,0,0
10497511,2,1,1,0,2,1,1,1,0
10497600,6,4,2,0,2,0,2,0,1
10497790,1,1,0,0,1,1,0,0,0
10498473,1,1,0,0,1,1,0,0,0
10498620,2,0,2,0,2,2,0,0,1
10499174,25,9,16,0,0,0,0,0,0
10499509,2,2,0,0,1,1,0,1,1
10499597,2,1,1,0,2,1,1,0,0
10500031,5,5,0,0,3,3,0,0,1
10501584,3,2,1,0,3,1,2,0,0
10502931,2,2,0,0,1,1,0,0,0
10503361,3,3,0,0,1,1,0,1,1
10505215,2,2,0,0,2,2,0,0,0
10505804,2,2,0,0,3,1,2,1,0
10507320,3,2,1,0,1,1,0,1,1
10507896,1,1,0,0,1,1,0,0,0
10508560,2,2,0,0,3,1,2,1,0
10508626,4,2,2,0,5,2,3,1,0
10510024,2,0,2,0,2,2,0,0,0
10510261,2,2,0,0,1,1,0,0,0
10510602,1,1,0,0,1,1,0,0,0
10510770,2,2,0,0,2,2,0,0,0
10511136,7,6,1,0,1,1,0,1,1
10511170,1,1,0,0,1,1,0,0,0
10512241,1,1,0,0,1,1,0,0,0
10512768,3,3,0,0,2,2,0,0,0
10514017,7,6,1,0,1,1,0,1,1
10515035,2,1,1,0,1,1,0,0,0
10516607,1,1,0,0,1,1,0,0,0
10518002,1,1,0,0,1,1,0,0,0
10518331,1,1,0,0,1,1,0,0,0
10519545,2,1,1,0,2,1,1,0,0
10520047,2,2,0,0,1,1,0,0,0
10520175,2,2,0,0,2,2,0,0,0
10520298,9,5,4,0,3,1,2,0,0
10520896,2,1,1,0,2,1,1,0,0
10524306,5,5,0,0,0,0,0,0,0
10525216,5,3,2,0,3,3,0,3,0
10525425,1,1,0,0,1,1,0,0,0
10525525,1,1,0,0,1,1,0,0,0
10527651,1,0,1,0,1,1,0,0,0
10531416,1,0,1,0,0,0,0,0,0
10533697,11,9,2,0,0,0,0,0,1
10535209,4,2,2,0,2,1,1,0,0
10536613,1,0,1,0,1,1,0,0,0
10536645,1,1,0,0,1,1,0,0,0
10537186,1,0,1,0,1,1,0,0,0
10537341,1,1,0,0,1,1,0,0,1
10537836,3,3,0,0,1,1,0,1,0
10538261,1,0,1,0,1,1,0,0,0
10538529,2,2,0,0,4,2,2,0,0
10538549,3,1,2,0,1,1,0,1,0
10538586,3,1,2,0,1,1,0,1,0
10538747,4,0,4,0,4,4,0,0,1
10539127,2,1,1,0,2,1,1,0,0
10539285,1,1,0,0,2,1,1,1,0
10539989,5,4,1,0,3,1,2,0,0
10540716,1,1,0,0,1,1,0,0,0
10541530,1,0,1,0,1,1,0,0,0
10544268,1,0,1,0,1,1,0,0,0
10545203,3,3,0,0,3,3,0,1,1
10545288,1,0,1,0,1,1,0,0,0
10546350,2,2,0,0,1,1,0,0,0
10546384,3,3,0,0,3,3,0,0,0
10547122,4,4,0,0,1,1,0,0,1
10548306,3,3,0,0,1,1,0,0,0
10548649,1,1,0,0,1,1,0,1,0
10549345,2,2,0,0,2,2,0,0,0
10549882,1,1,0,0,1,1,0,0,0
10550332,2,2,0,0,2,2,0,0,0
10552998,1,1,0,0,1,1,0,0,0
10555412,2,1,1,0,1,1,0,0,0
10555687,1,1,0,0,1,1,0,0,0
10556538,3,1,2,0,2,1,1,0,0
10557349,1,1,0,0,1,1,0,0,0
10557753,2,0,2,0,2,2,0,0,0
10557963,5,1,4,0,4,1,3,0,0
10558358,6,2,4,0,2,1,1,1,0
10558546,2,2,0,0,0,0,0,0,0
10559383,2,2,0,0,1,1,0,0,0
10560944,2,0,2,0,2,2,0,0,0
10561329,2,1,1,0,1,0,1,0,0
10565003,1,1,0,0,1,1,0,0,0
10567050,1,1,0,0,1,1,0,0,0
10567896,1,1,0,0,1,1,0,0,0
10570450,2,2,0,0,1,1,0,0,0
10571068,6,4,2,0,3,3,0,3,0
10572202,1,1,0,0,1,1,0,0,0
10573411,1,1,0,0,1,1,0,0,0
10574204,1,1,0,0,1,1,0,0,0
10574548,1,1,0,0,1,1,0,0,0
10574807,2,2,0,0,1,1,0,0,0
10577740,1,0,1,0,0,0,0,0,0
10578350,1,1,0,0,1,1,0,0,0
10579427,1,0,1,0,1,1,0,0,0
10582411,10,8,2,0,0,0,0,0,0
10582621,2,2,0,0,2,2,0,0,0
10584471,9,4,5,0,1,0,1,0,0
10584815,2,2,0,0,1,1,0,0,0
10584835,1,1,0,0,5,5,0,0,0
10585361,1,1,0,0,1,1,0,0,0
10585646,1,0,1,0,1,1,0,0,0
10586362,13,12,1,0,0,0,0,0,1
10586823,2,2,0,0,1,1,0,0,0
10586854,1,1,0,0,1,1,0,0,0
10587945,1,0,1,0,1,1,0,0,0
10588094,2,0,2,0,2,2,0,0,1
10588399,1,0,1,0,1,1,0,0,0
10589480,1,0,1,0,1,1,0,0,0
10590365,4,0,4,0,2,2,0,0,0
10592542,2,1,1,0,1,1,0,0,0
10593039,1,1,0,0,0,0,0,0,0
10593143,8,5,3,0,1,1,0,0,0
10593605,2,2,0,0,2,2,0,0,0
10595477,2,2,0,0,1,1,0,0,0
10596031,1,1,0,0,1,1,0,0,0
10598631,5,4,1,0,2,1,1,1,0
10599012,1,0,1,0,1,1,0,0,0
10600290,5,2,3,0,2,0,2,0,0
10600329,2,1,1,0,2,1,1,0,1
10601295,1,0,1,0,1,1,0,0,0
10602117,1,1,0,0,1,1,0,0,0
10602126,1,1,0,0,1,1,0,0,0
10603387,1,0,1,0,1,1,0,0,0
10603891,3,0,3,0,1,1,0,0,0
10605500,2,0,2,0,2,2,0,0,0
10605734,6,3,3,0,2,2,0,2,1
10605876,7,6,1,0,1,1,0,1,1
10608258,1,1,0,0,1,1,0,0,0
10608362,3,1,2,0,4,1,3,1,0
10609635,7,6,1,0,1,1,0,1,1
10610416,1,1,0,0,1,1,0,0,0
10611815,5,4,1,0,2,2,0,2,0
10611970,2,2,0,0,2,2,0,0,0
10611993,5,5,0,0,0,0,0,0,0
10613213,2,1,1,0,1,1,0,0,0
10614921,1,0,1,0,0,0,0,0,0
10615394,4,3,1,0,1,1,0,0,1
10617856,3,2,1,0,2,1,1,0,0
10617898,3,1,2,0,2,1,1,0,0
10617998,2,2,0,0,1,1,0,0,0
10619376,1,0,1,0,1,1,0,0,0
10619917,10,8,2,0,1,1,0,1,1
10620030,1,0,1,0,1,1,0,0,0
10622154,3,3,0,0,3,3,0,1,0
10622548,3,3,0,0,3,3,0,0,0
10622625,2,1,1,0,1,1,0,0,0
10622971,23,22,1,0,0,0,0,0,0
10623211,2,2,0,0,3,3,0,0,0
10624693,2,2,0,0,2,0,2,0,0
10625563,1,1,0,0,1,1,0,0,0
09360484,1,1,0,0,1,1,0,0,0
09360857,2,2,0,0,1,1,0,0,0
09361066,6,4,2,0,3,2,1,1,0
09361189,3,3,0,0,1,1,0,0,1
09362846,1,1,0,0,1,1,0,0,0
09363235,2,1,1,0,1,1,0,0,0
09364524,2,2,0,0,0,0,0,0,0
09364652,2,2,0,0,1,1,0,0,0
09364687,6,5,1,0,3,3,0,0,0
09364884,5,3,2,0,1,1,0,1,1
09368112,3,3,0,0,2,2,0,0,1
09368430,1,0,1,0,0,0,0,0,0
09369220,2,1,1,0,1,1,0,0,0
09369712,7,0,7,0,1,1,0,1,1
09370441,2,2,0,0,1,1,0,0,0
09370759,9,6,3,0,3,3,0,0,0
09370874,4,0,4,0,0,0,0,0,0
09373395,1,1,0,0,1,1,0,0,0
09376581,2,1,1,0,4,2,2,1,1
09376628,10,7,3,0,2,1,1,2,1
09376852,1,1,0,0,0,0,0,0,0
09377567,6,1,5,0,2,2,0,0,0
09377830,14,7,7,0,2,2,0,2,0
09382052,2,2,0,0,2,2,0,0,0
09382373,6,6,0,0,1,1,0,1,1
09382531,1,1,0,0,1,1,0,0,1
09383203,4,3,1,0,3,2,1,1,1
09383522,1,1,0,0,1,1,0,0,0
09384918,3,0,3,0,2,2,0,0,0
09385628,7,3,4,0,2,2,0,2,1
09386563,3,0,3,0,0,0,0,0,1
09387457,2,0,2,0,1,1,0,0,0
09387689,3,2,1,0,1,1,0,1,1
09387880,6,2,4,0,1,1,0,0,0
09388657,5,5,0,0,3,0,3,0,0
09389985,5,2,3,0,1,1,0,0,0
09390569,3,0,3,0,1,1,0,0,1
09390637,5,0,5,0,0,0,0,0,1
09390669,2,0,2,0,0,0,0,0,1
09390696,8,0,8,0,0,0,0,0,0
09390914,1,1,0,0,1,1,0,0,0
09396662,1,0,1,0,1,1,0,0,1
09397665,2,2,0,0,2,2,0,0,0
09398299,4,2,2,0,2,2,0,0,0
09398578,7,3,4,0,0,0,0,0,0
09399752,1,1,0,0,1,1,0,0,0
09401541,2,1,1,0,1,1,0,0,0
09402145,1,1,0,0,1,1,0,0,0
09403611,6,3,3,0,2,1,1,2,1
09403614,6,3,3,0,2,1,1,2,1
09403656,5,2,3,0,2,1,1,2,1
09403678,2,2,0,0,2,2,0,0,0
09404196,6,4,2,0,0,0,0,0,0
09404343,6,5,1,0,0,0,0,0,1
09404925,2,1,1,0,1,1,0,0,0
09406669,2,2,0,0,2,2,0,0,0
09406851,8,4,4,0,1,1,0,1,1
09412065,1,1,0,0,1,1,0,0,0
09413087,5,2,3,0,0,0,0,0,0
09413544,5,3,2,0,0,0,0,0,0
09413632,10,2,8,0,3,1,2,1,0
09414038,3,2,1,0,1,1,0,1,1
09415958,9,3,6,0,3,1,2,3,0
09416703,2,2,0,0,2,2,0,0,0
09418019,1,0,1,0,0,0,0,0,1
09418239,1,1,0,0,1,1,0,0,0
09418518,2,0,2,0,2,2,0,0,1
09420444,1,1,0,0,1,1,0,0,0
09420477,2,2,0,0,2,2,0,0,0
09420724,6,4,2,0,1,1,0,0,1
09421831,1,1,0,0,1,1,0,0,0
09422439,5,5,0,0,0,0,0,0,0
09422470,5,3,2,0,1,1,0,1,1
09422949,3,0,3,0,1,1,0,0,0
09423672,1,1,0,0,1,1,0,0,0
09423770,2,2,0,0,3,2,1,0,0
09425694,1,1,0,0,1,1,0,0,0
09426545,2,0,2,0,1,1,0,0,0
09427358,3,3,0,0,0,0,0,0,1
09427434,3,2,1,0,1,1,0,0,1
09428416,1,1,0,0,1,1,0,0,0
09429984,2,2,0,0,1,1,0,0,0
09430670,2,0,2,0,0,0,0,0,1
09430699,2,2,0,0,1,1,0,0,1
09430710,3,1,2,0,1,1,0,0,1
09432722,16,9,7,0,0,0,0,0,0
09433902,8,5,3,0,1,1,0,0,0
09434057,2,2,0,0,2,2,0,0,0
09434153,2,2,0,0,2,2,0,0,0
09436039,2,0,2,0,0,0,0,0,0
09436070,2,1,1,0,1,1,0,0,0
09436668,7,5,2,0,1,1,0,1,1
09438468,2,2,0,0,1,1,0,0,0
09438527,1,1,0,0,1,1,0,0,0
09441581,7,6,1,0,6,5,1,0,0
09442376,3,0,3,0,1,1,0,0,0
09442537,5,5,0,0,1,1,0,0,0
09443401,1,1,0,0,0,0,0,0,0
09443606,1,1,0,0,1,1,0,0,0
09445624,1,0,1,0,1,1,0,0,0
09446304,3,0,3,0,1,1,0,0,0
09446993,1,0,1,0,1,1,0,0,0
09447152,1,1,0,0,1,1,0,0,0
09447156,3,0,3,0,0,0,0,0,1
09447166,1,0,1,0,1,1,0,0,0
09448827,1,1,0,0,2,2,0,0,1
09448845,3,0,3,0,2,2,0,0,1
09448940,2,2,0,0,1,1,0,1,0
09448972,2,2,0,0,2,1,1,0,0
09451790,2,2,0,0,2,2,0,0,0
09452136,2,2,0,0,1,1,0,0,0
09452388,2,0,2,0,0,0,0,0,1
09452974,2,0,2,0,0,0,0,0,0
09454666,3,3,0,0,2,2,0,0,0
09454789,1,0,1,0,0,0,0,0,0
09454858,2,0,2,0,1,1,0,1,0
09456829,3,2,1,0,2,2,0,0,0
09458513,10,3,7,0,2,2,0,2,0
09458564,4,4,0,0,1,1,0,1,1
09461008,1,1,0,0,1,1,0,0,0
09462616,6,2,4,0,1,1,0,1,1
09462641,6,0,6,0,0,0,0,0,1
09463485,1,1,0,0,1,1,0,0,0
09464066,2,0,2,0,0,0,0,0,0
09466013,13,0,13,0,1,1,0,1,0
09466094,2,2,0,0,1,1,0,0,0
09466387,2,1,1,0,1,1,0,0,0
09466423,4,2,2,0,1,1,0,0,0
09466430,4,3,1,0,2,2,0,0,1
09467440,3,3,0,0,1,1,0,0,0
09468390,1,1,0,0,1,1,0,0,0
09469336,2,1,1,0,1,1,0,0,1
09469356,3,2,1,0,1,1,0,0,1
09469380,5,3,2,0,1,1,0,1,1
09471328,2,2,0,0,2,2,0,0,0
09472272,5,5,0,0,5,5,0,0,0
09472918,3,3,0,0,1,1,0,1,1
09473828,1,1,0,0,1,1,0,0,0
09474199,5,5,0,0,5,5,0,0,0
09474500,12,8,4,0,0,0,0,0,0
09475195,5,2,3,1,3,3,0,1,0
09475226,1,0,1,0,1,1,0,0,0
09476534,1,1,0,0,1,1,0,0,1
09477131,2,2,0,0,1,1,0,0,0
09477566,1,1,0,0,1,1,0,0,0
09479417,4,3,1,0,2,1,1,0,1
09479587,3,2,1,0,1,1,0,0,1
09479845,2,1,1,0,2,2,0,1,0
09481161,12,10,2,0,2,1,1,2,1
09481496,4,4,0,0,0,0,0,0,1
09482527,9,1,8,1,6,1,5,1,0
09482853,1,0,1,0,1,1,0,0,0
09483670,4,0,4,0,0,0,0,0,1
09484335,2,2,0,0,1,1,0,0,0
09484410,1,0,1,0,1,1,0,0,0
09484662,9,3,6,0,2,2,0,2,1
09484685,2,0,2,0,6,6,0,0,1
09485713,1,1,0,0,1,1,0,0,0
09487057,2,2,0,0,2,2,0,0,0
09487576,1,0,1,0,1,1,0,0,0
09488286,3,3,0,0,1,1,0,0,0
09489464,3,2,1,0,2,2,0,0,1
09489483,3,2,1,0,2,2,0,0,1
09489501,7,4,3,0,2,2,0,0,1
09490008,14,8,6,0,1,1,0,0,0
09490492,3,3,0,0,1,1,0,0,0
09494070,5,5,0,0,2,2,0,0,0
09494087,3,3,0,0,3,3,0,0,0
09494501,2,0,2,0,1,1,0,0,0
09497401,2,0,2,0,2,2,0,0,0
09498606,2,2,0,0,3,3,0,0,0
09499110,2,2,0,0,1,1,0,0,0
09500119,2,0,2,0,0,0,0,0,0
09500166,1,1,0,0,1,1,0,0,1
09500227,1,1,0,0,1,1,0,0,1
09501207,2,2,0,0,2,1,1,0,1
09501957,2,1,1,0,1,1,0,0,1
09502148,2,1,1,0,1,1,0,0,1
09504181,1,1,0,0,1,1,0,0,0
09504299,2,0,2,0,0,0,0,0,0
09504988,4,2,2,0,3,2,1,0,1
09505971,9,4,5,0,0,0,0,0,0
09508524,1,1,0,0,1,1,0,0,0
09509304,2,1,1,0,2,1,1,0,0
09511992,2,0,2,0,1,1,0,1,1
09512134,2,1,1,0,1,1,0,0,0
09512690,2,2,0,0,1,1,0,0,0
09512722,8,5,3,0,6,4,2,1,0
09512728,8,5,3,0,6,4,2,1,0
09512806,3,2,1,0,2,1,1,1,0
09512874,1,1,0,0,1,1,0,0,0
09513536,1,1,0,0,0,0,0,0,0
09513757,1,1,0,0,1,1,0,0,0
09514544,1,1,0,0,1,1,0,0,0
09514575,1,1,0,0,2,2,0,1,0
09514819,4,4,0,0,2,2,0,1,1
09516341,6,3,3,0,0,0,0,0,0
09516380,5,5,0,0,0,0,0,0,0
09516704,14,0,14,0,0,0,0,0,0
09517834,3,2,1,0,1,1,0,0,1
09518338,4,3,1,0,1,1,0,0,1
09518345,3,3,0,0,4,3,1,0,0
09518593,2,1,1,0,1,1,0,0,0
09519028,2,2,0,0,2,2,0,0,0
09519911,1,1,0,0,1,1,0,0,0
09520999,3,0,3,0,0,0,0,0,1
09521075,1,0,1,0,0,0,0,0,1
09521123,1,0,1,0,0,0,0,0,1
09521351,1,0,1,0,0,0,0,0,1
09521415,1,0,1,0,0,0,0,0,1
09521428,1,0,1,0,0,0,0,0,1
09521430,1,0,1,0,0,0,0,0,1
09521442,1,0,1,0,0,0,0,0,1
09521449,1,0,1,0,0,0,0,0,1
09521495,1,0,1,0,0,0,0,0,1
09521501,1,0,1,0,0,0,0,0,1
09521553,1,0,1,0,0,0,0,0,1
09521557,1,0,1,0,0,0,0,0,1
09521558,1,0,1,0,0,0,0,0,1
09521592,1,0,1,0,0,0,0,0,1
09521621,2,2,0,0,2,2,0,0,0
09521622,1,0,1,0,0,0,0,0,1
09521625,1,0,1,0,0,0,0,0,1
09521883,1,0,1,0,0,0,0,0,1
09521936,1,0,1,0,0,0,0,0,1
09521954,1,0,1,0,0,0,0,0,1
09521993,1,0,1,0,0,0,0,0,1
09523187,8,3,5,0,2,2,0,0,1
09523744,11,1,10,0,6,1,5,0,0
09524321,2,2,0,0,2,2,0,0,0
09524602,3,2,1,0,1,1,0,0,0
09524884,7,2,5,0,1,1,0,1,1
09525278,2,2,0,0,1,1,0,0,0
09525376,7,2,5,0,1,1,0,1,1
09525853,2,2,0,0,2,2,0,0,0
09530088,1,0,1,0,0,0,0,0,0
09533323,2,2,0,0,0,0,0,0,0
09533744,1,1,0,0,1,1,0,0,0
09534793,2,1,1,0,1,1,0,0,1
09536422,3,2,1,0,1,1,0,0,0
09539644,1,1,0,0,1,1,0,0,0
09540439,2,2,0,0,2,2,0,0,0
09540661,2,0,2,0,0,0,0,0,1
09541366,10,0,10,0,3,1,2,0,0
09541849,2,2,0,0,4,4,0,1,0
09542163,3,2,1,0,1,1,0,1,1
09542177,3,2,1,0,1,1,0,0,1
09542812,1,1,0,0,1,1,0,0,0
09545340,1,0,1,0,1,1,0,0,0
09545556,7,0,7,0,3,1,2,0,0
09545668,3,1,2,0,1,1,0,1,0
09547558,1,1,0,0,1,1,0,0,0
09548843,11,3,8,0,7,2,5,0,0
09550181,11,1,10,0,6,1,5,0,0
09550202,6,0,6,0,2,1,1,0,0
09551510,2,2,0,0,2,2,0,0,0
09552311,8,2,6,0,3,2,1,1,1
09553892,3,0,3,0,0,0,0,0,0
09557142,3,2,1,0,1,1,0,0,1
09558823,5,0,5,0,2,2,0,0,1
09559332,2,1,1,0,2,2,0,0,1
09559344,2,1,1,0,1,1,0,0,1
09559394,1,1,0,0,1,1,0,0,0
09559419,3,0,3,0,0,0,0,0,1
09559440,2,1,1,0,1,1,0,0,1
08271384,18,8,10,0,1,1,0,0,1
08271985,21,3,18,0,2,1,1,2,1
08272167,6,4,2,0,1,1,0,1,1
08272183,16,3,13,0,1,1,0,1,1
08272234,9,6,3,0,0,0,0,0,0
08272250,14,6,8,0,1,1,0,1,1
08272354,13,2,11,0,1,1,0,1,1
08274655,2,0,2,0,1,1,0,0,0
08274789,2,1,1,0,1,1,0,0,1
08276620,1,1,0,0,1,1,0,0,0
08277551,1,1,0,0,1,1,0,0,0
08278739,5,3,2,0,2,2,0,0,1
08282623,4,2,2,0,1,1,0,0,0
08282931,3,2,1,0,1,1,0,0,1
08283042,2,2,0,0,3,3,0,0,0
08283131,11,4,7,0,1,0,1,1,1
08283695,2,1,1,0,1,1,0,0,0
08284274,7,6,1,0,0,0,0,0,0
08284280,2,2,0,0,1,1,0,0,0
08285984,1,1,0,0,1,1,0,0,0
08286295,33,15,18,0,4,3,1,0,0
08288548,3,1,2,0,4,3,1,0,0
08288600,1,1,0,0,2,2,0,0,0
08290086,3,2,1,0,1,1,0,1,1
08290423,14,6,8,0,0,0,0,0,0
08290455,8,6,2,0,2,1,1,1,0
08290937,3,2,1,0,1,1,0,0,0
08291888,3,3,0,0,3,3,0,0,0
08294615,2,2,0,0,2,2,0,0,0
08295042,1,1,0,0,0,0,0,0,1
08295181,2,1,1,0,0,0,0,0,1
08295286,1,1,0,0,1,1,0,0,0
08295307,3,2,1,0,2,2,0,0,0
08295748,3,2,1,0,1,1,0,0,0
08296453,2,2,0,0,1,1,0,0,0
08298940,10,6,4,0,0,0,0,0,0
08299496,4,0,4,0,0,0,0,0,1
08300427,3,2,1,0,0,0,0,0,0
08300587,4,0,4,0,0,0,0,0,1
08302822,8,4,4,0,0,0,0,0,1
08304492,3,1,2,0,1,1,0,0,0
08305570,3,2,1,0,3,3,0,3,1
08307685,3,0,3,0,2,1,1,0,0
08309457,11,6,5,0,6,6,0,5,1
08309693,2,1,1,0,1,1,0,0,0
08310813,5,4,1,0,1,0,1,1,1
08310843,14,0,14,0,0,0,0,0,1
08311200,18,8,10,0,0,0,0,0,0
08312420,4,3,1,0,1,1,0,0,0
08312487,7,4,3,0,1,0,1,1,1
08314967,6,5,1,0,0,0,0,0,0
08315446,1,1,0,0,1,1,0,0,0
08316380,1,1,0,0,0,0,0,0,1
08318939,1,1,0,0,0,0,0,0,0
08319063,1,1,0,0,0,0,0,0,0
08321170,4,0,4,0,0,0,0,0,0
08321254,7,4,3,0,4,4,0,0,1
08321446,1,0,1,0,0,0,0,0,1
08321586,9,3,6,0,2,1,1,2,1
08322209,5,3,2,0,1,1,0,1,0
08323206,3,2,1,0,1,1,0,0,0
08324940,12,6,6,1,1,1,0,1,1
08326256,1,1,0,0,1,1,0,0,0
08327435,2,2,0,0,1,1,0,0,0
08328145,3,2,1,0,2,2,0,0,0
08329317,3,2,1,0,1,1,0,0,0
08330611,2,2,0,0,2,2,0,0,0
08334627,10,4,6,0,0,0,0,0,0
08335008,4,4,0,0,2,2,0,0,1
08335167,2,2,0,0,2,2,0,0,0
08336356,3,2,1,0,1,1,0,0,0
08336375,1,1,0,0,1,1,0,0,0
08336545,2,1,1,0,1,1,0,0,0
08336774,2,2,0,0,1,1,0,0,0
08337483,2,2,0,0,1,1,0,0,0
08338106,2,2,0,0,1,1,0,0,0
08338562,2,0,2,0,0,0,0,0,0
08338746,2,0,2,0,1,1,0,1,1
08338990,4,4,0,0,1,1,0,0,0
08339761,5,0,5,0,2,2,0,0,1
08343538,2,1,1,0,1,1,0,0,0
08346019,10,3,7,0,1,1,0,1,0
08346842,4,3,1,1,1,1,0,0,0
08348098,2,0,2,0,0,0,0,0,0
08349593,1,1,0,0,1,1,0,0,1
08349638,5,3,2,0,2,2,0,2,1
08353765,2,2,0,0,2,2,0,0,0
08355909,5,1,4,0,0,0,0,0,0
08356706,41,16,25,0,0,0,0,0,0
08359113,21,5,16,0,0,0,0,0,1
08359705,14,9,5,0,1,1,0,0,0
08359812,2,0,2,0,1,1,0,0,0
08362867,2,2,0,0,1,1,0,0,0
08365274,2,2,0,0,1,1,0,0,0
08366788,1,0,1,0,0,0,0,0,1
08367867,14,4,10,0,1,1,0,1,1
08368317,1,1,0,0,1,1,0,0,0
08370902,2,1,1,0,1,1,0,0,0
08372184,3,0,3,0,0,0,0,0,1
08375453,2,2,0,0,1,1,0,0,0
08376361,3,2,1,0,2,1,1,0,0
08377340,3,2,1,0,2,2,0,0,0
08378172,3,2,1,0,1,1,0,0,0
08379496,1,1,0,0,1,1,0,0,0
08379841,1,1,0,0,1,1,0,0,0
08381392,2,2,0,0,1,1,0,0,0
08383471,1,0,1,0,0,0,0,0,0
08383568,3,3,0,0,1,1,0,0,1
08385190,4,2,2,0,1,1,0,0,1
08392167,1,1,0,0,1,1,0,0,0
08392713,9,2,7,0,1,1,0,0,0
08392938,3,1,2,0,1,1,0,0,0
08393301,3,3,0,0,1,1,0,1,0
08395289,3,2,1,0,4,2,2,0,1
08395925,3,0,3,0,1,1,0,0,1
08396817,3,1,2,0,1,1,0,0,0
08397102,4,0,4,0,0,0,0,0,0
08397898,3,0,3,0,0,0,0,0,0
08398077,4,4,0,0,2,2,0,1,1
08398246,2,0,2,0,0,0,0,0,0
08398703,2,2,0,0,1,1,0,0,0
08398865,2,1,1,0,1,1,0,0,0
08400456,3,2,1,0,1,1,0,0,0
08401483,2,2,0,0,2,2,0,0,0
08404129,1,1,0,0,1,1,0,0,0
08404165,1,1,0,0,1,1,0,0,0
08404285,2,2,0,0,2,1,1,1,0
08405783,2,1,1,0,1,1,0,0,0
08406149,23,10,13,0,0,0,0,0,0
08406187,2,1,1,0,1,1,0,0,0
08408637,3,3,0,0,2,1,1,0,0
08409289,21,9,12,0,0,0,0,0,0
08409391,1,1,0,0,1,1,0,0,0
08409765,6,2,4,0,1,1,0,0,1
08412018,1,1,0,0,1,1,0,0,0
08412502,2,1,1,0,1,1,0,0,0
08412510,2,1,1,0,1,1,0,0,1
08412608,2,2,0,0,1,1,0,0,0
08413342,9,8,1,0,0,0,0,0,0
08415007,3,0,3,0,0,0,0,0,0
08415470,3,3,0,0,1,1,0,1,0
08415561,1,1,0,0,1,1,0,0,0
08415696,4,2,2,0,1,1,0,0,1
08416073,2,1,1,0,1,1,0,0,0
08416148,1,1,0,0,0,0,0,0,0
08416359,4,2,2,0,3,3,0,0,0
08418325,3,2,1,0,0,0,0,0,1
08419102,1,1,0,0,1,1,0,0,0
08420243,12,6,6,0,0,0,0,0,1
08422054,2,2,0,0,1,1,0,1,1
08422643,2,2,0,0,2,2,0,0,0
08423050,3,2,1,0,1,1,0,0,0
08425363,9,5,4,0,1,1,0,1,1
08425695,3,2,1,0,2,2,0,0,0
08427496,3,1,2,0,1,1,0,0,0
08429424,4,3,1,0,3,3,0,0,0
08430154,9,0,9,0,0,0,0,0,1
08430305,7,2,5,0,0,0,0,0,0
08430689,2,2,0,0,2,2,0,0,0
08431680,2,0,2,0,2,2,0,0,1
08432971,5,3,2,0,3,2,1,1,1
08433699,1,1,0,0,1,1,0,0,0
08436383,3,3,0,0,2,2,0,0,0
08437029,1,0,1,0,1,1,0,0,0
08438970,12,4,8,0,2,2,0,2,1
08439027,3,3,0,0,0,0,0,0,0
08442645,2,1,1,0,1,1,0,0,0
08444641,1,1,0,0,1,1,0,0,0
08445524,1,1,0,0,1,1,0,0,0
08447006,15,4,11,0,0,0,0,0,1
08447479,2,2,0,0,2,1,1,0,0
08447573,2,2,0,0,1,1,0,0,0
08447779,1,1,0,0,1,1,0,0,0
08449024,1,1,0,0,1,1,0,0,0
08449267,3,0,3,0,0,0,0,0,1
08449344,15,4,11,0,1,1,0,1,1
08450211,2,1,1,0,1,1,0,0,1
08451196,1,0,1,0,0,0,0,0,0
08451340,2,0,2,0,0,0,0,0,0
08451514,1,1,0,0,1,1,0,0,0
08451521,1,0,1,0,0,0,0,0,0
08451815,1,1,0,0,1,1,0,0,0
08451858,5,4,1,0,0,0,0,0,0
08452584,1,1,0,0,1,1,0,0,0
08452822,3,1,2,0,1,1,0,0,0
08454473,3,1,2,0,1,1,0,0,0
08454816,5,3,2,0,2,1,1,1,1
08455969,6,0,6,0,0,0,0,0,1
08456001,3,2,1,0,1,1,0,0,0
08456543,2,2,0,0,2,2,0,0,0
08457584,7,6,1,0,1,1,0,0,0
08457973,3,0,3,0,0,0,0,0,1
08458139,3,3,0,0,2,2,0,0,1
08458188,3,3,0,0,2,2,0,0,1
08458625,30,5,25,0,0,0,0,0,0
08458686,30,5,25,0,0,0,0,0,0
08458805,2,1,1,0,1,1,0,0,0
08458959,1,0,1,0,1,1,0,0,0
08458989,1,0,1,0,1,1,0,0,1
08460100,15,4,11,0,2,2,0,2,1
08463158,5,4,1,0,1,1,0,1,0
08463187,12,3,9,0,1,1,0,1,0
08463808,2,2,0,0,2,2,0,0,0
08463903,2,2,0,0,0,0,0,0,1
08464005,2,2,0,0,2,2,0,0,0
08464800,6,4,2,0,1,1,0,1,0
08465383,3,3,0,0,2,2,0,0,0
08465498,2,2,0,0,2,2,0,0,0
08466138,2,1,1,0,1,1,0,0,0
08467215,1,0,1,0,0,0,0,0,1
08468060,2,2,0,0,2,2,0,0,0
08470150,4,3,1,0,2,2,0,1,1
08471677,2,2,0,0,1,1,0,0,0
08472025,11,2,9,0,2,2,0,0,0
08474849,1,1,0,0,1,1,0,1,0
08475552,1,1,0,0,1,1,0,0,0
08475693,8,4,4,0,2,1,1,2,1
08475750,9,4,5,0,1,1,0,1,1
08476476,1,0,1,0,0,0,0,0,1
08477278,2,0,2,0,0,0,0,0,1
08477940,3,3,0,0,2,2,0,0,0
08478180,1,0,1,0,0,0,0,0,0
08478678,1,1,0,0,1,1,0,0,0
08478767,2,0,2,0,1,1,0,0,0
08479033,12,2,10,0,1,1,0,1,1
08479228,2,2,0,0,2,2,0,0,0
08483386,2,0,2,0,1,1,0,0,0
08483535,3,3,0,0,2,2,0,0,1
08485163,2,2,0,0,1,1,0,0,0
08486144,2,0,2,0,2,2,0,0,0
08486509,14,8,6,0,1,1,0,1,1
08486553,14,6,8,0,1,1,0,1,1
08486606,11,3,8,0,1,1,0,1,1
08486652,11,3,8,0,1,1,0,1,1
08486720,12,3,9,0,1,1,0,1,1
08486960,3,3,0,0,1,1,0,0,0
08489085,4,2,2,0,1,1,0,0,1
08489220,2,2,0,0,2,2,0,0,0
08490611,1,1,0,0,1,1,0,0,0
08490730,6,3,3,0,2,2,0,0,0
08491307,1,1,0,0,1,1,0,0,0
08491453,9,3,6,0,2,1,1,0,1
08491683,2,0,2,0,0,0,0,0,0
08491718,8,1,7,0,2,1,1,1,1
08492451,6,2,4,0,1,1,0,1,0
08492457,3,1,2,0,0,0,0,0,0
08493685,4,2,2,0,1,1,0,0,0
08493946,2,2,0,0,2,2,0,0,0
08494309,2,2,0,0,2,2,0,0,0
08495394,8,5,3,0,4,4,0,0,0
08495673,10,7,3,0,2,2,0,0,1
08496640,3,2,1,0,1,1,0,1,1
08497586,2,0,2,0,0,0,0,0,1
08499273,5,3,2,0,1,1,0,1,1
08499813,1,0,1,0,0,0,0,0,1
08500308,1,1,0,0,1,1,0,0,0
08500793,1,1,0,0,1,1,0,0,0
08501272,2,1,1,0,1,1,0,0,0
08501860,2,2,0,0,1,1,0,1,0
08502070,1,1,0,0,1,1,0,0,0
08502871,2,0,2,0,1,1,0,0,0
08504199,2,1,1,0,1,1,0,0,0
08504835,6,4,2,0,1,1,0,1,1
08505206,2,2,0,0,2,2,0,0,0
08506088,5,3,2,0,1,1,0,0,0
08506143,2,2,0,0,2,2,0,0,0
08507003,6,1,5,0,1,1,0,0,0
08509488,1,1,0,0,1,1,0,1,0
08509512,1,1,0,0,1,1,0,1,0
08510088,2,2,0,0,1,1,0,0,0
08510241,1,1,0,0,1,1,0,0,0
08511293,2,2,0,0,2,2,0,0,0
08511344,9,2,7,0,3,1,2,0,0
08514281,1,1,0,0,1,1,0,0,0
08514550,3,2,1,0,1,1,0,0,0
08514974,3,3,0,0,3,3,0,0,0
08515335,3,2,1,0,2,2,0,0,1
08516986,14,3,11,0,2,2,0,2,1
08517742,2,2,0,0,1,1,0,0,0
08520729,1,1,0,0,1,1,0,1,0
08521753,6,0,6,0,0,0,0,0,1
08524643,3,3,0,0,2,2,0,0,0
08525604,6,1,5,0,1,1,0,0,0
08527187,3,2,1,0,2,2,0,0,0
08527536,3,2,1,0,0,0,0,0,0
08528475,8,5,3,0,1,1,0,1,0
08529099,13,8,5,0,1,1,0,0,0
08529446,8,2,6,0,1,1,0,1,1
10780217,13,10,3,0,0,0,0,0,0
10780732,1,0,1,0,1,1,0,0,0
10781199,1,0,1,0,1,1,0,0,0
10781433,2,2,0,0,0,0,0,0,0
10781896,3,1,2,0,3,1,2,0,0
10782017,1,0,1,0,1,1,0,0,0
10783342,2,1,1,0,1,1,0,0,0
10785898,1,1,0,0,1,1,0,0,0
10786166,1,1,0,0,1,1,0,0,0
10786521,1,1,0,0,1,1,0,0,0
10786620,1,1,0,0,1,1,0,0,0
10787361,1,1,0,0,1,1,0,0,0
10789182,1,1,0,0,1,1,0,1,0
10793104,1,1,0,0,1,1,0,0,0
10793423,1,1,0,0,1,1,0,0,0
10794518,1,1,0,0,1,1,0,0,0
10794874,2,2,0,0,1,1,0,1,0
10795183,1,1,0,0,1,1,0,0,0
10795295,1,1,0,0,1,1,0,0,0
10795378,2,2,0,0,2,2,0,0,0
10795421,2,1,1,0,2,1,1,0,0
10796006,7,5,2,2,3,1,2,1,0
10796595,3,3,0,0,3,3,0,0,0
10798023,2,2,0,0,2,2,0,0,0
10799072,3,3,0,0,1,1,0,1,0
10799097,3,3,0,0,1,1,0,1,0
10799250,3,3,0,0,1,1,0,1,0
10799393,1,0,1,0,1,1,0,0,0
10800225,2,1,1,0,1,1,0,0,0
10800391,2,1,1,0,1,1,0,0,0
10800931,1,1,0,0,1,1,0,0,0
10801154,2,2,0,0,0,0,0,0,0
10803852,6,6,0,0,3,2,1,2,1
10804475,2,2,0,0,2,2,0,0,1
10804678,4,4,0,0,0,0,0,0,0
10805544,2,1,1,0,2,1,1,0,0
10806387,1,1,0,0,2,2,0,1,0
10807353,1,1,0,0,1,1,0,0,0
10809231,1,1,0,0,2,2,0,0,0
10809267,1,1,0,0,1,1,0,0,0
10809348,3,3,0,0,2,2,0,2,1
10809493,4,2,2,0,2,2,0,0,0
10809850,1,0,1,0,1,1,0,0,0
10810086,4,2,2,0,2,2,0,0,0
10810516,3,3,0,0,3,3,0,0,0
10811528,1,1,0,0,1,1,0,0,0
10813531,5,5,0,0,1,1,0,1,1
10815928,2,2,0,0,1,1,0,0,1
10816042,2,2,0,0,2,2,0,0,0
10816750,2,2,0,0,0,0,0,0,0
10817594,2,2,0,0,0,0,0,0,0
10817605,1,1,0,0,1,1,0,0,0
10817792,1,0,1,0,1,1,0,0,0
10817978,1,1,0,0,0,0,0,0,1
10817984,5,3,2,0,1,0,1,0,0
10818888,4,4,0,0,2,2,0,0,1
10819037,3,2,1,0,2,1,1,0,0
10820893,1,0,1,0,1,1,0,0,0
10821922,1,0,1,0,1,1,0,0,0
10822013,1,1,0,0,1,1,0,0,0
10824165,10,4,6,0,3,1,2,3,1
10824626,1,1,0,0,1,1,0,0,0
10825203,5,5,0,0,1,1,0,1,1
10825215,5,5,0,0,1,1,0,1,1
10825361,5,5,0,0,1,1,0,1,1
10826207,6,6,0,0,0,0,0,0,0
10826783,7,6,1,0,1,1,0,1,1
10826907,2,2,0,0,1,1,0,0,0
10827225,3,3,0,0,2,2,0,0,0
10827306,1,1,0,0,1,1,0,0,0
10827877,2,0,2,0,1,1,0,0,0
10828006,6,5,1,0,1,1,0,1,1
10828635,4,3,1,0,3,2,1,1,1
10829236,1,1,0,0,1,1,0,0,0
10830076,1,0,1,0,1,1,0,0,0
10830119,1,1,0,0,1,1,0,0,0
10831398,4,4,0,0,0,0,0,0,1
10832049,1,1,0,0,1,1,0,0,0
10832211,1,1,0,0,1,1,0,0,0
10832845,3,3,0,0,1,1,0,0,0
10833385,3,3,0,0,3,0,3,0,0
10834118,3,2,1,0,1,1,0,0,0
10834144,2,2,0,0,1,1,0,0,0
10836686,2,2,0,0,2,2,0,0,0
10836987,1,1,0,0,1,1,0,0,0
10837163,2,2,0,0,2,2,0,0,0
10838557,1,1,0,0,1,1,0,0,0
10838893,1,0,1,0,1,1,0,0,0
10839397,2,1,1,0,1,1,0,0,0
10840098,2,0,2,0,1,1,0,0,0
10840230,1,1,0,0,0,0,0,0,0
10840958,1,0,1,0,1,1,0,0,0
10841722,1,1,0,0,1,1,0,0,0
10842116,7,1,6,0,1,1,0,0,0
10842264,2,2,0,0,2,2,0,0,1
10842321,1,1,0,0,1,1,0,0,0
10842387,1,1,0,0,1,1,0,0,0
10842777,4,4,0,0,2,2,0,1,1
10843206,1,1,0,0,1,1,0,0,1
10843393,2,2,0,0,2,2,0,0,0
10843512,5,4,1,0,2,1,1,1,0
10843659,3,1,2,0,2,1,1,0,0
10843843,1,0,1,0,1,1,0,0,0
10844634,2,0,2,0,2,1,1,0,0
10844903,3,2,1,0,3,2,1,0,0
10845042,1,1,0,0,1,1,0,0,0
10845406,1,1,0,0,1,1,0,0,0
10846027,1,0,1,0,1,1,0,0,0
10846128,2,2,0,0,2,2,0,0,0
10847223,3,2,1,0,2,1,1,0,0
10847911,3,3,0,0,3,3,0,0,0
10849410,1,1,0,0,1,1,0,0,0
10850274,4,1,3,0,1,1,0,0,1
10851204,1,0,1,0,1,1,0,0,0
10851366,2,0,2,0,1,1,0,0,0
10851555,2,2,0,0,2,2,0,0,0
10852550,4,3,1,0,0,0,0,0,0
10853107,1,1,0,0,1,1,0,0,0
10857544,2,2,0,0,1,1,0,0,0
10857702,2,2,0,0,2,2,0,0,0
10858091,1,0,1,0,0,0,0,0,0
10859112,2,2,0,0,2,2,0,0,0
10860791,2,1,1,0,1,1,0,0,0
10861916,8,7,1,2,3,1,2,1,0
10862616,1,1,0,0,1,1,0,0,0
10862780,2,2,0,0,2,2,0,0,0
10862934,2,1,1,0,1,1,0,0,0
10863679,2,0,2,0,2,2,0,0,0
10865041,5,5,0,0,1,1,0,0,1
10866138,2,2,0,0,2,2,0,0,0
10866247,2,2,0,0,2,2,0,0,1
10868930,3,3,0,0,2,2,0,0,0
10868947,1,1,0,0,1,1,0,0,0
10869717,1,1,0,0,1,1,0,0,0
10869961,3,2,1,0,2,2,0,0,0
10870119,4,3,1,0,2,2,0,0,1
10871753,1,0,1,0,2,2,0,0,0
10872211,2,0,2,0,1,1,0,0,0
10872299,2,2,0,0,0,0,0,0,0
10872508,2,2,0,0,1,1,0,1,1
10873140,1,1,0,0,0,0,0,0,0
10873169,3,3,0,0,1,1,0,0,1
10873712,1,1,0,0,1,1,0,0,0
10874233,2,2,0,0,1,1,0,0,0
10875326,3,3,0,0,1,1,0,0,0
10876367,2,0,2,0,2,2,0,0,0
10876500,8,7,1,0,3,1,2,1,1
10876673,1,1,0,0,1,1,0,0,0
10877606,1,1,0,0,1,1,0,0,0
10878629,3,2,1,0,3,2,1,0,0
10880327,1,0,1,0,1,1,0,0,0
10881203,2,0,2,0,2,2,0,0,0
10881477,2,0,2,0,2,2,0,0,0
10884537,1,1,0,0,1,1,0,0,0
10884796,1,0,1,0,1,1,0,0,0
10889591,4,0,4,0,1,1,0,1,1
10890160,3,1,2,0,2,1,1,1,1
10890922,1,1,0,0,1,1,0,0,0
10892130,1,1,0,0,1,1,0,0,1
10892751,4,4,0,0,1,1,0,1,0
10894988,1,1,0,0,1,1,0,0,0
10896235,5,5,0,0,0,0,0,0,0
10896445,1,0,1,0,1,1,0,0,0
10899678,3,2,1,0,2,1,1,0,0
10899794,1,1,0,0,1,1,0,0,0
10899991,3,3,0,0,2,0,2,0,1
10902750,2,2,0,0,2,2,0,0,0
10904035,2,0,2,0,2,2,0,0,0
10906072,2,2,0,0,1,1,0,0,1
10907066,1,0,1,0,1,1,0,0,0
10907623,1,0,1,0,1,1,0,0,0
10908128,1,1,0,0,1,1,0,0,0
10910472,1,1,0,0,1,1,0,0,0
10911041,2,2,0,0,2,2,0,0,0
10912488,7,4,3,0,2,2,0,0,1
10912845,1,1,0,0,1,1,0,0,0
10914843,1,1,0,0,1,1,0,0,0
10915816,2,0,2,0,2,2,0,0,0
10916023,4,4,0,0,2,2,0,0,0
10916246,1,1,0,0,1,1,0,0,0
10917290,2,1,1,0,2,1,1,1,0
10917368,1,1,0,0,1,1,0,0,0
10917391,2,1,1,0,2,1,1,2,0
10918855,11,5,6,0,0,0,0,0,0
10919076,1,0,1,0,1,1,0,1,0
10922145,1,1,0,0,1,1,0,0,0
10923027,1,1,0,0,1,1,0,0,0
10923437,4,4,0,0,1,1,0,1,1
10924542,5,5,0,0,2,2,0,0,1
10924547,5,5,0,0,2,2,0,0,1
10924565,5,5,0,0,2,2,0,0,1
10924576,5,5,0,0,2,2,0,0,1
10924587,5,5,0,0,2,2,0,0,1
10924611,5,5,0,0,2,2,0,0,1
10924643,5,5,0,0,2,2,0,0,1
10924660,5,5,0,0,2,2,0,0,1
10924674,5,5,0,0,2,2,0,0,1
10925188,5,5,0,0,0,0,0,0,0
10925445,2,2,0,0,1,1,0,0,0
10925975,1,1,0,0,1,1,0,0,0
10926207,5,5,0,0,2,2,0,0,1
10926428,1,1,0,0,1,1,0,0,0
10927407,1,0,1,0,1,1,0,0,0
10929532,7,7,0,0,0,0,0,0,0
10929780,2,2,0,0,2,2,0,1,0
10931415,1,1,0,0,1,1,0,0,0
10932702,1,1,0,0,1,1,0,0,0
10934240,2,1,1,0,1,1,0,0,0
10934275,1,0,1,0,1,1,0,0,0
10935230,11,5,6,0,2,2,0,0,0
10935504,1,0,1,0,1,1,0,0,0
10937553,2,0,2,0,1,1,0,0,0
10942160,1,1,0,0,1,1,0,0,1
10943199,1,1,0,0,1,1,0,0,0
10943425,3,3,0,0,1,1,0,0,0
10943441,1,1,0,0,1,1,0,0,0
10943646,1,1,0,0,1,1,0,0,0
10944258,2,2,0,0,2,2,0,0,0
10944814,2,0,2,0,2,2,0,0,0
10945167,4,3,1,0,1,1,0,1,0
10945535,4,4,0,0,1,1,0,1,1
10946918,5,5,0,0,1,1,0,1,1
10948115,3,3,0,0,1,1,0,0,0
10950350,1,1,0,0,1,1,0,0,0
10950608,4,3,1,0,0,0,0,0,1
10951737,5,5,0,0,0,0,0,0,0
10951909,4,0,4,0,1,1,0,1,1
10952334,3,3,0,0,2,2,0,1,1
10952419,3,3,0,0,1,1,0,1,0
10952709,4,4,0,0,1,1,0,0,0
10955433,1,1,0,0,1,1,0,1,1
10955661,3,3,0,0,1,1,0,0,1
10955796,4,4,0,0,1,1,0,0,0
10956884,1,0,1,0,1,1,0,0,0
10957107,2,1,1,0,3,1,2,0,0
10958026,1,1,0,0,0,0,0,0,0
10958042,3,2,1,0,1,1,0,1,0
10958547,4,2,2,0,2,2,0,0,0
10958898,1,1,0,0,1,1,0,0,0
10959427,1,1,0,0,1,1,0,0,0
10961634,1,0,1,0,1,1,0,0,0
10962061,2,1,1,0,1,1,0,0,0
10963229,2,2,0,0,2,2,0,0,0
10964014,3,2,1,0,2,2,0,1,0
10964129,2,2,0,0,1,1,0,1,0
10964325,1,1,0,0,1,1,0,0,0
10964370,1,0,1,0,1,1,0,0,0
10967059,7,6,1,0,1,1,0,0,1
10967931,1,1,0,0,1,1,0,0,1
10970772,2,2,0,0,2,2,0,0,0
10972915,3,1,2,0,3,1,2,0,0
10973198,2,2,0,0,2,2,0,0,0
10973378,2,2,0,0,1,1,0,1,1
10974710,7,6,1,0,1,1,0,1,1
10974937,2,2,0,0,1,1,0,0,0
10975304,4,3,1,0,2,2,0,0,0
10975726,2,2,0,0,1,1,0,0,0
10976098,2,0,2,0,1,0,1,0,0
10976672,2,2,0,0,2,2,0,0,0
10977342,2,2,0,0,1,1,0,1,1
10978767,2,1,1,0,2,1,1,0,0
10979006,1,0,1,0,1,1,0,0,0
10979689,1,1,0,0,1,1,0,0,0
10982039,1,1,0,0,1,1,0,0,0
10982181,1,1,0,0,0,0,0,0,0
10982714,4,4,0,0,1,1,0,1,0
10983867,3,1,2,0,2,2,0,0,0
10983939,2,2,0,0,0,0,0,0,1
10984981,1,1,0,0,1,1,0,0,0
10985117,13,3,10,0,1,1,0,1,1
10985310,2,0,2,0,2,2,0,0,0
10985874,2,2,0,0,2,2,0,0,0
10986527,3,1,2,0,3,1,2,0,0
10986644,1,0,1,0,1,1,0,0,0
10987644,1,1,0,0,1,1,0,0,0
10987837,1,1,0,0,1,1,0,0,0
10988655,3,2,1,0,3,2,1,0,0
10989395,3,3,0,0,1,1,0,0,0
10990191,2,2,0,0,1,1,0,0,0
10990754,3,2,1,0,1,1,0,0,0
10991207,1,0,1,0,1,1,0,0,0
10991406,2,0,2,0,1,1,0,0,0
10991499,2,0,2,0,1,0,1,0,0
10991611,7,5,2,0,2,2,0,1,1
10991835,7,5,2,0,1,1,0,1,1
10995363,1,1,0,0,1,1,0,0,0
10996295,3,3,0,0,0,0,0,0,0
10997643,1,1,0,0,1,1,0,0,0
10998993,2,0,2,0,1,1,0,0,0
10999309,1,1,0,0,1,1,0,0,0
11000155,1,1,0,0,1,1,0,0,0
11000364,2,2,0,0,1,1,0,0,0
11000585,2,1,1,0,2,1,1,0,0
11001365,2,2,0,0,1,1,0,0,0
11001712,2,2,0,0,1,1,0,0,0
11002318,1,1,0,0,1,1,0,0,0
11003310,1,1,0,0,1,1,0,0,0
11005332,4,2,2,0,2,1,1,2,0
11006175,2,2,0,0,1,1,0,1,0
11006461,11,8,3,0,0,0,0,0,0
11007620,2,0,2,0,2,2,0,0,0
11008275,1,0,1,0,1,1,0,0,0
11010111,1,0,1,0,1,1,0,0,0
11012955,2,2,0,0,2,2,0,0,0
11016070,1,1,0,0,1,1,0,0,0
11016981,4,2,2,0,2,1,1,1,0
11017245,1,1,0,0,1,1,0,0,0
11017261,1,1,0,0,1,1,0,0,0
11018286,10,3,7,0,5,1,4,1,0
11019043,2,2,0,0,1,1,0,0,0
11020071,2,2,0,0,2,2,0,0,0
11020394,2,0,2,0,2,2,0,0,0
11020556,2,2,0,0,2,2,0,0,0
11021079,1,1,0,0,1,1,0,0,0
11021937,1,1,0,0,1,1,0,0,1
11022680,6,3,3,0,4,3,1,0,0
11025314,1,1,0,0,1,1,0,0,0
11025566,2,2,0,0,2,2,0,0,1
11026838,3,1,2,0,3,1,2,0,0
11026959,1,1,0,0,1,1,0,0,0
11027292,2,2,0,0,0,0,0,0,0
11029583,4,4,0,0,1,1,0,1,1
11031415,2,2,0,0,0,0,0,0,0
11032241,4,4,0,0,0,0,0,0,1
11033059,1,1,0,0,0,0,0,0,0
11033542,1,1,0,0,1,1,0,0,0
11033553,3,3,0,0,1,1,0,1,0
11033570,6,3,3,0,0,0,0,0,0
11035713,3,3,0,0,2,1,1,0,0
11037043,2,0,2,0,3,1,2,0,0
11038146,1,0,1,0,1,1,0,0,0
11040911,3,2,1,0,1,1,0,0,0
11040946,1,1,0,0,1,1,0,0,0
11041836,1,1,0,0,1,1,0,0,0
11043332,2,2,0,0,1,1,0,0,0
11045515,1,0,1,0,1,1,0,0,0
11045877,4,4,0,0,2,1,1,2,0
11046093,2,2,0,0,1,1,0,0,0
11046391,1,1,0,0,1,1,0,0,0
11048056,1,1,0,0,0,0,0,0,0
11048146,1,1,0,0,1,1,0,0,0
11048536,1,0,1,0,1,1,0,0,0
11049046,1,1,0,0,1,1,0,0,0
11051693,2,2,0,0,2,2,0,0,0
11052156,3,3,0,0,2,2,0,0,1
11053102,1,1,0,0,1,1,0,0,0
11053647,1,0,1,0,1,1,0,0,0
11054226,1,0,1,0,1,1,0,0,0
11054427,5,5,0,0,2,2,0,2,0
11055829,1,1,0,0,1,1,0,1,1
11056928,2,2,0,0,1,1,0,0,0
11057135,2,2,0,0,2,2,0,0,0
11057634,2,0,2,0,1,1,0,0,0
11058296,3,3,0,0,1,1,0,1,1
11059958,2,1,1,0,1,1,0,0,1
11060766,5,4,1,0,0,0,0,0,0
11061284,12,12,0,0,0,0,0,0,0
11061940,1,1,0,0,1,1,0,0,0
11062399,3,3,0,0,2,2,0,0,0
11062707,2,2,0,0,1,1,0,1,1
11064904,2,2,0,0,1,1,0,1,1
11064966,2,2,0,0,1,1,0,0,1
11065011,2,2,0,0,1,1,0,1,1
11066476,8,5,3,0,1,1,0,1,1
11066677,1,1,0,0,1,1,0,1,0
11067387,3,3,0,0,2,2,0,0,0
11069399,2,2,0,0,1,1,0,0,0
11070483,1,1,0,0,1,1,0,0,0
11070616,3,3,0,0,2,2,0,0,0
11072294,2,2,0,0,1,1,0,0,0
11072963,2,2,0,0,2,2,0,0,0
11074077,3,3,0,0,4,1,3,1,1
11075810,2,2,0,0,2,2,0,0,0
11076996,1,1,0,0,1,1,0,0,0
11078363,1,1,0,0,1,1,0,0,0
11078756,1,1,0,0,1,1,0,0,0
11078824,2,0,2,0,1,1,0,0,0
11079179,2,2,0,0,1,1,0,1,1
11079387,2,2,0,0,1,1,0,1,1
09030063,3,2,1,0,0,0,0,0,1
09030133,11,3,8,0,2,2,0,2,1
09032235,4,0,4,0,1,1,0,0,1
09033182,1,1,0,0,1,1,0,0,0
09033569,1,1,0,0,1,1,0,0,0
09033925,2,2,0,0,2,2,0,0,0
09034299,9,1,8,0,1,1,0,0,0
09035654,3,3,0,0,2,2,0,0,0
09036393,2,0,2,0,0,0,0,0,0
09038024,3,1,2,0,0,0,0,0,1
09038364,2,2,0,0,1,1,0,0,0
09039188,2,0,2,0,2,2,0,0,0
09039532,4,0,4,0,0,0,0,0,0
09039827,8,8,0,2,2,1,1,2,0
09040461,2,0,2,0,1,1,0,0,0
09043334,3,3,0,0,1,1,0,1,0
09044416,6,5,1,0,2,2,0,0,1
09044431,6,5,1,0,2,2,0,0,1
09044503,6,5,1,0,2,2,0,0,1
09044542,6,5,1,0,2,2,0,0,1
09044548,6,5,1,0,2,2,0,0,1
09044556,8,5,3,0,2,2,0,0,1
09044570,6,5,1,0,2,2,0,0,1
09044609,6,5,1,0,2,2,0,0,1
09044611,6,5,1,0,2,2,0,0,1
09044618,6,5,1,0,2,2,0,0,1
09044645,6,0,6,0,0,0,0,0,1
09046599,8,4,4,0,2,2,0,2,1
09049226,3,2,1,0,1,1,0,0,0
09049843,1,1,0,0,1,1,0,0,0
09050507,1,1,0,0,1,1,0,0,0
09051215,1,0,1,0,0,0,0,0,0
09051475,4,0,4,0,0,0,0,0,1
09052305,3,2,1,0,3,2,1,0,0
09052429,1,0,1,0,0,0,0,0,0
09053025,1,1,0,0,1,1,0,0,0
09054038,1,1,0,0,1,1,0,0,0
09056288,1,1,0,0,1,1,0,0,0
09056764,1,1,0,0,1,1,0,0,0
09056915,1,0,1,0,0,0,0,0,0
09057600,1,1,0,0,1,1,0,0,0
09058943,1,1,0,0,1,1,0,0,0
09061147,1,1,0,0,1,1,0,0,0
09061230,2,2,0,0,2,2,0,0,0
09061410,2,2,0,0,2,2,0,0,0
09062447,7,4,3,0,1,1,0,1,0
09062808,1,1,0,0,2,1,1,0,0
09063616,1,1,0,0,1,1,0,0,0
09063867,1,0,1,0,0,0,0,0,0
09064099,3,0,3,0,1,1,0,0,0
09064671,2,2,0,0,2,2,0,0,0
09065220,9,3,6,0,0,0,0,0,0
09066937,2,0,2,0,0,0,0,0,1
09066967,2,0,2,0,0,0,0,0,1
09067032,2,0,2,0,0,0,0,0,1
09067690,6,1,5,0,3,1,2,0,0
09068058,4,3,1,0,1,1,0,0,0
09069122,13,7,6,0,0,0,0,0,0
09069877,8,0,8,0,5,1,4,0,0
09071340,3,0,3,0,0,0,0,0,1
09072206,4,2,2,0,1,1,0,0,0
09073411,2,2,0,0,2,2,0,0,0
09073571,2,2,0,0,2,2,0,0,0
09075560,12,5,7,0,2,2,0,0,1
09075593,9,7,2,0,1,1,0,1,1
09075658,11,7,4,0,0,0,0,0,0
09077495,11,5,6,0,2,2,0,2,1
09077880,1,0,1,0,0,0,0,0,1
09078071,4,1,3,0,1,1,0,0,0
09079901,3,2,1,0,2,2,0,0,0
09080180,10,5,5,0,1,1,0,1,1
09080222,7,3,4,0,1,1,0,1,1
09080819,8,2,6,0,0,0,0,0,0
09081098,2,0,2,0,0,0,0,0,0
09081101,4,2,2,0,2,2,0,0,0
09081161,3,2,1,0,3,3,0,0,0
09082232,3,2,1,0,3,1,2,3,0
09082338,10,6,4,0,1,1,0,1,1
09083904,5,5,0,0,0,0,0,0,0
09084066,18,10,8,0,0,0,0,0,1
09086461,3,2,1,0,2,1,1,0,1
09086536,3,3,0,0,2,2,0,0,0
09086796,1,1,0,0,1,1,0,0,0
09086908,3,3,0,0,2,2,0,0,0
09088446,7,3,4,0,1,1,0,1,0
09089701,3,0,3,0,0,0,0,0,0
09090223,6,2,4,0,4,1,3,4,1
09090448,6,2,4,0,2,1,1,2,1
09090452,6,2,4,0,1,1,0,1,1
09090594,1,1,0,0,1,1,0,0,0
09091944,18,6,12,0,1,1,0,1,1
09094829,1,1,0,0,1,1,0,0,0
09095146,1,1,0,0,1,1,0,0,0
09095991,1,0,1,0,0,0,0,0,0
09098445,7,3,4,0,3,1,2,2,1
09099533,2,2,0,0,1,1,0,0,0
09099972,2,2,0,0,2,2,0,0,0
09100870,3,0,3,0,1,1,0,0,1
09101743,1,0,1,0,0,0,0,0,0
09101981,2,0,2,0,1,1,0,0,0
09102435,5,2,3,0,0,0,0,0,1
09102436,5,2,3,0,0,0,0,0,1
09104001,1,0,1,0,0,0,0,0,0
09104211,1,1,0,0,1,1,0,0,0
09106115,1,1,0,0,1,1,0,0,0
09108533,2,2,0,0,1,1,0,0,0
09109364,2,2,0,0,1,1,0,1,1
09112135,1,1,0,0,1,1,0,0,0
09112245,2,0,2,0,0,0,0,0,0
09113696,1,1,0,0,2,2,0,1,0
09114167,1,1,0,0,1,1,0,0,0
09122058,2,0,2,0,1,1,0,0,0
09122208,2,0,2,0,1,1,0,0,0
09123466,4,2,2,0,1,1,0,0,0
09125376,2,0,2,0,1,1,0,0,0
09125426,6,5,1,0,1,1,0,1,1
09125898,1,1,0,0,2,2,0,0,0
09125965,2,2,0,0,2,2,0,0,0
09126010,13,10,3,0,0,0,0,0,0
09127390,4,3,1,0,1,1,0,1,1
09127436,7,5,2,0,1,1,0,1,1
09127721,1,1,0,0,1,1,0,0,0
09127749,6,0,6,0,4,1,3,1,0
09127759,5,2,3,0,3,3,0,1,0
09128201,5,2,3,0,3,3,0,1,0
09130381,7,6,1,0,0,0,0,0,0
09130543,2,0,2,0,0,0,0,0,1
09131035,2,2,0,0,0,0,0,0,0
09131811,2,1,1,0,1,1,0,0,0
09132565,3,1,2,0,1,1,0,0,0
09136178,2,2,0,0,1,1,0,0,0
09136408,7,3,4,0,2,2,0,0,0
09136556,22,10,12,0,0,0,0,0,0
09136616,8,1,7,0,2,1,1,0,0
09137257,3,3,0,0,2,2,0,0,0
09137960,1,1,0,0,1,1,0,0,0
09138209,2,2,0,0,2,2,0,0,0
09139394,4,2,2,0,2,2,0,0,0
09141973,1,1,0,0,1,1,0,0,0
09142567,3,2,1,0,1,1,0,0,1
09142869,3,2,1,0,1,1,0,0,0
09145229,2,2,0,0,2,2,0,0,0
09145482,1,1,0,0,2,2,0,0,0
09146323,3,0,3,0,0,0,0,0,1
09147059,11,6,5,0,0,0,0,0,0
09147268,8,0,8,0,3,1,2,0,0
09147387,3,2,1,0,1,1,0,0,0
09148081,3,3,0,0,3,3,0,0,0
09148134,6,5,1,0,1,1,0,1,1
09148310,4,4,0,0,1,1,0,0,1
09148896,2,0,2,0,2,2,0,0,0
09149177,1,1,0,0,1,1,0,0,0
09149419,1,0,1,0,0,0,0,0,0
09152652,3,3,0,0,2,2,0,0,0
09153785,4,3,1,0,2,2,0,1,0
09154420,2,0,2,0,1,1,0,1,1
09154707,4,4,0,0,1,1,0,0,0
09154843,1,1,0,0,1,1,0,0,0
09155074,1,1,0,0,1,1,0,0,0
09155970,17,3,14,0,1,1,0,1,1
09155980,17,3,14,0,1,1,0,1,1
09156760,2,1,1,0,2,1,1,0,0
09157234,5,1,4,0,1,1,0,0,0
09158397,4,3,1,0,0,0,0,0,0
09158492,2,0,2,0,1,1,0,0,0
09160126,9,3,6,0,1,1,0,1,1
09161117,3,2,1,0,2,2,0,0,0
09163676,4,0,4,0,1,1,0,0,0
09164117,2,2,0,0,1,1,0,0,0
09172733,3,0,3,0,2,2,0,0,1
09173262,1,0,1,0,1,1,0,0,0
09173593,1,1,0,0,1,1,0,0,0
09176084,10,1,9,0,2,1,1,0,0
09176541,3,1,2,0,1,1,0,0,1
09177368,1,1,0,0,1,1,0,0,0
09179847,2,2,0,0,1,1,0,0,0
09181692,5,2,3,0,2,2,0,0,0
09183300,2,2,0,0,2,2,0,0,0
09185739,2,2,0,0,3,3,0,0,0
09188274,1,0,1,0,0,0,0,0,0
09190811,2,2,0,0,2,2,0,0,1
09191251,6,2,4,0,3,2,1,1,0
09192516,1,0,1,0,1,1,0,0,0
09192684,1,1,0,0,1,1,0,0,0
09192995,1,1,0,0,1,1,0,0,0
09193673,1,0,1,0,0,0,0,0,0
09194815,2,2,0,0,0,0,0,0,1
09196491,5,3,2,0,2,2,0,0,0
09197832,1,1,0,0,1,1,0,0,0
09198154,2,1,1,0,1,1,0,0,0
09198776,2,1,1,0,3,2,1,0,0
09199117,3,3,0,0,2,2,0,0,0
09199138,1,1,0,0,1,1,0,0,0
09199187,2,1,1,0,1,1,0,0,0
09202107,3,0,3,0,0,0,0,0,1
09203788,10,1,9,0,4,1,3,0,0
09205990,3,3,0,0,3,1,2,2,0
09206830,2,2,0,0,2,2,0,0,0
09208199,1,0,1,0,0,0,0,0,0
09208873,2,1,1,0,2,1,1,0,0
09209274,1,1,0,0,1,1,0,0,0
09209488,16,4,12,0,3,1,2,3,1
09210656,3,2,1,0,1,1,0,0,1
09211585,1,1,0,0,1,1,0,0,0
09214243,1,1,0,0,1,1,0,0,0
09216875,1,1,0,0,1,1,0,0,0
09217123,1,1,0,0,1,1,0,0,0
09218107,2,2,0,0,1,1,0,0,0
09220044,2,1,1,0,1,1,0,0,0
09220823,4,3,1,0,2,1,1,0,0
09221512,2,2,0,0,1,1,0,0,0
09221830,6,1,5,0,3,1,2,0,0
09223184,1,1,0,0,1,1,0,0,0
09227469,13,4,9,0,1,1,0,1,1
09228116,1,1,0,0,1,1,0,0,0
09228587,14,1,13,0,8,1,7,0,0
09229783,9,5,4,0,2,2,0,2,1
09231509,7,2,5,0,1,0,1,1,0
09231817,2,2,0,0,2,2,0,0,0
09233797,3,3,0,0,1,1,0,0,0
09234515,3,2,1,0,2,2,0,0,0
09234594,1,1,0,0,2,2,0,0,0
09234800,1,1,0,0,1,1,0,0,0
09235698,1,1,0,0,2,2,0,0,0
09236544,2,1,1,0,0,0,0,0,0
09237306,1,1,0,0,1,1,0,0,0
09237669,14,6,8,0,0,0,0,0,0
09238093,1,1,0,0,1,1,0,0,0
09239412,1,1,0,0,1,1,0,0,0
09241789,3,3,0,0,1,1,0,0,0
09242900,3,3,0,0,3,3,0,0,0
09243068,2,1,1,0,1,1,0,0,0
09243231,1,1,0,0,1,1,0,0,0
09244206,2,2,0,0,1,1,0,0,0
09245417,6,0,6,0,2,1,1,2,1
09245462,3,1,2,0,2,1,1,0,0
09245526,2,1,1,0,1,1,0,0,0
09246247,1,1,0,0,1,1,0,0,0
09247526,6,5,1,0,4,2,2,0,1
09247898,2,0,2,0,2,2,0,0,1
09251948,1,1,0,0,1,1,0,0,0
09252083,1,0,1,0,1,1,0,0,0
09252203,5,2,3,0,4,2,2,0,0
09252650,2,2,0,0,2,2,0,0,0
09253012,3,1,2,0,1,1,0,0,0
09253030,2,2,0,0,1,1,0,0,0
09254129,3,1,2,0,1,1,0,1,1
09254473,3,2,1,0,2,2,0,0,0
09254623,1,1,0,0,1,1,0,0,0
09255557,1,1,0,0,1,1,0,0,0
09255770,6,3,3,0,1,1,0,0,0
09257035,3,3,0,0,1,1,0,0,0
09257930,3,0,3,0,1,1,0,1,0
09262151,1,1,0,0,1,1,0,0,0
09263689,4,4,0,0,1,1,0,0,0
09263837,2,2,0,0,1,1,0,0,0
09264360,1,1,0,0,2,1,1,2,0
09265948,3,2,1,0,2,1,1,0,1
09267773,1,0,1,0,0,0,0,0,1
09267876,6,3,3,0,2,2,0,2,1
09268443,3,2,1,0,1,1,0,0,1
09269775,2,0,2,0,0,0,0,0,1
09270704,15,5,10,0,1,0,1,0,0
09271872,1,1,0,0,1,1,0,0,0
09276774,2,2,0,0,1,1,0,0,0
09277081,6,4,2,0,0,0,0,0,0
09278190,2,0,2,0,0,0,0,0,1
09278458,3,1,2,0,1,1,0,0,0
09280000,5,3,2,0,2,2,0,2,0
09282170,1,0,1,0,1,1,0,0,0
09283843,4,2,2,0,4,2,2,0,0
09285057,3,2,1,0,2,1,1,0,0
09286154,3,2,1,0,1,1,0,0,0
09287532,3,2,1,0,0,0,0,0,0
09290363,1,0,1,0,1,1,0,0,0
09291049,1,0,1,0,1,1,0,0,1
09293057,2,0,2,0,0,0,0,0,1
09293129,2,0,2,0,0,0,0,0,1
09293932,2,2,0,0,1,1,0,0,0
09296621,7,3,4,0,4,1,3,4,0
09298638,12,4,8,0,1,1,0,1,0
09299100,7,6,1,0,1,0,1,0,0
09301325,3,3,0,0,1,1,0,1,1
09301412,10,1,9,0,4,1,3,0,0
09302743,1,1,0,0,2,2,0,0,0
09303356,1,1,0,0,1,1,0,0,0
09304510,1,0,1,0,0,0,0,0,1
09304538,1,1,0,0,1,1,0,0,0
09305035,6,5,1,0,1,1,0,1,1
09307275,3,2,1,0,2,2,0,0,0
09307788,1,1,0,0,2,2,0,0,0
09308676,2,2,0,0,2,2,0,0,0
09311542,8,1,7,0,3,1,2,0,0
09312589,8,3,5,0,2,1,1,1,1
09313107,7,5,2,0,1,1,0,1,1
09313150,3,3,0,0,0,0,0,0,1
09313424,1,1,0,0,1,1,0,0,0
09314835,7,5,2,0,1,1,0,1,1
09314999,2,0,2,0,2,2,0,0,0
09315803,2,2,0,0,2,2,0,0,0
09316861,2,2,0,0,1,1,0,0,0
09317510,5,1,4,0,3,1,2,0,0
09319289,3,3,0,0,1,1,0,0,0
09319928,1,1,0,0,1,1,0,1,0
09320460,1,1,0,0,1,1,0,0,0
09321977,3,2,1,0,1,1,0,0,0
09322561,8,0,8,0,3,0,3,0,0
09324649,3,0,3,0,1,1,0,1,0
09326862,2,0,2,0,0,0,0,0,1
09328206,2,1,1,0,2,1,1,0,0
09329369,10,6,4,0,0,0,0,0,0
09332237,4,0,4,0,2,1,1,0,0
09333290,13,9,4,0,0,0,0,0,1
09333326,3,3,0,0,2,2,0,0,0
09334026,23,7,16,0,4,3,1,0,0
09336261,4,3,1,0,0,0,0,0,0
09336743,2,1,1,0,2,2,0,1,1
09337513,5,3,2,0,5,4,1,1,1
09338705,2,2,0,1,1,1,0,1,0
09340934,1,0,1,0,1,1,0,0,0
09341143,6,5,1,0,1,1,0,0,1
09341468,2,2,0,0,1,1,0,1,0
09341865,5,5,0,0,1,1,0,0,0
09342002,5,2,3,0,1,1,0,1,1
09342621,5,4,1,0,3,3,0,0,0
09342684,2,1,1,0,1,1,0,1,0
09342948,1,1,0,0,2,2,0,0,1
09343573,4,3,1,0,4,3,1,1,1
09345035,3,3,0,0,2,2,0,0,1
09346227,1,0,1,0,0,0,0,0,1
09348505,3,1,2,0,2,1,1,0,0
09349667,2,1,1,0,2,2,0,0,0
09351158,2,1,1,0,1,1,0,0,0
09353567,1,0,1,0,0,0,0,0,0
09354792,3,0,3,0,0,0,0,0,1
09356243,1,1,0,0,1,1,0,0,0
09357525,1,1,0,0,1,1,0,0,0
09357596,1,0,1,0,0,0,0,0,1
09358015,6,5,1,0,1,1,0,1,1
09359021,2,1,1,0,1,1,0,0,0
09359207,7,5,2,0,2,2,0,0,0
06473013,4,0,4,0,0,0,0,0,1
06473519,8,3,5,0,1,1,0,1,1
06473522,13,3,10,0,2,2,0,2,1
06473524,8,0,8,0,1,1,0,1,1
06473574,4,2,2,0,2,2,0,0,1
06473724,3,3,0,0,2,2,0,0,0
06474876,4,0,4,0,1,1,0,0,1
06475379,15,5,10,0,2,1,1,2,1
06476320,11,3,8,0,1,1,0,1,1
06476820,5,2,3,0,1,1,0,0,1
06476843,4,2,2,0,1,1,0,0,1
06476890,5,2,3,0,1,1,0,0,1
06477520,5,3,2,0,1,1,0,0,0
06477767,9,4,5,0,1,1,0,1,1
06478896,13,3,10,0,1,1,0,1,1
06479462,4,0,4,0,0,0,0,0,1
06479557,5,2,3,0,2,2,0,0,1
06480375,25,5,20,0,1,1,0,1,1
06480936,13,5,8,0,1,1,0,0,1
06481401,13,5,8,0,3,2,1,2,1
06481575,8,3,5,0,1,1,0,0,1
06482013,9,2,7,0,2,2,0,0,1
06482035,4,1,3,0,1,1,0,0,1
06482037,4,2,2,0,1,1,0,0,1
06482951,5,3,2,0,2,2,0,0,1
06483429,6,3,3,0,2,2,0,0,0
06483462,7,0,7,0,0,0,0,0,1
06484132,20,4,16,0,2,2,0,2,1
06484329,3,3,0,0,1,1,0,0,0
06484965,36,0,36,0,0,0,0,0,0
06485008,4,3,1,0,1,1,0,0,1
06486224,5,2,3,0,1,1,0,0,1
06486792,2,2,0,0,1,1,0,0,0
06486872,3,3,0,0,1,1,0,0,0
06487402,6,4,2,0,3,3,0,0,1
06487629,5,2,3,0,1,1,0,0,0
06487777,16,5,11,0,1,1,0,1,1
06487855,8,2,6,0,1,1,0,0,1
06488655,11,4,7,1,0,0,0,0,1
06488805,21,4,17,0,2,2,0,2,1
06489299,3,1,2,0,1,1,0,0,0
06489429,26,5,21,0,1,1,0,1,1
06489498,4,2,2,0,1,1,0,0,1
06491384,11,7,4,0,1,1,0,1,1
06493667,4,0,4,0,0,0,0,0,1
06494177,5,2,3,0,2,1,1,1,0
06494543,12,4,8,0,1,1,0,1,1
06494599,7,0,7,0,0,0,0,0,1
06495027,6,2,4,0,1,1,0,0,1
06495411,2,1,1,0,1,1,0,0,0
06495626,3,3,0,0,2,2,0,0,0
06496203,4,2,2,0,2,2,0,0,0
06497030,6,5,1,0,1,1,0,0,0
06497412,6,3,3,0,2,1,1,0,0
06498073,12,4,8,0,1,1,0,1,1
06498124,2,2,0,0,1,1,0,0,0
06498164,14,4,10,0,2,2,0,2,1
06498940,6,0,6,0,0,0,0,0,1
06499168,5,0,5,0,0,0,0,0,1
06500123,6,1,5,0,2,1,1,0,0
06500894,11,3,8,0,1,1,0,1,1
06501672,11,2,9,0,1,1,0,1,1
06502878,19,6,13,0,0,0,0,0,0
06503335,10,4,6,0,1,1,0,1,1
06503967,18,4,14,0,0,0,0,0,1
06504755,5,3,2,0,2,2,0,0,1
06504809,4,0,4,0,0,0,0,0,1
06504920,19,2,17,0,4,4,0,0,1
06504934,5,2,3,0,2,2,0,1,1
06504999,5,1,4,0,1,1,0,0,0
06505633,3,3,0,0,1,1,0,0,0
06505871,12,3,9,1,3,1,2,1,1
06507766,12,5,7,0,1,1,0,1,1
06508034,16,8,8,0,0,0,0,0,0
06508320,7,0,7,0,2,2,0,0,0
06510558,7,0,7,0,0,0,0,0,0
06510589,3,3,0,0,2,2,0,0,0
06510709,22,7,15,0,0,0,0,0,1
06511551,7,2,5,0,2,2,0,0,1
06511639,4,1,3,0,1,1,0,0,0
06514391,13,4,9,0,1,1,0,1,1
06514428,2,1,1,0,1,1,0,0,0
06514525,6,0,6,0,1,1,0,0,1
06514913,10,3,7,0,5,3,2,0,1
06515387,2,2,0,0,1,1,0,0,0
06516193,8,7,1,0,7,6,1,0,0
06517359,14,5,9,0,0,0,0,0,1
06517819,12,4,8,0,1,1,0,1,1
06518321,12,4,8,0,1,1,0,1,1
06519375,11,2,9,0,1,1,0,1,1
06519453,16,5,11,0,4,3,1,0,0
06520111,12,0,12,0,1,1,0,1,1
06521186,4,2,2,0,1,1,0,0,0
06522082,5,2,3,0,1,1,0,0,0
06522245,4,2,2,0,2,2,0,0,0
06522874,19,4,15,0,2,2,0,2,1
06522979,4,1,3,0,1,1,0,0,0
06523078,12,0,12,0,0,0,0,0,1
06523815,16,4,12,0,0,0,0,0,0
06526655,5,2,3,0,1,1,0,0,1
06526690,3,0,3,0,0,0,0,0,1
06526705,3,0,3,0,0,0,0,0,1
06527890,6,5,1,0,1,1,0,1,1
06528950,15,4,11,0,2,2,0,2,0
06530161,8,5,3,0,1,1,0,1,1
06533356,14,7,7,0,1,1,0,1,1
06534012,3,2,1,0,1,1,0,0,0
06534044,6,4,2,0,3,3,0,0,0
06534323,3,3,0,0,1,1,0,1,1
06534699,4,3,1,0,2,1,1,1,0
06535283,24,3,21,0,1,1,0,1,1
06535320,7,0,7,0,0,0,0,0,1
06535919,7,0,7,0,0,0,0,0,1
06535922,7,0,7,0,0,0,0,0,1
06537238,16,5,11,0,1,1,0,1,1
06537479,20,4,16,0,2,2,0,2,1
06537828,24,8,16,0,0,0,0,0,0
06538265,5,2,3,0,1,1,0,0,0
06538359,14,4,10,0,1,1,0,1,0
06538909,18,4,14,0,2,2,0,2,1
06539520,24,3,21,0,1,1,0,1,1
06539528,27,3,24,0,1,1,0,1,1
06540431,3,3,0,0,2,2,0,0,0
06540775,5,0,5,0,0,0,0,0,1
06540797,6,1,5,0,1,1,0,1,1
06545357,65,16,49,0,0,0,0,0,0
06545839,16,3,13,0,2,2,0,2,1
06545882,17,4,13,0,2,2,0,2,1
06546965,10,7,3,0,0,0,0,0,0
06547210,5,3,2,0,1,1,0,0,0
06548014,29,1,28,0,0,0,0,0,1
06548265,17,3,14,0,1,1,0,1,1
06548295,14,0,14,0,0,0,0,0,1
06549630,13,3,10,0,0,0,0,0,1
06549638,13,3,10,0,1,1,0,1,1
06550122,3,3,0,0,2,2,0,0,0
06550177,3,3,0,0,2,2,0,0,1
06552039,7,2,5,0,1,1,0,1,1
06552216,5,3,2,0,2,2,0,0,1
06553035,14,4,10,0,2,2,0,2,1
06553083,7,2,5,0,1,1,0,0,1
06553727,14,4,10,0,2,2,0,2,1
06553837,4,0,4,0,0,0,0,0,0
06553884,14,0,14,0,0,0,0,0,1
06554687,5,2,3,0,1,1,0,1,0
06554781,7,5,2,0,2,2,0,0,0
06559788,6,0,6,0,1,1,0,0,1
06560588,2,2,0,0,2,2,0,0,0
06560987,4,0,4,0,0,0,0,0,0
06561917,4,3,1,0,1,1,0,0,0
06562743,7,2,5,0,2,1,1,0,1
06565349,2,2,0,0,2,2,0,0,0
06565970,11,3,8,0,0,0,0,0,1
06566162,4,4,0,0,2,2,0,0,1
06568044,6,4,2,0,2,2,0,0,0
06569604,20,6,14,0,0,0,0,0,1
06569609,20,6,14,0,0,0,0,0,1
06569621,17,5,12,0,0,0,0,0,1
06569622,21,6,15,0,0,0,0,0,1
06569680,8,4,4,0,2,2,0,0,1
06570511,6,0,6,0,0,0,0,0,0
06584462,1,1,0,0,1,1,0,0,0
06585360,5,4,1,0,3,3,0,0,0
06585451,6,0,6,0,0,0,0,0,0
06588742,17,4,13,0,2,2,0,2,1
06588903,16,1,15,0,1,1,0,1,1
06590356,3,3,0,0,2,2,0,0,0
06592155,14,3,11,1,2,1,1,2,1
06592162,13,3,10,1,2,1,1,2,1
06592478,4,0,4,0,1,1,0,1,1
06592512,29,3,26,0,1,1,0,1,1
06596080,1,1,0,0,1,1,0,0,0
06596258,40,19,21,0,0,0,0,0,0
06600224,5,3,2,0,1,1,0,0,0
06602677,2,1,1,0,1,1,0,0,1
06603693,19,4,15,0,2,2,0,2,1
06606117,5,3,2,0,2,1,1,0,1
06607986,2,2,0,0,0,0,0,0,0
06610235,2,2,0,0,1,1,0,0,0
06610329,2,1,1,0,1,1,0,1,1
06613925,4,1,3,0,1,1,0,1,1
06614285,9,6,3,0,0,0,0,0,1
06614532,12,0,12,0,0,0,0,0,1
06617595,6,0,6,0,1,1,0,0,0
06617637,6,3,3,0,3,1,2,1,0
06620459,5,3,2,0,2,2,0,0,1
06620678,3,2,1,0,1,1,0,0,0
06620874,15,0,15,0,1,1,0,1,1
06624724,2,2,0,0,1,1,0,0,0
06625215,21,5,16,0,0,0,0,0,0
06625791,19,3,16,0,2,2,0,2,1
06627681,15,4,11,0,0,0,0,0,0
06628631,23,0,23,0,4,4,0,0,0
06631742,2,0,2,0,0,0,0,0,0
06632447,8,5,3,0,1,1,0,1,1
06633157,4,3,1,0,2,1,1,0,1
06635661,4,1,3,0,2,2,0,0,0
06635818,5,3,2,0,1,1,0,0,0
06636358,5,0,5,0,0,0,0,0,1
06637991,5,2,3,0,2,2,0,0,0
06639465,10,0,10,0,0,0,0,0,0
06641234,3,3,0,0,3,3,0,0,0
06641752,6,3,3,0,2,2,0,0,0
06643744,4,0,4,0,2,2,0,0,0
06644602,4,3,1,0,1,1,0,0,0
06645035,2,0,2,0,0,0,0,0,1
06645239,1,1,0,0,1,1,0,0,0
06646230,4,2,2,0,1,1,0,0,0
06647081,5,1,4,0,1,1,0,0,0
06647451,3,3,0,0,2,2,0,0,0
06650610,4,2,2,0,2,2,0,0,0
06650882,3,1,2,0,1,1,0,0,0
06653440,4,0,4,0,1,1,0,1,1
06654421,2,0,2,0,0,0,0,0,0
06656512,7,2,5,0,1,1,0,1,0
06657184,8,3,5,0,1,1,0,1,1
06657602,14,5,9,0,1,1,0,1,1
06658523,2,1,1,0,1,1,0,0,0
06658907,1,1,0,0,1,1,0,0,0
06659115,7,2,5,0,0,0,0,0,1
06660360,4,2,2,0,1,1,0,1,0
06661373,19,4,15,0,2,2,0,2,1
06662891,6,2,4,0,1,1,0,0,0
06666175,4,3,1,0,3,3,0,0,0
06666433,2,2,0,0,1,1,0,0,0
06667092,23,3,20,0,0,0,0,0,1
06667605,8,4,4,0,1,1,0,1,1
06668849,7,3,4,0,1,1,0,1,1
06669272,4,2,2,0,1,1,0,0,0
06670975,9,3,6,0,1,1,0,1,1
06672484,7,6,1,0,5,5,0,0,0
06674463,5,0,5,0,0,0,0,0,1
06675067,7,3,4,0,2,1,1,2,0
06675130,2,2,0,0,1,1,0,0,0
06675192,3,0,3,0,0,0,0,0,1
06676746,2,2,0,0,1,1,0,0,0
06678336,7,0,7,0,0,0,0,0,1
06678337,7,0,7,0,0,0,0,0,1
06679087,6,0,6,0,2,2,0,0,1
06679670,17,4,13,0,1,1,0,0,1
06681177,16,0,16,0,0,0,0,0,1
06681322,13,4,9,0,0,0,0,0,1
06681897,5,3,2,0,1,1,0,0,0
06684470,5,3,2,0,1,1,0,1,1
06686573,3,2,1,0,1,1,0,0,1
06687527,2,1,1,0,1,1,0,0,0
06689538,21,5,16,0,1,1,0,1,1
06689614,24,0,24,0,1,1,0,1,1
06692246,13,6,7,0,2,1,1,1,1
06695464,3,0,3,0,2,2,0,0,0
06697848,6,3,3,0,0,0,0,0,0
06698128,9,4,5,0,1,1,0,1,1
06698816,3,0,3,0,1,1,0,0,0
01869239,29,0,29,0,1,1,0,1,1
01869365,6,0,6,0,2,2,0,0,1
01869518,22,4,18,0,0,0,0,0,0
01869637,25,0,25,0,0,0,0,0,1
01869807,12,0,12,0,0,0,0,0,0
01870209,5,2,3,0,0,0,0,0,0
01871639,0,0,0,0,0,0,0,0,0
01872070,62,6,56,0,1,1,0,1,1
01872071,62,4,58,0,1,1,0,1,1
01872153,11,4,7,0,1,1,0,0,1
01877695,23,4,19,0,2,1,1,2,1
01878675,6,3,3,0,0,0,0,0,1
01878772,8,2,6,0,1,1,0,0,0
01880187,15,3,12,0,1,1,0,1,1
01881038,1,0,1,0,0,0,0,0,1
01882537,5,3,2,0,1,1,0,0,1
01883182,29,2,27,0,1,1,0,1,1
01883900,26,2,24,0,1,1,0,1,1
01884123,17,5,12,0,0,0,0,0,0
01884217,12,0,12,0,0,0,0,0,1
01885001,18,0,18,0,0,0,0,0,1
01885666,14,3,11,0,1,1,0,1,1
01885688,32,0,32,0,0,0,0,0,1
01886368,29,0,29,0,1,1,0,1,1
01886448,24,2,22,0,1,1,0,1,1
01887129,16,3,13,0,3,1,2,3,1
01887852,35,9,26,0,1,1,0,1,0
01889626,136,16,120,0,0,0,0,0,1
01890117,17,5,12,0,0,0,0,0,1
01890646,17,0,17,0,0,0,0,0,0
01891934,24,9,15,0,0,0,0,0,0
01892278,5,1,4,0,1,1,0,0,1
01894682,21,3,18,0,1,1,0,1,1
01895770,33,4,29,0,0,0,0,0,1
01897065,6,3,3,0,2,2,0,0,1
01897176,31,8,23,0,0,0,0,0,0
01897331,3,0,3,0,2,2,0,0,0
01900518,7,2,5,0,1,1,0,0,0
01900907,69,6,63,0,2,2,0,2,1
01901923,29,0,29,0,0,0,0,0,1
01902503,40,5,35,0,0,0,0,0,1
01903635,24,4,20,0,1,1,0,0,0
01905465,17,2,15,0,0,0,0,0,1
01905896,7,6,1,0,2,2,0,0,1
01908967,58,3,55,0,1,1,0,1,1
01908981,5,1,4,0,3,2,1,0,0
01910477,39,0,39,0,0,0,0,0,0
01910866,16,3,13,0,1,1,0,1,1
01911185,5,2,3,0,1,1,0,0,0
01913344,30,4,26,0,1,1,0,1,1
01915688,16,0,16,0,0,0,0,0,1
01915763,38,3,35,0,2,1,1,2,1
01915767,43,5,38,0,1,1,0,1,1
01917322,17,0,17,0,0,0,0,0,1
01923684,22,3,19,0,0,0,0,0,1
01925803,10,5,5,0,4,4,0,0,0
01926842,33,4,29,0,0,0,0,0,1
01927946,7,2,5,0,1,1,0,0,1
01928541,89,18,71,0,0,0,0,0,1
01929349,3,3,0,0,1,1,0,0,0
01929778,14,1,13,0,1,1,0,0,0
01931184,43,3,40,0,1,1,0,1,1
01933064,26,5,21,0,3,2,1,0,0
01933411,5,5,0,0,2,2,0,0,1
01933427,17,4,13,0,1,1,0,1,1
01934416,7,5,2,0,3,3,0,0,0
01934811,41,3,38,0,1,1,0,1,1
01938001,13,6,7,0,2,2,0,0,1
01938239,15,3,12,0,1,1,0,1,1
01938291,28,5,23,0,1,1,0,1,1
01939029,22,13,9,0,1,1,0,1,0
01939640,41,5,36,0,1,1,0,1,1
01939932,96,13,83,0,0,0,0,0,1
01940208,16,5,11,0,1,1,0,1,1
01940849,19,3,16,0,1,1,0,1,1
01941250,3,3,0,0,0,0,0,0,0
01943058,13,0,13,0,0,0,0,0,1
01943787,16,3,13,0,1,1,0,1,1
01945130,35,4,31,0,1,1,0,1,1
01945142,21,5,16,0,1,1,0,1,1
01945480,28,9,19,0,0,0,0,0,0
01945769,27,0,27,0,2,1,1,1,1
01946456,9,3,6,0,1,1,0,1,1
01949696,35,3,32,0,1,1,0,1,1
01951092,32,2,30,0,1,1,0,1,1
01952080,6,5,1,0,2,2,0,0,1
01952379,22,0,22,0,1,1,0,1,1
01952992,34,3,31,0,1,1,0,1,1
01953965,4,0,4,0,0,0,0,0,0
01955804,5,3,2,0,1,1,0,0,0
01956063,7,5,2,0,0,0,0,0,0
01957239,19,2,17,0,1,1,0,1,1
01957749,27,0,27,0,0,0,0,0,1
01959777,9,2,7,0,1,1,0,0,1
01961457,64,4,60,0,1,1,0,1,0
01964697,50,11,39,0,0,0,0,0,0
01966277,68,3,65,0,1,1,0,1,1
01967707,23,10,13,0,3,2,1,1,0
01969090,26,2,24,0,2,1,1,1,1
01969549,19,0,19,0,0,0,0,0,1
01970895,7,1,6,0,2,2,0,1,1
01971914,10,3,7,0,1,1,0,0,0
01973492,18,0,18,0,0,0,0,0,1
01974699,42,0,42,0,0,0,0,0,1
01975338,20,6,14,0,1,1,0,1,1
01977118,10,3,7,0,2,2,0,0,0
01978664,13,5,8,0,0,0,0,0,1
01981238,57,2,55,0,1,1,0,1,1
01981540,20,4,16,0,2,1,1,1,1
01981854,37,9,28,0,0,0,0,0,0
01982349,22,0,22,0,0,0,0,0,1
01983051,6,3,3,0,2,2,0,0,0
01983358,93,28,65,0,24,21,3,0,0
01983540,33,2,31,0,1,1,0,1,1
01984357,23,5,18,0,0,0,0,0,0
01985361,142,10,132,0,0,0,0,0,1
01985479,38,4,34,0,1,1,0,1,1
01985536,19,0,19,0,1,1,0,1,1
01985540,49,3,46,0,1,1,0,1,1
01987453,45,2,43,0,1,1,0,1,1
01987572,5,5,0,0,0,0,0,0,1
01989841,17,5,12,0,0,0,0,0,0
01990370,62,7,55,0,1,1,0,1,1
01991604,15,3,12,0,0,0,0,0,0
01992524,20,4,16,0,1,1,0,0,1
01995414,13,0,13,0,0,0,0,0,1
01995498,33,6,27,0,0,0,0,0,1
01996296,23,2,21,0,1,0,1,0,0
01996687,31,5,26,0,1,1,0,1,1
01998251,46,6,40,0,1,1,0,1,1
01999120,61,6,55,0,1,1,0,1,1
01999238,23,11,12,0,0,0,0,0,1
01999403,19,0,19,0,0,0,0,0,0
02000053,22,3,19,0,1,1,0,1,1
02000173,58,12,46,0,0,0,0,0,0
02001247,18,3,15,0,1,1,0,1,0
02002694,36,0,36,0,0,0,0,0,1
02003020,58,9,49,0,1,1,0,1,1
02003242,34,0,34,0,0,0,0,0,1
02005012,109,11,98,0,0,0,0,0,1
02005521,34,2,32,0,1,1,0,1,1
02005917,35,3,32,0,1,1,0,1,1
02006455,22,0,22,0,1,1,0,1,1
02007160,7,5,2,0,6,5,1,1,0
02010626,43,6,37,0,1,1,0,1,1
02013926,13,3,10,0,0,0,0,0,1
02014522,23,0,23,0,1,1,0,1,1
02016337,12,4,8,0,0,0,0,0,0
02016429,7,5,2,0,1,1,0,0,0
02017204,5,0,5,0,0,0,0,0,0
02017829,25,6,19,0,1,1,0,1,1
02017977,7,2,5,0,0,0,0,0,0
02018312,24,0,24,0,1,1,0,1,1
02018469,26,7,19,0,1,1,0,1,1
02019645,27,7,20,0,1,1,0,1,1
02019835,39,4,35,0,1,0,1,1,1
02020520,12,5,7,1,2,1,1,0,1
02020959,3,3,0,0,0,0,0,0,0
02021099,10,2,8,0,0,0,0,0,0
02021722,4,2,2,0,1,1,0,1,0
02023215,22,0,22,0,0,0,0,0,1
02024448,8,3,5,0,0,0,0,0,0
02024630,34,3,31,0,1,1,0,1,1
02027686,14,4,10,0,1,1,0,1,1
02028024,8,2,6,0,0,0,0,0,0
02029685,14,4,10,0,5,3,2,0,0
02030418,36,3,33,0,1,1,0,1,1
02031867,21,4,17,0,1,1,0,0,0
02032794,35,0,35,0,0,0,0,0,0
02033068,12,3,9,0,0,0,0,0,1
02034496,1,1,0,0,0,0,0,0,1
02034539,6,0,6,0,0,0,0,0,0
02034991,17,8,9,0,1,1,0,0,1
02036686,62,3,59,0,1,1,0,1,1
02037678,7,3,4,0,1,1,0,1,1
02038004,11,3,8,0,1,1,0,1,1
02038895,39,8,31,0,0,0,0,0,1
02040753,18,2,16,0,1,1,0,1,1
02042718,2,2,0,0,0,0,0,0,1
02045934,40,4,36,0,1,1,0,1,1
02046233,36,4,32,0,0,0,0,0,1
02047353,20,0,20,0,1,1,0,1,1
02047473,0,0,0,0,0,0,0,0,0
02048526,22,3,19,0,1,1,0,1,0
02051135,8,4,4,0,3,3,0,0,1
02051469,16,0,16,0,0,0,0,0,1
02051703,30,9,21,0,1,1,0,1,1
02051962,15,0,15,0,1,1,0,1,1
02052268,87,8,79,0,0,0,0,0,1
02052961,38,5,33,0,1,1,0,1,1
02054169,11,5,6,0,1,1,0,1,1
02054230,23,2,21,0,0,0,0,0,0
02057284,33,7,26,0,1,1,0,1,1
02057930,27,0,27,0,1,1,0,1,1
02058399,16,3,13,0,2,2,0,0,1
02059168,65,6,59,0,1,1,0,0,1
02059279,46,4,42,0,1,1,0,1,1
02059633,17,2,15,0,1,1,0,1,1
02061305,37,0,37,0,0,0,0,0,1
02067075,35,5,30,0,1,1,0,1,1
02068452,4,2,2,0,3,3,0,0,0
02071702,45,4,41,0,1,1,0,1,1
02072264,52,6,46,0,1,1,0,1,1
02073090,3,3,0,0,1,1,0,0,0
02074908,30,2,28,0,1,1,0,1,1
02075744,20,4,16,0,1,1,0,1,1
02076041,23,2,21,0,1,1,0,1,1
02076479,14,3,11,0,0,0,0,0,0
02077711,12,4,8,0,1,1,0,1,0
02078324,19,4,15,0,1,1,0,1,1
02078327,7,3,4,0,1,1,0,0,0
02079271,5,2,3,0,1,1,0,0,0
02079368,21,4,17,0,1,1,0,1,1
02080756,48,10,38,0,0,0,0,0,0
02081330,41,9,32,0,0,0,0,0,1
02081960,61,3,58,0,1,1,0,1,1
02082358,3,0,3,0,0,0,0,0,1
02083169,20,3,17,0,0,0,0,0,1
02084595,3,2,1,0,2,2,0,0,1
02085568,5,2,3,0,1,1,0,0,0
02085795,11,5,6,0,1,1,0,1,1
02085859,5,0,5,0,0,0,0,0,1
02086530,34,0,34,0,0,0,0,0,1
02086754,56,4,52,0,1,1,0,1,1
02086839,10,5,5,0,2,2,0,0,0
02087293,30,10,20,0,0,0,0,0,0
02089682,12,0,12,0,0,0,0,0,1
02090371,3,0,3,0,0,0,0,0,1
02090588,77,0,77,0,0,0,0,0,1
02091878,15,2,13,0,1,1,0,1,1
02091894,54,10,44,0,1,1,0,1,1
02093429,52,7,45,0,1,1,0,1,1
02093520,22,4,18,0,1,1,0,0,1
02093521,19,4,15,0,3,3,0,0,1
02094367,5,2,3,0,1,1,0,0,0
02094531,0,0,0,0,0,0,0,0,0
02094782,48,9,39,0,1,1,0,1,0
02095011,20,2,18,0,1,1,0,0,1
02096856,11,2,9,0,2,1,1,2,0
02098187,8,1,7,0,1,1,0,0,0
02098633,2,2,0,0,0,0,0,0,1
02098758,21,0,21,0,1,1,0,1,1
02099151,28,4,24,0,1,1,0,1,1
02100628,34,5,29,0,1,1,0,1,1
02100855,26,7,19,0,0,0,0,0,1
02100955,13,0,13,0,0,0,0,0,1
02101271,33,8,25,0,3,1,2,0,0
02102576,36,2,34,0,0,0,0,0,1
02103030,31,6,25,0,1,1,0,1,1
02103849,21,9,12,0,0,0,0,0,0
02104493,9,2,7,0,0,0,0,0,0
02104695,35,3,32,0,1,1,0,1,1
02105209,21,0,21,0,1,1,0,1,1
02107637,3,2,1,0,2,2,0,0,0
02107754,34,0,34,0,0,0,0,0,1
02107783,25,0,25,0,0,0,0,0,1
02108698,37,3,34,0,1,1,0,1,1
11401317,1,1,0,0,1,1,0,0,0
11401690,1,1,0,0,1,1,0,0,0
11401691,1,1,0,0,1,1,0,0,0
11402359,2,2,0,0,1,1,0,0,0
11403068,2,2,0,0,1,1,0,1,1
11403166,1,1,0,0,1,1,0,0,0
11404216,1,1,0,0,1,1,0,0,0
11406674,1,1,0,0,1,1,0,0,0
11407233,2,2,0,0,2,2,0,0,0
11407454,1,1,0,0,1,1,0,0,0
11409733,2,2,0,0,1,1,0,0,0
11409978,1,1,0,0,1,1,0,0,0
11410729,1,1,0,0,1,1,0,0,1
11410766,1,1,0,0,1,1,0,0,0
11410963,1,1,0,0,1,1,0,0,0
11414353,3,3,0,0,0,0,0,0,0
11415260,1,1,0,0,1,1,0,0,0
11417126,1,0,1,0,1,1,0,0,0
11417754,1,1,0,0,1,1,0,0,0
11418587,1,1,0,0,0,0,0,0,0
11420157,1,1,0,0,0,0,0,0,0
11420650,1,1,0,0,1,1,0,0,0
11421068,4,4,0,0,3,1,2,2,1
11421855,2,2,0,0,0,0,0,0,0
11422184,4,4,0,0,1,1,0,1,1
11422496,4,4,0,0,1,1,0,1,1
11423161,1,1,0,0,2,2,0,2,0
11423668,2,2,0,0,2,2,0,0,0
11423736,1,1,0,0,1,1,0,0,0
11426304,2,2,0,0,1,1,0,1,0
11427190,1,1,0,0,1,1,0,0,0
11427693,6,6,0,0,0,0,0,0,0
11427971,1,1,0,0,1,1,0,0,0
11431596,2,2,0,0,2,2,0,0,0
11431642,5,3,2,0,2,1,1,2,1
11431989,2,2,0,0,2,2,0,0,0
11432522,2,2,0,0,1,1,0,0,0
11432797,1,1,0,0,1,1,0,0,0
11432864,2,2,0,0,2,2,0,0,0
11433413,1,1,0,0,1,1,0,0,0
11433798,7,6,1,0,1,1,0,1,1
11434871,4,2,2,0,2,1,1,0,0
11435515,2,2,0,0,2,2,0,0,1
11436237,1,1,0,0,1,1,0,0,0
11436899,6,6,0,0,0,0,0,0,0
11436974,2,1,1,0,1,1,0,0,0
11437206,1,1,0,0,1,1,0,0,0
11437731,1,1,0,0,1,1,0,0,0
11439047,2,2,0,0,1,1,0,0,0
11439167,5,3,2,0,2,1,1,2,0
11439948,1,1,0,0,1,1,0,0,0
11440237,2,2,0,0,2,2,0,0,0
11440728,1,1,0,0,1,1,0,0,0
11440798,2,2,0,0,0,0,0,0,0
11440966,2,2,0,0,1,1,0,0,0
11441691,1,1,0,0,1,1,0,0,0
11441842,2,2,0,0,2,2,0,0,1
11442110,1,1,0,0,1,1,0,0,0
11442912,2,2,0,0,2,2,0,0,0
11443294,2,2,0,0,2,2,0,0,0
11444009,3,3,0,0,3,3,0,0,0
11444061,2,2,0,0,2,2,0,0,0
11444070,2,2,0,0,2,2,0,0,0
11447115,2,2,0,0,2,2,0,0,0
11447910,2,2,0,0,1,1,0,1,0
11449165,1,1,0,0,0,0,0,0,0
11449209,1,1,0,0,1,1,0,0,0
11449720,1,1,0,0,1,1,0,0,0
11450557,1,1,0,0,1,1,0,0,0
11452379,1,0,1,0,1,1,0,0,0
11453654,1,1,0,0,1,1,0,0,0
11453691,11,11,0,0,0,0,0,0,0
11453908,2,2,0,0,1,1,0,1,0
11453961,4,4,0,0,2,2,0,0,0
11454093,2,2,0,0,1,1,0,0,1
11455588,1,1,0,0,1,1,0,0,0
11456441,2,2,0,0,2,2,0,0,0
11456750,1,1,0,0,1,1,0,0,0
11456829,4,4,0,0,0,0,0,0,0
11457044,1,1,0,0,1,1,0,0,0
11457151,2,2,0,0,2,2,0,0,0
11457333,1,1,0,0,0,0,0,0,0
11457507,2,2,0,0,2,2,0,0,0
11459499,1,1,0,0,1,1,0,0,0
11459652,1,1,0,0,1,1,0,0,0
11460275,1,1,0,0,1,1,0,0,0
11461317,1,1,0,0,1,1,0,0,0
11461397,1,1,0,0,1,1,0,0,0
11463408,9,8,1,0,0,0,0,0,0
11463703,8,7,1,0,0,0,0,0,0
11464098,1,1,0,0,1,1,0,0,0
11464594,1,1,0,0,2,2,0,0,0
11464821,3,3,0,0,2,2,0,0,0
11466619,2,2,0,0,1,1,0,0,0
11467530,2,1,1,0,1,1,0,0,0
11467587,7,6,1,0,2,1,1,2,1
11467616,3,2,1,0,1,1,0,1,0
11467694,1,1,0,0,1,1,0,0,0
11467714,1,1,0,0,1,1,0,0,0
11467897,1,1,0,0,1,1,0,0,0
11469231,4,4,0,0,0,0,0,0,0
11470309,3,3,0,0,0,0,0,0,0
11471170,4,4,0,0,3,3,0,0,0
11471757,2,2,0,0,1,1,0,0,0
11472914,1,1,0,0,1,1,0,0,0
11474597,1,1,0,0,0,0,0,0,0
11475190,3,3,0,0,2,2,0,0,1
11475457,3,3,0,0,1,1,0,0,0
11476051,1,1,0,0,1,1,0,0,0
11476303,1,1,0,0,1,1,0,0,0
11478310,2,2,0,0,1,1,0,0,0
11478464,1,1,0,0,2,2,0,1,0
11481749,1,1,0,0,1,1,0,0,0
11481816,4,4,0,2,1,1,0,1,0
11483032,1,1,0,0,1,1,0,0,0
11483443,2,2,0,0,2,2,0,1,0
11483520,2,2,0,0,2,2,0,1,0
11483908,2,2,0,0,2,2,0,0,0
11485236,2,2,0,0,2,2,0,0,0
11485917,1,1,0,0,1,1,0,0,0
11486251,2,1,1,0,2,1,1,0,0
11487167,2,2,0,0,2,2,0,0,0
11487770,2,1,1,0,3,2,1,0,1
11488206,1,1,0,0,1,1,0,0,0
11488720,1,1,0,0,1,1,0,0,0
11488988,6,6,0,0,2,1,1,1,0
11491236,5,4,1,0,1,1,0,1,1
11491624,2,2,0,0,2,2,0,0,0
11491776,1,1,0,0,1,1,0,0,0
11492870,1,1,0,0,1,1,0,0,0
11493249,7,5,2,0,1,1,0,1,0
11495448,1,1,0,0,1,1,0,0,0
11495876,3,3,0,0,2,2,0,0,0
11496480,1,1,0,0,1,1,0,0,0
11497159,2,2,0,0,2,2,0,0,0
11497301,2,2,0,0,2,2,0,0,1
11497823,2,2,0,0,1,1,0,1,1
11497957,1,1,0,0,1,1,0,0,0
11498113,2,2,0,0,2,2,0,0,0
11498686,2,2,0,0,1,1,0,0,0
11499131,1,1,0,0,1,1,0,0,0
11499536,2,1,1,0,1,1,0,0,0
11499718,1,1,0,0,0,0,0,0,0
11499835,1,1,0,0,1,1,0,0,0
11501348,2,2,0,0,2,2,0,2,0
11502592,1,0,1,0,1,1,0,0,0
11502983,4,4,0,0,1,1,0,1,1
11503693,2,2,0,0,3,3,0,1,0
11503996,1,1,0,0,1,1,0,0,0
11504181,1,1,0,0,1,1,0,0,0
11504605,2,2,0,0,1,1,0,0,0
11505738,1,1,0,0,1,1,0,0,0
11505764,1,1,0,0,1,1,0,0,0
11505802,2,2,0,0,2,2,0,0,0
11506730,2,2,0,0,1,1,0,1,1
11507083,1,1,0,0,1,1,0,0,0
11507847,2,1,1,0,1,1,0,0,0
11509563,1,1,0,0,1,1,0,0,0
11509725,1,1,0,0,1,1,0,0,0
11510555,1,1,0,0,1,1,0,0,0
11511111,1,1,0,0,1,1,0,0,0
11511188,11,9,2,0,0,0,0,0,0
11511747,2,2,0,0,2,2,0,0,0
11512425,2,2,0,0,1,1,0,0,0
11512543,3,3,0,0,0,0,0,0,0
11513686,2,1,1,0,2,1,1,0,0
11516189,1,1,0,0,1,1,0,0,0
11516411,5,5,0,0,0,0,0,0,0
11516576,2,0,2,0,3,1,2,0,0
11517267,6,6,0,0,4,3,1,0,1
11520461,2,2,0,0,1,1,0,1,1
11520520,1,1,0,0,1,1,0,0,0
11520627,1,1,0,0,1,1,0,0,0
11520687,1,1,0,0,0,0,0,0,0
11521524,1,1,0,0,1,1,0,0,0
11522080,3,2,1,0,0,0,0,0,0
11522241,1,1,0,0,1,1,0,0,0
11522546,1,1,0,0,1,1,0,0,0
11523531,1,1,0,0,1,1,0,0,0
11525403,2,2,0,0,2,2,0,0,0
11527021,1,1,0,0,1,1,0,0,0
11527030,1,1,0,0,1,1,0,0,0
11528436,2,2,0,0,2,2,0,0,1
11528935,1,1,0,0,1,1,0,0,0
11530355,1,1,0,0,2,2,0,0,0
11530711,1,1,0,0,1,1,0,0,0
11530771,2,2,0,0,2,2,0,0,0
11530996,1,1,0,0,1,1,0,0,0
11531377,5,5,0,0,2,2,0,0,1
11531390,3,3,0,0,2,2,0,0,0
11531410,5,5,0,0,2,2,0,0,1
11531481,5,5,0,0,2,2,0,0,1
11531536,5,5,0,0,2,2,0,0,1
11531543,5,5,0,0,2,2,0,0,1
11531546,5,5,0,0,2,2,0,0,1
11531608,5,5,0,0,2,2,0,0,1
11531614,5,5,0,0,2,2,0,0,1
11531663,2,2,0,0,2,2,0,0,0
11531689,5,5,0,0,2,2,0,0,1
11531711,5,5,0,0,2,2,0,0,1
11532061,1,1,0,0,1,1,0,0,0
11533699,1,1,0,0,1,1,0,0,0
11534076,1,1,0,0,1,1,0,0,0
11535090,2,2,0,0,2,2,0,0,0
11535361,3,3,0,0,2,2,0,0,0
11535719,3,3,0,0,2,2,0,0,1
11536507,1,1,0,0,2,2,0,0,0
11536769,4,3,1,0,1,1,0,1,0
11536969,2,1,1,0,1,1,0,0,0
11538016,2,2,0,0,1,1,0,0,0
11539076,2,2,0,0,1,1,0,0,0
11539835,3,3,0,0,1,1,0,0,1
11540429,4,4,0,0,0,0,0,0,0
11540795,2,2,0,0,1,1,0,0,0
11541362,3,3,0,0,1,1,0,1,0
11542560,2,2,0,0,4,4,0,1,0
11543247,1,1,0,0,1,1,0,0,0
11543773,1,1,0,0,1,1,0,0,0
11544650,1,1,0,0,1,1,0,0,0
11544778,7,5,2,0,1,1,0,1,0
11544897,1,1,0,0,1,1,0,0,0
07490243,2,1,1,0,1,1,0,0,1
07490873,1,1,0,0,1,1,0,0,0
07491219,8,4,4,0,2,1,1,1,0
07493343,2,2,0,0,2,2,0,0,0
07493534,6,5,1,0,0,0,0,0,0
07493575,8,2,6,0,0,0,0,0,0
07494637,2,0,2,0,0,0,0,0,0
07495535,5,2,3,0,2,2,0,0,0
07496237,2,1,1,0,1,1,0,0,0
07496752,18,2,16,0,2,2,0,2,1
07496754,18,2,16,0,2,2,0,2,1
07496756,22,9,13,0,1,1,0,1,1
07496765,18,2,16,0,2,2,0,2,1
07498765,14,4,10,0,4,3,1,2,1
07504878,5,3,2,0,2,2,0,0,0
07505595,3,2,1,0,2,2,0,0,0
07506340,2,2,0,0,2,2,0,0,0
07506360,5,2,3,0,4,1,3,1,1
07507035,3,0,3,0,0,0,0,0,0
07509364,1,0,1,0,0,0,0,0,0
07509556,17,6,11,0,0,0,0,0,0
07510176,2,1,1,0,1,1,0,0,0
07510835,2,2,0,0,2,2,0,0,0
07511594,15,6,9,0,1,1,0,1,0
07513112,11,7,4,0,0,0,0,0,0
07513309,37,7,30,0,0,0,0,0,0
07513742,2,0,2,0,0,0,0,0,0
07515070,11,2,9,0,1,1,0,1,1
07515728,10,4,6,0,0,0,0,0,0
07517968,7,6,1,0,0,0,0,0,0
07519888,42,10,32,0,0,0,0,0,0
07519927,23,10,13,0,0,0,0,0,0
07520152,11,7,4,0,0,0,0,0,0
07521736,3,3,0,0,1,1,0,0,0
07521823,3,3,0,0,1,1,0,0,0
07521873,9,4,5,0,2,1,1,2,1
07521907,9,4,5,0,2,1,1,2,1
07523406,4,4,0,0,0,0,0,0,0
07523436,38,9,29,0,0,0,0,0,0
07523689,2,1,1,0,1,1,0,0,0
07523925,4,0,4,0,0,0,0,0,0
07528584,4,0,4,0,0,0,0,0,1
07530104,5,2,3,1,1,1,0,0,1
07534028,6,0,6,0,0,0,0,0,1
07534492,2,2,0,0,1,1,0,0,0
07534860,3,0,3,0,0,0,0,0,0
07536991,3,0,3,0,0,0,0,0,0
07537246,12,6,6,0,0,0,0,0,0
07538278,5,0,5,0,0,0,0,0,0
07539853,8,5,3,0,1,1,0,1,1
07539908,7,0,7,0,0,0,0,0,0
07540370,2,2,0,0,1,1,0,0,0
07543121,5,3,2,0,2,1,1,1,1
07544338,10,4,6,0,2,1,1,1,0
07544471,3,1,2,0,2,1,1,0,1
07545147,4,2,2,0,1,1,0,1,0
07546316,2,0,2,0,0,0,0,0,1
07548631,3,1,2,0,1,1,0,0,1
07549973,2,1,1,0,1,1,0,0,0
07551425,1,1,0,0,1,1,0,0,0
07552481,23,11,12,0,0,0,0,0,0
07554085,42,18,24,0,0,0,0,0,0
07557831,46,10,36,0,0,0,0,0,0
07558274,2,2,0,0,1,1,0,0,0
07558889,2,2,0,0,1,1,0,0,0
07559238,29,0,29,0,0,0,0,0,0
07561173,19,5,14,0,1,1,0,0,0
07562205,7,5,2,0,3,2,1,0,0
07562444,2,2,0,0,2,2,0,0,0
07564775,1,1,0,0,1,1,0,0,0
07565213,4,1,3,0,2,1,1,0,0
07566145,2,2,0,0,2,2,0,0,0
07566864,13,7,6,0,1,1,0,0,1
07566876,20,8,12,0,0,0,0,0,0
07568647,4,0,4,0,0,0,0,0,0
07569800,9,0,9,0,2,2,0,0,1
07572212,1,1,0,0,1,1,0,0,0
07572731,8,4,4,0,2,2,0,0,1
07572807,8,4,4,0,2,2,0,0,1
07572889,8,0,8,0,0,0,0,0,1
07572899,9,4,5,0,2,2,0,0,1
07572901,9,4,5,0,2,2,0,0,1
07574354,7,0,7,0,0,0,0,0,1
07575896,13,5,8,0,0,0,0,0,1
07577516,2,2,0,0,2,2,0,0,0
07580631,3,1,2,0,1,1,0,0,0
07580701,5,4,1,0,0,0,0,0,0
07581094,2,0,2,0,2,2,0,0,0
07582667,33,9,24,0,0,0,0,0,0
07583593,2,2,0,0,1,1,0,0,0
07583788,3,3,0,0,1,1,0,0,0
07583822,5,3,2,0,1,1,0,1,1
07585008,1,1,0,0,1,1,0,0,0
07585782,1,1,0,0,1,1,0,0,0
07586374,6,4,2,0,4,4,0,0,0
07586830,1,1,0,0,1,1,0,0,0
07588143,14,0,14,0,1,1,0,1,1
07589363,3,1,2,0,1,1,0,0,0
07589481,9,3,6,0,3,3,0,1,0
07590914,3,3,0,0,1,1,0,0,0
07591304,1,1,0,0,1,1,0,0,0
07592665,12,8,4,0,1,1,0,0,1
07594260,2,1,1,0,2,2,0,0,1
07594985,4,2,2,0,1,1,0,0,0
07597478,1,1,0,0,1,1,0,0,0
07599770,19,10,9,0,0,0,0,0,1
07603246,1,1,0,0,1,1,0,0,0
07604056,2,2,0,0,1,1,0,0,0
07607048,6,6,0,0,1,1,0,1,0
07609153,5,0,5,0,0,0,0,0,0
07609633,8,2,6,0,1,1,0,1,1
07609890,3,0,3,0,0,0,0,0,1
07610890,12,6,6,0,0,0,0,0,0
07611216,1,0,1,0,0,0,0,0,0
07612934,10,5,5,0,0,0,0,0,1
07613189,5,2,3,0,2,2,0,0,0
07613938,4,1,3,0,1,1,0,0,0
07615079,6,2,4,0,1,1,0,1,1
07616837,1,1,0,0,2,2,0,0,0
07617194,11,7,4,0,0,0,0,0,1
07617428,4,0,4,0,0,0,0,0,1
07617803,2,1,1,0,1,1,0,0,0
07618383,25,9,16,0,0,0,0,0,0
07618878,3,1,2,0,1,1,0,0,0
07619883,3,0,3,0,0,0,0,0,1
07620159,3,2,1,0,1,1,0,0,1
07620214,3,1,2,0,1,1,0,0,0
07620273,2,0,2,0,0,0,0,0,1
07620417,2,1,1,0,1,1,0,0,0
07620500,4,2,2,0,4,3,1,1,1
07621081,2,1,1,0,1,1,0,0,0
07621395,36,0,36,0,0,0,0,0,0
07621435,29,6,23,0,1,1,0,1,1
07621563,1,0,1,0,0,0,0,0,1
07621620,2,2,0,0,2,2,0,0,0
07622804,1,0,1,0,0,0,0,0,1
07624752,3,3,0,0,3,3,0,0,0
07625498,2,1,1,0,1,1,0,0,1
07625798,4,3,1,0,1,1,0,1,0
07626228,2,0,2,0,0,0,0,0,1
07627849,2,0,2,0,2,2,0,0,0
07629032,2,1,1,0,2,2,0,0,0
07631987,2,1,1,0,1,1,0,0,1
07634625,4,1,3,0,1,1,0,0,0
07635600,3,2,1,0,1,1,0,0,0
07635780,8,3,5,0,0,0,0,0,0
07635853,1,0,1,0,0,0,0,0,1
07636451,2,2,0,0,1,1,0,0,0
07636956,3,3,0,0,2,2,0,0,0
07637289,10,7,3,0,2,2,0,0,1
07637558,2,2,0,0,1,1,0,1,1
07637968,6,0,6,0,0,0,0,0,0
07637971,6,0,6,0,0,0,0,0,0
07638010,2,2,0,0,1,1,0,1,1
07638361,6,1,5,0,1,1,0,0,0
07638800,34,10,24,0,4,3,1,0,0
07639256,2,2,0,0,2,2,0,0,0
07639269,8,7,1,0,1,1,0,0,0
07639348,1,1,0,0,1,1,0,0,0
07640730,8,0,8,0,1,1,0,1,1
07642002,3,2,1,0,1,1,0,0,1
07643107,1,1,0,0,0,0,0,0,0
07643381,1,1,0,0,1,1,0,0,1
07643489,1,1,0,0,1,1,0,0,0
07644310,5,0,5,0,1,1,0,1,1
07645159,23,7,16,0,0,0,0,0,1
07645531,6,5,1,0,1,1,0,1,1
07647443,1,1,0,0,1,1,0,0,0
07648378,2,2,0,0,2,2,0,0,0
07648445,1,1,0,0,1,1,0,0,0
07649077,5,5,0,0,1,1,0,0,1
07649093,15,4,11,1,6,4,2,0,0
07649122,25,0,25,0,0,0,0,0,0
07650615,18,0,18,0,0,0,0,0,0
07651297,3,3,0,0,1,1,0,1,0
07652341,1,0,1,0,0,0,0,0,0
07652548,19,4,15,0,1,1,0,1,1
07653084,3,2,1,0,1,1,0,0,0
07653209,11,6,5,0,1,1,0,1,1
07653794,4,0,4,0,0,0,0,0,0
07654298,38,10,28,0,0,0,0,0,0
07654899,7,5,2,0,0,0,0,0,0
07655648,3,2,1,0,2,2,0,0,0
07656439,16,7,9,0,1,1,0,1,1
07657307,31,7,24,0,5,4,1,0,1
07657603,8,0,8,0,0,0,0,0,1
07658130,2,1,1,0,1,1,0,0,0
07658413,14,10,4,0,0,0,0,0,0
07658679,1,1,0,0,2,1,1,0,0
07660591,5,5,0,0,1,1,0,0,1
07660874,11,6,5,0,3,2,1,1,1
07661987,21,4,17,0,4,1,3,4,1
07662896,6,0,6,0,0,0,0,0,1
07663383,7,2,5,0,1,1,0,1,0
07665387,45,17,28,0,0,0,0,0,0
07665967,2,2,0,0,2,2,0,0,0
07666136,16,5,11,0,0,0,0,0,0
07666140,4,2,2,0,2,2,0,0,0
07667884,1,1,0,0,1,1,0,0,1
07668762,2,2,0,0,2,2,0,0,0
07671949,37,9,28,0,0,0,0,0,1
07674379,1,1,0,0,1,1,0,0,0
07675052,3,3,0,0,2,2,0,0,0
07675537,1,0,1,0,0,0,0,0,1
07677386,1,0,1,0,1,1,0,0,0
07678756,16,4,12,0,2,2,0,2,1
07679091,10,0,10,0,0,0,0,0,1
07680583,2,2,0,0,1,1,0,0,1
07680728,13,0,13,0,0,0,0,0,1
07680770,30,14,16,0,0,0,0,0,0
07680947,10,3,7,0,2,1,1,1,0
07681344,1,1,0,0,1,1,0,0,0
07681400,11,7,4,0,1,1,0,1,1
07681691,4,2,2,0,2,2,0,0,1
07681706,2,2,0,0,0,0,0,0,1
07682104,1,1,0,0,1,1,0,0,0
07683167,1,1,0,0,1,1,0,0,0
07684197,5,3,2,0,1,1,0,0,0
07684902,33,14,19,0,0,0,0,0,0
07684990,1,1,0,0,2,2,0,0,0
07687047,1,0,1,0,0,0,0,0,1
07687362,1,1,0,0,1,1,0,0,0
07688256,2,0,2,0,1,1,0,0,0
07688954,2,0,2,0,0,0,0,0,1
07691585,3,1,2,0,1,1,0,0,0
07691647,5,3,2,0,2,2,0,0,1
07692348,16,0,16,0,0,0,0,0,1
07692632,13,0,13,0,0,0,0,0,1
07692831,4,2,2,0,2,1,1,1,0
07692959,2,1,1,0,0,0,0,0,1
07693250,20,7,13,0,0,0,0,0,1
07693359,14,0,14,0,0,0,0,0,1
07694530,48,18,30,0,0,0,0,0,1
07694783,2,1,1,0,1,1,0,0,0
07695253,2,2,0,0,1,1,0,0,0
07695890,7,0,7,0,0,0,0,0,1
07695941,2,2,0,0,2,2,0,0,0
07696969,3,3,0,0,2,2,0,0,0
07697161,4,2,2,0,1,1,0,1,1
07697175,4,2,2,0,1,1,0,0,1
07697698,34,12,22,0,0,0,0,0,0
07699161,10,4,6,0,2,1,1,1,0
07699549,3,2,1,0,1,1,0,0,0
07700324,1,0,1,0,0,0,0,0,1
07700432,1,1,0,0,1,1,0,0,0
07700859,8,4,4,0,3,3,0,0,1
07701442,1,1,0,0,1,1,0,0,0
07703006,1,1,0,0,1,1,0,0,0
07703851,3,2,1,0,1,1,0,0,1
07705256,1,0,1,0,0,0,0,0,1
07706999,17,5,12,0,5,3,2,1,0
07708541,8,6,2,0,1,1,0,0,0
07708822,6,4,2,0,3,1,2,1,0
07709347,2,2,0,0,1,1,0,0,1
07709697,4,3,1,0,2,2,0,0,0
07710305,8,4,4,0,4,4,0,0,0
07710455,1,1,0,0,1,1,0,0,0
07710817,3,2,1,0,2,2,0,0,0
07711071,1,1,0,0,1,1,0,0,0
07711740,7,3,4,0,3,2,1,0,1
07712579,30,9,21,0,0,0,0,0,0
07712913,1,1,0,0,1,1,0,0,0
07713452,1,0,1,0,0,0,0,0,1
07713552,10,4,6,0,1,1,0,1,1
07713704,3,3,0,0,3,3,0,0,0
07714497,3,0,3,0,0,0,0,0,1
07714504,2,1,1,0,1,1,0,0,0
07715022,7,0,7,0,1,1,0,0,1
07715613,41,14,27,0,8,5,3,0,0
07716530,12,4,8,0,2,2,0,2,1
07717015,36,13,23,0,4,3,1,0,0
07717283,3,3,0,0,0,0,0,0,0
07717873,6,4,2,0,2,2,0,0,0
07719271,2,1,1,0,1,1,0,0,0
07721870,6,0,6,0,1,1,0,0,1
07722777,1,1,0,0,0,0,0,0,0
07723074,2,1,1,0,1,1,0,0,0
07724287,2,2,0,0,2,2,0,0,0
07725010,6,5,1,0,0,0,0,0,0
07726595,4,1,3,0,2,2,0,0,0
07728462,4,1,3,0,1,1,0,0,0
07728537,2,1,1,0,1,1,0,0,0
07728703,3,3,0,0,2,2,0,0,0
07729971,20,6,14,0,1,1,0,1,1
07733161,1,0,1,0,0,0,0,0,1
07735003,3,3,0,0,3,3,0,0,0
07736179,4,0,4,0,0,0,0,0,1
07737613,8,0,8,0,1,1,0,1,1
07737703,8,5,3,0,1,1,0,1,1
07737738,8,5,3,0,1,1,0,1,1
07737778,9,5,4,0,1,1,0,1,1
07737899,3,0,3,0,0,0,0,0,1
07739489,2,0,2,0,2,2,0,0,0
07741421,2,2,0,0,1,1,0,0,0
07742231,2,2,0,0,1,1,0,0,1
07744116,7,0,7,0,1,1,0,0,0
07744796,1,1,0,0,1,1,0,0,0
07744964,1,1,0,0,1,1,0,0,0
07746772,3,0,3,0,0,0,0,0,1
07748482,1,0,1,0,0,0,0,0,1
07749682,4,2,2,0,1,1,0,0,0
07753274,4,3,1,0,2,1,1,0,0
07754091,3,1,2,0,1,1,0,1,0
07755580,2,0,2,0,1,1,0,0,0
07755924,2,0,2,0,1,1,0,0,0
07757413,5,2,3,0,0,0,0,0,0
07759931,4,0,4,0,0,0,0,0,1
07760448,4,0,4,0,0,0,0,0,0
07763785,1,1,0,0,1,1,0,0,0
07764623,3,2,1,0,3,3,0,0,0
07766672,1,0,1,0,0,0,0,0,0
07766681,1,0,1,0,0,0,0,0,0
07766977,4,0,4,0,1,1,0,1,1
07767438,3,1,2,0,1,1,0,0,0
07767624,4,3,1,0,1,1,0,0,0
07767710,4,2,2,0,3,2,1,0,0
07770942,3,2,1,0,2,2,0,1,0
07772804,3,1,2,0,1,1,0,0,0
07774204,2,0,2,0,1,1,0,0,0
07774541,2,2,0,0,2,2,0,0,0
07776979,2,2,0,0,2,2,0,0,0
07778713,1,1,0,0,1,1,0,0,0
08000160,7,0,7,0,0,0,0,0,0
08002160,3,3,0,0,1,1,0,1,0
08002172,4,4,0,0,3,3,0,0,0
08003975,2,0,2,0,0,0,0,0,1
08004006,1,1,0,0,1,1,0,0,0
08004196,3,2,1,0,1,1,0,0,1
08004383,3,2,1,0,1,1,0,0,0
08004760,8,5,3,0,4,4,0,0,0
08005512,20,6,14,0,0,0,0,0,0
08006377,4,0,4,0,3,3,0,0,0
08007139,1,0,1,0,1,1,0,0,0
08007897,2,2,0,0,1,1,0,0,0
08008214,1,1,0,0,1,1,0,0,0
08008915,9,1,8,0,1,1,0,0,0
08011029,3,3,0,0,2,2,0,0,0
08011541,11,4,7,0,0,0,0,0,0
08011855,3,0,3,0,0,0,0,0,0
08011922,12,2,10,0,0,0,0,0,1
08012443,7,4,3,0,3,3,0,0,1
08013043,28,12,16,0,0,0,0,0,0
08013982,3,2,1,0,2,2,0,0,0
08015004,1,1,0,0,1,1,0,0,0
08015679,2,2,0,0,1,1,0,0,0
08015844,4,0,4,0,0,0,0,0,1
08017068,4,1,3,0,1,1,0,0,0
08017096,1,1,0,0,0,0,0,0,1
08018487,4,1,3,0,2,2,0,0,0
08021195,10,2,8,0,1,1,0,0,1
08022028,1,1,0,0,1,1,0,0,0
08023015,1,0,1,0,0,0,0,0,0
08024332,5,0,5,0,0,0,0,0,1
08025222,2,1,1,0,1,1,0,0,0
08029920,1,0,1,0,0,0,0,0,0
08030181,5,3,2,0,3,1,2,1,1
08030879,2,2,0,0,1,1,0,0,0
08030927,2,0,2,0,0,0,0,0,0
08032098,1,0,1,0,0,0,0,0,0
08033539,3,2,1,0,1,1,0,1,0
08033728,3,2,1,0,1,1,0,1,0
08034553,8,4,4,0,1,1,0,1,1
08034734,2,1,1,0,1,1,0,0,0
08035368,2,2,0,0,1,1,0,0,0
08035787,1,1,0,0,1,1,0,0,0
08037191,3,2,1,0,2,2,0,0,1
08037357,1,1,0,0,1,1,0,0,0
08039743,2,0,2,0,1,1,0,0,0
08041426,1,1,0,0,1,1,0,0,0
08041891,10,5,5,0,4,0,4,0,0
08042021,9,5,4,0,2,2,0,0,1
08042040,8,4,4,0,2,2,0,0,1
08042066,10,5,5,0,2,2,0,0,1
08042089,9,5,4,0,2,2,0,0,1
08043198,1,1,0,0,1,1,0,0,0
08043633,4,4,0,0,1,1,0,0,0
08043853,2,1,1,0,1,1,0,0,0
08044108,4,4,0,0,3,2,1,0,1
08044110,21,12,9,0,0,0,0,0,0
08044644,2,2,0,0,2,2,0,0,0
08045327,2,2,0,0,2,2,0,0,0
08046334,1,0,1,0,0,0,0,0,0
08047395,2,2,0,0,1,1,0,0,0
08047635,3,2,1,0,2,2,0,0,1
08048025,11,3,8,0,1,1,0,1,1
08049051,20,6,14,0,1,1,0,1,1
08051155,2,2,0,0,2,2,0,0,0
08052689,1,0,1,0,1,1,0,0,0
08053808,2,1,1,0,2,1,1,0,0
08055250,2,2,0,0,0,0,0,0,1
08058035,2,2,0,0,3,2,1,1,0
08058861,3,1,2,0,1,1,0,0,0
08059499,3,0,3,0,0,0,0,0,1
08059762,3,0,3,0,1,1,0,0,0
08059813,3,1,2,0,1,1,0,0,0
08062225,6,0,6,0,0,0,0,0,1
08062438,2,0,2,0,0,0,0,0,1
08063192,4,4,0,0,1,1,0,0,0
08064696,5,2,3,0,2,1,1,0,0
08064796,52,10,42,0,0,0,0,0,1
08064823,2,0,2,0,0,0,0,0,1
08065361,2,1,1,0,1,1,0,0,0
08066178,1,1,0,0,1,1,0,0,0
08069338,1,0,1,0,1,1,0,0,0
08070292,1,0,1,0,1,1,0,0,0
08070821,7,5,2,0,0,0,0,0,0
08070927,2,2,0,0,2,2,0,0,0
08071783,30,10,20,0,1,1,0,0,0
08073296,2,2,0,0,2,2,0,0,0
08074308,1,1,0,0,2,2,0,0,0
08075354,3,3,0,0,1,1,0,1,1
08075594,3,0,3,0,0,0,0,0,0
08075971,3,0,3,0,0,0,0,0,0
08077041,3,2,1,0,2,2,0,0,0
08077071,6,4,2,0,2,2,0,0,0
08078513,1,1,0,0,1,1,0,0,0
08079222,3,3,0,0,2,2,0,0,0
08079461,1,1,0,0,1,1,0,0,0
08081660,2,0,2,0,0,0,0,0,0
08084081,2,2,0,0,2,2,0,0,1
08086209,1,0,1,0,0,0,0,0,1
08086266,1,1,0,0,1,1,0,0,0
08087907,9,4,5,0,1,1,0,0,1
08089385,1,0,1,0,0,0,0,0,1
08090159,5,3,2,0,1,1,0,0,0
08090165,5,3,2,0,1,1,0,0,0
08090844,2,2,0,0,1,1,0,0,0
08091232,2,0,2,0,1,1,0,0,0
08091613,2,0,2,0,0,0,0,0,1
08093934,5,0,5,0,0,0,0,0,1
08094315,5,0,5,0,0,0,0,0,1
08094396,4,0,4,0,0,0,0,0,1
08095601,13,7,6,0,1,1,0,0,0
08096411,2,2,0,0,1,1,0,0,0
08097203,4,3,1,0,1,1,0,0,0
08097631,4,3,1,0,1,1,0,0,0
08098889,1,0,1,0,0,0,0,0,1
08099214,4,0,4,0,0,0,0,0,0
08099275,3,0,3,0,0,0,0,0,0
08099283,3,0,3,0,0,0,0,0,0
08100818,1,1,0,0,1,1,0,0,0
08102243,1,1,0,0,1,1,0,0,0
08102719,2,1,1,0,1,1,0,0,0
08103166,2,2,0,0,1,1,0,0,0
08105110,1,1,0,0,1,1,0,0,0
08105841,6,4,2,0,0,0,0,0,0
08105978,9,8,1,0,3,3,0,0,1
08106111,3,0,3,0,0,0,0,0,0
08107589,9,4,5,0,1,1,0,1,1
08109403,70,24,46,0,0,0,0,0,1
08109918,2,1,1,0,1,1,0,0,0
08110458,2,0,2,0,0,0,0,0,0
08111371,1,0,1,0,0,0,0,0,0
08111534,23,13,10,0,0,0,0,0,0
08113168,9,6,3,0,0,0,0,0,0
08113439,2,1,1,0,1,1,0,0,0
08113704,1,0,1,0,0,0,0,0,0
08113751,1,0,1,0,0,0,0,0,0
08114471,10,7,3,0,0,0,0,0,0
08115121,37,7,30,0,7,3,4,2,0
08115531,1,1,0,0,1,1,0,0,0
08116403,2,2,0,0,4,4,0,0,0
08116654,2,2,0,0,2,2,0,0,0
08117939,2,0,2,0,0,0,0,0,0
08118207,1,1,0,0,1,1,0,0,0
08119358,2,2,0,0,2,2,0,0,0
08120083,1,1,0,0,1,1,0,0,0
08120113,8,4,4,0,4,4,0,0,0
08121657,8,7,1,0,2,2,0,0,1
08122177,4,1,3,0,0,0,0,0,0
08123510,13,8,5,0,0,0,0,0,0
08124201,3,1,2,0,1,1,0,0,0
08124965,6,4,2,0,0,0,0,0,0
08126913,1,1,0,0,1,1,0,0,1
08126948,1,1,0,0,1,1,0,0,1
08127108,27,14,13,0,4,4,0,0,0
08128049,3,3,0,0,2,2,0,0,0
08128583,11,2,9,0,1,1,0,1,0
08128622,3,0,3,0,0,0,0,0,0
08130468,31,12,19,0,5,1,4,1,0
08130713,13,7,6,0,0,0,0,0,0
08130916,2,1,1,0,1,1,0,0,0
08130964,2,0,2,0,0,0,0,0,1
08132021,2,0,2,0,2,2,0,0,0
08133075,1,1,0,0,1,1,0,0,0
08135114,2,2,0,0,3,3,0,0,0
08137505,3,2,1,0,3,2,1,0,0
08137960,1,1,0,0,1,1,0,0,0
08138345,4,4,0,0,0,0,0,0,0
08140381,1,1,0,0,1,1,0,0,0
08142572,25,8,17,0,0,0,0,0,0
08142578,4,3,1,0,2,2,0,0,0
08144558,8,7,1,0,2,1,1,2,1
08144871,8,4,4,0,1,1,0,1,1
08145589,2,0,2,0,2,1,1,0,0
08145797,2,2,0,0,2,2,0,0,0
08147954,5,4,1,0,4,4,0,1,0
08148983,1,0,1,0,0,0,0,0,0
08149175,3,3,0,0,0,0,0,0,0
08150106,36,9,27,0,0,0,0,0,0
08150702,1,1,0,0,1,1,0,0,0
08151209,17,8,9,0,0,0,0,0,0
08151616,1,0,1,0,0,0,0,0,0
08152053,1,1,0,0,1,1,0,0,0
08152826,2,1,1,0,1,1,0,1,0
08153063,4,2,2,0,0,0,0,0,0
08153177,45,12,33,0,0,0,0,0,0
08154998,2,2,0,0,5,2,3,1,0
08157580,5,4,1,0,1,1,0,0,0
08160508,1,0,1,0,1,1,0,0,0
08161843,5,3,2,0,2,2,0,2,1
08162661,4,3,1,0,1,1,0,0,1
08163598,1,0,1,0,0,0,0,0,1
08163696,5,3,2,0,1,1,0,1,0
08167089,6,5,1,0,0,0,0,0,0
08167403,3,3,0,0,3,3,0,0,0
08167525,11,3,8,0,1,1,0,1,1
08168420,4,1,3,0,2,2,0,0,0
08169302,3,1,2,0,3,1,2,1,0
08170294,2,2,0,0,1,1,0,0,0
08171446,1,0,1,0,1,1,0,0,0
08172554,3,3,0,0,2,2,0,0,0
08172622,3,2,1,0,1,1,0,1,1
08172730,2,0,2,0,1,1,0,0,1
08173770,4,3,1,0,3,3,0,0,0
08175447,1,1,0,0,2,2,0,0,0
08175562,2,2,0,0,3,3,0,0,0
08177657,23,3,20,0,0,0,0,0,0
08179498,17,12,5,0,3,3,0,0,0
08180474,13,4,9,0,1,1,0,1,1
08180871,3,3,0,0,2,2,0,0,0
08183618,12,5,7,0,0,0,0,0,0
08184012,5,2,3,0,2,2,0,0,1
08184628,1,1,0,0,1,1,0,0,0
08185428,2,1,1,0,1,1,0,0,0
08185742,2,2,0,0,0,0,0,0,1
08185864,2,2,0,0,0,0,0,0,1
08186697,1,1,0,0,1,1,0,0,0
08186831,4,0,4,0,0,0,0,0,0
08188395,2,0,2,0,0,0,0,0,0
08188751,1,1,0,0,1,1,0,0,0
08189798,15,4,11,0,1,1,0,1,1
08189893,9,0,9,0,1,1,0,0,1
08190142,8,6,2,0,1,0,1,1,1
08190147,5,3,2,0,1,1,0,0,1
08190241,5,5,0,0,1,1,0,1,1
08190259,5,5,0,0,1,1,0,1,1
08190642,3,1,2,0,1,1,0,0,0
08191399,3,1,2,0,2,1,1,0,0
08195416,2,1,1,0,1,1,0,0,0
08196643,1,1,0,0,1,1,0,0,0
08197047,1,0,1,0,0,0,0,0,0
08197670,4,0,4,0,0,0,0,0,1
08197840,1,1,0,0,2,2,0,0,0
08197966,25,6,19,0,1,1,0,1,1
08198531,1,0,1,0,0,0,0,0,1
08198858,7,0,7,0,0,0,0,0,0
08200466,3,0,3,0,0,0,0,0,1
08203264,10,5,5,0,1,1,0,1,1
08204212,2,0,2,0,1,1,0,0,0
08205954,3,0,3,0,0,0,0,0,0
08207150,5,1,4,0,4,1,3,4,1
08208097,2,1,1,0,1,1,0,0,0
08209427,2,0,2,0,0,0,0,0,1
08212217,3,3,0,0,1,1,0,0,1
08213686,1,1,0,0,1,1,0,0,0
08214746,2,0,2,0,0,0,0,0,1
08214819,2,2,0,0,1,1,0,0,1
08214904,2,0,2,0,0,0,0,0,1
08215328,1,1,0,0,1,1,0,0,0
08215397,9,3,6,0,6,2,4,0,1
08219440,4,0,4,0,1,1,0,1,1
08222685,4,3,1,0,1,1,0,0,0
08224627,14,8,6,0,0,0,0,0,0
08226854,3,3,0,0,2,2,0,0,0
08230252,3,1,2,0,2,1,1,0,0
08230280,6,1,5,0,2,1,1,0,0
08233813,11,6,5,0,0,0,0,0,0
08234049,1,1,0,0,1,1,0,0,0
08234330,1,1,0,0,1,1,0,0,0
08236188,2,2,0,0,2,2,0,0,0
08237374,4,0,4,0,0,0,0,0,1
08238527,1,1,0,0,1,1,0,0,0
08238750,2,2,0,0,1,1,0,0,0
08239991,1,0,1,0,0,0,0,0,0
08240940,3,3,0,0,1,1,0,0,0
08247225,1,1,0,0,1,1,0,0,0
08248102,1,1,0,0,1,1,0,0,0
08248158,1,1,0,0,0,0,0,0,1
08248561,2,2,0,0,1,1,0,0,1
08249262,2,1,1,0,1,1,0,0,0
08250810,3,0,3,0,0,0,0,0,1
08251122,1,1,0,0,1,1,0,0,0
08251500,2,1,1,0,1,1,0,0,0
08251960,2,2,0,0,1,1,0,0,0
08252639,26,10,16,0,0,0,0,0,1
08253207,3,0,3,0,1,1,0,0,0
08253452,7,4,3,0,4,1,3,2,0
08253617,1,1,0,0,1,1,0,0,0
08254664,1,1,0,0,1,1,0,0,0
08255003,1,1,0,0,1,1,0,0,0
08255056,2,0,2,0,0,0,0,0,0
08256463,4,3,1,0,1,1,0,0,1
08256622,5,0,5,0,0,0,0,0,1
08257461,21,3,18,0,0,0,0,0,1
08257472,6,3,3,0,0,0,0,0,0
08258198,6,4,2,0,2,1,1,1,1
08258425,2,0,2,0,0,0,0,0,0
08258475,1,0,1,0,1,1,0,0,0
08259069,25,12,13,0,5,3,2,0,0
08260217,5,0,5,0,0,0,0,0,1
08260807,6,4,2,0,1,1,0,1,1
08260933,6,4,2,0,1,1,0,1,1
08265992,2,0,2,0,1,1,0,0,0
08266005,9,5,4,0,0,0,0,0,0
08266903,2,2,0,0,2,2,0,0,0
08268543,2,2,0,0,1,1,0,0,0
08268976,10,3,7,0,1,1,0,1,1
08269213,3,0,3,0,0,0,0,0,0
08269385,3,3,0,0,1,1,0,1,0
08269806,1,1,0,0,1,1,0,0,0
06960112,6,3,3,0,1,1,0,0,1
06960329,22,9,13,0,0,0,0,0,0
06963114,2,0,2,0,1,1,0,0,0
06964924,2,1,1,0,1,1,0,0,1
06967248,18,11,7,0,0,0,0,0,1
06967542,8,0,8,0,0,0,0,0,1
06967743,1,1,0,0,1,1,0,0,0
06968171,9,5,4,0,3,1,2,1,1
06968511,8,1,7,0,1,1,0,1,0
06969470,5,1,4,0,1,1,0,0,1
06975073,6,4,2,0,3,3,0,0,0
06975228,6,3,3,0,1,1,0,1,0
06976903,1,1,0,0,0,0,0,0,0
06978074,14,5,9,0,2,2,0,0,0
06979925,4,2,2,0,1,1,0,0,0
06980222,1,0,1,0,1,1,0,0,0
06980618,3,1,2,0,2,1,1,0,1
06980632,4,1,3,0,0,0,0,0,1
06982795,3,1,2,0,1,1,0,0,0
06982933,3,3,0,0,2,2,0,0,0
06983042,28,8,20,0,1,0,1,0,1
06983710,11,0,11,1,0,0,0,0,1
06985637,3,1,2,0,1,1,0,0,0
06986368,2,2,0,0,1,1,0,0,0
06989380,4,0,4,0,2,2,0,0,1
06990256,19,7,12,0,1,1,0,1,1
06990762,5,3,2,0,1,1,0,1,1
06991044,11,0,11,0,0,0,0,0,1
06991161,6,0,6,0,2,2,0,0,1
06991987,5,0,5,0,0,0,0,0,1
06993738,13,3,10,0,1,1,0,1,1
06995381,10,2,8,0,3,1,2,3,0
06997861,1,1,0,0,1,1,0,0,0
06997931,32,8,24,0,0,0,0,0,0
06999022,5,3,2,0,1,1,0,1,1
06999441,2,2,0,0,1,1,0,0,0
06999901,3,3,0,0,1,1,0,0,0
06999996,3,2,1,0,1,1,0,0,0
07003077,5,3,2,0,2,2,0,0,0
07003896,6,4,2,0,2,2,0,0,1
07004848,2,1,1,0,1,1,0,0,0
07006334,2,2,0,0,1,1,0,0,0
07007118,13,0,13,0,0,0,0,0,1
07009482,4,4,0,0,0,0,0,0,0
07010975,3,0,3,0,0,0,0,0,1
07012843,3,2,1,0,1,1,0,0,0
07012945,2,1,1,0,1,1,0,0,1
07014292,10,5,5,0,1,1,0,1,1
07015948,1,1,0,0,1,1,0,0,0
07016710,3,1,2,0,1,1,0,0,0
07016879,4,3,1,0,4,4,0,0,0
07017619,13,2,11,0,0,0,0,0,1
07018193,3,1,2,0,1,1,0,0,1
07018881,8,0,8,0,0,0,0,0,1
07018892,12,5,7,0,1,1,0,1,1
07018896,13,4,9,0,1,1,0,1,1
07019414,5,0,5,0,1,1,0,1,1
07019796,2,2,0,0,2,1,1,1,0
07019871,9,6,3,0,0,0,0,0,0
07020484,1,1,0,0,1,1,0,0,0
07020571,11,4,7,0,1,1,0,1,1
07022278,3,0,3,0,1,1,0,0,0
07023564,3,1,2,0,1,1,0,0,0
07024763,28,8,20,0,0,0,0,0,1
07025543,2,1,1,0,1,1,0,0,0
07026479,10,7,3,0,2,1,1,1,1
07027066,4,2,2,0,1,1,0,0,0
07030069,4,1,3,0,2,1,1,0,0
07030995,7,0,7,0,0,0,0,0,1
07033291,5,3,2,0,5,3,2,0,0
07034195,2,0,2,0,0,0,0,0,0
07034540,4,2,2,0,1,1,0,1,1
07034820,7,2,5,0,1,1,0,1,1
07034844,6,3,3,0,1,1,0,0,1
07035290,5,3,2,0,1,1,0,0,0
07035587,11,8,3,0,0,0,0,0,1
07036341,1,0,1,0,0,0,0,0,1
07036458,1,1,0,0,1,1,0,0,0
07036468,9,2,7,0,1,1,0,1,1
07036589,23,2,21,0,1,1,0,1,1
07037994,3,2,1,0,2,2,0,0,0
07038471,2,2,0,0,1,1,0,0,0
07039318,2,0,2,0,2,2,0,0,0
07039352,2,0,2,0,1,1,0,0,0
07039909,5,0,5,0,0,0,0,0,1
07041030,2,2,0,0,2,2,0,0,0
07042873,5,5,0,0,5,5,0,0,0
07043585,3,2,1,0,2,2,0,0,1
07044948,6,2,4,0,2,2,0,0,0
07046229,2,0,2,0,0,0,0,0,1
07046746,8,0,8,0,0,0,0,0,1
07047146,11,2,9,0,3,1,2,3,1
07047255,16,2,14,0,3,1,2,3,1
07047452,5,0,5,0,0,0,0,0,1
07047608,3,3,0,0,2,2,0,0,0
07047899,4,3,1,0,2,2,0,0,0
07050408,1,0,1,0,0,0,0,0,0
07050567,5,5,0,0,0,0,0,0,0
07051733,5,2,3,0,1,1,0,0,0
07052288,15,3,12,0,2,2,0,2,1
07052438,17,4,13,0,2,2,0,2,1
07055916,2,0,2,0,0,0,0,0,1
07057470,17,4,13,0,2,2,0,2,1
07058287,8,5,3,0,4,4,0,0,1
07060502,2,0,2,0,1,1,0,0,0
07063250,3,2,1,0,2,2,0,0,0
07064312,32,10,22,0,0,0,0,0,1
07064319,19,4,15,0,1,1,0,1,1
07065829,2,1,1,0,1,1,0,0,0
07066421,3,2,1,0,1,1,0,0,0
07066721,2,2,0,0,2,2,0,0,0
07070078,12,4,8,0,2,2,0,2,1
07072513,1,0,1,0,0,0,0,0,0
07073669,2,2,0,0,2,2,0,0,0
07073928,15,3,12,0,1,1,0,0,0
07074289,3,1,2,0,1,1,0,0,0
07074814,6,2,4,0,1,1,0,0,0
07074834,5,2,3,0,1,1,0,0,0
07075571,22,10,12,0,1,1,0,1,0
07075976,4,1,3,0,1,1,0,1,0
07077945,12,4,8,0,2,2,0,2,1
07078731,3,2,1,0,2,2,0,0,1
07078853,1,1,0,0,1,1,0,0,0
07079508,3,0,3,0,0,0,0,0,1
07082057,2,0,2,0,0,0,0,0,0
07082887,5,0,5,0,1,1,0,0,0
07082890,6,3,3,0,1,1,0,0,0
07083059,52,14,38,0,0,0,0,0,0
07083120,4,0,4,0,0,0,0,0,0
07083460,17,4,13,0,2,2,0,2,1
07086238,2,1,1,0,1,1,0,1,0
07086844,1,1,0,0,2,2,0,0,0
07087275,2,0,2,0,0,0,0,0,1
07087384,13,5,8,0,0,0,0,0,0
07087896,4,0,4,0,0,0,0,0,0
07088386,12,4,8,0,1,1,0,1,0
07088419,12,4,8,0,1,1,0,1,0
07088434,12,4,8,0,1,1,0,1,0
07089066,6,3,3,0,2,2,0,0,0
07090521,9,4,5,0,1,1,0,1,1
07091156,4,0,4,0,0,0,0,0,0
07092487,1,1,0,0,1,1,0,0,0
07093115,11,2,9,0,1,1,0,1,1
07093532,3,0,3,0,0,0,0,0,0
07094272,2,0,2,0,1,1,0,0,0
07096105,21,10,11,0,1,1,0,1,1
07097107,17,9,8,0,0,0,0,0,0
07099552,2,1,1,0,1,1,0,0,0
07099666,27,8,19,0,8,4,4,0,0
07100268,5,2,3,0,2,2,0,0,0
07101530,23,8,15,0,6,6,0,0,1
07101581,8,5,3,0,1,1,0,1,1
07101777,3,1,2,0,2,2,0,0,0
07102432,4,2,2,0,1,1,0,1,1
07103770,22,8,14,0,6,6,0,0,1
07104037,2,2,0,0,2,2,0,0,0
07104418,2,1,1,0,1,1,0,0,0
07105051,14,6,8,0,1,1,0,1,1
07106472,18,2,16,0,2,1,1,2,1
07106728,13,6,7,0,1,1,0,0,0
07107825,2,2,0,0,2,2,0,0,0
07107908,1,0,1,0,0,0,0,0,1
07108723,9,4,5,0,1,1,0,1,1
07108769,6,3,3,0,0,0,0,0,0
07109145,11,0,11,0,0,0,0,0,1
07109537,5,2,3,0,2,2,0,0,1
07110269,2,2,0,0,3,3,0,0,0
07111287,7,2,5,0,1,1,0,1,1
07111969,14,4,10,0,2,2,0,2,1
07113915,4,2,2,0,1,1,0,0,1
07114143,5,0,5,0,0,0,0,0,1
07114668,62,14,48,0,0,0,0,0,0
07116211,3,0,3,0,0,0,0,0,1
07117817,5,2,3,0,1,1,0,0,1
07117832,7,2,5,0,0,0,0,0,1
07117937,5,1,4,0,1,1,0,0,1
07117959,6,2,4,0,1,1,0,0,1
07118278,1,1,0,0,1,1,0,0,0
07118962,7,3,4,0,0,0,0,0,1
07119657,1,0,1,0,0,0,0,0,1
07120232,4,3,1,0,2,2,0,0,0
07121047,21,3,18,0,2,2,0,2,1
07121942,6,0,6,0,1,1,0,1,1
07122681,7,3,4,0,1,1,0,0,1
07124620,3,2,1,0,1,1,0,0,0
07125033,8,3,5,0,1,1,0,1,1
07125097,2,0,2,0,2,2,0,0,1
07126090,1,1,0,0,1,1,0,0,0
07126995,5,4,1,0,1,1,0,0,0
07127130,8,4,4,0,0,0,0,0,1
07127152,2,2,0,0,1,1,0,0,0
07127388,2,2,0,0,1,1,0,0,1
07127476,18,9,9,0,0,0,0,0,1
07128317,24,3,21,0,2,2,0,2,1
07130145,27,10,17,0,0,0,0,0,0
07130547,3,0,3,0,0,0,0,0,1
07131018,2,0,2,0,0,0,0,0,1
07131294,10,3,7,0,2,2,0,2,1
07131416,11,4,7,0,0,0,0,0,1
07133066,2,1,1,0,1,1,0,0,0
07133193,6,0,6,0,0,0,0,0,0
07133922,2,2,0,0,1,1,0,0,0
07134366,3,3,0,0,1,1,0,0,1
07134442,3,0,3,0,0,0,0,0,1
07135297,2,0,2,0,2,2,0,0,0
07135691,8,0,8,0,0,0,0,0,1
07136274,16,0,16,0,0,0,0,0,1
07137203,7,3,4,0,1,1,0,1,1
07137953,2,0,2,0,0,0,0,0,1
07138012,2,1,1,0,1,1,0,0,1
07138167,1,1,0,0,1,1,0,0,0
07139131,14,8,6,0,3,3,0,1,1
07139260,6,6,0,0,0,0,0,0,0
07140606,17,7,10,0,1,1,0,0,0
07140614,7,3,4,0,0,0,0,0,1
07140994,2,2,0,0,1,1,0,0,0
07140997,1,1,0,0,1,1,0,0,0
07141268,10,5,5,0,0,0,0,0,0
07143677,2,2,0,0,2,2,0,0,0
07145272,9,0,9,1,0,0,0,0,1
07146157,1,0,1,0,0,0,0,0,1
07146505,10,0,10,0,0,0,0,0,1
07148936,13,5,8,0,0,0,0,0,0
07150857,3,0,3,0,0,0,0,0,0
07151159,32,8,24,0,2,2,0,1,1
07153323,13,3,10,0,1,1,0,1,1
07153998,2,2,0,0,1,1,0,1,0
07154018,21,3,18,0,1,1,0,1,1
07155068,1,0,1,0,1,1,0,0,0
07155164,2,2,0,0,1,1,0,0,0
07155558,10,2,8,0,2,1,1,1,1
07156554,1,1,0,0,1,1,0,0,1
07157573,2,0,2,0,2,2,0,0,0
07158636,4,2,2,0,1,1,0,0,0
07159767,28,11,17,0,2,1,1,0,1
07160485,8,3,5,0,2,1,1,0,1
07160526,8,3,5,0,2,1,1,0,1
07160558,9,0,9,0,0,0,0,0,1
07160564,13,0,13,0,1,1,0,1,1
07160790,6,5,1,0,0,0,0,0,1
07162100,13,4,9,0,1,1,0,2,1
07162168,7,5,2,0,1,1,0,0,1
07162177,10,4,6,0,0,0,0,0,0
07162316,3,2,1,0,1,1,0,0,0
07163887,8,3,5,0,0,0,0,0,0
07163927,24,7,17,0,0,0,0,0,0
07164379,5,5,0,0,0,0,0,0,0
07165429,20,3,17,0,2,2,0,2,1
07166149,1,1,0,0,1,1,0,0,0
07166304,10,4,6,0,1,1,0,1,1
07167526,6,1,5,0,1,1,0,0,1
07167859,5,3,2,0,0,0,0,0,1
07168038,5,3,2,0,2,2,0,0,0
07168674,31,7,24,0,0,0,0,0,1
07169795,4,2,2,0,2,1,1,0,1
07169907,6,4,2,0,2,1,1,1,1
08530782,4,0,4,0,0,0,0,0,0
08531034,2,0,2,0,0,0,0,0,0
08532600,13,5,8,0,0,0,0,0,0
08534345,7,4,3,0,1,1,0,1,1
08534514,2,1,1,0,1,1,0,0,0
08535984,2,2,0,0,1,1,0,0,0
08536408,2,2,0,0,0,0,0,0,1
08536722,2,2,0,0,2,2,0,0,1
08538786,2,2,0,0,2,2,0,0,1
08538791,2,2,0,0,2,2,0,0,1
08539189,2,0,2,0,1,1,0,0,0
08539526,2,0,2,0,1,1,0,0,0
08542357,1,1,0,0,1,1,0,0,0
08542379,2,1,1,0,2,1,1,0,1
08542489,2,2,0,0,2,2,0,0,0
08542591,3,3,0,0,3,3,0,0,0
08543305,1,1,0,0,1,1,0,0,0
08545067,1,0,1,0,1,1,0,0,0
08545833,4,2,2,0,2,1,1,0,0
08546426,2,2,0,0,1,1,0,0,0
08548118,6,3,3,0,3,3,0,0,1
08548165,6,3,3,0,3,3,0,0,1
08548178,6,3,3,0,3,3,0,0,1
08548196,6,3,3,0,3,3,0,0,1
08549781,1,1,0,0,1,1,0,0,0
08549807,24,13,11,0,4,3,1,0,0
08550268,15,10,5,0,1,0,1,0,0
08551069,7,5,2,0,3,1,2,1,1
08551602,1,0,1,0,1,1,0,0,0
08551665,3,0,3,0,1,1,0,0,0
08552573,12,7,5,0,2,1,1,0,0
08557607,1,0,1,0,0,0,0,0,1
08561412,4,0,4,0,0,0,0,0,0
08565402,3,2,1,0,0,0,0,0,0
08565408,3,2,1,0,1,1,0,0,1
08566758,2,2,0,0,1,1,0,0,0
08567573,2,2,0,0,2,2,0,0,0
08568596,3,2,1,0,1,1,0,0,0
08573867,2,1,1,0,1,1,0,0,0
08575689,8,4,4,0,0,0,0,0,0
08576415,2,2,0,0,3,3,0,1,0
08576475,2,2,0,0,0,0,0,0,0
08576824,2,2,0,0,2,2,0,0,0
08577555,2,2,0,0,2,2,0,0,0
08578057,4,3,1,0,1,1,0,0,0
08578328,6,0,6,0,0,0,0,0,0
08578954,7,2,5,0,2,2,0,0,0
08579378,1,0,1,0,0,0,0,0,0
08579692,2,1,1,0,1,1,0,0,0
08580215,4,3,1,0,1,1,0,0,0
08582114,1,1,0,0,1,1,0,0,0
08583892,4,2,2,0,0,0,0,0,1
08585232,6,3,3,0,0,0,0,0,1
08588297,3,3,0,0,2,2,0,0,0
08588963,3,1,2,0,1,1,0,0,0
08590001,1,0,1,0,0,0,0,0,1
08590449,7,7,0,0,1,1,0,0,0
08590560,3,1,2,0,3,1,2,0,0
08593656,2,2,0,0,1,1,0,0,0
08593983,1,0,1,0,0,0,0,0,0
08594745,2,0,2,0,0,0,0,0,0
08595012,3,2,1,0,2,2,0,0,0
08596836,8,5,3,0,2,2,0,0,1
08597833,1,1,0,0,1,1,0,0,0
08599501,5,0,5,0,0,0,0,0,1
08600335,1,1,0,0,1,1,0,0,0
08600373,1,1,0,0,1,1,0,0,0
08601507,1,1,0,0,1,1,0,1,1
08601814,15,9,6,0,1,1,0,0,0
08604037,14,11,3,0,3,3,0,0,0
08604765,6,5,1,0,1,1,0,1,1
08604848,1,1,0,0,1,1,0,0,0
08605549,14,7,7,0,0,0,0,0,0
08606594,2,2,0,0,1,1,0,0,0
08606603,3,0,3,0,0,0,0,0,0
08608223,13,3,10,0,0,0,0,0,1
08609837,7,5,2,0,5,5,0,0,0
08613109,2,0,2,0,2,2,0,0,0
08614761,2,1,1,0,1,1,0,0,0
08617000,3,0,3,0,0,0,0,0,1
08618431,9,0,9,0,0,0,0,0,0
08618570,6,2,4,0,0,0,0,0,0
08627693,2,2,0,0,2,1,1,1,0
08627710,2,2,0,0,2,2,0,0,0
08629162,2,1,1,0,1,1,0,0,0
08629270,2,0,2,0,1,1,0,0,0
08632620,3,0,3,0,0,0,0,0,0
08634357,2,1,1,0,1,1,0,0,1
08634734,2,2,0,0,1,1,0,0,0
08634825,3,3,0,0,2,2,0,0,0
08634972,2,1,1,0,1,1,0,0,1
08637677,3,2,1,0,1,1,0,0,0
08638347,1,1,0,0,1,1,0,0,0
08638564,4,0,4,0,3,3,0,0,1
08638770,1,1,0,0,1,1,0,0,0
08638781,1,1,0,0,1,1,0,0,0
08641053,1,1,0,0,1,1,0,0,0
08641929,1,0,1,0,1,1,0,0,0
08643393,8,5,3,2,3,1,2,1,0
08643420,8,5,3,2,3,1,2,1,0
08643773,5,3,2,0,1,1,0,0,0
08644101,6,5,1,0,4,4,0,1,0
08644945,2,2,0,0,2,2,0,0,0
08649086,2,1,1,0,0,0,0,0,0
08652271,5,0,5,0,3,3,0,0,0
08653864,2,2,0,0,2,2,0,0,0
08654072,1,1,0,0,1,1,0,0,0
08654404,4,0,4,0,0,0,0,0,0
08654722,4,3,1,0,1,1,0,0,0
08654923,2,2,0,0,2,2,0,0,0
08655079,1,1,0,0,1,1,0,0,0
08656257,3,0,3,0,1,1,0,0,0
08656387,1,1,0,0,1,1,0,0,0
08656711,1,0,1,0,1,1,0,0,0
08658766,2,1,1,0,1,1,0,0,0
08658805,15,8,7,0,6,6,0,0,0
08659352,2,0,2,0,0,0,0,0,1
08659358,2,2,0,0,2,2,0,0,0
08659610,3,1,2,0,1,1,0,1,1
08659634,3,1,2,0,1,1,0,1,1
08659926,3,2,1,0,2,2,0,0,0
08661460,11,9,2,0,1,1,0,1,1
08666041,10,1,9,0,1,1,0,1,1
08667191,14,3,11,0,0,0,0,0,0
08668299,1,0,1,0,0,0,0,0,0
08669980,5,5,0,0,2,2,0,0,0
08670478,6,4,2,0,0,0,0,0,0
08672590,2,0,2,0,0,0,0,0,1
08672655,2,0,2,0,0,0,0,0,1
08672777,2,0,2,0,0,0,0,0,1
08672822,2,0,2,0,0,0,0,0,1
08673057,2,0,2,0,0,0,0,0,1
08674428,2,2,0,0,2,2,0,0,0
08675587,2,2,0,0,3,3,0,1,0
08676158,2,2,0,0,1,1,0,0,0
08677410,1,1,0,0,1,1,0,0,0
08677510,1,1,0,0,1,1,0,0,0
08678419,2,2,0,0,2,2,0,0,0
08680036,4,2,2,0,3,2,1,0,0
08680130,3,3,0,0,1,1,0,0,0
08680406,14,7,7,0,0,0,0,0,0
08681332,1,1,0,0,1,1,0,0,0
08683577,10,8,2,0,1,1,0,1,1
08685063,1,1,0,0,1,1,0,0,1
08685505,7,5,2,0,1,1,0,1,1
08686547,1,0,1,0,1,1,0,0,0
08686818,4,0,4,0,0,0,0,0,0
08688637,7,2,5,0,1,1,0,0,0
08690205,1,0,1,0,0,0,0,0,0
08694373,14,7,7,0,1,1,0,1,1
08696102,2,0,2,0,0,0,0,0,1
08696232,1,1,0,0,1,1,0,0,0
08696249,3,3,0,0,1,1,0,0,1
08697555,2,2,0,0,2,2,0,0,0
08699882,3,2,1,0,1,1,0,0,1
08700209,1,1,0,0,1,1,0,0,0
08702833,1,0,1,0,0,0,0,0,1
08703455,1,1,0,0,1,1,0,0,0
08703722,1,1,0,0,1,1,0,0,0
08703897,2,2,0,0,2,2,0,0,0
08705142,1,1,0,0,1,1,0,0,0
08705984,2,2,0,0,1,1,0,0,0
08706064,9,5,4,0,4,1,3,4,1
08706112,9,5,4,0,1,1,0,1,1
08706689,2,2,0,0,1,1,0,0,1
08707246,2,2,0,0,1,1,0,0,0
08707909,14,9,5,0,0,0,0,0,1
08709619,6,3,3,0,1,1,0,0,1
08712250,2,2,0,0,1,1,0,0,0
08713438,2,0,2,0,0,0,0,0,1
08713503,2,0,2,0,0,0,0,0,1
08713566,2,0,2,0,0,0,0,0,1
08713590,2,0,2,0,0,0,0,0,1
08713604,2,0,2,0,0,0,0,0,1
08713681,2,0,2,0,0,0,0,0,1
08714915,3,0,3,0,0,0,0,0,0
08717705,3,3,0,0,1,1,0,0,0
08719717,3,3,0,0,2,2,0,0,0
08721484,2,2,0,0,1,1,0,0,0
08722187,3,2,1,0,2,2,0,0,0
08724301,2,1,1,0,1,1,0,0,0
08724834,3,3,0,0,1,1,0,0,0
08728191,5,1,4,0,4,1,3,0,0
08728895,9,7,2,0,0,0,0,0,0
08729562,2,0,2,0,1,1,0,0,1
08730339,3,3,0,0,1,1,0,1,1
08731048,6,1,5,0,4,1,3,0,0
08731237,1,1,0,0,1,1,0,0,0
08732579,1,1,0,0,1,1,0,0,0
08732916,3,2,1,0,2,2,0,0,0
08734933,2,1,1,0,1,1,0,0,0
08737354,3,3,0,0,1,1,0,0,0
08738521,4,0,4,0,1,1,0,0,0
08743407,8,6,2,0,6,6,0,0,0
08745854,5,3,2,0,1,0,1,0,1
08747388,5,2,3,0,3,1,2,1,0
08747430,12,5,7,0,2,2,0,1,1
08747445,1,0,1,0,0,0,0,0,1
08749024,13,6,7,0,7,7,0,6,1
08750835,2,2,0,0,1,1,0,0,0
08751126,7,4,3,0,1,1,0,1,1
08751342,1,1,0,0,1,1,0,0,0
08751723,3,2,1,0,2,2,0,0,0
08752221,2,2,0,0,1,1,0,0,0
08753310,10,5,5,0,2,1,1,1,1
08753813,9,8,1,0,0,0,0,0,1
08754046,3,1,2,0,1,1,0,0,0
08754690,3,1,2,0,1,1,0,0,0
08755562,4,2,2,0,1,1,0,1,0
08755654,10,2,8,0,1,1,0,1,0
08756310,2,2,0,0,1,1,0,1,0
08757539,3,2,1,0,0,0,0,0,0
08758074,1,1,0,0,2,2,0,0,1
08760381,12,4,8,0,2,2,0,0,1
08760407,12,4,8,0,2,2,0,0,1
08760413,12,4,8,0,2,2,0,0,1
08760424,8,3,5,0,2,2,0,0,1
08760430,12,4,8,0,2,2,0,0,1
08760435,12,4,8,0,2,2,0,0,1
08760439,12,4,8,0,2,2,0,0,1
08760442,12,4,8,0,2,2,0,0,1
08760444,12,4,8,0,2,2,0,0,1
08760447,12,4,8,0,2,2,0,0,1
08760450,12,4,8,0,2,2,0,0,1
08760458,8,3,5,0,2,2,0,0,1
08760550,12,4,8,0,2,2,0,0,1
08760682,2,1,1,0,1,1,0,0,0
08760754,12,4,8,0,2,2,0,0,1
08760919,9,4,5,0,2,1,1,0,0
08760995,22,11,11,0,0,0,0,0,0
08762270,7,5,2,0,0,0,0,0,0
08766038,2,2,0,0,2,2,0,0,0
08767545,1,1,0,0,1,1,0,0,0
08770246,2,2,0,0,2,2,0,0,0
08771442,2,1,1,0,2,1,1,0,0
08771656,2,0,2,0,1,1,0,0,0
08772426,1,1,0,0,1,1,0,0,0
08776217,4,1,3,0,2,1,1,0,0
08776473,5,1,4,0,2,0,2,0,0
08776650,7,6,1,0,1,1,0,1,1
08776872,7,6,1,0,1,1,0,1,1
08779988,2,0,2,0,1,1,0,0,0
08779997,2,0,2,0,0,0,0,0,0
08780103,1,1,0,0,1,1,0,0,0
08780268,1,1,0,0,1,1,0,0,0
08783035,1,1,0,0,1,1,0,0,0
08783135,1,1,0,0,1,1,0,0,0
08783393,8,5,3,0,1,0,1,1,1
08783948,1,0,1,0,0,0,0,0,0
08784612,4,2,2,0,0,0,0,0,1
08785021,1,1,0,0,1,1,0,0,0
08785667,2,2,0,0,1,1,0,0,0
08785707,5,3,2,0,2,2,0,2,0
08786309,1,0,1,0,0,0,0,0,0
08787158,2,0,2,0,0,0,0,0,0
08788258,2,2,0,0,2,2,0,0,0
08788890,1,1,0,0,1,1,0,0,0
08790592,2,2,0,0,1,1,0,0,0
08792247,4,4,0,0,1,1,0,0,0
08794297,11,0,11,0,0,0,0,0,1
08794782,2,2,0,0,1,1,0,0,0
08797383,3,0,3,0,0,0,0,0,1
08798207,1,1,0,0,1,1,0,0,0
08798931,19,6,13,0,0,0,0,0,0
08799644,3,3,0,0,2,2,0,0,0
08799775,4,3,1,0,2,2,0,0,1
08799986,2,2,0,0,2,2,0,0,0
10080222,1,0,1,0,1,1,0,0,0
10080286,1,1,0,0,1,1,0,0,0
10080695,2,2,0,0,2,2,0,0,1
10081902,3,0,3,0,1,1,0,0,0
10082394,3,3,0,0,1,1,0,0,0
10083627,2,2,0,0,2,2,0,0,0
10084743,14,9,5,0,0,0,0,0,1
10085828,1,0,1,0,1,1,0,0,0
10086102,4,3,1,0,2,1,1,0,0
10087524,2,0,2,0,1,1,0,0,0
10089417,2,1,1,0,1,1,0,0,0
10089741,5,5,0,0,2,2,0,0,1
10090746,2,2,0,0,2,2,0,0,0
10092604,1,1,0,0,1,1,0,0,0
10093017,4,4,0,0,2,2,0,0,0
10094455,2,1,1,0,2,2,0,0,0
10095275,1,1,0,0,1,1,0,0,0
10095412,4,3,1,0,3,3,0,0,0
10097300,3,1,2,0,1,1,0,0,1
10097564,1,1,0,0,1,1,0,0,0
10097579,1,1,0,0,1,1,0,0,0
10100378,1,1,0,0,1,1,0,0,0
10101278,3,1,2,0,1,1,0,0,0
10102086,1,1,0,0,1,1,0,0,0
10102835,1,1,0,0,1,1,0,0,0
10103822,5,4,1,0,1,1,0,0,0
10104945,1,1,0,0,1,1,0,0,0
10105411,4,4,0,0,1,1,0,0,0
10109290,1,1,0,0,1,1,0,0,0
10109790,3,0,3,0,1,1,0,0,0
10109912,2,2,0,0,2,2,0,0,0
10112554,2,0,2,0,2,2,0,0,0
10112950,1,0,1,0,1,1,0,0,0
10114004,2,2,0,0,2,2,0,0,0
10114060,2,2,0,0,2,2,0,0,0
10114585,3,2,1,0,1,1,0,0,0
10116452,2,2,0,0,2,2,0,0,0
10118104,3,0,3,0,2,1,1,0,0
10119096,2,0,2,0,1,1,0,0,0
10120942,7,6,1,0,3,1,2,3,1
10121534,1,1,0,0,1,1,0,0,0
10122587,1,0,1,0,1,1,0,0,0
10123785,1,0,1,0,0,0,0,0,1
10125597,1,1,0,0,1,1,0,0,0
10125777,2,2,0,0,1,1,0,0,0
10127154,1,1,0,0,1,1,0,0,0
10129606,4,2,2,0,1,1,0,0,1
10129984,1,1,0,0,1,1,0,0,0
10131918,1,1,0,0,1,1,0,0,0
10132596,5,0,5,0,0,0,0,0,0
10133076,1,0,1,0,0,0,0,0,0
10133641,3,2,1,0,2,1,1,1,0
10133978,1,1,0,0,1,1,0,0,0
10135092,2,2,0,0,0,0,0,0,1
10136091,2,1,1,0,2,2,0,0,0
10136505,3,3,0,0,1,1,0,0,1
10137796,3,3,0,0,2,2,0,0,0
10139387,1,1,0,0,1,1,0,0,0
10139455,1,1,0,0,1,1,0,0,0
10140325,5,4,1,0,2,2,0,0,1
10140355,1,0,1,0,0,0,0,0,0
10143080,3,3,0,0,1,1,0,0,1
10146210,2,2,0,0,2,2,0,0,0
10147034,2,2,0,0,1,1,0,0,0
10148516,1,0,1,0,1,1,0,0,0
10149951,4,3,1,0,4,4,0,1,1
10151905,1,0,1,0,0,0,0,0,0
10152692,1,1,0,0,1,1,0,0,0
10153017,2,2,0,0,2,2,0,0,0
10155123,4,4,0,0,0,0,0,0,0
10155507,2,2,0,0,1,1,0,1,0
10155567,2,0,2,0,1,1,0,0,0
10156049,4,0,4,0,0,0,0,0,0
10157724,5,3,2,0,4,2,2,0,0
10159516,1,1,0,0,1,1,0,0,0
10159825,12,7,5,0,1,1,0,0,0
10162279,2,1,1,0,1,1,0,0,0
10162781,5,0,5,0,1,1,0,1,0
10163520,1,0,1,0,1,1,0,0,0
10163642,1,0,1,0,0,0,0,0,0
10164566,2,1,1,0,1,1,0,0,0
10164867,1,0,1,0,1,1,0,0,0
10166046,4,2,2,0,2,1,1,0,1
10166116,4,2,2,0,2,1,1,0,1
10168908,2,0,2,0,0,0,0,0,0
10169698,4,2,2,0,2,1,1,1,1
10169702,2,2,0,0,1,1,0,0,0
10170629,1,1,0,0,1,1,0,0,0
10171532,1,0,1,0,2,2,0,0,0
10172098,3,3,0,0,2,2,0,0,0
10172167,3,0,3,0,1,1,0,0,0
10172314,3,1,2,0,1,1,0,0,0
10172715,9,3,6,0,1,1,0,1,0
10173340,1,1,0,0,1,1,0,0,0
10173830,1,1,0,0,1,1,0,0,0
10174740,6,2,4,1,1,1,0,1,1
10176057,2,1,1,0,1,1,0,0,0
10176819,2,0,2,0,1,1,0,0,0
10177130,3,2,1,0,3,2,1,0,1
10177334,5,4,1,0,1,1,0,1,0
10177384,5,4,1,0,1,1,0,1,0
10180516,3,2,1,0,2,2,0,0,0
10182391,7,6,1,0,2,1,1,2,1
10185326,1,1,0,0,1,1,0,0,0
10187373,5,5,0,0,0,0,0,0,0
10188722,1,1,0,0,1,1,0,0,0
10189944,13,7,6,0,0,0,0,0,1
10191222,4,1,3,0,1,1,0,0,0
10191617,3,2,1,0,1,1,0,1,0
10192087,1,0,1,0,0,0,0,0,0
10193164,3,3,0,0,1,1,0,0,0
10193466,2,2,0,0,1,1,0,0,0
10193701,3,2,1,0,2,2,0,0,1
10195484,2,0,2,0,2,1,1,0,0
10195971,1,1,0,0,1,1,0,1,0
10198575,2,2,0,0,2,2,0,0,0
10198766,2,2,0,0,2,2,0,0,0
10199286,1,1,0,0,1,1,0,0,0
10199861,2,2,0,0,2,2,0,0,0
10200598,2,0,2,0,1,1,0,0,0
10201730,9,8,1,0,0,0,0,0,1
10201784,1,0,1,0,1,1,0,0,0
10203800,5,0,5,0,1,1,0,0,0
10204158,1,0,1,0,0,0,0,0,0
10206451,1,1,0,0,1,1,0,0,0
10206763,2,2,0,0,1,1,0,0,0
10208081,2,1,1,0,1,1,0,0,0
10209876,1,0,1,0,0,0,0,0,0
10210432,2,1,1,0,1,1,0,0,0
10213753,2,1,1,0,1,1,0,0,0
10213767,2,2,0,0,2,2,0,0,0
10214265,2,2,0,0,0,0,0,0,0
10214411,8,7,1,0,0,0,0,0,0
10214476,1,1,0,0,1,1,0,0,0
10216326,1,1,0,0,1,1,0,0,0
10217359,1,1,0,0,1,1,0,0,0
10218776,1,1,0,0,1,1,0,0,0
10219644,6,2,4,0,2,2,0,0,1
10220488,1,1,0,0,1,1,0,0,0
10221596,8,6,2,0,0,0,0,0,0
10225221,2,0,2,0,1,1,0,0,0
10226779,4,4,0,0,0,0,0,0,0
10227312,3,2,1,0,0,0,0,0,0
10227899,1,0,1,0,1,1,0,0,0
10231975,7,6,1,0,2,1,1,2,1
10232721,4,4,0,0,4,4,0,0,0
10233203,3,1,2,0,0,0,0,0,0
10233818,1,1,0,0,1,1,0,0,0
10236128,1,1,0,0,1,1,0,0,0
10236607,7,5,2,0,1,1,0,0,0
10238697,9,6,3,0,9,6,3,0,0
10239438,2,1,1,0,1,1,0,0,0
10239791,1,1,0,0,3,3,0,1,0
10242996,1,1,0,0,0,0,0,0,0
10243118,4,2,2,0,0,0,0,0,0
10243277,3,0,3,0,2,1,1,0,0
10243907,1,1,0,0,0,0,0,0,0
10244370,2,2,0,0,0,0,0,0,0
10245109,1,1,0,0,1,1,0,0,0
10245306,1,1,0,0,1,1,0,0,1
10247250,1,1,0,0,1,1,0,0,0
10248894,1,0,1,0,0,0,0,0,1
10249615,1,0,1,0,1,1,0,0,0
10249626,1,1,0,0,1,1,0,0,0
10250660,2,1,1,0,2,1,1,1,0
10251221,3,2,1,0,3,1,2,1,1
10251495,7,6,1,0,0,0,0,0,0
10251736,3,3,0,0,0,0,0,0,0
10251914,1,1,0,0,0,0,0,0,0
10252805,1,0,1,0,1,1,0,0,0
10252879,3,3,0,0,1,1,0,1,1
10253772,1,0,1,0,0,0,0,0,0
10254412,2,1,1,0,1,1,0,0,0
10255867,1,1,0,0,1,1,0,0,0
10257177,10,4,6,0,0,0,0,0,0
10257389,6,3,3,0,1,1,0,1,0
10257711,1,0,1,0,0,0,0,0,1
10257759,2,0,2,0,0,0,0,0,0
10259257,1,1,0,0,1,1,0,0,0
10261477,17,14,3,0,0,0,0,0,0
10261527,1,1,0,0,1,1,0,0,0
10261928,1,0,1,0,1,1,0,0,0
10262795,2,1,1,0,1,1,0,1,1
10262926,1,0,1,0,2,2,0,0,0
10263089,2,2,0,0,1,1,0,0,0
10265332,2,2,0,0,2,2,0,0,1
10266130,13,6,7,0,3,1,2,3,1
10266157,5,0,5,0,1,1,0,1,0
10266974,1,0,1,0,1,1,0,0,1
10267054,2,0,2,0,1,1,0,0,0
10268028,6,0,6,0,1,1,0,1,0
10268613,7,4,3,0,3,1,2,2,1
10269958,1,1,0,0,1,1,0,0,0
10270190,1,1,0,0,1,1,0,0,0
10270681,2,2,0,0,2,2,0,0,1
10272768,1,0,1,0,0,0,0,0,0
10273889,3,3,0,0,1,1,0,0,0
10274156,1,1,0,0,1,1,0,0,0
10275837,3,2,1,0,2,1,1,0,0
10276625,1,0,1,0,1,1,0,0,0
10278253,2,0,2,0,0,0,0,0,0
10278659,16,5,11,0,2,2,0,2,1
10281020,8,6,2,0,1,0,1,0,0
10282235,1,1,0,0,2,2,0,1,0
10283688,6,4,2,0,1,1,0,1,0
10285710,2,2,0,0,1,1,0,0,1
10286078,23,22,1,0,0,0,0,0,0
10286560,1,0,1,0,1,1,0,0,0
10288247,1,0,1,0,1,1,0,0,0
10292456,2,2,0,0,2,2,0,0,0
10293416,3,0,3,0,3,3,0,0,0
10293977,4,3,1,0,1,1,0,0,1
10295198,2,2,0,0,1,1,0,1,1
10295520,7,5,2,0,5,1,4,2,1
10296280,1,1,0,0,1,1,0,0,0
10297518,1,0,1,0,1,1,0,0,0
10297659,2,2,0,0,1,1,0,1,0
10298832,11,8,3,0,0,0,0,0,1
10298837,3,0,3,0,4,3,1,0,0
10299088,2,2,0,0,2,2,0,0,1
10299891,2,2,0,0,1,1,0,0,1
10302920,2,2,0,0,2,2,0,0,0
10303602,1,1,0,0,1,1,0,0,0
10303655,1,1,0,0,1,1,0,0,0
10306344,2,2,0,0,1,1,0,1,0
10311383,8,7,1,0,4,4,0,0,0
10314313,1,1,0,0,0,0,0,0,0
10314531,1,1,0,0,1,1,0,0,1
10315858,1,1,0,0,1,1,0,0,0
10316562,1,1,0,0,1,1,0,0,1
10317433,4,2,2,0,1,1,0,0,0
10320385,1,1,0,0,1,1,0,0,0
10322391,2,2,0,0,2,2,0,1,1
10323559,1,1,0,0,1,1,0,0,0
10323663,1,0,1,0,1,1,0,0,0
10323738,1,1,0,0,1,1,0,0,0
10328654,2,0,2,0,2,2,0,0,0
10329093,1,1,0,0,1,1,0,0,0
10333182,5,2,3,0,2,1,1,2,0
10333760,1,1,0,0,1,1,0,0,0
10333933,3,0,3,0,0,0,0,0,1
10336101,2,1,1,0,2,2,0,0,0
10339203,1,1,0,0,1,1,0,1,0
10339463,2,1,1,0,2,1,1,0,0
10340525,2,2,0,0,2,2,0,0,0
10340889,1,1,0,0,2,2,0,0,0
10343492,3,0,3,0,3,1,2,0,0
10343645,19,11,8,0,3,0,3,0,0
10344321,5,3,2,0,0,0,0,0,0
10346170,1,1,0,0,1,1,0,0,0
10346822,1,1,0,0,1,1,0,0,0
10347568,1,1,0,0,1,1,0,0,0
10347606,10,5,5,0,2,1,1,2,1
10348109,10,3,7,0,1,1,0,1,1
10348636,17,12,5,0,0,0,0,0,0
10349199,5,2,3,0,1,1,0,1,1
10349595,1,0,1,0,1,1,0,0,0
10350242,1,0,1,0,1,1,0,0,0
10351201,1,0,1,0,1,1,0,0,0
10352235,11,7,4,0,0,0,0,0,0
10352693,2,2,0,0,3,1,2,1,0
10353605,1,1,0,0,1,1,0,0,0
10353613,1,1,0,0,1,1,0,0,0
10353810,6,6,0,0,1,1,0,1,0
10355120,1,0,1,0,1,1,0,0,0
10355868,3,2,1,0,2,1,1,0,0
10356526,2,0,2,0,1,1,0,0,0
10360012,1,1,0,0,3,3,0,3,0
10360543,13,6,7,0,2,1,1,2,1
10361954,1,1,0,0,1,1,0,1,1
10363431,1,1,0,0,1,1,0,0,0
10364449,2,2,0,0,2,2,0,0,1
10364831,3,2,1,0,0,0,0,0,0
10369194,6,6,0,0,2,2,0,0,0
10369902,1,1,0,0,0,0,0,0,0
10370242,1,1,0,0,1,1,0,1,0
10373979,2,2,0,0,2,2,0,0,0
10374031,2,1,1,0,2,1,1,0,0
10374889,2,2,0,0,1,1,0,0,1
10375524,2,2,0,0,2,2,0,0,1
10377063,5,5,0,0,1,1,0,1,1
10377590,3,3,0,0,2,2,0,0,0
10377866,4,4,0,0,1,1,0,1,1
10377884,1,1,0,0,1,1,0,0,0
10378577,1,1,0,0,1,1,0,0,0
10380232,4,2,2,0,0,0,0,0,0
10380620,2,0,2,0,2,2,0,0,0
10380945,1,1,0,0,1,1,0,0,0
10381045,7,7,0,0,0,0,0,0,0
10387610,1,1,0,0,1,1,0,0,0
10390336,5,3,2,0,2,1,1,2,1
10390722,2,2,0,0,2,2,0,2,1
10390805,1,1,0,0,1,1,0,0,0
10391191,1,1,0,0,1,1,0,0,0
10392218,2,1,1,0,2,1,1,0,0
10392943,2,1,1,0,1,1,0,0,0
10393293,3,1,2,0,2,1,1,1,0
10394000,3,1,2,0,2,1,1,1,0
10398280,1,1,0,0,1,1,0,0,0
10399739,3,3,0,0,1,1,0,1,1
10400987,2,2,0,0,2,2,0,0,0
10402151,3,0,3,0,2,1,1,0,0
10403740,1,0,1,0,1,1,0,0,0
10404126,2,2,0,0,2,1,1,2,0
10404173,1,1,0,0,1,1,0,0,0
10404406,4,4,0,0,3,2,1,0,1
10404723,2,2,0,0,1,1,0,0,0
10404791,2,2,0,0,1,1,0,1,0
10406475,2,1,1,0,2,2,0,0,0
10406610,2,2,0,0,1,1,0,0,0
10407536,1,1,0,0,1,1,0,0,0
10407847,1,1,0,0,1,1,0,0,0
10408465,2,1,1,0,2,1,1,0,0
10409075,2,1,1,0,2,2,0,0,0
10409465,3,2,1,0,1,1,0,0,1
10411603,2,0,2,0,2,2,0,0,0
10411893,1,1,0,0,1,1,0,0,0
10413366,2,2,0,0,2,2,0,0,0
10415987,1,1,0,0,2,1,1,0,0
10417843,2,1,1,0,4,3,1,0,0
10418477,3,0,3,0,3,3,0,0,1
10419128,1,1,0,0,1,1,0,0,0
10419287,1,1,0,0,1,1,0,0,0
10419563,3,2,1,0,1,1,0,0,0
10420147,1,0,1,0,1,1,0,0,0
10421504,2,0,2,0,2,2,0,0,0
10423729,1,0,1,0,1,1,0,0,0
10423899,1,1,0,0,1,1,0,0,0
10424529,6,6,0,0,2,2,0,0,0
10424923,1,1,0,0,1,1,0,0,0
10425622,1,1,0,0,1,1,0,0,0
10426416,3,3,0,0,1,1,0,0,0
10428538,2,2,0,0,1,1,0,0,0
10429500,5,3,2,0,2,1,1,2,0
10429970,4,4,0,0,2,1,1,1,1
10430326,12,6,6,0,1,1,0,1,1
10430403,4,4,0,0,1,0,1,0,1
10430672,5,5,0,0,1,0,1,0,1
10431073,7,5,2,0,2,1,1,2,1
10431771,3,2,1,0,3,2,1,0,0
10432469,3,3,0,0,2,2,0,0,0
10433264,1,1,0,0,1,1,0,0,0
10434302,2,2,0,0,1,1,0,0,1
10435089,2,1,1,0,1,1,0,0,0
10436402,5,4,1,0,0,0,0,0,0
10437032,4,4,0,0,4,4,0,0,0
10437663,3,2,1,0,2,1,1,0,0
10437777,1,0,1,0,1,1,0,0,0
10437910,3,2,1,0,3,3,0,1,1
10438262,3,3,0,0,1,1,0,0,0
10440123,7,7,0,0,2,0,2,0,1
10442521,5,4,1,0,1,1,0,0,0
10444318,1,1,0,0,1,1,0,0,0
10445772,1,1,0,0,0,0,0,0,0
10447659,1,1,0,0,1,1,0,0,0
10447667,1,0,1,0,1,1,0,0,0
10449246,1,0,1,0,1,1,0,0,0
10449530,6,4,2,0,1,0,1,1,1
04494410,12,3,9,0,1,1,0,1,0
04494415,17,3,14,0,1,1,0,0,1
04496084,5,2,3,0,2,1,1,0,0
04496300,5,3,2,0,2,2,0,0,1
04496750,43,4,39,0,1,1,0,1,1
04497290,25,8,17,0,1,1,0,1,1
04498043,4,0,4,0,2,2,0,0,1
04498304,6,2,4,0,1,1,0,0,0
04498630,28,7,21,0,0,0,0,0,1
04498846,5,3,2,0,2,2,0,0,0
04499274,8,2,6,0,2,2,0,0,0
04500926,17,3,14,0,1,1,0,1,1
04502128,2,0,2,0,1,1,0,0,0
04502723,13,6,7,0,1,1,0,1,0
04503118,4,0,4,0,0,0,0,0,1
04503426,4,2,2,0,1,1,0,0,1
04503510,5,3,2,0,2,2,0,0,0
04503512,18,0,18,0,0,0,0,0,1
04504156,5,3,2,0,1,1,0,0,1
04504417,9,0,9,0,0,0,0,0,1
04506542,6,0,6,0,2,2,0,0,0
04506956,4,2,2,0,1,1,0,0,0
04507108,5,1,4,0,2,1,1,0,0
04507227,4,3,1,0,1,1,0,1,0
04507310,4,2,2,0,1,1,0,0,0
04507654,6,1,5,0,1,1,0,0,0
04508881,14,6,8,0,1,1,0,1,1
04509398,6,1,5,0,2,2,0,0,1
04509552,5,3,2,0,2,2,0,0,1
04509666,5,1,4,0,1,1,0,0,0
04509705,9,4,5,0,1,1,0,1,1
04510105,6,2,4,0,2,2,0,0,1
04510839,10,3,7,0,2,2,0,0,0
04511936,15,4,11,2,3,3,0,0,1
04511972,6,2,4,0,1,1,0,0,1
04512301,22,3,19,0,1,1,0,1,1
04512833,8,2,6,0,2,2,0,0,1
04513042,4,2,2,0,1,1,0,0,1
04513175,5,0,5,0,0,0,0,0,1
04513189,4,0,4,0,0,0,0,0,1
04513830,5,0,5,0,0,0,0,0,1
04513834,5,0,5,0,0,0,0,0,1
04513838,5,0,5,0,0,0,0,0,1
04515549,5,4,1,0,1,1,0,1,1
04517149,13,8,5,0,1,1,0,1,1
04517172,4,0,4,0,3,2,1,0,1
04517620,25,0,25,0,0,0,0,0,1
04518938,12,3,9,0,2,2,0,0,1
04519702,16,5,11,0,3,2,1,1,1
04520748,4,2,2,0,1,1,0,0,1
04522700,23,11,12,0,1,1,0,0,0
04523300,5,3,2,0,2,2,0,0,0
04523503,8,4,4,0,1,1,0,0,0
04523999,5,3,2,0,2,2,0,0,1
04524365,4,1,3,0,1,1,0,0,0
04524464,19,3,16,0,0,0,0,0,1
04524532,5,3,2,0,2,2,0,0,0
04528822,4,2,2,0,1,1,0,0,0
04528834,10,3,7,0,0,0,0,0,0
04529121,4,1,3,0,1,1,0,0,0
04529664,8,2,6,0,1,1,0,1,0
04530518,5,0,5,0,0,0,0,0,1
04530800,8,3,5,0,1,1,0,0,1
04531941,4,2,2,0,1,1,0,0,0
04532104,5,3,2,0,2,2,0,0,0
04532619,5,3,2,0,1,1,0,0,0
04532906,8,4,4,0,1,1,0,0,0
04532950,5,3,2,0,2,2,0,0,0
04533848,5,3,2,0,1,1,0,0,0
04533879,15,4,11,0,3,3,0,0,1
04534861,7,2,5,0,3,2,1,0,0
04535408,5,3,2,0,1,1,0,0,0
04535619,8,1,7,0,1,1,0,0,1
04536350,5,0,5,0,0,0,0,0,0
04536485,18,4,14,0,3,1,2,1,1
04537744,10,4,6,0,1,0,1,0,0
04538897,5,3,2,0,2,2,0,0,0
04539191,5,1,4,0,1,1,0,0,0
04539295,5,2,3,0,1,1,0,1,1
04540647,10,6,4,0,7,5,2,0,1
04542170,28,3,25,0,0,0,0,0,1
04543344,15,3,12,0,1,1,0,1,1
04544777,5,3,2,0,0,0,0,0,1
04545195,20,3,17,0,1,1,0,1,1
04545533,6,3,3,0,3,2,1,1,1
04545910,5,2,3,0,2,2,0,0,1
04546335,18,4,14,0,1,1,0,1,1
04548271,14,4,10,0,0,0,0,0,1
04548568,16,1,15,0,5,3,2,1,1
04549491,5,1,4,0,1,1,0,0,0
04549858,7,2,5,0,2,1,1,0,1
04549920,5,2,3,0,1,1,0,0,1
04550215,5,3,2,0,1,1,0,0,0
04550309,6,4,2,0,1,1,0,1,1
04552005,20,0,20,0,0,0,0,0,1
04552017,5,2,3,0,1,1,0,0,0
04552449,21,7,14,0,3,1,2,1,1
04552819,7,1,6,0,1,1,0,0,0
04552976,7,5,2,0,1,1,0,1,0
04554256,4,0,4,0,0,0,0,0,0
04555155,5,2,3,0,2,0,2,0,1
04555700,9,1,8,0,1,1,0,0,1
04555864,4,2,2,0,1,1,0,0,0
04557207,5,0,5,0,0,0,0,0,1
04557458,4,2,2,0,2,2,0,0,0
04557729,2,0,2,0,0,0,0,0,1
04557996,10,4,6,0,1,1,0,1,0
04559144,4,3,1,0,2,2,0,0,0
04560770,26,3,23,0,1,1,0,1,1
04561162,7,2,5,0,2,1,1,1,0
04562374,4,2,2,0,1,1,0,0,0
04562610,9,2,7,0,2,2,0,0,0
04564594,23,4,19,0,0,0,0,0,1
04566895,8,1,7,0,1,1,0,0,1
04567172,6,3,3,0,2,2,0,0,1
04567407,5,3,2,0,2,2,0,0,1
04568629,2,0,2,0,1,1,0,0,0
04568948,5,3,2,0,2,2,0,0,0
04569102,3,2,1,0,1,1,0,0,0
04569344,3,0,3,0,0,0,0,0,0
04572121,16,0,16,0,0,0,0,0,1
04573090,10,0,10,0,0,0,0,0,1
04573798,7,3,4,0,2,2,0,0,0
04574222,6,4,2,0,1,1,0,0,0
04577148,12,2,10,0,1,1,0,0,0
04578654,8,3,5,0,2,2,0,0,1
04579067,24,4,20,0,0,0,0,0,1
04579458,6,3,3,0,2,2,0,0,0
04581054,5,0,5,0,0,0,0,0,0
04581366,5,1,4,0,1,1,0,0,0
04582777,59,8,51,0,0,0,0,0,0
04583297,13,3,10,0,1,1,0,1,1
04583581,4,2,2,0,2,2,0,0,1
04583645,68,17,51,0,0,0,0,0,0
04583966,29,0,29,0,0,0,0,0,1
04584575,6,3,3,0,2,2,0,0,1
04585094,5,3,2,0,2,2,0,0,0
04585620,9,2,7,0,2,1,1,0,0
04585892,17,0,17,0,4,4,0,4,1
04586484,10,0,10,0,0,0,0,0,0
04586800,6,2,4,0,0,0,0,0,1
04588047,5,2,3,0,2,2,0,0,1
04590344,5,3,2,0,1,1,0,0,0
04591053,9,5,4,0,3,3,0,1,1
04591268,6,3,3,0,1,1,0,0,0
04591518,10,0,10,0,0,0,0,0,1
04593131,5,0,5,0,1,1,0,0,0
04593332,8,2,6,0,2,1,1,0,0
04593379,12,0,12,0,0,0,0,0,0
04594179,52,7,45,0,0,0,0,0,1
04594311,5,3,2,0,1,1,0,0,0
04594332,5,0,5,0,0,0,0,0,1
04594480,8,1,7,0,1,1,0,0,0
04594990,4,2,2,0,1,1,0,0,1
04596016,5,3,2,0,2,2,0,0,1
04596021,5,3,2,0,2,2,0,0,1
04599914,4,2,2,0,1,1,0,0,1
04601591,5,1,4,0,0,0,0,0,0
04603099,21,6,15,0,2,1,1,2,1
04603355,9,4,5,0,1,1,0,0,1
04603568,18,0,18,0,0,0,0,0,0
04605410,5,3,2,0,2,2,0,0,0
04605704,5,2,3,0,1,1,0,0,0
04607884,7,3,4,0,1,1,0,0,1
04608290,6,3,3,0,1,1,0,0,1
04608410,4,2,2,0,1,1,0,0,0
04609277,8,0,8,0,0,0,0,0,1
04610618,16,2,14,0,1,1,0,1,0
04611149,31,6,25,0,2,2,0,2,1
04611845,13,6,7,0,0,0,0,0,1
04612307,15,0,15,0,0,0,0,0,1
04613075,15,2,13,0,1,1,0,1,1
04614285,27,8,19,0,1,1,0,1,1
04614307,13,0,13,0,0,0,0,0,1
04615993,19,4,15,0,2,2,0,0,1
04616045,4,2,2,0,1,1,0,0,0
04616498,11,0,11,0,0,0,0,0,1
04616702,5,3,2,0,2,2,0,0,0
04616755,8,3,5,0,1,1,0,0,0
04617453,11,2,9,0,1,1,0,1,1
04618530,8,2,6,0,2,2,0,0,0
04618589,6,1,5,0,1,1,0,0,0
04619793,30,11,19,0,0,0,0,0,0
04619884,5,2,3,1,0,0,0,0,1
04620161,6,0,6,0,0,0,0,0,1
04620422,8,3,5,0,1,1,0,0,0
04620732,7,0,7,0,1,0,1,1,0
04621135,18,6,12,0,4,1,3,1,1
04622794,13,0,13,0,0,0,0,0,1
04623186,22,6,16,0,1,1,0,1,1
04623216,10,0,10,0,0,0,0,0,1
04623609,5,2,3,0,1,1,0,0,0
04625566,27,5,22,0,1,1,0,1,1
04625810,32,12,20,0,0,0,0,0,0
04625947,5,3,2,0,2,2,0,0,0
04626078,38,8,30,0,1,1,0,1,1
04626829,9,3,6,0,1,1,0,1,1
04627531,5,3,2,0,2,2,0,0,0
04628479,6,2,4,0,0,0,0,0,1
04631083,25,4,21,0,1,1,0,1,1
04633897,10,0,10,0,0,0,0,0,1
04634174,11,2,9,0,1,1,0,1,1
04634845,5,0,5,0,0,0,0,0,1
04635176,19,8,11,0,0,0,0,0,0
04636534,6,0,6,0,0,0,0,0,1
04636674,3,2,1,0,1,1,0,0,0
04636726,100,16,84,0,0,0,0,0,1
04636772,10,0,10,0,0,0,0,0,1
04637861,5,3,2,0,1,1,0,0,0
04638872,4,0,4,0,0,0,0,0,1
04639273,18,5,13,0,0,0,0,0,0
04640255,18,3,15,0,1,1,0,1,1
04640774,5,0,5,0,0,0,0,0,1
04642027,22,6,16,0,1,1,0,1,1
04644947,7,0,7,0,0,0,0,0,1
04645893,6,0,6,0,0,0,0,0,1
04646385,13,2,11,0,1,1,0,1,1
04646838,5,0,5,0,0,0,0,0,1
04647644,10,4,6,0,1,1,0,1,1
04648835,7,2,5,0,0,0,0,0,1
04649018,4,0,4,0,1,1,0,0,1
04649110,14,2,12,0,1,1,0,1,1
04651440,5,3,2,0,1,1,0,0,0
04651889,6,4,2,0,1,1,0,0,1
04652686,5,4,1,0,1,1,0,1,1
04653899,14,3,11,0,0,0,0,0,1
04655022,12,0,12,0,0,0,0,0,1
04655663,3,2,1,0,1,1,0,0,0
04656997,6,3,3,0,1,1,0,1,0
04657401,53,10,43,0,0,0,0,0,0
04658389,18,5,13,0,2,2,0,2,1
04659539,10,2,8,0,1,1,0,0,1
04660437,5,3,2,0,1,1,0,0,0
04660482,19,3,16,0,0,0,0,0,0
04661508,5,0,5,0,0,0,0,0,1
04661696,18,3,15,0,1,1,0,1,1
04661707,18,2,16,0,0,0,0,0,1
04661973,7,2,5,0,1,1,0,0,0
04662202,10,3,7,0,2,2,0,0,0
04662524,8,3,5,0,4,2,2,2,0
04662773,8,0,8,0,2,1,1,2,1
04663146,11,2,9,0,1,1,0,0,0
04663388,5,0,5,0,0,0,0,0,1
04665665,23,6,17,0,1,1,0,0,1
04666108,5,3,2,0,2,2,0,0,0
04666277,51,10,41,0,0,0,0,0,0
04666351,11,4,7,0,3,1,2,1,1
04666440,6,3,3,0,2,2,0,0,1
04668183,7,3,4,0,1,1,0,0,1
04668416,5,3,2,0,2,2,0,0,0
04668430,5,3,2,0,2,2,0,0,1
04669575,7,4,3,0,0,0,0,0,0
04669592,13,0,13,0,0,0,0,0,1
04669596,20,5,15,0,1,1,0,1,1
04669879,13,4,9,0,1,1,0,0,1
04669957,6,2,4,0,2,2,0,0,0
04240246,10,0,10,0,0,0,0,0,1
04241401,5,3,2,0,1,1,0,1,0
04241912,10,0,10,0,0,0,0,0,1
04242478,15,0,15,0,0,0,0,0,1
04242911,5,2,3,0,2,2,0,0,0
04242945,12,1,11,0,1,0,1,0,1
04243138,8,0,8,0,0,0,0,0,0
04243510,41,14,27,0,0,0,0,0,1
04246049,29,11,18,1,0,0,0,0,1
04246641,23,5,18,0,1,1,0,1,1
04246721,9,2,7,0,2,2,0,0,0
04246723,11,5,6,0,1,1,0,1,1
04246750,15,5,10,0,2,0,2,0,0
04249178,14,3,11,0,1,1,0,1,1
04249440,11,0,11,0,1,1,0,0,1
04250304,8,3,5,0,2,2,0,0,1
04250417,8,0,8,0,0,0,0,0,1
04250740,20,3,17,0,1,1,0,1,1
04250744,21,3,18,0,1,1,0,1,1
04251018,33,3,30,0,2,2,0,2,1
04251786,5,3,2,0,0,0,0,0,0
04252606,7,1,6,0,1,1,0,0,1
04253752,33,5,28,0,0,0,0,0,0
04253889,9,4,5,0,1,1,0,1,1
04254284,5,3,2,0,2,2,0,0,1
04254466,5,0,5,0,0,0,0,0,1
04254627,21,1,20,0,0,0,0,0,1
04255100,6,2,4,0,1,1,0,0,1
04255405,8,4,4,0,1,1,0,1,0
04255496,5,3,2,0,2,2,0,0,1
04257176,17,6,11,0,0,0,0,0,0
04257292,20,4,16,0,1,1,0,1,1
04258089,7,6,1,0,2,2,0,0,0
04258284,37,7,30,0,1,1,0,1,0
04258658,6,0,6,0,1,1,0,1,1
04259750,17,5,12,0,1,1,0,1,1
04259776,17,5,12,0,1,1,0,1,1
04260112,6,0,6,0,0,0,0,0,1
04260314,6,2,4,0,1,1,0,0,0
04260616,5,2,3,0,1,1,0,0,0
04261059,4,1,3,0,1,1,0,0,1
04261234,5,1,4,0,1,1,0,0,0
04261649,10,3,7,0,1,1,0,0,1
04262016,14,2,12,0,1,1,0,1,1
04262651,8,4,4,0,3,3,0,0,1
04262934,11,0,11,0,0,0,0,0,1
04263452,17,0,17,0,0,0,0,0,1
04263502,25,5,20,0,3,1,2,3,1
04263902,4,0,4,0,0,0,0,0,1
04263976,6,3,3,0,2,2,0,0,1
04264089,14,3,11,0,0,0,0,0,0
04264918,12,3,9,0,1,1,0,1,1
04266171,14,6,8,0,1,1,0,1,1
04266500,17,4,13,0,0,0,0,0,1
04267217,13,2,11,0,1,1,0,0,0
04267457,30,9,21,0,1,0,1,0,1
04267527,16,4,12,0,1,1,0,1,1
04267815,9,4,5,0,1,1,0,1,0
04269439,23,3,20,0,0,0,0,0,1
04269509,7,4,3,0,2,2,0,0,0
04270390,5,0,5,0,1,1,0,0,1
04270732,7,3,4,0,2,2,0,0,1
04273183,4,0,4,0,2,2,0,0,1
04277888,5,0,5,0,0,0,0,0,1
04277899,11,0,11,0,2,2,0,0,1
04277937,10,4,6,0,1,1,0,1,1
04278381,17,4,13,0,1,1,0,1,0
04278539,32,3,29,0,0,0,0,0,1
04278976,20,3,17,0,3,3,0,0,1
04280066,6,3,3,0,1,1,0,1,0
04280421,4,2,2,0,1,1,0,0,1
04281011,17,4,13,0,2,2,0,2,1
04281368,5,3,2,0,2,2,0,0,1
04281470,4,2,2,0,2,2,0,0,0
04281855,51,7,44,0,0,0,0,0,0
04283369,6,2,4,0,1,1,0,0,0
04284741,9,4,5,0,2,2,0,0,1
04285432,13,0,13,0,1,1,0,0,1
04285569,8,3,5,0,1,1,0,0,1
04285643,11,1,10,0,1,1,0,0,1
04285780,15,3,12,0,0,0,0,0,1
04286329,7,3,4,0,1,1,0,0,1
04286602,6,0,6,0,1,1,0,1,1
04287042,6,2,4,0,2,2,0,0,0
04287225,24,10,14,0,0,0,0,0,0
04287501,5,2,3,0,2,2,0,0,1
04289649,11,3,8,0,1,1,0,1,0
04292847,27,2,25,0,2,1,1,2,1
04293272,7,5,2,0,1,1,0,0,1
04293279,8,3,5,0,2,2,0,0,1
04293417,13,5,8,0,0,0,0,0,1
04294906,21,2,19,0,1,1,0,1,1
04295888,5,1,4,0,2,2,0,1,1
04296257,13,3,10,0,1,1,0,1,1
04296909,5,0,5,0,0,0,0,0,1
04296959,4,1,3,0,2,2,0,0,0
04298019,8,3,5,0,3,3,0,1,1
04298115,35,4,31,0,2,2,0,2,1
04298347,12,3,9,0,1,1,0,1,0
04299001,18,1,17,0,1,1,0,1,1
04299162,10,3,7,0,1,1,0,0,0
04300102,5,3,2,0,2,2,0,0,0
04300899,9,2,7,0,1,1,0,0,0
04301665,5,3,2,0,2,2,0,0,0
04302488,18,2,16,0,1,1,0,1,1
04303322,48,7,41,0,1,1,0,1,1
04303687,13,5,8,0,0,0,0,0,0
04303771,25,0,25,0,0,0,0,0,1
04304375,6,2,4,0,1,1,0,0,1
04304791,25,3,22,0,1,1,0,1,1
04305781,14,10,4,0,1,1,0,0,0
04306847,7,4,3,0,3,3,0,0,0
04307985,16,4,12,0,0,0,0,0,1
04308169,4,2,2,0,2,2,0,0,1
04308957,8,0,8,0,0,0,0,0,1
04309631,21,3,18,0,3,3,0,3,1
04309934,30,4,26,0,2,2,0,2,1
04310930,6,1,5,0,0,0,0,0,0
04311107,34,4,30,0,1,1,0,1,1
04311542,6,4,2,0,1,1,0,1,1
04311952,13,3,10,0,1,1,0,1,1
04311953,8,3,5,0,1,1,0,1,1
04312415,15,2,13,0,1,1,0,1,1
04312431,19,3,16,0,1,1,0,1,1
04312745,22,9,13,0,0,0,0,0,0
04313833,18,0,18,0,0,0,0,0,1
04313890,27,5,22,0,1,1,0,1,1
04314538,26,7,19,0,0,0,0,0,0
04314611,14,0,14,0,0,0,0,0,1
04314638,12,6,6,0,1,1,0,1,1
04314655,14,0,14,0,0,0,0,0,1
04314690,14,0,14,0,0,0,0,0,1
04314893,10,4,6,0,0,0,0,0,1
04316368,18,6,12,0,0,0,0,0,0
04316510,13,3,10,0,1,1,0,1,1
04316888,33,0,33,0,0,0,0,0,1
04316892,14,2,12,0,3,2,1,0,1
04318494,27,3,24,0,1,1,0,1,1
04318796,8,5,3,0,0,0,0,0,1
04319146,11,2,9,0,1,1,0,1,0
04320201,30,4,26,0,2,1,1,2,1
04320596,6,2,4,0,1,1,0,0,1
04321173,34,7,27,0,10,8,2,0,0
04321205,9,3,6,0,1,1,0,0,0
04321566,4,2,2,0,1,1,0,0,1
04321726,9,2,7,0,1,1,0,1,1
04324062,13,2,11,0,2,2,0,0,1
04324182,6,1,5,0,1,1,0,0,1
04324632,34,14,20,0,0,0,0,0,1
04325234,73,13,60,0,0,0,0,0,1
04325854,9,3,6,0,4,1,3,1,0
04326135,12,0,12,0,0,0,0,0,1
04326998,10,5,5,0,0,0,0,0,0
04327286,10,3,7,0,1,1,0,1,1
04328020,8,3,5,0,2,2,0,0,1
04328138,12,5,7,0,1,1,0,1,1
04328430,19,5,14,0,1,1,0,0,1
04328885,21,5,16,0,1,1,0,1,1
04329399,15,0,15,0,1,1,0,1,1
04329558,48,12,36,0,0,0,0,0,0
04329806,9,4,5,0,1,1,0,1,1
04329816,9,2,7,0,1,1,0,1,1
04329826,9,2,7,0,1,1,0,1,1
04329960,25,0,25,0,0,0,0,0,1
04330235,24,5,19,0,1,1,0,1,1
04330748,17,0,17,0,0,0,0,0,0
04331618,4,2,2,0,1,1,0,0,0
04331916,28,9,19,0,2,2,0,0,1
04332699,12,5,7,0,3,3,0,0,0
04334042,16,3,13,0,1,1,0,1,1
04336899,27,8,19,0,0,0,0,0,1
04338129,18,3,15,0,1,1,0,0,0
04338144,13,0,13,0,0,0,0,0,1
04338151,13,0,13,0,0,0,0,0,1
04338767,13,0,13,0,0,0,0,0,1
04338807,12,0,12,0,0,0,0,0,1
04339039,11,1,10,0,1,1,0,1,1
04339455,7,0,7,0,0,0,0,0,1
04339696,19,1,18,0,1,1,0,1,1
04340801,14,0,14,0,1,1,0,1,1
04341296,26,2,24,0,2,1,1,2,1
04342600,51,9,42,0,3,2,1,0,0
04342786,12,0,12,0,0,0,0,0,1
04343623,6,1,5,0,1,1,0,0,1
04343856,6,4,2,0,2,2,0,0,1
04344046,11,2,9,0,1,1,0,1,1
04344100,30,11,19,0,0,0,0,0,0
04344573,13,0,13,0,2,2,0,2,1
04345335,14,0,14,0,2,2,0,2,1
04345658,4,1,3,0,1,1,0,0,1
04345919,22,3,19,0,1,1,0,1,1
04346412,19,0,19,0,0,0,0,0,1
04346502,19,0,19,0,0,0,0,0,1
04346523,19,0,19,0,0,0,0,0,1
04347051,4,1,3,0,1,1,0,0,1
04351814,19,3,16,0,1,1,0,1,1
04352615,15,2,13,0,0,0,0,0,1
04352678,5,3,2,0,2,2,0,0,1
04353249,21,7,14,0,1,1,0,1,1
04353971,10,1,9,0,1,1,0,0,0
04354197,22,0,22,0,0,0,0,0,1
04355437,17,6,11,0,0,0,0,0,1
04355627,6,3,3,0,1,1,0,0,1
04355648,7,0,7,0,1,1,0,0,1
04355890,7,0,7,0,1,1,0,0,1
04356029,4,1,3,0,1,1,0,0,1
04356933,55,10,45,0,1,1,0,1,1
04358261,7,1,6,0,2,2,0,0,1
04358273,28,3,25,0,1,1,0,1,1
04358718,32,8,24,0,2,2,0,2,1
04359355,6,0,6,0,2,2,0,0,1
04361684,24,6,18,0,1,1,0,1,1
04361908,4,1,3,0,1,1,0,0,0
04362060,12,0,12,0,1,1,0,1,1
04362208,6,2,4,0,1,1,0,0,1
04362328,5,2,3,0,1,1,0,0,0
04362452,4,2,2,0,1,1,0,0,1
04362595,6,0,6,0,0,0,0,0,1
04363128,8,0,8,0,0,0,0,0,1
04363173,20,6,14,0,0,0,0,0,0
04363962,15,3,12,0,1,1,0,1,1
04364446,4,2,2,0,1,1,0,0,1
04364624,17,2,15,0,2,1,1,2,1
04364731,11,2,9,0,0,0,0,0,1
04365825,11,1,10,0,1,1,0,1,1
04366481,21,5,16,0,1,1,0,1,1
04366523,26,0,26,0,0,0,0,0,1
04367489,39,3,36,0,1,0,1,1,1
04367720,7,0,7,0,0,0,0,0,1
04368235,5,1,4,0,1,1,0,0,1
04368877,5,2,3,0,0,0,0,0,1
04369238,6,3,3,0,1,1,0,0,0
04870305,3,1,2,0,1,1,0,0,0
04871849,17,7,10,0,1,1,0,0,0
04872475,5,2,3,0,1,1,0,0,1
04874206,10,1,9,0,1,0,1,0,0
04875174,3,3,0,0,1,1,0,0,0
04876990,37,9,28,0,1,0,1,0,0
04879343,4,2,2,0,1,1,0,0,0
04879643,34,5,29,0,0,0,0,0,0
04880130,6,3,3,0,0,0,0,0,1
04880870,7,1,6,0,2,2,0,0,0
04882071,38,0,38,0,0,0,0,0,1
04882271,9,4,5,0,0,0,0,0,0
04884328,29,6,23,0,0,0,0,0,1
04884502,26,6,20,0,0,0,0,0,0
04884654,21,2,19,0,0,0,0,0,1
04884915,19,0,19,0,0,0,0,0,1
04885756,5,3,2,0,2,2,0,0,0
04886955,5,2,3,0,1,1,0,0,0
04889235,10,2,8,0,1,1,0,0,1
04889408,6,2,4,0,3,2,1,0,0
04891468,4,2,2,0,1,1,0,0,0
04891484,8,0,8,0,0,0,0,0,1
04892956,3,3,0,0,1,1,0,0,0
04897182,5,0,5,0,0,0,0,0,1
04897239,15,3,12,0,2,1,1,2,1
04897291,27,4,23,0,1,1,0,1,1
04898174,6,1,5,0,1,1,0,0,1
04898352,7,0,7,0,0,0,0,0,0
04899014,11,5,6,0,0,0,0,0,0
04899037,24,0,24,0,3,3,0,0,0
04899310,4,0,4,0,0,0,0,0,1
04899958,23,6,17,0,1,0,1,1,1
04901516,4,2,2,0,1,1,0,0,1
04902681,0,0,0,0,0,0,0,0,0
04902807,12,2,10,0,1,1,0,1,0
04903102,10,4,6,0,1,1,0,0,1
04903379,8,3,5,0,1,1,0,0,0
04903619,11,0,11,0,0,0,0,0,1
04903627,18,0,18,0,0,0,0,0,1
04903631,11,0,11,0,0,0,0,0,1
04904169,7,0,7,0,0,0,0,0,1
04904325,24,5,19,0,1,1,0,1,1
04904558,6,1,5,0,0,0,0,0,0
04906026,10,4,6,0,1,1,0,1,1
04906053,17,0,17,0,0,0,0,0,0
04906768,14,0,14,0,1,1,0,0,0
04906812,4,2,2,0,1,1,0,0,1
04907011,6,4,2,0,3,3,0,0,0
04908908,64,5,59,0,0,0,0,0,0
04910761,4,0,4,0,0,0,0,0,1
04910818,6,3,3,0,2,2,0,0,0
04910892,5,2,3,0,1,1,0,0,0
04911159,22,3,19,0,1,1,0,1,0
04913632,9,4,5,0,1,1,0,1,1
04913846,64,18,46,0,0,0,0,0,1
04914493,9,4,5,0,1,1,0,1,1
04915301,5,0,5,0,0,0,0,0,1
04915792,13,1,12,0,1,1,0,1,1
04916156,27,4,23,0,1,1,0,1,1
04916157,24,0,24,1,0,0,0,0,1
04916158,28,4,24,0,1,1,0,1,1
04916159,28,4,24,0,1,1,0,1,1
04916299,7,2,5,0,1,1,0,1,1
04916483,6,2,4,0,1,1,0,0,0
04916697,4,0,4,0,0,0,0,0,1
04917372,14,6,8,0,1,1,0,0,0
04918787,5,0,5,0,0,0,0,0,0
04920825,9,1,8,0,1,1,0,0,1
04920976,7,0,7,0,0,0,0,0,1
04921900,12,5,7,0,0,0,0,0,1
04921955,36,6,30,0,0,0,0,0,0
04923011,5,3,2,0,0,0,0,0,1
04923356,2,2,0,0,2,2,0,0,0
04923710,9,6,3,0,0,0,0,0,1
04926092,12,7,5,0,1,1,0,0,1
04926093,15,9,6,0,1,1,0,1,1
04926346,3,1,2,0,2,2,0,0,0
04926427,4,2,2,0,1,1,0,0,0
04928733,34,9,25,0,0,0,0,0,0
04929486,29,3,26,0,1,1,0,1,1
04930107,4,2,2,0,1,1,0,0,1
04930349,4,4,0,0,1,1,0,0,1
04930461,26,7,19,0,0,0,0,0,1
04931627,5,4,1,0,3,3,0,0,0
04932349,7,0,7,0,0,0,0,0,1
04932863,6,1,5,0,1,1,0,1,1
04933580,4,0,4,0,1,1,0,0,1
04933827,8,0,8,0,0,0,0,0,1
04934120,3,2,1,0,1,1,0,0,0
04934182,6,0,6,0,0,0,0,0,1
04934863,12,5,7,0,3,3,0,0,0
04936660,11,0,11,0,0,0,0,0,1
04936736,10,4,6,0,0,0,0,0,1
04937256,27,7,20,0,0,0,0,0,0
04938028,5,1,4,0,1,1,0,0,0
04938801,9,3,6,0,1,1,0,1,1
04939285,12,3,9,0,1,1,0,1,1
04939322,6,3,3,0,1,1,0,1,0
04942536,9,3,6,0,1,1,0,1,1
04942956,8,3,5,0,1,1,0,0,0
04944887,4,0,4,0,2,2,0,0,1
04947618,9,4,5,0,1,1,0,1,1
04948126,9,3,6,0,1,1,0,1,0
04949032,15,2,13,0,1,1,0,1,1
04951177,6,4,2,0,3,3,0,0,0
04952162,5,3,2,0,2,2,0,0,0
04953529,6,2,4,0,1,1,0,1,0
04954436,10,4,6,0,1,1,0,1,1
04955302,18,4,14,0,1,1,0,1,1
04955356,26,3,23,0,1,1,0,1,1
04955546,4,1,3,0,1,1,0,0,0
04957103,5,0,5,0,1,1,0,0,0
04957966,19,9,10,0,0,0,0,0,0
04961635,35,5,30,0,1,1,0,1,1
04964441,9,2,7,0,1,1,0,1,1
04965297,8,4,4,0,3,3,0,1,1
04965511,6,2,4,0,1,1,0,1,0
04966253,5,3,2,0,2,1,1,0,0
04966845,12,5,7,0,1,1,0,0,1
04967898,5,2,3,0,1,1,0,0,1
04968045,17,3,14,0,1,1,0,1,1
04968889,17,5,12,0,1,1,0,1,1
04970419,11,2,9,0,1,1,0,1,1
04971210,10,2,8,0,1,1,0,1,1
04971228,5,3,2,0,0,0,0,0,0
04971742,2,0,2,0,1,1,0,0,1
04972342,5,2,3,0,1,1,0,0,1
04973132,26,3,23,0,1,1,0,1,1
04975638,6,4,2,0,1,1,0,1,0
04977050,18,3,15,0,2,1,1,2,1
04977164,23,7,16,0,3,1,2,3,1
04977354,11,5,6,0,1,1,0,1,1
04977436,15,4,11,0,2,1,1,2,1
04977629,23,7,16,0,3,1,2,3,1
04977799,12,2,10,0,1,1,0,0,1
04979716,4,2,2,0,1,1,0,0,0
04979787,7,2,5,0,0,0,0,0,1
04980802,10,4,6,0,1,1,0,1,1
04982664,17,3,14,0,4,4,0,4,1
04983353,10,2,8,0,1,1,0,0,0
04983600,4,2,2,0,1,1,0,0,0
04986779,25,2,23,0,1,1,0,1,1
04987434,5,1,4,0,1,1,0,0,0
04987475,5,2,3,0,1,1,0,0,0
04987553,4,2,2,0,1,1,0,0,1
04988045,4,4,0,0,2,2,0,0,0
04988117,13,4,9,0,0,0,0,0,0
04990157,4,0,4,0,0,0,0,0,0
04990739,16,0,16,0,0,0,0,0,1
04992004,6,1,5,0,1,1,0,1,1
04992246,14,0,14,0,0,0,0,0,1
04994108,3,2,1,0,2,2,0,0,0
04994214,8,6,2,0,3,1,2,1,0
04994440,4,2,2,0,2,2,0,0,0
04995117,5,1,4,0,2,1,1,0,0
04997688,5,0,5,0,0,0,0,0,1
04998761,10,4,6,0,1,1,0,1,1
04999945,14,0,14,0,0,0,0,0,1
05002330,5,0,5,0,0,0,0,0,1
05002706,24,3,21,0,0,0,0,0,0
05003822,19,8,11,0,0,0,0,0,0
05003926,5,3,2,0,2,2,0,0,0
05008395,7,0,7,0,0,0,0,0,1
05008899,9,0,9,0,0,0,0,0,1
05009743,24,5,19,0,1,1,0,1,1
05010997,3,2,1,0,1,1,0,0,0
05011281,7,2,5,0,1,1,0,0,0
05012266,8,3,5,0,1,1,0,0,0
05012943,10,4,6,0,1,1,0,1,0
05013101,12,6,6,0,2,2,0,0,1
05013120,7,0,7,0,0,0,0,0,1
05013988,18,2,16,0,5,1,4,1,1
05014241,28,0,28,0,0,0,0,0,1
05019373,20,0,20,0,0,0,0,0,1
05020046,10,1,9,0,1,1,0,1,1
05021720,14,5,9,0,0,0,0,0,1
05022367,6,4,2,0,3,3,0,0,1
05024233,22,2,20,0,1,1,0,1,1
05024234,22,4,18,0,2,1,1,2,1
05024239,23,3,20,0,1,1,0,1,1
05024248,19,3,16,0,1,1,0,1,1
05025197,21,5,16,0,0,0,0,0,0
05025382,3,2,1,0,0,0,0,0,1
05025973,8,3,5,0,2,1,1,1,1
05026274,4,0,4,0,0,0,0,0,1
05027148,9,2,7,0,2,2,0,0,1
05029083,14,5,9,0,1,1,0,1,1
05029792,6,1,5,0,1,1,0,0,0
05030273,14,0,14,0,0,0,0,0,1
05031599,7,0,7,0,1,1,0,1,1
05031892,7,1,6,0,2,1,1,0,1
05032682,5,3,2,0,1,1,0,1,0
05032923,14,0,14,0,1,1,0,1,1
05032989,35,6,29,0,1,1,0,1,1
05033642,20,0,20,0,0,0,0,0,1
05033672,7,0,7,0,0,0,0,0,1
05033812,7,0,7,0,0,0,0,0,1
05033870,7,0,7,0,0,0,0,0,1
05033936,3,1,2,0,0,0,0,0,1
05034393,7,2,5,0,1,1,0,0,0
05034597,4,2,2,0,1,1,0,0,1
05035321,5,2,3,0,1,1,0,0,0
05035814,6,0,6,0,0,0,0,0,1
05036018,8,2,6,0,0,0,0,0,1
05037998,15,4,11,0,1,1,0,1,1
05038715,10,4,6,0,1,1,0,1,1
05038852,9,0,9,0,1,1,0,1,1
05039130,5,0,5,0,0,0,0,0,1
05039242,7,2,5,0,2,2,0,0,0
05042196,5,3,2,0,2,2,0,0,0
05042894,22,3,19,0,0,0,0,0,1
05042905,24,2,22,0,1,1,0,1,1
05042973,7,4,3,0,1,1,0,0,0
05043032,10,1,9,0,2,1,1,1,0
05043262,6,1,5,0,1,1,0,0,1
05043538,30,3,27,0,1,1,0,1,1
05043999,8,2,6,0,1,1,0,0,1
05044630,17,5,12,0,1,1,0,1,1
05048795,18,4,14,0,1,1,0,1,1
05048856,22,0,22,0,0,0,0,0,1
05048969,7,2,5,0,0,0,0,0,1
05051572,8,0,8,0,0,0,0,0,0
05051709,8,2,6,0,1,1,0,0,0
05052661,20,5,15,0,1,1,0,1,1
05053960,20,6,14,0,0,0,0,0,1
05055092,32,2,30,0,1,1,0,1,1
05055346,29,11,18,0,0,0,0,0,1
05055553,4,3,1,0,1,1,0,0,0
05056437,20,3,17,0,1,1,0,1,1
05056899,5,1,4,0,1,1,0,1,0
05057946,9,2,7,0,2,1,1,0,0
05058510,6,0,6,0,0,0,0,0,1
05058982,6,0,6,0,0,0,0,0,0
05059934,5,1,4,0,1,1,0,0,1
05060401,5,0,5,0,0,0,0,0,0
05061242,4,2,2,0,2,2,0,0,0
05061484,5,1,4,0,1,1,0,0,0
05062775,9,2,7,0,0,0,0,0,0
05064147,11,3,8,0,1,1,0,1,1
05065382,4,2,2,0,2,2,0,0,0
05065801,6,2,4,0,1,1,0,0,1
05065834,8,0,8,0,0,0,0,0,1
05066067,9,3,6,0,0,0,0,0,0
05066242,6,0,6,0,0,0,0,0,1
05066506,24,2,22,0,1,1,0,1,1
11250049,1,1,0,0,1,1,0,0,0
11250102,2,2,0,0,1,1,0,1,0
11252529,1,0,1,0,1,1,0,0,0
11252770,3,3,0,0,1,1,0,0,0
11255076,1,1,0,0,1,1,0,0,0
11256512,3,2,1,0,3,2,1,0,0
11257249,1,1,0,0,1,1,0,0,0
11257738,1,0,1,0,1,1,0,0,0
11258197,1,1,0,0,1,1,0,0,0
11258385,2,1,1,0,2,1,1,0,0
11258438,1,1,0,0,1,1,0,0,0
11259008,2,2,0,0,2,2,0,0,0
11259376,2,2,0,0,1,1,0,1,1
11259527,1,1,0,0,1,1,0,0,0
11259807,2,2,0,0,2,2,0,0,0
11259882,5,5,0,0,1,1,0,0,0
11260759,3,3,0,0,2,2,0,0,0
11261144,2,2,0,0,2,2,0,0,0
11261725,5,5,0,0,1,1,0,0,0
11262003,2,1,1,0,2,2,0,0,1
11262355,3,2,1,0,1,1,0,1,0
11264368,2,2,0,0,1,1,0,0,0
11264564,1,1,0,0,1,1,0,0,0
11265092,2,2,0,0,1,1,0,0,0
11267333,1,1,0,0,1,1,0,0,0
11267796,2,0,2,0,1,1,0,0,0
11268224,4,4,0,0,0,0,0,0,0
11268969,1,1,0,0,1,1,0,0,0
11269615,1,1,0,0,1,1,0,0,0
11269648,3,3,0,0,1,1,0,0,0
11270152,1,1,0,0,1,1,0,0,0
11270211,4,3,1,0,1,1,0,1,1
11270466,2,0,2,0,1,1,0,0,0
11270606,4,4,0,0,1,1,0,1,1
11270702,3,0,3,0,0,0,0,0,0
11271127,1,1,0,0,2,2,0,0,0
11271228,2,2,0,0,1,1,0,0,1
11271458,2,2,0,0,3,2,1,0,0
11271629,2,2,0,0,2,2,0,0,0
11271940,1,1,0,0,1,1,0,0,0
11273123,1,1,0,0,1,1,0,1,0
11274365,10,3,7,0,4,1,3,4,0
11274760,2,2,0,0,2,2,0,0,0
11275112,8,7,1,0,2,2,0,0,0
11275691,2,2,0,0,1,1,0,0,0
11275889,4,4,0,0,0,0,0,0,0
11276457,2,2,0,0,1,1,0,1,1
11276880,1,1,0,0,1,1,0,0,0
11276996,1,1,0,0,0,0,0,0,0
11279174,4,4,0,2,1,1,0,1,0
11279539,1,1,0,0,1,1,0,0,0
11279917,1,0,1,0,1,1,0,0,0
11280977,1,1,0,0,1,1,0,0,0
11281143,1,1,0,0,1,1,0,0,0
11281469,1,1,0,0,1,1,0,1,0
11281965,4,4,0,2,1,1,0,1,0
11282151,1,1,0,0,1,1,0,0,0
11282416,3,2,1,0,1,1,0,0,0
11282448,2,1,1,0,1,1,0,0,1
11282615,2,2,0,0,0,0,0,0,0
11285736,1,1,0,0,1,1,0,0,1
11286468,3,3,0,0,2,2,0,0,0
11287031,1,1,0,0,1,1,0,0,0
11288482,1,1,0,0,1,1,0,0,0
11289573,3,3,0,0,2,2,0,0,0
11290866,5,4,1,0,1,1,0,1,0
11290904,1,1,0,0,1,1,0,0,0
11291029,5,4,1,0,1,1,0,1,0
11291085,5,4,1,0,1,1,0,1,0
11291732,11,10,1,0,3,0,3,0,0
11292431,3,3,0,0,1,1,0,0,0
11292436,2,2,0,0,2,2,0,0,1
11293626,1,1,0,0,1,1,0,1,0
11294009,5,4,1,0,1,1,0,1,0
11294114,5,4,1,0,1,1,0,1,0
11294173,1,1,0,0,1,1,0,0,0
11294236,6,5,1,0,1,1,0,1,0
11294797,5,4,1,0,0,0,0,0,1
11295680,2,2,0,0,2,2,0,0,0
11296765,2,1,1,0,2,1,1,0,0
11296820,3,3,0,0,1,1,0,1,1
11296861,2,1,1,0,2,1,1,0,0
11298221,1,1,0,0,1,1,0,0,0
11298697,2,2,0,0,0,0,0,0,0
11300584,1,1,0,0,1,1,0,0,0
11300659,1,1,0,0,1,1,0,0,0
11300701,4,4,0,0,0,0,0,0,0
11301067,1,1,0,0,1,1,0,0,0
11301080,2,2,0,0,2,2,0,0,0
11301357,7,4,3,0,3,3,0,0,0
11301596,2,2,0,0,1,1,0,1,1
11301868,1,1,0,0,0,0,0,0,0
11302368,1,1,0,0,1,1,0,0,0
11302552,2,2,0,0,2,2,0,0,0
11303202,2,1,1,0,2,1,1,0,0
11304698,2,2,0,0,3,3,0,0,0
11307473,2,2,0,0,1,1,0,0,0
11307760,1,1,0,0,2,1,1,0,0
11308185,7,6,1,0,1,1,0,1,1
11310331,2,2,0,0,1,1,0,0,0
11312323,1,1,0,0,1,1,0,0,0
11312351,1,1,0,0,1,1,0,0,0
11312799,2,0,2,0,1,1,0,0,0
11312810,1,1,0,0,1,1,0,0,0
11314058,3,3,0,0,2,2,0,0,1
11314070,1,1,0,0,1,1,0,0,0
11314374,1,1,0,0,1,1,0,0,0
11316824,10,4,6,0,3,1,2,2,1
11318468,1,1,0,0,1,1,0,0,0
11319086,2,2,0,0,1,1,0,0,0
11319784,2,2,0,0,1,1,0,0,0
11320925,3,3,0,0,1,1,0,1,1
11322212,3,3,0,0,3,3,0,0,1
11323100,2,2,0,0,2,2,0,0,0
11323197,2,2,0,0,1,1,0,1,1
11323302,2,2,0,0,1,1,0,1,1
11323479,5,3,2,0,2,1,1,2,1
11323509,2,2,0,0,1,1,0,1,1
11323554,1,1,0,0,1,1,0,0,0
11324233,3,3,0,0,2,2,0,0,0
11324574,1,1,0,0,1,1,0,0,0
11324883,2,2,0,0,1,1,0,0,0
11325733,2,2,0,0,1,1,0,0,0
11327121,2,2,0,0,1,1,0,0,0
11327799,1,1,0,0,1,1,0,0,0
11329096,3,3,0,0,0,0,0,0,0
11329342,2,2,0,0,1,1,0,1,0
11330230,1,1,0,0,1,1,0,0,0
11331382,3,3,0,0,1,1,0,0,0
11332002,2,1,1,0,2,1,1,1,0
11332200,2,2,0,0,1,1,0,0,0
11332354,1,1,0,0,2,2,0,0,0
11333222,1,1,0,0,1,1,0,0,0
11333311,2,1,1,0,1,1,0,0,0
11334204,1,1,0,0,1,1,0,0,0
11334596,4,4,0,0,2,2,0,0,0
11335194,6,6,0,0,0,0,0,0,0
11335327,2,2,0,0,1,1,0,0,0
11335438,2,2,0,0,0,0,0,0,0
11335489,3,3,0,0,3,3,0,0,0
11335975,1,1,0,0,1,1,0,0,0
11335987,1,1,0,0,1,1,0,0,0
11336345,5,5,0,0,0,0,0,0,0
11338597,5,5,0,0,0,0,0,0,0
11338675,2,2,0,0,1,1,0,1,1
11338811,2,2,0,0,1,1,0,0,0
11339491,1,1,0,0,1,1,0,0,0
11340583,1,0,1,0,1,1,0,0,0
11341742,1,1,0,0,1,1,0,0,0
11342291,3,2,1,0,3,2,1,0,0
11342333,3,3,0,0,2,2,0,0,0
11343691,2,2,0,0,1,1,0,0,0
11344313,1,1,0,0,1,1,0,0,0
11346587,1,1,0,0,1,1,0,0,0
11346671,1,1,0,0,1,1,0,0,0
11347690,1,1,0,0,2,2,0,0,0
11348962,4,4,0,0,2,2,0,0,0
11350071,1,1,0,0,1,1,0,0,0
11350219,2,2,0,0,1,1,0,0,0
11352334,1,1,0,0,1,1,0,0,0
11352559,1,1,0,0,1,1,0,0,0
11353967,2,2,0,0,1,1,0,0,1
11356642,2,2,0,0,2,2,0,0,0
11357515,3,3,0,0,3,3,0,0,0
11358754,1,1,0,0,1,1,0,0,0
11359043,2,2,0,0,1,1,0,0,0
11359058,1,1,0,0,1,1,0,0,0
11360207,3,3,0,0,2,2,0,0,1
11360691,1,1,0,0,1,1,0,0,0
11361567,1,1,0,0,1,1,0,0,0
11362482,1,0,1,0,1,1,0,0,0
11362738,3,2,1,0,3,2,1,0,0
11364186,1,1,0,0,1,1,0,0,0
11364575,1,1,0,0,1,1,0,0,0
11365183,1,1,0,0,0,0,0,0,0
11365486,1,1,0,0,2,2,0,0,0
11366857,2,2,0,0,2,2,0,0,1
11367971,3,3,0,0,1,1,0,1,0
11368184,1,1,0,0,1,1,0,0,0
11368424,1,1,0,0,1,1,0,0,0
11368674,3,3,0,0,3,3,0,0,0
11369019,1,1,0,0,1,1,0,0,0
11370399,1,1,0,0,1,1,0,0,0
11371642,1,1,0,0,1,1,0,0,0
11374294,1,1,0,0,1,1,0,0,0
11374401,2,2,0,0,1,1,0,0,0
11375031,2,2,0,0,2,2,0,0,0
11376008,3,3,0,0,0,0,0,0,1
11376040,3,3,0,0,1,1,0,0,0
11378014,1,1,0,0,1,1,0,0,0
11378681,1,1,0,0,1,1,0,0,0
11378863,1,1,0,0,1,1,0,0,0
11380537,1,1,0,0,1,1,0,0,0
11380810,2,2,0,0,1,1,0,0,0
11382101,3,2,1,0,2,2,0,0,0
11382194,1,1,0,0,1,1,0,0,0
11382368,1,1,0,0,1,1,0,0,0
11382490,1,1,0,0,1,1,0,0,0
11382568,2,2,0,0,1,1,0,0,0
11383926,4,4,0,0,0,0,0,0,0
11384351,1,0,1,0,1,1,0,0,0
11384863,1,1,0,0,2,2,0,0,0
11384884,2,2,0,0,2,2,0,0,0
11385254,1,1,0,0,1,1,0,0,0
11385327,1,1,0,0,1,1,0,0,0
11385639,1,1,0,0,2,2,0,1,0
11386824,1,0,1,0,1,1,0,0,0
11387435,1,1,0,0,1,1,0,0,0
11387998,2,2,0,0,2,2,0,0,1
11388327,3,2,1,0,1,0,1,0,0
11388926,1,1,0,0,1,1,0,0,0
11389422,1,1,0,0,1,1,0,0,0
11390483,1,1,0,0,1,1,0,0,0
11390879,1,1,0,0,1,1,0,0,0
11393109,2,2,0,0,1,1,0,1,1
11393485,1,1,0,0,1,1,0,0,0
11394422,1,0,1,0,0,0,0,0,0
11394474,1,1,0,0,1,1,0,0,0
11394892,1,1,0,0,1,1,0,0,0
11395246,1,0,1,0,1,1,0,0,0
11395697,2,2,0,0,1,1,0,0,0
11397908,3,3,0,0,1,1,0,1,1
11398299,7,5,2,0,0,0,0,0,0
11398936,4,4,0,0,2,2,0,0,0
11399028,1,1,0,0,1,1,0,0,0
11399768,1,1,0,0,1,1,0,0,0
11545015,2,2,0,0,1,1,0,1,1
11545069,1,1,0,0,1,1,0,0,0
11545984,1,0,1,0,1,1,0,0,0
11546324,1,1,0,0,1,1,0,0,0
11546579,5,5,0,0,0,0,0,0,0
11546747,2,2,0,0,1,1,0,0,0
11547219,1,1,0,0,1,1,0,0,0
11549062,1,1,0,0,1,1,0,0,0
11549235,1,1,0,0,1,1,0,0,0
11550283,1,1,0,0,1,1,0,0,0
11550334,1,1,0,0,1,1,0,0,0
11550477,1,1,0,0,1,1,0,0,0
11550838,1,1,0,0,1,1,0,0,0
11551156,1,1,0,0,1,1,0,0,0
11551455,1,1,0,0,1,1,0,0,0
11551553,1,1,0,0,1,1,0,0,0
11552451,2,2,0,0,1,1,0,0,0
11553798,2,2,0,0,2,2,0,0,0
11556592,2,2,0,0,2,2,0,0,0
11559367,1,1,0,0,1,1,0,0,0
11560281,6,6,0,0,2,0,2,0,1
11563070,1,1,0,0,1,1,0,0,0
11564830,1,1,0,0,1,1,0,0,0
11564865,8,7,1,0,1,1,0,1,1
11566414,1,1,0,0,2,2,0,0,0
11566416,1,1,0,0,1,1,0,0,0
11566815,2,2,0,0,2,2,0,0,0
11566992,1,1,0,0,1,1,0,0,0
11567010,1,1,0,0,1,1,0,0,0
11568671,6,6,0,0,0,0,0,0,0
11568811,3,3,0,0,2,2,0,0,0
11568983,1,1,0,0,1,1,0,0,0
11569008,2,2,0,0,2,2,0,0,0
11569455,2,2,0,0,1,1,0,1,1
11569941,2,2,0,0,1,1,0,0,0
11570383,1,1,0,0,0,0,0,0,0
11571276,1,1,0,0,1,1,0,0,0
11572846,1,1,0,0,1,1,0,0,0
11574309,1,1,0,0,1,1,0,0,0
11574753,1,1,0,0,1,1,0,0,0
11575688,3,3,0,0,2,1,1,2,1
11576133,2,2,0,0,1,1,0,0,0
11576942,2,2,0,0,2,2,0,0,0
11577260,3,3,0,0,1,1,0,1,1
11577962,1,1,0,0,1,1,0,0,0
11578245,2,1,1,0,2,1,1,0,0
11579968,2,2,0,0,1,1,0,1,0
11581676,2,2,0,0,2,2,0,0,0
11581821,4,2,2,0,2,1,1,0,0
11582147,1,1,0,0,1,1,0,0,0
11583770,3,3,0,0,1,1,0,0,0
11584298,2,2,0,0,1,1,0,0,0
11584305,3,3,0,0,2,2,0,0,0
11584404,1,1,0,0,0,0,0,0,0
11586528,3,3,0,0,2,2,0,0,0
11587534,6,6,0,0,1,1,0,1,0
11587763,2,2,0,0,1,1,0,1,1
11590645,2,2,0,0,3,2,1,0,0
11591114,2,2,0,0,2,2,0,0,0
11591657,2,1,1,0,2,1,1,0,0
11591856,3,3,0,0,3,3,0,0,0
11592631,4,4,0,0,2,2,0,2,1
11593019,1,1,0,0,1,1,0,0,0
11595040,2,2,0,0,1,1,0,1,1
